time,open,high,low,close,Volume,Volume MA,RSI,RSI-based MA,Upper Bollinger Band,Lower Bollinger Band,CCI,Smoothing Line,Histogram,MACD,Signal,OnBalanceVolume,Smoothing Line,RSI,RSI-based MA,Upper Bollinger Band,Lower Bollinger Band,True Strength Index,Signal
1998-12-22T09:30:00-05:00,20.78125,20.828,20.75,20.828,1900,NaN,NaN,NaN,NaN,NaN,NaN,NaN,NaN,NaN,NaN,NaN,NaN,NaN,NaN,NaN,NaN,NaN,NaN
1998-12-23T09:30:00-05:00,20.96875,21.14062,20.96875,21.04687,700,NaN,NaN,NaN,NaN,NaN,NaN,NaN,NaN,NaN,NaN,700,NaN,NaN,NaN,NaN,NaN,NaN,NaN
1998-12-24T09:30:00-05:00,21.29687,21.53125,21.20312,21.53125,1500,NaN,NaN,NaN,NaN,NaN,NaN,NaN,NaN,NaN,NaN,2200,NaN,NaN,NaN,NaN,NaN,NaN,NaN
1998-12-28T09:30:00-05:00,21.5,21.5,21.3125,21.34375,2500,NaN,NaN,NaN,NaN,NaN,NaN,NaN,NaN,NaN,NaN,-300,NaN,NaN,NaN,NaN,NaN,NaN,NaN
1998-12-29T09:30:00-05:00,21.73437,21.73437,21.73437,21.73437,100,NaN,NaN,NaN,NaN,NaN,NaN,NaN,NaN,NaN,NaN,-200,NaN,NaN,NaN,NaN,NaN,NaN,NaN
1998-12-30T09:30:00-05:00,21.71875,21.71875,21.67187,21.67187,800,NaN,NaN,NaN,NaN,NaN,NaN,NaN,NaN,NaN,NaN,-1000,280,NaN,NaN,NaN,NaN,NaN,NaN
1998-12-31T09:30:00-05:00,21.85937,22,21.85937,21.92187,3300,NaN,NaN,NaN,NaN,NaN,NaN,NaN,NaN,NaN,NaN,2300,600,NaN,NaN,NaN,NaN,NaN,NaN
1999-01-04T09:30:00-05:00,21.9375,22.25,21.65625,21.65625,13000,NaN,NaN,NaN,NaN,NaN,NaN,NaN,NaN,NaN,NaN,-10700,-1980,NaN,NaN,NaN,NaN,NaN,NaN
1999-01-05T09:30:00-05:00,21.85937,22.29687,21.85937,22.1875,4400,NaN,NaN,NaN,NaN,NaN,NaN,NaN,NaN,NaN,NaN,-6300,-3180,NaN,NaN,NaN,NaN,NaN,NaN
1999-01-06T09:30:00-05:00,22.32812,22.57812,22.21875,22.57812,12900,NaN,NaN,NaN,NaN,NaN,NaN,NaN,NaN,NaN,NaN,6600,-1820,NaN,NaN,NaN,NaN,NaN,NaN
1999-01-07T09:30:00-05:00,22.46875,22.9375,22.32812,22.40625,56200,NaN,NaN,NaN,NaN,NaN,NaN,NaN,NaN,NaN,NaN,-49600,-11540,NaN,NaN,NaN,NaN,NaN,NaN
1999-01-08T09:30:00-05:00,22.60937,23.17187,22.60937,23.17187,25200,NaN,NaN,NaN,NaN,NaN,NaN,NaN,NaN,NaN,NaN,-24400,-16880,NaN,NaN,NaN,NaN,NaN,NaN
1999-01-11T09:30:00-05:00,23.1875,23.21875,23,23.21875,14200,NaN,NaN,NaN,NaN,NaN,NaN,NaN,NaN,NaN,NaN,-10200,-16780,NaN,NaN,NaN,NaN,NaN,NaN
1999-01-12T09:30:00-05:00,23.01562,23.125,22.57812,22.625,5100,NaN,NaN,NaN,NaN,NaN,NaN,NaN,NaN,NaN,NaN,-15300,-18580,NaN,NaN,NaN,NaN,NaN,NaN
1999-01-13T09:30:00-05:00,21.95312,22.375,21.95312,22.125,5500,NaN,63.34504926453038,NaN,NaN,NaN,NaN,NaN,NaN,NaN,NaN,-20800,-24060,NaN,NaN,NaN,NaN,NaN,NaN
1999-01-14T09:30:00-05:00,22.1875,22.21875,21.5625,21.75,127300,NaN,58.48469028943968,NaN,NaN,NaN,NaN,NaN,NaN,NaN,NaN,-148100,-43760,NaN,NaN,NaN,NaN,NaN,NaN
1999-01-15T09:30:00-05:00,22,22.07812,21.89062,22.07812,15800,NaN,61.28388769948813,NaN,NaN,NaN,NaN,NaN,NaN,NaN,NaN,-132300,-65340,NaN,NaN,NaN,NaN,NaN,NaN
1999-01-19T09:30:00-05:00,22,22,21.51562,21.67187,26700,NaN,56.228792303663106,NaN,NaN,NaN,NaN,NaN,NaN,NaN,NaN,-159000,-95100,NaN,NaN,NaN,NaN,NaN,NaN
1999-01-20T09:30:00-05:00,21.67187,21.82812,21.57812,21.59375,40900,NaN,55.28442832187671,NaN,NaN,NaN,NaN,NaN,NaN,NaN,NaN,-199900,-132020,NaN,NaN,NaN,NaN,NaN,NaN
1999-01-21T09:30:00-05:00,21.59375,21.625,21.39062,21.5,59900,20895,54.10993276446532,NaN,NaN,NaN,-62.04893486269214,NaN,NaN,NaN,NaN,-259800,-179820,0.9691821844713076,NaN,NaN,NaN,NaN,NaN
1999-01-22T09:30:00-05:00,21.28125,21.35937,21.04687,21.07812,7000,21150,49.05902105049297,NaN,NaN,NaN,-117.19924783933205,NaN,NaN,NaN,NaN,-266800,-203560,0.8507540607513278,NaN,NaN,NaN,NaN,NaN
1999-01-25T09:30:00-05:00,21.29687,21.5,21.21875,21.5,29300,22580,53.71214403608759,NaN,NaN,NaN,-86.51457919357928,NaN,NaN,NaN,NaN,-237500,-224600,0.7618963677080757,NaN,NaN,NaN,NaN,NaN
1999-01-26T09:30:00-05:00,21.42187,21.4375,21.1875,21.4375,1800,22595,52.94063300864963,NaN,NaN,NaN,-93.3299022995013,NaN,NaN,NaN,NaN,-239300,-240660,0.70165445162651,NaN,NaN,NaN,NaN,NaN
1999-01-27T09:30:00-05:00,21.82812,21.82812,21.26562,21.26562,15100,23225,50.78042299634085,NaN,NaN,NaN,-79.40122272354155,-87.69877738372927,NaN,NaN,NaN,-254400,-251560,0.6633198038148009,NaN,NaN,NaN,NaN,NaN
1999-01-28T09:30:00-05:00,21.39062,21.39062,21,21,6800,23560,47.551266840004324,NaN,NaN,NaN,-117.3671498244737,-98.76242037608557,NaN,NaN,NaN,-261200,-251840,0.6623187637297576,NaN,NaN,NaN,NaN,NaN
1999-01-29T09:30:00-05:00,20.95312,21.10937,20.95312,21.10937,400,23540,48.989645392753644,NaN,NaN,NaN,-116.66352257263887,-98.65527532274693,NaN,-0.31542807172039034,NaN,-260800,-250640,1.349444064268127,NaN,NaN,NaN,NaN,NaN
1999-02-01T09:30:00-05:00,21.28125,21.5,21.28125,21.28125,2900,23520,51.25222968870763,NaN,NaN,NaN,-69.29994697288667,-95.21234887860842,NaN,-0.3059232445567446,NaN,-257900,-254720,1.3161107903070643,NaN,NaN,NaN,NaN,NaN
1999-02-02T09:30:00-05:00,21.20312,21.375,21.1875,21.29687,2800,23010,51.46292766808549,53.89179080889896,NaN,NaN,-71.2613920112141,-90.79864682095099,NaN,-0.2937440979805892,NaN,-255100,-257880,1.2895420960475263,NaN,NaN,NaN,NaN,NaN
1999-02-03T09:30:00-05:00,21.3125,21.39062,21.25,21.3125,1100,22845,51.687949015706906,53.059140791125856,NaN,NaN,-61.83566252095082,-87.28553478043284,NaN,-0.27960768287983484,NaN,-254000,-257800,1.343840811173365,NaN,NaN,NaN,NaN,NaN
1999-02-04T09:30:00-05:00,21.35937,22.01562,21.35937,21.9375,6800,22540,59.728004051077036,53.1479489169571,NaN,NaN,-1.669930674699788,-64.14609095047805,NaN,-0.21548818178517237,NaN,-247200,-255000,3.3478089746326134,NaN,NaN,NaN,NaN,NaN
1999-02-05T09:30:00-05:00,22.04687,22.4375,22.04687,22.23437,44400,21950,62.88734535577104,53.262481606691594,NaN,NaN,65.7454573709948,-27.664294961751324,NaN,-0.1391144623316869,NaN,-202800,-243400,11.379134725048331,NaN,NaN,NaN,NaN,NaN
1999-02-08T09:30:00-05:00,22.29687,22.35937,22.03125,22.125,22300,21805,60.98905823526543,53.602500601806035,NaN,NaN,68.9628206804894,-0.011741431076106323,NaN,-0.08641682501249903,NaN,-225100,-236840,15.647897148562507,NaN,NaN,NaN,NaN,NaN
1999-02-09T09:30:00-05:00,22.125,22.125,21.70312,21.70312,14200,21805,54.19355410068009,53.52458101457771,NaN,NaN,33.79245668897094,20.999028308960902,NaN,-0.07779894021811984,NaN,-239300,-233680,17.704313266496982,4.141944107759878,NaN,NaN,NaN,NaN
1999-02-10T09:30:00-05:00,21.85937,21.85937,21.65625,21.75,4900,21795,54.79629016963075,53.5736065435181,NaN,NaN,31.27660357188416,39.6214815275279,0.13135063541575676,-0.06642072346790329,-0.19777135888366004,-234400,-229760,20.300027767033882,5.522718792228633,NaN,NaN,NaN,NaN
1999-02-11T09:30:00-05:00,21.625,21.82812,21.53125,21.53125,10100,22025,51.3977688851491,53.74065996027925,NaN,NaN,10.772732233138065,42.11001410909547,0.09885758525609561,-0.07419937731354054,-0.17305696256963615,-244500,-229220,20.67122350571121,6.938466609725768,NaN,NaN,NaN,NaN
1999-02-12T09:30:00-05:00,21.5625,21.625,21.42187,21.42187,2500,15785,49.73669000072277,53.4566989577532,NaN,NaN,-18.953017006182545,25.170319233660003,0.06790664416317385,-0.08817365736566884,-0.1560803015288427,-247000,-238060,19.1027276208022,8.248525984946777,NaN,NaN,NaN,NaN
1999-02-16T09:30:00-05:00,21.82812,21.82812,21.21875,21.21875,6300,15310,46.717274106579005,53.012173321891005,NaN,NaN,-30.648784552349813,5.247998187092159,0.03340772584934987,-0.11432064421715538,-0.14772837006650524,-253300,-243700,18.15615776276509,9.495276221456676,NaN,NaN,NaN,NaN
1999-02-17T09:30:00-05:00,21.125,21.42187,21,21,5100,14230,43.64433472962108,52.502452731411026,NaN,NaN,-97.00712470052144,-20.911918090806317,-0.0025801185963935658,-0.15095351831199721,-0.14837339971560365,-258400,-247520,17.522827253720493,10.699526753592796,NaN,NaN,10.229621559511731,NaN
1999-02-18T09:30:00-05:00,21.04687,21.1875,20.92187,21.15625,31000,13735,46.35848673795835,52.41725415269345,NaN,NaN,-101.06519176584516,-47.38027715835218,-0.01367714627958666,-0.16546983256508696,-0.1517926862855003,-227400,-246120,18.642912841019736,11.98385490197065,NaN,NaN,8.24094940881619,NaN
1999-02-19T09:30:00-05:00,21.23437,21.35937,21.1875,21.32812,8100,11145,49.25360630671044,52.43610850369037,NaN,NaN,-44.868265295640825,-58.50847666410796,-0.007563362811336238,-0.1612468897996706,-0.15368352698833437,-219300,-241080,22.712175389740935,13.509764282361568,NaN,NaN,7.27889148630671,NaN
1999-02-22T09:30:00-05:00,21.25,21.75,21.25,21.6875,10000,11295,54.752762595999016,52.686146568496895,NaN,NaN,19.348824558637016,-50.84810835114405,0.021001017602071348,-0.12743225498574517,-0.14843327258781652,-209300,-233540,28.475838502277668,15.44974483321661,NaN,NaN,7.922900875497198,NaN
1999-02-23T09:30:00-05:00,21.73437,21.75,21.375,21.5,5300,10095,51.610373688637935,52.696678427107784,NaN,NaN,12.162514148652823,-42.28584861094352,0.027191135662906485,-0.11444435300918343,-0.14163548867208992,-214600,-225800,33.92325340363314,17.78072421232987,NaN,NaN,7.567147689679898,NaN
1999-02-24T09:30:00-05:00,21.8125,21.8125,21.4375,21.4375,2800,10145,50.56854154354084,52.6167207505245,NaN,NaN,15.035023872823473,-19.87741889627454,0.0269482372040383,-0.10795019216704205,-0.13489842937108035,-217400,-217600,39.20595741333933,20.48516111248458,NaN,NaN,6.981332017431486,NaN
1999-02-25T09:30:00-05:00,21.3125,21.4375,21.25,21.4375,6800,9730,50.56854154354084,51.96247342855764,NaN,NaN,-32.90626824360763,-6.2456341918270315,0.02661316526239238,-0.10163197279308989,-0.12824513805548227,-217400,-215600,40.45634299504828,23.135770685371416,NaN,NaN,6.4977501286779145,NaN
1999-02-26T09:30:00-05:00,21.4375,21.4375,21.4375,21.4375,700,9425,50.568541543540825,51.082558870541185,NaN,NaN,-21.828104183401365,-1.6376019693791393,0.026177229005374822,-0.09552360179876374,-0.12170083080413856,-217400,-215220,40.705878791504205,25.23053811868969,NaN,NaN,6.09281095887727,NaN
1999-03-01T09:30:00-05:00,21.28125,21.29687,21.1875,21.1875,2100,9510,45.93591624680429,50.00733444279397,NaN,NaN,-85.44741251304013,-22.596849383714574,0.009686846294065923,-0.10959227293655616,-0.11927911923062208,-219500,-217260,39.74296183498921,26.95161416772017,NaN,NaN,4.485558925263522,NaN
1999-03-02T09:30:00-05:00,21.23437,21.4375,21,21,47700,11750,42.77113655052283,49.19144747492559,NaN,NaN,-100.63522990974676,-45.15639819539449,-0.012035173611235711,-0.1343230862446667,-0.122287912633431,-267200,-227780,35.12811960681559,28.19617176345721,NaN,NaN,2.1942926482043705,NaN
1999-03-03T09:30:00-05:00,21.26562,21.26562,20.85937,20.85937,3900,11805,40.51646130998844,48.17145969923685,NaN,NaN,-130.82680651287018,-74.32876427253322,-0.03287901368044649,-0.16338667973398913,-0.13050766605354264,-271100,-238520,31.151217682212078,28.971256757398514,NaN,NaN,-0.4196840429928266,NaN
1999-03-04T09:30:00-05:00,20.84375,21.125,20.84375,20.92187,2900,11895,41.980307187157386,47.49878386366601,NaN,NaN,-126.17918870909193,-92.98334836563008,-0.03904153912812097,-0.17930958996369384,-0.14026805083557287,-268200,-248680,27.929900583413342,29.48973369152009,NaN,NaN,-2.2680165793624543,NaN
1999-03-05T09:30:00-05:00,21.17187,21.625,21.17187,21.625,4200,11765,55.305959302890486,47.896588813820856,NaN,NaN,1.606425702810696,-88.29644238838766,0.005293442308180796,-0.13365124795034689,-0.13894469025852768,-264000,-258000,25.341142169793798,29.93533473073378,NaN,NaN,-0.08866386666435014,4.978068554557437
1999-03-08T09:30:00-05:00,21.4375,21.76562,21.4375,21.76562,6700,9880,57.41259931585118,48.660540614483146,NaN,NaN,63.04627450980231,-58.59770498381918,0.04304503087326278,-0.08513840166694919,-0.12818343254021197,-257300,-265560,23.443011523641516,30.312967142224952,NaN,NaN,2.3485308771919553,4.602420314933797
1999-03-09T09:30:00-05:00,21.65625,21.65625,21.5,21.57812,5600,9045,53.773076432743785,49.3840221647062,NaN,NaN,55.13142245448182,-27.44437451097346,0.05365331548972593,-0.06111678817805455,-0.11477010366778048,-262900,-264700,24.139123508524946,30.78555973185384,NaN,NaN,3.2984866776405317,4.4161440810347585
1999-03-10T09:30:00-05:00,21.59375,21.96875,21.54687,21.875,26800,9675,58.28248914575951,50.235736622406286,NaN,NaN,128.31689397542686,24.38436558668595,0.07748231247647108,-0.01791721307219163,-0.09539952554866271,-236100,-257700,29.739172212372466,31.578149686950464,NaN,NaN,5.515210162687283,4.573153521270833
1999-03-11T09:30:00-05:00,21.98437,22.21875,21.9375,22.10937,13900,10125,61.477315776287774,51.108858727376095,NaN,NaN,205.09707606250734,90.6396185410058,0.10418280042311627,0.03482897498023263,-0.06935382544288364,-222200,-248500,36.38581565327228,32.554838277202705,NaN,NaN,8.38570185068371,5.1178032826155295
1999-03-12T09:30:00-05:00,22.29687,22.35937,22.01562,22.01562,7900,10015,59.51394821756092,51.44894341463051,NaN,NaN,189.57570973314432,128.23347534707253,0.11010609404674646,0.06827879211554944,-0.04182730193119702,-230100,-241720,40.828336250483304,33.437159544931674,NaN,NaN,10.138902123006863,5.835103116957148
1999-03-15T09:30:00-05:00,22.01562,22.15625,21.90625,22.0625,6700,10225,60.19847033796318,52.06237888958232,NaN,NaN,140.96236487423016,143.81669341995809,0.11141985995249756,0.09744752300942494,-0.013972336943072625,-223400,-234940,44.96720576395316,34.22601328495453,NaN,NaN,11.765148348678059,6.682252435774421
1999-03-16T09:30:00-05:00,22.03125,22.09375,21.95312,21.96875,7500,10285,58.08350509888127,52.599162000678064,NaN,NaN,114.44737150149551,155.67988322936083,0.10054696694496615,0.11171137173813506,0.011164404793168912,-230900,-228540,48.620563923732966,34.89848517855408,NaN,NaN,12.537190326933178,7.5186721345113865
1999-03-17T09:30:00-05:00,22.07812,22.07812,21.875,21.90625,3500,10205,56.65446201572876,53.033870605834345,NaN,NaN,93.07166974391974,148.6308383830594,0.08437082236154209,0.11662793274509653,0.03225711038355444,-234400,-228200,48.81496439909757,35.4955295645576,NaN,NaN,12.793526545303557,8.272222764624553
1999-03-18T09:30:00-05:00,22.14062,22.375,22.01562,22.375,11300,9220,63.84010469176964,53.98183940213641,NaN,NaN,140.25364016620898,135.66215120379974,0.09942951839278735,0.15654400837453863,0.057114489981751275,-223100,-228380,48.70988843207227,36.06724453888389,NaN,NaN,15.19506100178654,9.261199655647694
1999-03-19T09:30:00-05:00,22.625,22.625,22.32812,22.32812,5300,9080,62.72025422561654,55.18072068633728,NaN,NaN,149.72510834689032,127.69203092654895,0.10014328369337183,0.18229359459846606,0.08215031090509423,-228400,-228040,48.933491459731,36.723710940651166,NaN,NaN,16.82576770943982,10.341852234760854
1999-03-22T09:30:00-05:00,22.23437,22.46875,22.23437,22.39062,24900,9825,63.636082826424605,56.67107399175884,NaN,NaN,117.83726531476047,123.06701101465504,0.09858063683090408,0.20537610694372432,0.10679547011282024,-203500,-224060,51.59381078024381,37.89983173875318,NaN,NaN,18.43633107172696,11.49820635432744
1999-03-23T09:30:00-05:00,22.28125,22.28125,21.70312,21.82812,16700,10395,51.397970757329915,57.44832466656895,NaN,NaN,38.114640803082686,107.80046487497248,0.05556237035856203,0.17624843306102278,0.12068606270246075,-220200,-221920,53.01125771179261,39.461263169437494,NaN,NaN,16.07835573088944,12.152513408122012
1999-03-24T09:30:00-05:00,21.73437,22,21.6875,21.84375,76000,14055,51.67606653801526,58.14087890591594,NaN,NaN,19.332715553647986,93.05267403691812,0.02558388135810244,0.1526659144000888,0.12708203304198637,-144200,-203880,62.87927330046584,41.957646934941245,NaN,NaN,14.290369416794174,12.457921409360893
1999-03-25T09:30:00-05:00,21.84375,22.125,21.84375,21.92187,3800,13905,53.11989794872269,57.98473166633253,NaN,NaN,36.54936017388578,72.31181803845348,0.00927964915632365,0.13868159448739092,0.12940194533106728,-140400,-187340,69.25456795396522,45.094320205239214,NaN,NaN,13.226493360390743,12.567717402365156
1999-03-26T09:30:00-05:00,21.70312,21.90625,21.625,21.75,4200,14080,49.60810145951581,57.427267533737144,NaN,NaN,-3.8298731004969375,41.600821748976024,-0.013574056980220184,0.11243437410579205,0.12600843108601223,-144600,-170580,74.10728129830756,48.713196617715354,NaN,NaN,11.277747078314889,12.383435927500832
1999-03-29T09:30:00-05:00,21.98437,22.21875,21.92187,22.10937,5300,14240,56.13774521441142,57.5961724467134,NaN,NaN,53.93562886200416,28.820494458424736,-0.005401383706940793,0.11925670145233624,0.12465808515927704,-139300,-157740,77.09056228577951,52.49544224466211,NaN,NaN,11.506812750861947,12.258204045123849
1999-03-30T09:30:00-05:00,22.09375,22.09375,21.84375,22.0625,16500,12680,55.13431183866996,57.37130263906415,NaN,NaN,31.26947784984686,27.451461867777574,-0.004123378841357744,0.11950386160757986,0.12362724044893761,-155800,-144860,79.62639142450107,56.05881504552844,NaN,NaN,11.394634235652111,12.13483692948503
1999-03-31T09:30:00-05:00,21.9375,22.04687,21.71875,21.75,10600,13015,48.86306322454562,56.470284599654,NaN,NaN,-19.698941717696204,19.64513041350873,-0.02417630171408798,0.09340686330632764,0.11758316502041562,-166400,-149300,76.48352972262994,58.922937479053985,NaN,NaN,9.345823630727262,11.736406458233919
1999-04-01T09:30:00-05:00,21.78125,22.17187,21.78125,22,12300,13485,53.427012677556334,56.035503489653664,NaN,NaN,9.389776070035596,14.213213592738697,-0.02059529091216833,0.0918390513802052,0.11243434229237353,-154100,-152040,74.52854593342597,61.3300953135499,NaN,NaN,9.003265803161636,11.345957793223592
1999-04-05T09:30:00-04:00,22.0625,22.42187,22.0625,22.26562,11900,13870,57.742369438184035,55.86006771109802,NaN,NaN,100.83300166600256,35.145788546038595,-0.0013449381091185375,0.11075316965597537,0.11209810776509391,-142200,-151560,74.6507864246668,63.450351075029445,NaN,NaN,10.081234356131743,11.165283016496184
1999-04-06T09:30:00-04:00,22.14062,22.26562,21.875,21.875,52800,16175,50.35331206242982,55.3079110656372,NaN,NaN,-4.461130489823226,23.46643667567312,-0.015159118926696385,0.09314920910672342,0.1083083280334198,-195000,-162700,66.65563233552231,64.7385702473001,NaN,NaN,8.558147993976528,10.792835156136233
1999-04-07T09:30:00-04:00,22,22.1875,21.9375,22.10937,45200,18155,54.1448449855281,55.12865270633716,NaN,NaN,18.572092317147742,20.926959569133295,-0.00905339425809737,0.09699158521079809,0.10604497946889546,-149800,-161500,67.06482995602482,66.0421320727949,NaN,NaN,8.54698206342275,10.471999000034307
1999-04-08T09:30:00-04:00,22.07812,22.42187,22.04687,22.42187,12000,17415,58.67647642788638,54.75982211605979,NaN,NaN,111.38193926994263,47.14313576666106,0.014224377671074692,0.12382545155773883,0.10960107388666414,-137800,-155780,69.01664441558287,67.49261464304567,NaN,NaN,10.056339475854292,10.41261906800859
1999-04-09T09:30:00-04:00,22.09375,22.45312,22.09375,22.3125,25100,17975,56.56939731908538,54.3204751941647,NaN,NaN,94.210001788013,64.10718091025655,0.020089818807353263,0.13471334739585572,0.11462352858850246,-162900,-157540,67.68745123495745,68.83218319841899,NaN,NaN,10.58674854493864,10.437494707570027
1999-04-12T09:30:00-04:00,22.3125,23.01562,22.3125,22.96875,16200,18390,64.74918093325064,54.399982201795105,NaN,NaN,231.49890049323187,90.2403606757024,0.06354836323026536,0.19405898262633414,0.13051061939606878,-146700,-158440,66.97709678097888,69.93098934132863,NaN,NaN,13.992111087292209,10.945297047530339
1999-04-13T09:30:00-04:00,23.14062,23.29687,23.01562,23.25,68000,21455,67.56836063155191,55.555010049953815,NaN,NaN,270.8164874106097,145.295884255789,0.10421490427737651,0.26077924974278943,0.15656434546541292,-78700,-135180,74.44228622387354,71.46177709219155,NaN,NaN,17.74598433821184,11.916823803341982
1999-04-14T09:30:00-04:00,26.40625,26.40625,23.25,24.375,300800,36120,75.8784178139598,57.28374942680699,NaN,NaN,403.3559184201701,222.25264947639343,0.194608291417469,0.39982470973724915,0.20521641831978016,222100,-60800,85.62959661426929,73.08680018603465,NaN,NaN,24.789638653492002,13.755797353363413
1999-04-15T09:30:00-04:00,24.6875,25.85937,24.6875,25.3125,1005500,86220,80.3882036837254,59.23148555073576,NaN,NaN,310.52266435081265,262.08079449256746,0.2990215679705035,0.5789933782829095,0.27997181031240603,1227600,212280,94.73746761263044,74.90700730451074,NaN,NaN,32.67556647867312,16.45862151412194
1999-04-16T09:30:00-04:00,25.46875,25.89062,25.375,25.59375,170800,94195,81.5053309044873,61.509859082519434,NaN,NaN,237.84342139353382,290.8074784136717,0.36418685058591593,0.735205373544801,0.37101852295888504,1398400,524540,97.04431004634698,76.54536650079926,NaN,NaN,38.88641551941789,19.662592086307075
1999-04-19T09:30:00-04:00,25.59375,26.84375,25.59375,25.85937,864200,137140,82.51813609800507,63.39417271706184,NaN,NaN,202.8565600391517,285.0790103228556,0.3995086535806247,0.8704043399346659,0.4708956863540412,2262600,1006400,98.28999751522319,78.05961187433095,NaN,NaN,43.951956845441316,23.132501337611966
1999-04-20T09:30:00-04:00,25.92187,25.9375,25.45312,25.54687,140800,142935,77.16424655420357,64.9677394824571,NaN,NaN,140.6582106099347,259.0473549627206,0.37646868559378355,0.9414815433462707,0.5650128577524871,2121800,1446500,98.79112383308528,79.42852133208699,NaN,NaN,45.9608281640647,26.39369088424807
1999-04-21T09:30:00-04:00,25.71875,25.84375,25.42187,25.65625,83200,146260,77.70939457831555,67.0281917220121,NaN,NaN,117.88346827794416,201.9528649342754,0.3441218311298584,0.9951651466648102,0.6510433155349518,2205000,1843080,99.05879366911554,81.04104018540738,NaN,NaN,47.68384337229512,29.43514123968336
1999-04-22T09:30:00-04:00,25.6875,25.71875,25,25.25,86900,146805,70.93600633603343,68.27883412618904,NaN,NaN,88.65304271060155,157.57894060623318,0.2739466508319486,0.9934766290748875,0.719529978242939,2118100,2021180,99.14983500676098,82.7997036906456,NaN,NaN,46.821533530438295,31.918911566934064
1999-04-23T09:30:00-04:00,25.125,25.6875,25.125,25.625,127400,152985,73.25351681837064,69.38677322477379,NaN,NaN,83.66623166389338,126.7435026603051,0.23297327769455745,1.0107465753611358,0.7777732976665783,2245500,2190600,99.22648433370848,84.55511068414856,NaN,NaN,46.873710364750735,34.05531139519359
1999-04-26T09:30:00-04:00,25.75,25.75,25.29687,25.375,38100,154680,69.28698014103792,70.73917808753151,NaN,NaN,74.17090006408417,101.00637066529158,0.1720338903659545,0.9928156606240215,0.820781770258067,2207400,2179560,98.60263070039993,86.83703913878269,NaN,NaN,45.62253092153812,35.707771327528526
1999-04-27T09:30:00-04:00,25.3125,26,25.1875,25.875,84500,158640,72.49481659969632,72.04989034568639,NaN,NaN,74.70117661395942,87.81496386609652,0.1492458833578314,1.0073391244553562,0.8580932410975248,2291900,2213580,98.63119004126875,89.09177914487154,NaN,NaN,45.60059841000015,37.12103233931019
1999-04-28T09:30:00-04:00,26,27.375,26,27.25,138200,164725,78.99276169885601,73.50105357932706,NaN,NaN,111.5689605467715,86.55206231986199,0.2070653016852273,1.116924868204059,0.9098595665188316,2430100,2258600,98.66993071002132,91.20987102304571,NaN,NaN,48.05303766976716,38.68274738651833
1999-04-29T09:30:00-04:00,27.3125,27.79687,27.3125,27.45312,733600,200875,79.75368714757798,75.15707428136226,NaN,NaN,126.34806870332392,94.09106751840646,0.2371183155546286,1.2062574609621173,0.9691391454074887,3163700,2467720,98.83488629720699,93.4346878132064,NaN,NaN,50.18173556113014,40.325459982891445
1999-04-30T09:30:00-04:00,27.4375,27.625,26.76562,27.125,527700,226645,75.02599069551445,75.89113212152395,NaN,NaN,105.56366295002123,98.47055377563204,0.21374952005536452,1.2363260454766944,1.02257652542133,2636000,2545820,98.89024185752552,95.71419817581686,NaN,NaN,50.23641910804033,41.74131128648414
1999-05-03T09:30:00-04:00,27.21875,27.84375,27.125,27.75,181000,235100,77.73357120975317,76.61721859139547,NaN,NaN,115.36823050057485,106.71001986293018,0.21846071361603547,1.2956524174413744,1.077191703825339,2817000,2667740,98.97232558837585,97.46634384470988,NaN,NaN,51.22195207196915,43.09568854155343
1999-05-04T09:30:00-04:00,27.92187,28.01562,27.39062,27.57812,415700,253245,75.31529284277451,76.57699537916794,NaN,NaN,116.27312918816237,115.02441037777075,0.18917199566894527,1.3136566984115206,1.1244847027425753,2401300,2689620,98.98680920530649,98.4204304583554,NaN,NaN,51.19210325800678,44.25231921533248
1999-05-05T09:30:00-04:00,27.64062,28.03125,27.32812,27.90625,293900,265680,76.79919736061042,76.32063778465974,NaN,NaN,117.98385754272263,116.30738977696099,0.17158646371041386,1.3389677823805926,1.1673813186701787,2695200,2742640,99.02275132341057,98.72652215198255,NaN,NaN,51.64293975995184,45.3081221502781
1999-05-06T09:30:00-04:00,27.90625,28.25,27.6875,28.14062,139600,272060,77.82459046297552,76.05772775312319,NaN,NaN,120.53009816189181,115.14379566867456,0.15588350022638786,1.3622356939531635,1.2063521937267756,2834800,2676860,94.54175171920599,98.5477679857582,NaN,NaN,52.32815715908615,46.310984294393535
1999-05-07T09:30:00-04:00,28.14062,28.3125,27.76562,28.20312,32100,272410,78.10252600159029,75.7423270319507,NaN,NaN,111.30278597948657,116.29162027456763,0.13086003757516962,1.3699272406957377,1.239067203120568,2866900,2723040,94.72231447253827,98.29293348270926,NaN,NaN,52.959300476315676,47.26074374895384
1999-05-10T09:30:00-04:00,28.20312,28.48437,27.95312,28.04687,84600,275830,75.55306023502571,75.62724229486658,NaN,NaN,103.27121204957824,113.87221658436832,0.0870480674195091,1.3478772873949545,1.2608292199754454,2782300,2716100,94.21788730515883,97.96627373071452,NaN,NaN,52.751188647608686,48.04509302019025
1999-05-11T09:30:00-04:00,28.14062,28.21875,27.6875,28,152800,280070,74.76467197640048,75.41690496615834,NaN,NaN,84.2223623111752,107.46206320897087,0.040538496540062585,1.3115023406505237,1.2709638441104611,2629500,2761740,94.42803535693228,97.63550527984428,NaN,NaN,52.363172678177214,48.66196154275982
1999-05-12T09:30:00-04:00,27.92187,27.92187,27.04687,27.29687,167300,273395,63.978921673880194,74.91997034743312,NaN,NaN,45.31942140919735,92.92917598226582,-0.04719714514360729,1.211967412680952,1.2591645578245594,2462200,2715140,90.79937243238243,97.03904366738868,NaN,NaN,48.76638869977715,48.67687970804801
1999-05-13T09:30:00-04:00,27.10937,27.40625,27.03125,27.1875,126900,229465,62.46930097045192,74.14966921543892,NaN,NaN,26.963586043814203,74.2158735586503,-0.11817329410316502,1.1114479401956032,1.2296212342987682,2335300,2615240,83.40029589456287,95.90860163602113,NaN,NaN,45.37231339709133,48.20479880648277
1999-05-14T09:30:00-04:00,27.15625,27.48437,27.04687,27.10937,36800,222765,61.35554752942381,73.58313831460934,NaN,NaN,23.287097372600797,56.61273583727315,-0.1726612260386613,1.0137947017504416,1.186455927789103,2298500,2501560,75.82800066087106,94.28184234748336,NaN,NaN,42.25068193294308,47.354210681691384
1999-05-17T09:30:00-04:00,27.10937,27.26562,26.8125,27.07812,23600,180735,60.88795166920965,72.75407653386029,NaN,NaN,8.18199681896484,37.594892791150464,-0.21057301360454095,0.9232396607834268,1.1338126743879677,2274900,2400080,69.74066682879848,92.21823354659263,NaN,NaN,39.53161115629674,46.23669646377786
1999-05-18T09:30:00-04:00,26.96875,26.98437,26.20312,26.42187,53100,176350,51.93649986597964,70.82148640294055,NaN,NaN,-38.31444746703134,13.087530835509156,-0.2755138978558558,0.7894203020681481,1.0649341999240038,2221800,2318540,65.21073621969623,89.82829108299798,NaN,NaN,34.32067184160555,44.53440723203896
1999-05-19T09:30:00-04:00,26.42187,26.82812,26.34375,26.6875,55400,174960,54.831134695293265,69.04130408492021,NaN,NaN,-38.515546572684535,-3.6794627608672217,-0.29453160798263145,0.6967696899457145,0.991301297928346,2277200,2281540,63.204557813804016,87.28326761989776,NaN,NaN,30.692900753380027,42.55704916365911
1999-05-20T09:30:00-04:00,26.79687,26.90625,26.34375,26.375,36500,172440,50.94400479228946,67.32116223468987,NaN,NaN,-57.03062334975178,-20.47830463958042,-0.31999223132844534,0.5913110087677893,0.9113032400962346,2240700,2262620,62.15160982000561,84.65907961721777,NaN,NaN,26.41326566603207,40.250794378283814
1999-05-21T09:30:00-04:00,26.25,26.59375,26.1875,26.35937,11800,166660,50.75021391094132,65.39377957048902,NaN,NaN,-85.06643693200013,-42.149011500500606,-0.32848158303198716,0.5007012613062507,0.8291828443382379,2228900,2248700,61.34192000562186,81.9711935041639,NaN,NaN,22.87166711339268,37.768061911870795
1999-05-24T09:30:00-04:00,26.39062,26.89062,26.125,26.25,35000,166505,49.335958836086746,63.53811285572561,NaN,NaN,-94.26680680005194,-62.63877222430396,-0.331122236447581,0.41528004877876157,0.7464022852263426,2193900,2232500,60.35643429487572,79.21188101056171,NaN,NaN,19.494836720231312,35.15760117020801
1999-05-25T09:30:00-04:00,26.48437,26.64062,26,26,123400,168450,46.16883350053423,61.35022972286301,NaN,NaN,-129.26944784332855,-80.8297722995634,-0.33817859517555804,0.32367904125689506,0.6618576364324531,2070500,2202240,58.4669554317055,76.3150384468685,NaN,NaN,15.659306186860858,32.37213045830128
1999-05-26T09:30:00-04:00,25.57812,25.89062,25.5,25.75,46400,163860,43.183427056385426,58.87586090810658,NaN,NaN,-165.92127813210558,-106.31091861144759,-0.34686194903740264,0.22828020013569983,0.5751421491731025,2024100,2151620,55.34562559024931,73.51531515194301,NaN,NaN,11.471384582073568,29.386309618840176
1999-05-27T09:30:00-04:00,25.57812,25.6875,25,25.15625,35100,128935,37.0549920353867,55.94389419623489,NaN,NaN,-176.12742597991718,-130.1302791374807,-0.3772566295635348,0.10357136221868402,0.4808279917822188,1989000,2101280,52.35238640483755,70.48889171853583,NaN,NaN,5.700954595806175,26.00268747269246
1999-05-28T09:30:00-04:00,25.04687,25.25,24.65625,24.65625,49400,105020,32.8297540565173,52.89222946919858,NaN,NaN,-176.67214937301785,-148.45142162568422,-0.41282345949368426,-0.03520133258488656,0.3776221269087977,1939600,2043420,49.06763045086941,67.26387337180087,NaN,NaN,-0.7618937706618459,22.179175866498987
1999-06-01T09:30:00-04:00,24.90625,25.90625,24.85937,25.71875,215900,106765,46.73021018852224,50.88976791292157,NaN,NaN,-107.9415677516721,-151.18637381600826,-0.3491116125878654,-0.05876738882603405,0.29034422376183133,2155500,2035740,48.63146481039677,63.99268976133404,NaN,NaN,-1.980040440065831,18.72785925127544
1999-06-02T09:30:00-04:00,25.78125,25.78125,25.375,25.6875,11700,86565,46.4258988041159,49.635980565081255,NaN,NaN,-89.01920447082249,-143.13632514150706,-0.2955185684999491,-0.07905398686310505,0.21646458163684407,2143800,2050400,49.5532859872159,61.04654072953643,NaN,NaN,-3.008795215944523,15.622622898815445
1999-06-03T09:30:00-04:00,25.625,25.89062,25.51562,25.76562,57600,74750,47.348947094353946,48.55595528821711,NaN,NaN,-74.0648692910021,-124.76504337328636,-0.24342394542728862,-0.08781535014726671,0.1556085952800219,2201400,2085860,51.80612813266101,58.789814460829156,NaN,NaN,-3.5345747056433745,12.885880383892756
1999-06-04T09:30:00-04:00,25.76562,26.34375,25.625,26.25,5500,68045,52.78134745980728,47.943512426101655,NaN,NaN,-40.452146014369205,-97.62998738017676,-0.16851801332771305,-0.05503892137961941,0.11347909194809364,2206900,2129440,54.4957020008138,57.266078842253634,NaN,NaN,-2.2391400532406904,10.725163178587978
1999-06-07T09:30:00-04:00,26.375,26.5625,26.25,26.32812,13900,67135,53.612623448096784,47.42384612459359,NaN,NaN,-6.294148836095566,-63.554387272792304,-0.10878356485790461,-0.02250036412428713,0.08628320073361748,2220800,2185680,57.77096083969003,56.4110998430316,NaN,NaN,-0.9460940933001211,9.057840711175393
1999-06-08T09:30:00-04:00,26.20312,26.40625,25.90625,26,44700,65140,49.658245554259665,47.26111367375644,NaN,NaN,-26.323621963666643,-47.23079811519121,-0.0873670349023622,-0.022925592894335267,0.06444144200802693,2176100,2189800,58.00940234336084,55.89671885186478,NaN,NaN,-1.0301055779584822,7.616705527013411
1999-06-09T09:30:00-04:00,26.04687,26.40625,25.75,25.75,90300,62015,46.82440527102644,46.68920442916596,NaN,NaN,-33.80219117757292,-36.1873954565413,-0.08590556077701442,-0.042940508963241086,0.042965051813773324,2085800,2178200,57.03297013252165,55.45589116034462,NaN,NaN,-1.9466883268754058,6.250506405029294
1999-06-10T09:30:00-04:00,25.78125,26.1875,25.78125,26.1875,59900,56645,51.98804700398296,46.76377887285836,NaN,NaN,-16.55895612415431,-24.686212823171747,-0.052957701916417854,-0.023232075581749,0.029725626334668857,2145700,2167060,56.0571128272954,55.0205699465796,NaN,NaN,-1.143755622969732,5.19418325817229
1999-06-11T09:30:00-04:00,26.3125,26.48437,25.95312,25.95312,3400,50470,49.230005444617916,46.655192553835256,NaN,NaN,1.8143825690423026,-16.232907106489442,-0.04475907895253664,-0.02622322235600194,0.018535856596534696,2142300,2154140,54.884189589597874,54.55930348829217,NaN,NaN,-1.3043990405030514,4.265814358361528
1999-06-14T09:30:00-04:00,26.3125,26.84375,26.3125,26.57812,222900,59775,55.942196309401254,47.12706665907201,NaN,NaN,81.8106031998162,1.3880433006929274,0.002443055986698077,0.02158967657990729,0.019146620593209214,2365200,2183020,57.047631980613914,54.3229604658449,NaN,NaN,0.7277967379128863,3.760383269726008
1999-06-15T09:30:00-04:00,26.75,27.01562,26.64062,26.8125,62700,61730,58.17533095609542,47.98467362018352,NaN,NaN,127.76172636982989,32.20511296739223,0.046683398637920474,0.07750086889060981,0.030817470252689334,2427900,2233380,60.59601080904502,54.475035849940575,NaN,NaN,3.105827291012801,3.6668752727669784
1999-06-16T09:30:00-04:00,26.9375,26.9375,26.5,26.92187,100700,64110,59.21420604522662,49.12972926224361,NaN,NaN,116.04930869155446,62.175412941217715,0.07866394833456505,0.12914740567089567,0.050483457336330605,2528600,2321940,65.92680903368267,55.23083466732867,NaN,NaN,5.349534299347268,3.90725513370702
1999-06-17T09:30:00-04:00,26.78125,27.01562,26.59375,27.01562,35700,63125,60.12842857486962,50.77783187220667,NaN,NaN,125.05767973241396,90.49874011253137,0.10010770109932124,0.17561808371048215,0.07551038261116091,2564300,2405660,70.05160024083632,56.49506422704287,NaN,NaN,7.458503940457563,4.41457639181424
1999-06-18T09:30:00-04:00,26.89062,27.03125,26.8125,27,8600,61730,59.887563363460764,52.710532536988346,NaN,NaN,127.39713806859629,115.61529121244216,0.10661517313254978,0.20877934902684814,0.10216417589429835,2555700,2488340,73.46762647257086,58.23792108573583,NaN,NaN,9.120289370013174,5.086821102985516
1999-06-21T09:30:00-04:00,27.07812,27.07812,26.34375,26.34375,66400,64460,50.698660152686536,52.99399324871437,NaN,NaN,68.76568821609195,113.0063082156973,0.06229323381292036,0.1800307181604488,0.11773748434752844,2489300,2513160,74.41121621830696,60.07933190058656,NaN,NaN,7.938264436840354,5.494170150679064
1999-06-22T09:30:00-04:00,26.4375,26.4375,25.9375,26,56100,65515,46.6600639112783,53.010719327797396,NaN,NaN,1.3376083057192554,87.72148460287518,0.008236874546856274,0.12803357753109879,0.11979670298424251,2433200,2514220,74.45300269396553,61.857883093925814,NaN,NaN,5.686306857444474,5.521618251645552
1999-06-23T09:30:00-04:00,26,26.1875,25.78125,26.125,7700,59730,48.27367031134499,53.0767709861539,NaN,NaN,-11.875521116765505,62.13651864121118,-0.01919135046666451,0.09580751490091188,0.11499886536757639,2440900,2496680,72.34767791243466,63.325136649623936,NaN,NaN,4.307488723555173,5.348171176204069
1999-06-24T09:30:00-04:00,26.03125,26.03125,25.53125,25.53125,101900,62505,41.80452762552901,52.2927124265626,NaN,NaN,-63.706591925166656,24.383664309695057,-0.07431694882439907,0.022102679337077547,0.09641962816147662,2339000,2451620,67.0984474765904,64.22533275503655,NaN,NaN,1.0135475750199843,4.728939233177771
1999-06-25T09:30:00-04:00,25.5625,25.98437,25.5625,25.6875,38000,62650,43.933834950396324,51.60137039101256,NaN,NaN,-63.01714261264839,-13.699191826553875,-0.09588031802795667,-0.023430769373469218,0.07244954865448745,2377000,2415880,63.182678010476266,64.61188398152129,NaN,NaN,-1.0384296256705992,3.9050293961994322
1999-06-28T09:30:00-04:00,25.9375,26.28125,25.9375,26.17187,85300,64445,50.03680510389494,51.62841035884365,NaN,NaN,-11.638824103843296,-29.780094290540923,-0.07411876226944512,-0.020198904182318955,0.05391985808712617,2462300,2410480,62.58835563576267,64.93895207383571,NaN,NaN,-0.9248508932821883,3.215046497702058
1999-06-29T09:30:00-04:00,25.9375,26.01562,25.82812,26.01562,6900,53995,48.213592314242646,51.727638004787664,NaN,NaN,-50.66595387660911,-40.18080672700659,-0.06705669974308738,-0.029901016591733054,0.03715568315135433,2455400,2414920,62.89738691674183,65.3578389869943,NaN,NaN,-1.3847836242229532,2.5579279088556275
1999-06-30T09:30:00-04:00,26,26.32812,25.84375,26,27100,54765,48.02520022691163,51.44457752071115,NaN,NaN,-36.51245150139419,-45.10819280393233,-0.06045068593970761,-0.03840767427328018,0.022043011666427425,2428300,2412400,62.58141876950392,65.82386084000919,NaN,NaN,-1.8092203934130069,1.9340495799601083
1999-07-01T09:30:00-04:00,26.14062,26.48437,25.96875,26.25,13700,52570,51.304815108616715,51.59277821099677,NaN,NaN,-6.321784682058236,-33.631231355310646,-0.037387785595829476,-0.024691720328359423,0.012696065267470054,2442000,2433000,64.16614971437771,66.48685799177919,NaN,NaN,-1.2277383494862861,1.4823655900391948
1999-07-02T09:30:00-04:00,26.375,26.8125,26.375,26.78125,54600,55025,57.44923657342167,51.70042394414109,NaN,NaN,73.57010370584473,-6.313782091612021,0.01281490933796163,0.028714701939922094,0.015899792601960464,2496600,2456920,65.96845566922417,67.12405968382278,NaN,NaN,1.1954122724506335,1.4413722589551146
1999-07-06T09:30:00-04:00,26.875,26.875,26.53125,26.65625,15200,55090,55.669292194582816,51.521421175461626,NaN,NaN,72.71392201952423,10.556767133061486,0.03548704386015492,0.060258597427154115,0.024771553566999192,2481400,2460740,66.26030790768432,67.52865233372559,NaN,NaN,2.66479897901287,1.616147504677651
1999-07-07T09:30:00-04:00,26.65625,26.65625,26.4375,26.5,38700,54790,53.44041230361884,51.10900733677535,NaN,NaN,38.29507324756342,28.34897255789599,0.03763986157081301,0.07182138053051546,0.034181518959702444,2442700,2458200,65.85588939515506,67.52358664525931,NaN,NaN,3.254286846156417,1.850167410603189
1999-07-08T09:30:00-04:00,26.40625,26.75,26.25,26.3125,85900,54570,50.811368697531655,50.44350305982264,NaN,NaN,16.602683162236648,38.97199949062216,0.02473862391488782,0.06510479885331222,0.0403661749384244,2356800,2443900,63.50583344509924,67.05603187413524,NaN,NaN,3.0050449147127196,2.0151499111902647
1999-07-09T09:30:00-04:00,26.28125,26.98437,26.28125,26.73437,31700,53160,56.05033508246933,50.169415325466105,NaN,NaN,56.180841318453716,51.47252469072455,0.04191028566947559,0.09275403202526888,0.05084374635579329,2388500,2433200,61.73075482281572,66.21768389915273,NaN,NaN,4.349155410091072,2.348579268176094
1999-07-12T09:30:00-04:00,26.625,26.73437,26.5,26.5625,10100,53495,53.54808377334213,50.37294558408437,NaN,NaN,38.82720366887073,44.52394468332975,0.03904426954797367,0.09964908329076039,0.060604813742786715,2378400,2409560,57.88137146412516,65.03698070242545,NaN,NaN,4.744807372742976,2.6908975688285057
1999-07-13T09:30:00-04:00,26.40625,26.67187,26.40625,26.54687,11800,42940,53.314982007613516,50.84829687667974,NaN,NaN,27.6978145590449,35.520723191233884,0.03365114843575004,0.10266874928747427,0.06901760085172423,2366600,2386600,54.33734400331455,63.60014793880754,NaN,NaN,5.002778105447639,3.0211662169169533
1999-07-14T09:30:00-04:00,26.5625,26.8125,26.39062,26.40625,18200,40715,51.15732572820972,51.05427226359865,NaN,NaN,30.627899548794897,33.98728845148018,0.018903535619132786,0.09264702037564021,0.07374348475650742,2348400,2367740,51.54542461266643,62.114272703109805,NaN,NaN,4.630768985540779,3.2511094695775
1999-07-15T09:30:00-04:00,26.35937,26.5,26,26,69700,39165,45.436381713792464,51.31369041276032,NaN,NaN,-41.624424298921866,22.341866959248474,-0.017929168159410952,0.05133202455724373,0.06926119271665468,2278700,2352120,49.28672511483706,60.84200682012742,NaN,NaN,2.6281754338015486,3.1621188930380786
1999-07-16T09:30:00-04:00,26.23437,26.32812,26.10937,26.23437,10500,37905,48.9811195277304,51.674210739712755,NaN,NaN,-23.772023692756925,6.351293957006346,-0.025749811902541733,0.037073927838477516,0.06282373974101925,2289200,2332260,46.496910598573805,59.65016629070582,NaN,NaN,1.9316446194090422,2.9863368539482162
1999-07-19T09:30:00-04:00,26.29687,26.29687,25.71875,25.98437,9900,37970,45.57959147868236,51.355838337911855,NaN,NaN,-68.72822802871816,-15.159792382511432,-0.045828960197851265,0.005537539493705168,0.05136649969155643,2279300,2312440,43.8304776892966,58.31031786595825,NaN,NaN,0.3312406519206456,2.607037396515706
1999-07-20T09:30:00-04:00,25.84375,26.125,25.8125,25.9375,13600,35330,44.94934798076583,51.1226780283778,NaN,NaN,-72.71262720553646,-35.241880735427706,-0.05947118400508988,-0.02297248031480592,0.03649870369028396,2265700,2292260,41.23748704356008,56.76318216073098,NaN,NaN,-1.1625789917706504,2.0685207696176553
1999-07-21T09:30:00-04:00,26.23437,26.25,25.875,25.875,8300,32940,44.074178985033726,50.840462225386524,NaN,NaN,-59.60562505392955,-53.28858565597259,-0.06922564355981198,-0.05003335075948101,0.019192292800330968,2257400,2274060,38.99676377847824,55.07856394708629,NaN,NaN,-2.652060558020933,1.3941520085264285
1999-07-22T09:30:00-04:00,25.92187,26.23437,25.90625,26,218200,43465,46.32507112158703,50.48476622631297,NaN,NaN,-48.3974087574258,-54.64318254767338,-0.06390839170083566,-0.06069319682571361,0.0032151948751220523,2475600,2313440,45.85263099709484,53.770455467280364,NaN,NaN,-3.32879544680283,0.7194452291936774
1999-07-23T09:30:00-04:00,26.26562,26.26562,25.85937,26,14500,39095,46.32507112158703,49.690182979753345,NaN,NaN,-56.793947289809374,-61.247567267083866,-0.0572547700692985,-0.06835326771150108,-0.011098497642202573,2475600,2350720,51.41887184298723,52.73119947969201,NaN,NaN,-3.893662529526551,0.0604298350907877
1999-07-26T09:30:00-04:00,25.75,25.96875,25.67187,25.67187,17900,38090,41.26839449785161,48.66154742998683,NaN,NaN,-127.88190415883109,-73.07830249310646,-0.07092232642067063,-0.09975140566804086,-0.02882907924737023,2457700,2386400,56.07311110674035,52.00354256533887,NaN,NaN,-5.802084581334233,-0.7770722243985009
1999-07-27T09:30:00-04:00,25.98437,26.03125,25.76562,26.03125,230900,45370,47.967494686280865,48.270624743034126,NaN,NaN,-78.39244089665529,-74.21426523133023,-0.05257339917728191,-0.09454582821897262,-0.041972429041690705,2688600,2470980,64.70525508920068,51.92135440062784,NaN,NaN,-5.607506954401322,-1.4671343286846181
1999-07-28T09:30:00-04:00,26.01562,26.20312,26,26.17187,12700,45660,50.35370813301097,48.23793470271121,NaN,NaN,-35.37643837438508,-69.36842789542132,-0.028959968090837965,-0.07817238915523816,-0.0492124210644002,2701300,2559760,71.12046135159582,52.46525639394902,NaN,NaN,-4.755423094974084,-1.9368898667259704
1999-07-29T09:30:00-04:00,25.875,25.9375,25.48437,25.6875,13500,44980,43.03303012143821,47.308127205494706,NaN,NaN,-133.0126035506181,-86.29146685405979,-0.04310409914697845,-0.10309254499812326,-0.05998844585114481,2687800,2602200,73.59155042148305,53.312456079568115,NaN,NaN,-6.227537836127932,-2.549839576640536
1999-07-30T09:30:00-04:00,25.5625,25.76562,25.51562,25.70312,8600,44725,43.31921335889354,46.57749360446267,NaN,NaN,-125.20313550551842,-99.9733044972016,-0.048166043253313445,-0.12019599991778662,-0.07202995666447318,2696400,2646360,75.90210207562953,54.59965112324699,NaN,NaN,-7.3242896364953545,-3.2319038709055103
1999-08-02T09:30:00-04:00,25.53125,25.875,25.53125,25.78125,6800,42335,44.81263422680239,45.97018304869044,NaN,NaN,-101.83462782068997,-94.76384922957337,-0.04317107073538254,-0.12599379508370134,-0.0828227243483188,2703200,2695460,78.1872785353166,56.30321787553286,NaN,NaN,-7.812278015287215,-3.886243034388611
1999-08-03T09:30:00-04:00,25.85937,26.09375,25.76562,25.76562,22000,42675,44.55969603863266,45.498923785149216,NaN,NaN,-62.897020092541545,-91.66476506875063,-0.03801961098213236,-0.13034723807598425,-0.0923276270938519,2681200,2693980,77.94733626366275,58.18906870774687,NaN,NaN,-8.283720293618074,-4.514454071421391
1999-08-04T09:30:00-04:00,26.07812,26.46875,26.07812,26.39062,123000,46890,55.40026206650798,46.21062952462891,NaN,NaN,50.98932383289778,-74.39161262729405,0.007930048261420367,-0.08241506676707644,-0.0903451150284968,2804200,2714560,78.9162537384738,60.305463609435215,NaN,NaN,-5.355919523808958,-4.634663421762472
1999-08-05T09:30:00-04:00,26.42187,26.59375,26.04687,26.57812,9800,43085,58.050352017053974,46.858431845294874,NaN,NaN,76.35243236730427,-32.518605443709575,0.04910416938296486,-0.028964903299790734,-0.07806907268275559,2814000,2739800,80.07264312100384,62.70373021818021,NaN,NaN,-2.0755524219544608,-4.269076136075613
1999-08-06T09:30:00-04:00,26.51562,26.51562,26.0625,26.1875,17900,42395,51.221905309306536,47.26145426176803,NaN,NaN,46.225662709955756,1.76715419938526,0.04812047411993814,-0.017918480032832917,-0.06603895415277106,2796100,2759740,80.96106540500818,65.35591505501675,NaN,NaN,-1.355299729758628,-3.8528223637446155
1999-08-09T09:30:00-04:00,25.96875,26.28125,25.9375,25.9375,7500,42265,47.38052626176224,47.43510985326777,NaN,NaN,-5.049774580660422,21.124124847391165,0.029629006802609048,-0.029002695649509747,-0.058631702452118795,2788600,2776820,81.71313228547848,68.24703257229665,NaN,NaN,-1.9824082435027135,-3.585620346567201
1999-08-10T09:30:00-04:00,25.82812,25.89062,25.73437,25.84375,14200,42385,45.98772450349207,47.5717916760148,NaN,NaN,-75.10590909595902,18.682347046707672,0.011037339887696618,-0.04483502759249802,-0.05587236748019464,2774400,2795460,82.52444364660218,71.35615256287693,NaN,NaN,-2.9187180947214753,-3.490348596303526
1999-08-11T09:30:00-04:00,25.96875,26.67187,25.79687,26.5,34900,43220,55.78567329930322,48.247548974423104,NaN,NaN,115.42261373702064,31.56900502753225,0.0411955672401831,-0.004377908429965771,-0.04557347567014887,2809300,2796480,82.57001419081067,73.97882279099949,NaN,NaN,-0.4515322061358974,-3.056231969136722
1999-08-12T09:30:00-04:00,26.53125,26.9375,26.53125,26.73437,134700,46470,58.66926152414426,49.12927686032004,NaN,NaN,224.06795192243484,61.112108938558364,0.07331105072300886,0.04606533773361221,-0.027245712989396653,2944000,2822480,83.73436058887793,76.28707198713452,NaN,NaN,2.5290662844971274,-2.2583322186176007
1999-08-13T09:30:00-04:00,26.46875,26.78125,26.46875,26.71875,11600,46525,58.395913225633734,50.35267105516162,NaN,NaN,168.46596039761985,85.56016847609118,0.08884888922581138,0.08381539854286757,-0.005033490682943807,2932400,2849740,84.87516942384616,78.3443618669278,NaN,NaN,4.772242998888267,-1.2539643304024768
1999-08-16T09:30:00-04:00,26.625,26.625,26.32812,26.32812,42900,48175,51.88533414272526,50.63251673062194,NaN,NaN,89.23098047375986,104.41631948697523,0.06904689514902575,0.08127512825333838,0.012228233104312633,2889500,2869920,85.67607927961271,79.84227788052866,NaN,NaN,4.6426927434892304,-0.41158474841794723
1999-08-17T09:30:00-04:00,26.51562,26.65625,26.32812,26.65625,9300,47960,56.29341052348891,51.056781187084646,NaN,NaN,105.31766788508166,140.50103488318337,0.07384484411321673,0.10453428824583355,0.030689444132616817,2898800,2894800,86.61701510599869,80.94917457727172,NaN,NaN,5.968295231304727,0.4998266772567205
1999-08-18T09:30:00-04:00,26.32812,26.625,26.20312,26.20312,30000,49045,49.543200894783396,51.52179338518073,NaN,NaN,49.576141371595746,127.33174041009838,0.04378354901126245,0.08541888039669487,0.04163533138543243,2868800,2906700,87.05502174187806,81.91085110015707,NaN,NaN,4.837830349361542,1.1195414875574092
1999-08-19T09:30:00-04:00,26.125,26.46875,25.96875,26.42187,15600,38915,52.50411373881294,52.17785769803212,NaN,NaN,32.49159488870056,89.01646900335155,0.03622703822872485,0.08691912917133848,0.050692090942613635,2884400,2894780,84.08631697125362,82.49543787841594,NaN,NaN,4.8905305260315926,1.6582542073394353
1999-08-20T09:30:00-04:00,26.64062,26.875,26.60937,26.65625,1600,38270,55.51618423913474,52.94239698462729,NaN,NaN,118.4979067511089,79.02285827404936,0.04408711638661024,0.10580098642587643,0.06171387003926619,2886000,2885500,81.74902918241378,82.7498486389229,NaN,NaN,5.907120257071162,2.2652350715868246
1999-08-23T09:30:00-04:00,26.59375,26.8125,26.53125,26.6875,39300,39340,55.91759459834552,53.7536754531782,NaN,NaN,101.93471774391868,81.56360572808111,0.04813421003075603,0.12188163257771123,0.0737474225469552,2925300,2892660,82.16103768354746,83.05082731177181,NaN,NaN,6.834632652673337,2.9180061545991833
1999-08-24T09:30:00-04:00,26.59375,26.75,26.4375,26.57812,20800,28835,54.078173603432695,53.65924056295854,NaN,NaN,75.80712630582278,75.66149741222935,0.040494857851257046,0.12436599486102651,0.08387113700976946,2904500,2893800,82.22982185343992,83.28751074855509,NaN,NaN,7.059222413588347,3.5096084773119207
1999-08-25T09:30:00-04:00,26.75,26.75,25.82812,25.9375,25500,29475,44.78591359547974,52.71178067570323,NaN,NaN,-21.672673992675477,61.41173433937511,-0.008063656400549055,0.07379156650908314,0.0818552229096322,2879000,2895840,82.36089252308795,83.45095713441823,NaN,NaN,4.236608226122026,3.613465584284793
1999-08-26T09:30:00-04:00,25.89062,25.89062,25.59375,25.64062,18000,29700,41.24859910743239,51.99940166128365,NaN,NaN,-130.54661582028774,28.80409219757745,-0.05776892868242464,0.009644062056601399,0.06741299073902604,2861000,2891160,80.88690994488225,83.44566031583781,NaN,NaN,0.7115977531368646,3.198913036977946
1999-08-27T09:30:00-04:00,25.79687,25.79687,25.4375,25.65625,41300,31335,41.51052154501088,51.58011561008713,NaN,NaN,-147.54095748852225,-24.403680650348782,-0.08551200898048997,-0.03947702048658641,0.04603498849390355,2902300,2894420,81.1401117810856,83.40473027980975,NaN,NaN,-1.9863316234353705,2.458163799776044
1999-08-30T09:30:00-04:00,25.65625,25.65625,25.07812,25.15625,7400,31365,35.98391442445262,50.8655577472986,NaN,NaN,-201.01410023367038,-84.99344424586658,-0.1307466775375099,-0.11739835842798385,0.013348319109526066,2894900,2888340,79.03711934552456,83.15563568687564,NaN,NaN,-6.2119326816923595,1.2195785881377006
1999-08-31T09:30:00-04:00,24.875,24.92187,24.54687,24.54687,6700,30600,30.631271185607645,49.06881473917748,NaN,NaN,-257.05200723216086,-151.5652709534633,-0.19125583661729664,-0.22572147666209474,-0.034465640044798095,2888200,2885080,77.87170463771058,82.82004214736848,NaN,NaN,-11.855072184270595,-0.6482286650634843
1999-09-01T09:30:00-04:00,24.54687,24.9375,24.54687,24.875,32800,26090,36.139764584860096,47.45956495780005,NaN,NaN,-184.43422715659688,-184.11758158624758,-0.1979011515906609,-0.28184207953312423,-0.08394092794246333,2921000,2893480,78.74152172399991,82.46341079987721,NaN,NaN,-14.62395699748567,-2.644761283980939
1999-09-02T09:30:00-04:00,24.89062,24.89062,24.54687,24.625,76300,29415,33.92911272762879,45.7119363507997,NaN,NaN,-160.55138840364657,-190.11853610291936,-0.2068811434295676,-0.34254235722942283,-0.13566121379985524,2844700,2890220,77.46881054126908,81.93438516540742,NaN,NaN,-17.606647268032827,-4.782173567416923
1999-09-03T09:30:00-04:00,25.10937,25.21875,25.0625,25.1875,3100,28675,42.45791130319901,45.03854900511924,NaN,NaN,-90.47923915991014,-178.70619243719693,-0.16453034366117952,-0.34132414337632966,-0.17679379971515014,2847800,2879320,73.20813019840014,81.04381737389224,NaN,NaN,-17.254239856596513,-6.5638973230140065
1999-09-07T09:30:00-04:00,24.78125,25.0625,24.70312,24.8125,156900,36145,38.85678762809871,43.793075941162805,NaN,NaN,-106.85509725165184,-159.8743918407932,-0.1516805589560526,-0.3663944984102159,-0.21471393945416328,2690900,2838520,59.92304642033435,79.1371053249162,NaN,NaN,-18.192123002776025,-8.225072420122867
1999-09-08T09:30:00-04:00,24.70312,24.9375,24.60937,24.8125,26300,36750,38.85678762809871,43.02976070782819,NaN,NaN,-100.24725299717629,-128.5134409937963,-0.13371771130313787,-0.3818610785830856,-0.24814336727994774,2690900,2799060,50.39739522724995,76.5187034310142,NaN,NaN,-18.913815226313826,-9.752035678150147
1999-09-09T09:30:00-04:00,24.78125,25.01562,24.76562,24.82812,306200,50315,39.10628788069849,42.072773146534296,NaN,NaN,-82.59504236604064,-108.14560403568507,-0.11219013538600381,-0.3883810365124525,-0.2761909011264487,2997100,2814280,53.4697969034752,74.3318091404586,NaN,NaN,-19.412521079898912,-11.132105021257113
1999-09-10T09:30:00-04:00,24.78125,25.34375,24.78125,25.34375,22700,44715,46.82076746376326,41.45167194829348,NaN,NaN,-51.08649156458383,-86.25262466787254,-0.057391593857581635,-0.3479303934484257,-0.29053879959084405,3019800,2849300,59.661120623829696,72.75410138627403,NaN,NaN,-17.429328312141408,-12.031708348526298
1999-09-13T09:30:00-04:00,25.125,25.53125,25.04687,25.53125,8800,44575,49.33436340400377,40.981441148697634,NaN,NaN,-26.42940337960379,-73.44265751181126,-0.005421768723895215,-0.2973160104957131,-0.2918942417718179,3028600,2885460,64.86039151842263,71.51834094590798,NaN,NaN,-15.01648187177318,-12.458104566132995
1999-09-14T09:30:00-04:00,25.07812,25.29687,25,25.125,30100,43935,44.43382409171189,40.292559040717585,NaN,NaN,-44.18147948640371,-60.90793395876163,0.004171347081234067,-0.2866800579202753,-0.29085140500150936,2998500,2946980,71.57338658898044,70.75716699844659,NaN,NaN,-14.443431828954687,-12.741722746536094
1999-09-15T09:30:00-04:00,25.17187,25.17187,24.75,24.89062,5800,43760,41.85090354580186,40.0829154657406,NaN,NaN,-59.76655511316344,-52.81179438195907,-0.0023404899933000545,-0.29377701749313445,-0.2914365274998344,2992700,3007340,76.34769498257256,70.32765288840979,NaN,NaN,-14.762700436909359,-13.030433845160847
1999-09-16T09:30:00-04:00,24.5,24.5,24.125,24.125,20800,43300,34.745709501081336,39.61842335100123,NaN,NaN,-124.99796430725856,-61.29237877020266,-0.05250239954464364,-0.35706452693063895,-0.3045621273859953,2971900,3002300,75.21180222806724,69.92228805149442,NaN,NaN,-17.467114371508213,-13.664245348924757
1999-09-17T09:30:00-04:00,24.375,24.5625,24.25,24.54687,19900,43515,40.718038526642786,39.561817421117794,NaN,NaN,-96.97235979851435,-70.46955241698876,-0.05149125749916872,-0.3689261992599562,-0.31743494176078746,2991800,2996700,73.89625631277747,69.40486980375813,NaN,NaN,-17.69512192589826,-14.240084859920971
1999-09-20T09:30:00-04:00,24.57812,24.57812,24.0625,24.20312,13800,44125,37.69097991792692,39.68375067065167,NaN,NaN,-113.90229894846918,-87.96413153076185,-0.06720156461705329,-0.4014368975321041,-0.3342353329150508,2978000,2986580,71.46359285920319,68.86390362616375,NaN,NaN,-18.895313179838098,-14.90511747705199
1999-09-21T09:30:00-04:00,24.0625,24.1875,23.8125,23.90625,21400,43230,35.25348181519527,40.01390857276508,NaN,NaN,-146.38972222380056,-108.40578007824122,-0.08942405382404023,-0.4460154001951011,-0.3565913463710609,2956600,2978200,69.42548708856842,68.2606023726536,NaN,NaN,-20.678537167755167,-15.729891718581015
1999-09-22T09:30:00-04:00,23.84375,24.09375,23.71875,23.73437,10500,42715,33.88706097339103,39.853001171945856,NaN,NaN,-157.56426138422762,-127.96532133245405,-0.10638292768952956,-0.48957000598297284,-0.3831870782934433,2946100,2968880,67.13234856739444,67.43137571861034,NaN,NaN,-22.548751603756852,-16.70401455932042
1999-09-23T09:30:00-04:00,23.5,23.57812,23.25,23.34375,249300,53905,30.95096363058262,39.64027623644256,NaN,NaN,-201.09932614821557,-143.18559370064546,-0.13287066481312232,-0.5492754093098462,-0.4164047444967239,2696800,2913860,55.48169182120285,65.8608672386056,NaN,NaN,-25.07917463119469,-17.9004659981596
1999-09-24T09:30:00-04:00,23.07812,23.3125,22.78125,22.85937,16500,53830,27.74116589755343,38.5890801360393,NaN,NaN,-210.21932740239788,-165.83498722142218,-0.1696230829106724,-0.6284335981350644,-0.458810515224392,2680300,2851560,45.79107264014142,63.90250598444428,NaN,NaN,-28.31136070164072,-19.387736670085474
1999-09-27T09:30:00-04:00,23.45312,23.625,23.40625,23.4375,6500,52090,36.24028378343963,38.402187004277934,NaN,NaN,-125.09479633473157,-168.07348669867466,-0.14268907039553425,-0.6371718532188098,-0.4944827828232755,2686800,2793320,38.943256388353085,62.403949553588475,NaN,NaN,-28.248423246906068,-20.6535490382027
1999-09-28T09:30:00-04:00,23.4375,23.5625,23.0625,23.10937,17400,52590,33.8096021509873,38.04167375591283,NaN,NaN,-132.97881012028589,-165.3913042779717,-0.13475974118287626,-0.6629324593018708,-0.5281727181189946,2669400,2735880,33.60549318819206,61.20452797937006,NaN,NaN,-28.99619390336238,-21.845355447511228
1999-09-29T09:30:00-04:00,23.32812,23.6875,23.32812,23.35937,3900,52450,37.262188943798044,37.90995240327709,NaN,NaN,-95.18307321510521,-152.9150666441472,-0.10195579713008596,-0.655617464531602,-0.553661667401516,2673300,2681320,29.473134767626576,59.4904806839523,NaN,NaN,-28.493506445648915,-22.79509130438804
1999-09-30T09:30:00-04:00,23.54687,24.0625,23.42187,23.70312,118500,56735,41.76054951148017,37.5485082638283,NaN,NaN,-59.924043917098324,-124.68001019792378,-0.0490652794819576,-0.614993266753963,-0.5659279872720054,2791800,2700320,32.582175189567764,57.55627029579074,NaN,NaN,-26.633023198501643,-23.343367289261412
1999-10-01T09:30:00-04:00,23.90625,23.92187,23.4375,23.8125,13300,53585,43.15717652862542,37.107280629872704,NaN,NaN,-54.78974792348282,-93.59409430214076,-0.001202611150542987,-0.5674312512101842,-0.5662286400596412,2805100,2725280,36.53992238714948,55.53337964355694,NaN,NaN,-24.708356444458307,-23.538365740003826
1999-10-04T09:30:00-04:00,23.78125,24.01562,23.76562,23.84375,225300,64695,43.573511584162794,37.045829736476335,NaN,NaN,-33.992030353420255,-75.3735411058785,0.03601632539154287,-0.5212082333202126,-0.5572245587117555,3030400,2794000,45.94813734569515,53.703004697607994,NaN,NaN,-23.034861528922725,-23.46643656699224
1999-10-05T09:30:00-04:00,24.10937,24.10937,23.60937,23.6875,6800,57190,41.92023419491942,37.05078192569903,NaN,NaN,-37.3103453835402,-56.23984815852937,0.052564998439782906,-0.4915183106620269,-0.5440833091018098,3023600,2864840,53.58696461357573,52.077238242679655,NaN,NaN,-22.087129874544,-23.269392753785347
1999-10-06T09:30:00-04:00,23.96875,23.98437,23.53125,23.98437,11900,56470,46.10438712780108,37.86211604189329,NaN,NaN,-29.87664366146147,-43.17856224780061,0.08408769555786522,-0.43897368965447825,-0.5230613852123435,3035500,2937280,59.83755128626649,50.97907746112246,NaN,NaN,-20.061638782746087,-22.811142186494024
1999-10-07T09:30:00-04:00,24.125,24.15625,23.79687,24.14062,70000,44660,48.21881593645401,38.3978858568798,NaN,NaN,-2.1829245845009924,-31.63033838128116,0.11417765624274478,-0.3803393149089125,-0.49451697115165727,3105500,3000020,64.31945979416858,50.2950205669361,NaN,NaN,-17.75299526920875,-22.088549769738986
1999-10-08T09:30:00-04:00,24.375,24.71875,24.29687,24.29687,117000,49375,50.317874258261945,39.299806881189454,NaN,NaN,59.014820999685085,-8.869424596647567,0.14153200605326466,-0.3176019635850764,-0.4591339696383411,3222500,3083500,69.23842723869498,50.136080165471235,NaN,NaN,-15.20409900112522,-21.105056802794163
1999-10-11T09:30:00-04:00,24.28125,24.5625,24.28125,24.34375,3900,49130,50.96019730219352,40.42171513026075,NaN,NaN,68.22557445738681,11.574096365513846,0.15843544978482127,-0.2610896574073145,-0.41952510719213576,3226400,3122700,71.24322693315838,50.2659187257991,NaN,NaN,-12.90182210092501,-19.93316613109857
1999-10-12T09:30:00-04:00,24.23437,24.42187,24,24,8300,48040,46.239499052185906,41.30403213588896,NaN,NaN,41.185006302095935,27.27316670264107,0.14261216114640796,-0.24125990575912581,-0.38387206690553377,3218100,3161600,73.11567509973793,50.69329919239505,NaN,NaN,-12.12050465060938,-18.817071633885828
1999-10-13T09:30:00-04:00,24.125,24.125,23.70312,23.70312,3400,47920,42.571594895984305,42.13407722627478,NaN,NaN,-3.303090680044148,32.58787729892454,0.10977196555823954,-0.24665710995773438,-0.3564290755159739,3214700,3197440,74.74715966682871,52.06940403851119,NaN,NaN,-12.47079709350239,-17.910460985259622
1999-10-14T09:30:00-04:00,23.9375,24.0625,23.82812,24.0625,15500,47655,47.95370214472831,43.577829815358704,NaN,NaN,31.220752363893148,39.26861268860337,0.10961822722770592,-0.2194062914813415,-0.3290245187090474,3230200,3222380,75.84564052055816,54.216158887112385,NaN,NaN,-11.209159177187233,-16.953132155534995
1999-10-15T09:30:00-04:00,23.6875,23.71875,23.375,23.4375,17500,47535,40.79347091289534,43.90305746746269,NaN,NaN,-67.23720183153172,14.018208122360004,0.06688911225950539,-0.24541312838466567,-0.31230224064417106,3212700,3220420,75.5674378708494,56.83217185014784,NaN,NaN,-12.31713326692761,-16.290846600019655
1999-10-18T09:30:00-04:00,23.1875,23.60937,23.1875,23.5625,15100,47600,42.63824016788815,44.53367446866989,NaN,NaN,-71.62128756536067,-13.951164282189492,0.04742530089620722,-0.253020614523912,-0.3004459154201192,3227800,3220700,75.58121761920384,59.83043788093439,NaN,NaN,-12.655566763154283,-15.771520909038887
1999-10-19T09:30:00-04:00,23.75,24.04687,23.45312,23.60937,7500,46905,43.350985583294744,44.96858851434822,NaN,NaN,-9.902914071398628,-24.168748356888408,0.038469890334749235,-0.2523585525016827,-0.29082844283643194,3235300,3224140,75.76208184926676,63.1367912439087,NaN,NaN,-12.723480401693314,-15.336086550846662
1999-10-20T09:30:00-04:00,23.82812,23.82812,23.21875,23.40625,10300,46895,40.97484721923269,44.91246692204483,NaN,NaN,-57.169234169699095,-34.94197705481939,0.020528940794568573,-0.2651672668432212,-0.2856962076377898,3225000,3226200,75.87730717044158,66.22930067111396,NaN,NaN,-13.468318781574506,-15.069262583807783
1999-10-21T09:30:00-04:00,23.59375,23.84375,23.40625,23.75,7800,34820,46.335689237180176,45.139503544084455,NaN,NaN,-18.087343628462467,-44.803596253290515,0.03274969992557042,-0.2447590827308268,-0.2775087826563972,3232800,3226720,75.9084414138689,69.04133774445107,NaN,NaN,-12.540224167462213,-14.707971381472701
1999-10-22T09:30:00-04:00,24,24.1875,23.85937,24.0625,576200,62805,50.71775018002086,45.64980630093146,NaN,NaN,66.24316326756333,-18.107523233471504,0.06116565614975944,-0.20105171246919795,-0.2622173686189574,3809000,3345980,81.73191081537904,71.5973215637142,NaN,NaN,-10.4138233917888,-14.094521668660715
1999-10-25T09:30:00-04:00,23.90625,24.29687,23.84375,24.0625,6700,62815,50.71775018002086,46.27820029986727,NaN,NaN,67.52246446401304,9.721227172403237,0.07816040793251072,-0.164516858703319,-0.24267726663582972,3809000,3462220,85.42894439873466,73.87174869122555,NaN,NaN,-8.699750401520088,-13.323840059069196
1999-10-26T09:30:00-04:00,24.15625,24.21875,23.625,23.70312,19800,62935,45.73659640575921,46.25192953400715,NaN,NaN,-0.723757596653282,11.557058467352306,0.06399274166322991,-0.16268633955679235,-0.22667908122002225,3789200,3573000,87.93493950816134,75.87870499278947,NaN,NaN,-8.633216832317123,-12.653751026676042
1999-10-27T09:30:00-04:00,23.79687,23.82812,23.35937,23.65625,26800,64080,45.11428214562495,46.0301771203765,NaN,NaN,-77.7835953132892,7.434186238634285,0.0508335736690943,-0.1631371141336544,-0.2139706878027487,3762400,3680480,89.77274400838313,77.69679672237622,NaN,NaN,-8.754397152776761,-12.09670047326186
1999-10-28T09:30:00-04:00,23.98437,23.98437,23.54687,23.59375,13500,58830,44.249661482728534,45.596733350695544,NaN,NaN,-47.44255739613908,1.563143485098962,0.037883008104272836,-0.16661692767240766,-0.2044999357766805,3748900,3783700,91.16466257343922,79.26295638914367,NaN,NaN,-9.092050684307312,-11.667464789125496
1999-10-29T09:30:00-04:00,23.57812,24.4375,23.57812,24.26562,40600,60195,54.372992933014,45.84050446718272,NaN,NaN,66.57051349837353,1.6286135312609986,0.07252151528691339,-0.11384804166803875,-0.18636955695495214,3789500,3779800,90.66258797645125,80.65005360652172,NaN,NaN,-6.304208768710912,-10.901285357637699
1999-11-01T09:30:00-05:00,24.40625,24.4375,24,24.03125,4500,49155,50.9008137660274,46.173455518171394,NaN,NaN,76.06316768449301,3.3367541753569925,0.07717271266912584,-0.08990366611854483,-0.16707637878767068,3785000,3775000,90.00557725779841,81.85647518924033,NaN,NaN,-5.014279794766993,-10.060284562941884
1999-11-02T09:30:00-05:00,24,24.32812,24,24.25,21200,49875,53.862273314596564,46.97993254807227,NaN,NaN,77.36188848404693,18.953883391497033,0.09152578937310052,-0.05266914207129503,-0.14419493144439555,3806200,3778400,90.06052252123563,82.95028682169797,NaN,NaN,-3.0268255687617382,-9.055504706630435
1999-11-03T09:30:00-05:00,24.375,24.375,24.21875,24.21875,8600,49710,53.367060995066055,47.36660103738211,NaN,NaN,88.40457715295506,52.191517884745885,0.09504438233900565,-0.025389453520638483,-0.12043383585964414,3797600,3785440,90.1808938145632,83.97423348555547,NaN,NaN,-1.5597124386646297,-7.984677239778177
1999-11-04T09:30:00-05:00,24.65625,24.67187,24.42187,24.53125,14800,46950,57.56833949757997,48.56480593628815,NaN,NaN,139.84178714461524,89.64838679289676,0.11330837690371226,0.02120163526999619,-0.09210674163371607,3812400,3798140,90.40660213763331,85.03417379032575,NaN,NaN,0.9795990387159802,-6.704066342850441
1999-11-05T09:30:00-05:00,24.78125,24.8125,24.48437,24.48437,75900,44895,56.74245545569862,49.57224988541748,NaN,NaN,146.73551860557302,105.68138781433666,0.11666403001606125,0.05372329588636049,-0.06294073412970076,3736500,3787540,88.57647674491011,85.96240658501905,NaN,NaN,2.82827610132286,-5.342303136539969
1999-11-08T09:30:00-05:00,24.39062,24.39062,24,24.24609,161800,52790,52.611057106842615,50.233683565670894,NaN,NaN,61.57363017606659,102.78348031265136,0.0980189128697251,0.059582906957455606,-0.03843600591226949,3574700,3745480,81.52440945064112,86.37400141368866,NaN,NaN,3.2555926109104085,-4.1140323154756295
1999-11-09T09:30:00-05:00,24.29687,24.625,24.29687,24.34375,18900,53320,54.086568313504024,51.17023507240456,NaN,NaN,103.8621157213465,108.08352576011127,0.08777704805468912,0.07128530415609191,-0.01649174389859721,3593600,3702960,75.02171007728862,86.3128873356063,NaN,NaN,4.025743972240139,-2.951207131516234
1999-11-10T09:30:00-05:00,24.29687,24.59375,24.21875,24.40625,17600,54030,55.05113487719308,51.79276690383404,NaN,NaN,90.2969261140176,108.46199555232378,0.08089518377252816,0.084627235817063,0.0037320520445348337,3611200,3665680,69.76728539237007,85.87423333407067,NaN,NaN,4.932973682627026,-1.8248955866386256
1999-11-11T09:30:00-05:00,24.57812,24.65625,24.15625,24.26562,15600,54035,52.38441621543238,51.91181447779201,NaN,NaN,72.49436006667214,94.99251013673518,0.06333240288924628,0.08289755565609269,0.019565152766846405,3595600,3622320,64.1404016724178,84.6176969667163,NaN,NaN,4.994379546511687,-0.8507134247600097
1999-11-12T09:30:00-05:00,24.40625,24.5,24.21875,24.34375,51600,55740,53.72556385704526,52.12665831186518,NaN,NaN,66.43525601249188,78.93245761811895,0.05381210517888201,0.08683028424044892,0.033018179061566906,3647200,3604460,61.92496790976207,82.93884150321824,NaN,NaN,5.400792204050804,0.04235880792724933
1999-11-15T09:30:00-05:00,24.26562,25,24.23437,24.96875,84400,59205,62.761389145603786,53.342714936139785,NaN,NaN,141.12234201333544,94.84219998557272,0.08460906698922822,0.1387795127981022,0.054170445808873965,3731600,3635840,64.26073168969612,81.24782665904215,NaN,NaN,8.566678867007917,1.2601188163673447
1999-11-16T09:30:00-05:00,25,25.07812,24.82812,25.0625,125900,65125,63.900087724105354,54.68455819174553,NaN,NaN,177.47675004920117,109.56512685114367,0.10496570328291838,0.18537757491252194,0.08041187162960356,3857500,3688620,67.83489761253566,79.68083763076731,NaN,NaN,11.50907045318689,2.7242547644844226
1999-11-17T09:30:00-05:00,25,25.10937,24.875,24.96875,15000,65360,61.86290356679066,55.942646912035684,NaN,NaN,158.82222084065052,123.27018579647024,0.10550636725725462,0.21229483070117183,0.10678846344391721,3842500,3734880,70.60924430747262,78.21259346891257,NaN,NaN,13.373389519559991,4.245559729495218
1999-11-18T09:30:00-05:00,24.73437,25.01562,24.625,24.8125,8300,65385,58.514587720732735,56.238475111158444,NaN,NaN,110.52291789209184,130.8758973615542,0.08936934684073111,0.2185001469948311,0.1291308001541,3834200,3782600,73.17920742540078,76.96378057240895,NaN,NaN,14.008730761893068,5.6402984484091965
1999-11-19T09:30:00-05:00,24.5625,24.79687,24.5625,24.70312,61600,39655,56.22058435918807,56.618458724955644,NaN,NaN,74.13465743875499,132.41577764680682,0.06641244930797066,0.21214636178906332,0.14573391248109266,3772600,3807680,74.44400413664637,75.85223963518379,NaN,NaN,13.897765567316847,6.819936608253147
1999-11-22T09:30:00-05:00,24.5,24.54687,24.28125,24.42187,9700,39805,50.714974792393875,56.39365168765545,NaN,NaN,10.703012052356398,106.331911654611,0.029264714138704073,0.18231480515447274,0.15305009101576866,3762900,3813940,74.76389579595768,74.75962344052108,NaN,NaN,12.17572606771173,7.585049388175801
1999-11-23T09:30:00-05:00,24.20312,24.45312,24.125,24.20312,130200,45325,46.8703949742486,55.92960411473991,NaN,NaN,-32.372034561165464,64.36215473253766,-0.010908313692184674,0.13941469890053781,0.1503230125927225,3632700,3768980,68.16448839176522,73.18702305317836,NaN,NaN,9.528878287520785,7.86273923093937
1999-11-24T09:30:00-05:00,24.07812,24.375,24.07812,24.23437,13500,44660,47.48288660432217,55.20921462236436,NaN,NaN,-53.47487750344183,21.902735063719184,-0.034892321644196644,0.10670761053747668,0.14159993218167333,3646200,3729720,62.93994821219666,71.22511920136147,NaN,NaN,7.532245821245074,7.815525886697328
1999-11-26T09:30:00-05:00,24.20312,24.35937,24.15625,24.17187,7900,44380,46.33244786957297,54.465642651926814,NaN,NaN,-65.71711974008628,-13.345272462716448,-0.05337546356491024,0.07488060272553554,0.12825606629044578,3638300,3690540,58.1499224043071,69.05179389131838,NaN,NaN,5.536492010050717,7.489949618604955
1999-11-29T09:30:00-05:00,24,24,23.59375,23.625,33500,44025,37.72064211228637,53.40204158088709,NaN,NaN,-196.68493647357064,-67.50919124518158,-0.09823156073041325,0.005466615377429207,0.10369817610784246,3604800,3656980,54.33542975491123,67.10972391305195,NaN,NaN,0.8605544966792843,6.542893172615574
1999-11-30T09:30:00-05:00,23.92187,24.17187,23.79687,23.92187,7100,44155,43.82473337781152,52.669053371194764,NaN,NaN,-126.39727693247227,-94.92924904214733,-0.10319687931308141,-0.025297923033509306,0.0778989562795721,3611900,3626780,51.08774370801125,65.400154886675,NaN,NaN,-1.2554896464500294,5.42883848417763
1999-12-01T09:30:00-05:00,24.03125,24.03125,23.82812,23.98437,47300,45460,45.04590125074547,51.95439382644851,NaN,NaN,-121.93877651308864,-112.84259743253196,-0.09762087979433706,-0.04412714346334923,0.053493736330987834,3659200,3632080,51.634109787460886,64.10492805775291,NaN,NaN,-2.58898155715106,4.283435621130675
1999-12-02T09:30:00-05:00,24.03125,24.5625,23.875,24.48437,18700,45965,53.71451608618946,52.04940096007402,NaN,NaN,-27.35426018938045,-107.61847396971969,-0.05758736376561664,-0.018490468376032965,0.03909689538958368,3677900,3638420,52.32022695012342,63.26062986330333,NaN,NaN,-0.9519067586574589,3.535529566875227
1999-12-03T09:30:00-05:00,24.46875,24.875,24.46875,24.64062,96600,50055,56.047786497680825,52.2152740058337,NaN,NaN,63.845998028428994,-81.7058504160166,-0.019861235690521596,0.014270350776431684,0.03413158646695328,3774500,3665660,55.2571036893062,62.784353847556474,NaN,NaN,1.1352639250273233,3.1926344751826696
1999-12-06T09:30:00-05:00,24.57812,24.98437,24.57812,24.65625,68700,49695,56.285182048119154,51.7526877845848,NaN,NaN,79.53117526891808,-26.462628067518853,0.005512228231224256,0.0410218717559836,0.03550964352475934,3843200,3713340,59.91170946534898,62.47370940296025,NaN,NaN,2.8618668796810103,3.1453819615395755
1999-12-07T09:30:00-05:00,24.625,24.79687,24.375,24.375,85600,45885,50.95216800538218,50.82783637610458,NaN,NaN,19.65080572512241,2.7469884640000886,0.0028544111487453505,0.03907765746069103,0.03622324631194568,3757600,3742480,62.48063919952152,62.091262373459244,NaN,NaN,2.726472178367087,3.0855377068006486
1999-12-08T09:30:00-05:00,24.45312,24.65625,24.375,24.57812,58400,47860,54.31854983845265,50.28895396693758,NaN,NaN,23.078316708413205,31.750407108300458,0.013671313395240456,0.05331238805599625,0.039641074660755796,3816000,3773840,65.07451025511173,61.69592422686204,NaN,NaN,3.6487757488349084,3.1660002842341144
1999-12-09T09:30:00-05:00,24.34375,24.57812,24.25,24.48437,14500,47705,52.526598912184284,49.861240480612686,NaN,NaN,-2.0261738768233144,36.81602437081189,0.013390159232396247,0.056378773701251106,0.04298861446885486,3801500,3798560,67.01059570530143,61.25530910399781,NaN,NaN,3.873790768624505,3.267113210575599
1999-12-10T09:30:00-05:00,24.70312,24.98437,24.375,24.78125,10200,47435,57.32747637248233,49.940304195847986,NaN,NaN,60.72682499422876,36.19218976397184,0.031066272018715917,0.08182145449224976,0.05075518247353384,3811700,3806000,67.59287542932813,60.76594276776079,NaN,NaN,5.549841961416311,3.593217317838558
1999-12-13T09:30:00-05:00,24.57812,24.90625,24.57812,24.8125,15900,45650,57.811116217459166,50.4471714404955,NaN,NaN,66.53148885471516,33.592252481131254,0.04204834844016991,0.10331561802374623,0.06126726958357632,3827600,3802880,67.05834019702877,60.21554593926586,NaN,NaN,7.045764827674921,4.086438390672324
1999-12-14T09:30:00-05:00,24.71875,25.35937,24.64062,25.0625,120200,47440,61.56416914911631,51.49672673870034,NaN,NaN,118.02033444237328,53.26615822458143,0.062123311228641495,0.13892140861937818,0.07679809739073669,3947800,3840920,70.1570943208095,60.357874934197596,NaN,NaN,9.485037943082572,4.857666898159502
1999-12-15T09:30:00-05:00,25.26562,25.82812,25.26562,25.76562,120000,47145,69.72219634790572,53.08524886324203,NaN,NaN,223.6105178065701,93.3725984442128,0.11562062454831817,0.2213238780761344,0.10570325352781623,4067800,3891280,73.6861315195185,61.12545945614915,NaN,NaN,14.69964069177531,6.263663154390332
1999-12-16T09:30:00-05:00,25.78125,25.78125,25.17187,25.3125,17500,47270,60.77041364524616,54.11653213293296,NaN,NaN,166.54224350813467,127.0862819212044,0.113209943714558,0.24721568317101372,0.13400573945645572,4050300,3941040,76.62720041809068,62.44526502856227,NaN,NaN,15.990000667376542,7.6531399419597905
1999-12-17T09:30:00-05:00,25.875,26.3125,25.6875,26.20312,325800,63145,69.15356558731283,56.361740952577726,NaN,NaN,232.32209380626395,161.40533568361144,0.1613799063526326,0.3357306223972465,0.17435071604461388,4376100,4053920,81.64030961237184,64.39561358980946,NaN,NaN,20.510038738462306,9.489839770031578
1999-12-20T09:30:00-05:00,25.98437,25.98437,24.875,25.01562,384600,79295,52.9164132182386,57.01114665546537,NaN,NaN,95.8327385992148,167.26558563251137,0.10573910638723621,0.30652459902865914,0.20078549264142292,3991500,4086700,82.79440761916311,66.66037529774887,NaN,NaN,17.324558860890384,10.609085354439978
1999-12-21T09:30:00-05:00,25.0625,25.125,24.85937,25,507400,104180,52.740994594740854,57.56079618003646,NaN,NaN,46.84698122281677,153.03091498860007,0.062494157309273796,0.27890318927801516,0.21640903196874137,3484100,3993960,69.48622165530767,67.93552614545222,NaN,NaN,15.051202097123092,11.243673460537567
1999-12-22T09:30:00-05:00,25,25.0625,24.79687,25.03125,395500,117445,53.076139567698135,57.515197857287085,NaN,NaN,37.67793925413148,115.84439927811236,0.032134356186932445,0.2565769772024069,0.22444262101547446,3879600,3956320,64.9248445071284,68.83585597095257,NaN,NaN,13.50320539492671,11.566463736878873
1999-12-23T09:30:00-05:00,24.95312,25.4375,24.95312,25.39062,483800,140960,56.864565417517085,57.573539208703956,NaN,NaN,73.06029386434624,97.14800934935465,0.03230883827238737,0.2648286688559587,0.2325198305835713,4363400,4018940,68.61593438306554,69.79005816336395,NaN,NaN,13.571510987302183,11.852899058367917
1999-12-27T09:30:00-05:00,25.70312,25.75,25.40625,25.5,673200,174225,57.976646732404404,57.69435811472433,NaN,NaN,101.72246609071186,71.02808380624424,0.035585054730283866,0.27700114899642614,0.24141609426614227,5036600,4151040,74.67132230805358,70.84431622355713,NaN,NaN,13.990658433669335,12.158293254839549
1999-12-28T09:30:00-05:00,25.34375,26.09375,25.34375,26.01562,172100,181155,62.84018589791494,58.543502249905245,NaN,NaN,125.63118765322503,76.98777361704626,0.06647781573327072,0.32451336393273067,0.25803554819945995,5208700,4394480,81.6846227140215,72.2160293317357,NaN,NaN,15.99998960408178,12.70710701901701
1999-12-29T09:30:00-05:00,25.98437,26.65625,25.98437,26.53125,348700,198235,66.95845874691311,59.44635288622385,NaN,NaN,178.16817647345826,103.25201266717457,0.11290976404360337,0.3991727532539642,0.2862629892103608,5557400,4809140,87.85387525540783,73.84312683175685,NaN,NaN,19.131598220651416,13.624891476393355
1999-12-30T09:30:00-05:00,26.53125,26.53125,26.07812,26.07812,43800,198060,60.602230087126486,60.023183684434,NaN,NaN,137.36854009002923,123.19013283435413,0.10456599026695679,0.41697047704405676,0.3124044867771,5513600,5135940,90.55426777822376,75.52481769410845,NaN,NaN,19.533705171625034,14.469007718569308
1999-12-31T09:30:00-05:00,26,26.67187,26,26.57812,123600,203305,64.59596055279378,60.542361125884824,NaN,NaN,142.25660220709048,137.02939450290296,0.1229154523482644,0.4660488022124305,0.3431333498641661,5637200,5390700,92.03998720241827,77.27103996361487,NaN,NaN,21.25885543237619,15.438985963398864
2000-01-03T09:30:00-05:00,26.67187,26.6875,25.9375,25.96875,140500,205500,57.01087371542724,60.48520094716825,NaN,NaN,101.50019489975317,136.98494026471124,0.08595625751953112,0.45057867176358,0.3646224142440489,5496700,5482720,92.49893149726755,79.0882250564891,NaN,NaN,20.01457155130008,16.092641047384753
2000-01-04T09:30:00-05:00,26,26.04687,25.60937,25.71875,258000,214965,54.1990352047293,59.959119951140615,NaN,NaN,47.42059038905607,121.34282081187743,0.03900637225952486,0.41338037956845497,0.3743740073089301,5238700,5488720,92.52917752395717,80.68623099957107,NaN,NaN,18.071374451928957,16.375317248033923
2000-01-05T09:30:00-05:00,26.01562,26.8125,25.75,26.78125,102700,215820,62.633994081060635,59.452819789223106,NaN,NaN,113.98274737096118,108.50573499137803,0.07192748670349813,0.46428336568830275,0.3923558789848046,5341400,5445520,89.72393326088435,81.83178826681147,NaN,NaN,19.433930516026532,16.812262000604296
2000-01-06T09:30:00-05:00,26.79687,27.73437,26.78125,27.46875,1335000,279650,66.88387102871383,59.889495316613655,NaN,NaN,189.24427056847455,118.88088108706708,0.12908885596155573,0.5537169489367493,0.42462809297519355,6676400,5678080,91.26008809391156,82.87699452937011,NaN,NaN,22.141661465878347,17.57360478135773
2000-01-07T09:30:00-05:00,27.75,27.9375,27.45312,27.45312,619400,309895,66.69814004479568,59.714107777862424,NaN,NaN,190.9210572044576,128.61377208654054,0.15328072031927642,0.616228993374289,0.4629482730550126,6057000,5762040,91.74015531246195,83.59841207937654,NaN,NaN,24.09532480692613,18.505279070724644
2000-01-10T09:30:00-05:00,27.70312,27.70312,27.14062,27.35937,171200,317945,65.5228296295342,60.61456609295497,NaN,NaN,145.8249818053445,137.47872946765878,0.1502049665615769,0.6507044812569838,0.5004995146954069,5885800,5839860,92.16948301442233,84.26806032189506,NaN,NaN,25.245834849423854,19.468215610538817
2000-01-11T09:30:00-05:00,27.14062,27.25,26.82812,27.03125,39700,319135,61.441983685824425,61.23606531374666,NaN,NaN,98.85955445692755,147.7665222812331,0.11490034075402122,0.6441249406379335,0.5292245998839122,5846100,5961340,92.7987342924381,85.93323979597581,NaN,NaN,24.915906776981377,20.246457205744896
2000-01-12T09:30:00-05:00,26.60937,27.03125,26.60937,26.64062,135300,319890,56.8986261945564,61.50910007280796,NaN,NaN,64.43014270500468,137.85600134804181,0.05699488586181345,0.6004682072111791,0.5434733213493657,5710800,6035220,93.15879289792929,87.94995039531872,NaN,NaN,23.2078001044005,20.669506191267125
2000-01-13T09:30:00-05:00,26.89062,26.96875,26.625,26.75,45900,316185,57.83874389952021,61.5786842500939,NaN,NaN,60.50964364606178,112.10907596355923,0.01973873599155651,0.5681467413388113,0.5484080053472548,5756700,5851280,82.14628426079025,88.91640395801335,NaN,NaN,22.10873334854631,20.87511007087844
2000-01-14T09:30:00-05:00,26.51562,26.71875,26.4375,26.5625,76000,319110,55.599952768657765,61.40892039554057,NaN,NaN,34.658048565121334,80.85647423569199,-0.021612977201641126,0.5213917838452033,0.5430047610468445,5680700,5776020,78.0793129585797,89.15983186162237,NaN,NaN,20.54002310209703,20.827240503909668
2000-01-18T09:30:00-05:00,26.21875,26.3125,25.6875,25.92187,34400,304540,48.66837284475752,60.39664803460075,NaN,NaN,-28.101854834292265,46.071106907764644,-0.09223242266415888,0.4277142327166459,0.5199466553808048,5646300,5728120,75.51670483630099,88.71926629892803,NaN,NaN,16.97186797316117,20.276472999517026
2000-01-19T09:30:00-05:00,25.78125,25.95312,25.42187,25.42187,125700,291595,44.05228881690465,58.76049303960014,NaN,NaN,-70.87749781861176,12.12369645265677,-0.16830943326801134,0.3095598637957906,0.47786929706380193,5520600,5663020,72.05537674588393,87.59080211967634,NaN,NaN,12.421408934493533,19.154320990227955
2000-01-20T09:30:00-05:00,25.6875,25.6875,24.75,24.75,99400,271195,38.73564463681372,57.198594078863515,NaN,NaN,-129.7768083545021,-26.71769375924459,-0.2544037880011166,0.15986456206240618,0.4142683500635228,5421200,5605100,69.02405220489277,86.05292957872413,NaN,NaN,6.6605239963723415,17.36949284824858
2000-01-21T09:30:00-05:00,25.125,25.125,24.5625,24.85937,180100,260425,40.00499599050423,55.44209661012855,NaN,NaN,-150.89481879194716,-68.99858624684637,-0.2918268622525885,0.049484772247787134,0.34131163450037566,5601300,5574020,67.38583384332503,84.29191862450318,NaN,NaN,2.473813363431146,15.241538636131803
2000-01-24T09:30:00-05:00,24.76562,24.76562,23.85937,24.20312,190900,245780,35.281372808091106,53.88998940246169,NaN,NaN,-191.22517804387462,-114.17523156864556,-0.34497688874910515,-0.08990947643600578,0.2550674123130994,5410400,5519960,64.51750704844423,82.29324544958722,NaN,NaN,-2.7532258638483893,12.67085799327749
2000-01-25T09:30:00-05:00,24.10937,24.25,23.39062,23.75,63400,215290,32.43372399150333,52.33532431580269,NaN,NaN,-199.0615509922834,-148.3671708002438,-0.3914484978535254,-0.23424321000380743,0.157205287849718,5347000,5460100,61.40091320737346,80.06979799840268,NaN,NaN,-8.073994447711286,9.707307644564809
2000-01-26T09:30:00-05:00,23.96875,24.39062,23.75,23.75,300700,221720,32.43372399150333,50.178162166548596,NaN,NaN,-154.66689540956332,-165.12505031843412,-0.40148883564151944,-0.3446557567021813,0.05683307893933813,5347000,5425380,59.602478652724194,77.91826552639124,NaN,NaN,-12.253149944257919,6.570099417590134
2000-01-27T09:30:00-05:00,24,24.17187,23.75,23.875,54300,207000,34.134568619470485,47.838926280174064,NaN,NaN,-132.0549743579846,-165.58068351913062,-0.37927614501519735,-0.41726210232965855,-0.03798595731446121,5401300,5421400,59.387742748381534,75.64166943028195,NaN,NaN,-15.192617450897675,3.461139864949019
2000-01-28T09:30:00-05:00,23.84375,23.85937,22.84375,23.46875,29400,206280,31.370644327456844,45.31553372893558,NaN,NaN,-140.92073376027807,-163.5858665127968,-0.37105099382010864,-0.501799699589597,-0.13074870576948838,5371900,5375520,56.84525099120581,73.14917626447793,NaN,NaN,-18.569367932368475,0.31392446533223417
2000-01-31T09:30:00-05:00,23.25,23.375,23.10937,23.32812,16300,200915,30.451446606196058,42.81043494155428,NaN,NaN,-126.57014757259847,-150.65486041854155,-0.35422718923984703,-0.5735326923192972,-0.21930550307945013,5355600,5364560,56.2259928902315,70.58178411275004,NaN,NaN,-21.633802395083706,-2.821465086155757
2000-02-01T09:30:00-05:00,23.32812,23.875,23.32812,23.75,42700,196025,36.465797052230954,41.02642161058332,NaN,NaN,-92.94793514093692,-129.43213724827228,-0.29619041744632874,-0.5895435248873611,-0.2933531074410323,5398300,5374820,56.70151606617875,68.00341138230293,NaN,NaN,-22.570467668023486,-5.642751169279718
2000-02-02T09:30:00-05:00,23.875,23.875,23.5625,23.85937,49000,185575,37.9635545181412,39.673916490839375,NaN,NaN,-77.8050623507128,-114.05977063650218,-0.23463311995516523,-0.5866445073849889,-0.35201138742982363,5447300,5394880,57.66973729212232,65.46847883903101,NaN,NaN,-22.92080500927884,-8.111044574993878
2000-02-03T09:30:00-05:00,23.98437,23.98437,23.3125,23.45312,183800,189630,34.69207621594782,38.020583084869926,NaN,NaN,-78.4715709851188,-103.34308996192901,-0.2064670478896195,-0.610095197291848,-0.4036281494022285,5263500,5367320,55.82282328672348,63.588231626597654,NaN,NaN,-24.167427742629176,-10.404813598941777
2000-02-04T09:30:00-05:00,23.60937,23.60937,23.28125,23.42187,105000,128130,34.446175655454,36.50959900535537,NaN,NaN,-79.0602854903304,-90.97100030793948,-0.17630425696746543,-0.6240084706115603,-0.44770421364409485,5158500,5324640,52.99245702497512,61.796313345625904,NaN,NaN,-25.25648725214267,-12.526481263684762
2000-02-07T09:30:00-05:00,23.54687,23.54687,22.95312,22.96875,49100,99615,31.013534648893256,35.24853913422221,NaN,NaN,-86.83786503651801,-83.02454380072338,-0.17299206946109347,-0.6639443004704617,-0.49095223100936825,5109400,5275400,49.852007552857145,59.963120682522764,NaN,NaN,-27.21674513757221,-14.625090388525825
2000-02-08T09:30:00-05:00,23,23.28125,22.75,22.90625,134700,97790,30.56114930544811,34.28488631197531,NaN,NaN,-90.35058160114448,-82.50507309276489,-0.16136021057586292,-0.692652494229197,-0.531292283653334,4974700,5190680,44.919525638288846,58.024845603408835,NaN,NaN,-28.961370891269777,-16.67313046034639
2000-02-09T09:30:00-05:00,22.89062,23.01562,22.45312,22.45312,33500,97480,27.436421394890232,33.47779893755221,NaN,NaN,-104.99732478169052,-87.94352557896043,-0.16968482557006026,-0.7433983156159094,-0.5737134900458492,4941200,5089460,39.84680005402353,55.940756164061035,NaN,NaN,-31.432674963147605,-18.78163681788942
2000-02-10T09:30:00-05:00,22.5,22.5,22.09375,22.26562,131100,97270,26.24082881403625,32.49464413923307,NaN,NaN,-123.20146082523631,-96.88950354698393,-0.17274274961589364,-0.7896419270657162,-0.6168991774498226,4810100,4998780,35.93193598642199,53.694049174282235,NaN,NaN,-33.86225017264237,-20.936010154282698
2000-02-11T09:30:00-05:00,22.20312,22.4375,21.46875,21.71875,24300,96190,23.08154825698935,31.62322809986865,NaN,NaN,-150.16179051709733,-111.10980455233732,-0.19487975055410334,-0.8604988656424517,-0.6656191150883484,4785800,4924240,33.05687176679933,51.44686093987902,NaN,NaN,-37.019349586289614,-23.23363007314083
2000-02-14T09:30:00-05:00,22,22.25,21.64062,22.07812,24100,93595,29.120655507718723,31.386580351026897,NaN,NaN,-137.72844100941617,-121.28791974691697,-0.16953639906671947,-0.8775396139217477,-0.7080032148550283,4809900,4864340,30.91608439583179,49.26937316762605,NaN,NaN,-37.89442313279437,-25.328029081662763
2000-02-15T09:30:00-05:00,22.15625,23.03125,22.01562,23.03125,32600,93505,42.103980235666675,32.077312939895705,NaN,NaN,-73.81786497294829,-117.98137642127772,-0.07748303907358811,-0.8048570136970135,-0.7273739746234253,4842500,4837900,29.992773995032465,47.15439426350522,NaN,NaN,-34.28494536564957,-26.607588550803737
2000-02-16T09:30:00-05:00,23,23.0625,22.45312,22.5,17400,88090,37.93320096822431,32.34864382194955,NaN,NaN,-68.72633343860154,-110.72717815265992,-0.0429957916768986,-0.7811187142195486,-0.73812292254265,4825100,4814680,29.16888533591957,44.99590444832937,NaN,NaN,-32.65641108346832,-27.471706055470104
2000-02-17T09:30:00-05:00,22.75,22.96875,22.39062,22.45312,45700,85405,37.5794337165696,32.79212877831475,NaN,NaN,-67.67470315684571,-99.62182661898181,-0.015388388980992596,-0.7573584087688907,-0.7419700197878981,4779400,4808540,28.942484235015556,43.00284968003006,NaN,NaN,-31.50340269542522,-28.047662718320836
2000-02-18T09:30:00-05:00,22.57812,22.57812,21.71875,21.76562,90500,80925,32.75500795490822,32.95666887465133,NaN,NaN,-117.23087184699214,-93.03564288496078,-0.03438816387082233,-0.784955224626426,-0.7505670607556036,4688900,4789160,28.19851492117111,41.00088696795432,NaN,NaN,-32.08310249113933,-28.624154114437765
2000-02-22T09:30:00-05:00,22.125,22.625,21.82812,22.45312,48900,73825,40.92272253106896,33.27502069456833,NaN,NaN,-78.35243470639892,-81.16044162435733,0.006223250185812157,-0.7427879980233385,-0.7490112482091507,4737800,4774740,27.62941685837029,38.92430845311087,NaN,NaN,-29.75132287230471,-28.78517822270447
2000-02-23T09:30:00-05:00,22.46875,22.54687,22.01562,22.20312,56300,73470,39.06459335089674,33.35366632547944,NaN,NaN,-75.55972170946369,-81.5088129716604,0.02222564130635496,-0.721229196576207,-0.743454837882562,4681500,4742540,26.350548548597487,36.68722354285909,NaN,NaN,-28.502549696870012,-28.744802719013833
2000-02-24T09:30:00-05:00,21.96875,21.96875,21.125,21.40625,18800,59375,33.79690086335904,33.289725228865954,NaN,NaN,-145.33727037215894,-96.83100035837188,-0.012985920722972333,-0.7596872387862774,-0.7467013180633051,4662700,4710060,25.08905995372156,34.49195473335895,NaN,NaN,-29.22591472762928,-28.8135330059589
2000-02-25T09:30:00-05:00,21.46875,21.46875,21,21.0625,24900,57905,31.80454804743674,33.101037542579,NaN,NaN,-165.76545912966066,-116.44915155293486,-0.0495048907723914,-0.8085824315287944,-0.759077540756403,4637800,4681740,24.009757050487636,32.42176187803842,NaN,NaN,-30.47711427163509,-29.05118747248407
2000-02-28T09:30:00-05:00,21,21.53125,20.82812,21.125,199600,66415,32.5827324298276,33.21312309836003,NaN,NaN,-144.93697485419327,-121.99037215437508,-0.0588901764995724,-0.8326902613808684,-0.773800084881296,4837400,4711440,27.530714828035727,30.827383826265464,NaN,NaN,-31.210783246045487,-29.359701154421415
2000-02-29T09:30:00-05:00,21.20312,21.29687,20.76562,20.98437,29100,67055,31.70603118369121,33.294900375377395,NaN,NaN,-139.48705705446005,-134.21729662398732,-0.06360566180090521,-0.8533071621324275,-0.7897015003315223,4808300,4725540,29.207726898027957,29.705112487675397,NaN,NaN,-32.06923692827735,-29.74677769354369
2000-03-01T09:30:00-05:00,21.23437,21.23437,20.57812,20.76562,119700,70905,30.338573045088395,33.50219692182012,NaN,NaN,-140.15493730807023,-147.13633974370862,-0.06998747886100509,-0.8771858489077786,-0.8071983700467735,4688600,4726960,29.38495531740483,28.957837863631205,NaN,NaN,-33.18705843340839,-30.23824637066722
2000-03-02T09:30:00-05:00,20.75,20.75,20.15625,20.3125,184000,77655,27.675866877567998,33.604699640643815,NaN,NaN,-160.3116722947731,-150.13122012823146,-0.0918766052371579,-0.9220441265932209,-0.830167521356063,4504600,4695340,27.720736327694894,28.371323602293558,NaN,NaN,-34.96332308800344,-30.91325733028668
2000-03-03T09:30:00-05:00,20.5,21.53125,20.5,20.96875,162400,76585,36.38417921080672,34.55488756591648,NaN,NaN,-94.98393032142164,-135.97491436658365,-0.05133114141393991,-0.8943314481234879,-0.843000306709548,4667000,4701180,28.525873650199117,28.047680879679255,NaN,NaN,-33.799109854662966,-31.32552197662615
2000-03-06T09:30:00-05:00,21.15625,21.15625,20.25,20.46875,20900,72380,33.112792129795665,34.84004018177912,NaN,NaN,-115.35645922013725,-130.05881123977244,-0.04745052595925503,-0.9023134641586168,-0.8548629381993618,4646100,4662920,26.447348963677854,27.72848549166826,NaN,NaN,-33.84193206430977,-31.685009132009522
2000-03-07T09:30:00-05:00,20.57812,20.59375,19.75,19.8125,198400,79845,29.37907459392443,33.93111835022611,NaN,NaN,-145.9266377893553,-131.34672738675152,-0.07661751604495548,-0.9506348332555561,-0.8740173172106006,4447700,4590800,23.03947006084998,27.23182092494094,NaN,NaN,-35.106887802683545,-32.17384894210581
2000-03-08T09:30:00-05:00,19.8125,20.29687,19.6875,20.23437,112600,78740,34.49270497162266,33.685368636183135,NaN,NaN,-128.21569929254542,-128.95887978364655,-0.05599139669610098,-0.9440065630807268,-0.8880151663846259,4560300,4565140,21.95546748451649,26.71657679269786,NaN,NaN,-34.48425819267224,-32.50390740647244
2000-03-09T09:30:00-05:00,19.89062,20.25,19.82812,20.20312,112400,82685,34.29460800097425,33.45073822792632,NaN,NaN,-113.49456988462647,-119.59545930161721,-0.034026620375911754,-0.9305484418545156,-0.8965218214786038,4447900,4553800,21.4746015312097,26.18315659956887,NaN,NaN,-34.054422117697115,-32.72540950807597
2000-03-10T09:30:00-05:00,20.1875,20.73437,20.1875,20.375,27700,77515,36.45624835533308,33.71511254224239,NaN,NaN,-77.13662487740056,-116.025998212813,0.0006666059320363793,-0.8956885640635583,-0.8963551699955947,4475600,4515520,19.890879749119932,25.58975408727951,NaN,NaN,-33.06058926053867,-32.77329232985635
2000-03-13T09:30:00-05:00,20,20.73437,19.96875,20.6875,47000,78650,40.30175322487683,33.67075759180009,NaN,NaN,-68.22688930634203,-106.60008423005395,0.05049162240663674,-0.8332406419872989,-0.8837322643939356,4522600,4490820,18.921234335169956,24.967741049908057,NaN,NaN,-31.07873388873613,-32.53121255255346
2000-03-14T09:30:00-05:00,20.85937,20.85937,20.15625,20.32812,16400,78265,37.491762196879414,33.558412509370285,NaN,NaN,-64.50170628126176,-90.31509792843524,0.06419614952398922,-0.8034870774889491,-0.8676832270129383,4506200,4502520,20.88854046291263,24.577597615216284,NaN,NaN,-30.19791585593464,-32.19788445303649
2000-03-15T09:30:00-05:00,20.17187,22.5,20.17187,21.54687,444600,98865,50.17834251395417,34.728515484412796,NaN,NaN,26.67856974576743,-59.33624412077266,0.15510889351549406,-0.6737971101185707,-0.8289060036340647,4950800,4580620,32.638270788250466,25.11682696053978,NaN,NaN,-25.042247623146118,-31.175650620195004
2000-03-16T09:30:00-05:00,21.625,22.9375,21.625,22.90625,233900,109690,59.94371686581619,36.73845611429704,NaN,NaN,133.49592065525567,-9.938146012796238,0.29826960932482316,-0.45606899197803585,-0.754338601302859,5184700,4727980,48.25444965358826,26.848590717904106,NaN,NaN,-16.603875369356167,-29.09396844150374
2000-03-17T09:30:00-05:00,22.85937,22.85937,22,22,65200,110665,52.54891853886886,38.16461226494284,NaN,NaN,118.27498512490075,29.144175987664028,0.32140658992495064,-0.3525803638966707,-0.6739869538216213,5119500,4856760,57.522247792820444,28.990843072531586,NaN,NaN,-12.425395914008853,-26.712743794718758
2000-03-20T09:30:00-05:00,22.3125,22.6875,22.15625,22.26562,27500,107515,54.3273467694271,39.78042052106684,NaN,NaN,121.36856837456592,67.06326752384562,0.3421555948526953,-0.24629246025575213,-0.5884480551084474,5147000,4981640,64.21537629302543,31.49138945788857,NaN,NaN,-8.604836213134963,-24.125899854492502
2000-03-21T09:30:00-05:00,22.20312,22.75,22.125,22.53125,45400,107340,56.09934099244119,41.62047537444918,NaN,NaN,128.4588127287788,105.65537132585371,0.35954096213235703,-0.13902185244300114,-0.49856281457535817,5192400,5118880,69.83975989314781,34.38101835615593,NaN,NaN,-5.013405719889919,-21.395543549549277
2000-03-22T09:30:00-05:00,22.32812,22.45312,21.84375,21.95312,120400,110545,51.42309509534632,43.31670596143334,NaN,NaN,93.59591181215248,119.03883973913071,0.3192404382147801,-0.09951226680688308,-0.4187527050216632,5072000,5143120,70.71526046410042,37.4520557944706,NaN,NaN,-3.6024060662997672,-18.853666766227917
2000-03-23T09:30:00-05:00,22.07812,22.73437,21.96875,22.625,31700,111190,56.01214955097006,44.71870384287358,NaN,NaN,115.14036617220323,115.36772884252022,0.3239412397277472,-0.013826155361979175,-0.33776739508972636,5103700,5126920,69.26808267637865,40.362213582054856,NaN,NaN,-0.8727159063262822,-16.284959500527684
2000-03-24T09:30:00-05:00,22.60937,22.76562,22.45312,22.51562,12000,110545,55.09956641013439,46.28918772004063,NaN,NaN,108.66879486529777,113.44649079059964,0.3060050607709078,0.044738930873908345,-0.26126612989699943,5091700,5121360,68.74807025783409,43.38369367449459,NaN,NaN,0.9769809052306156,-13.818968013990784
2000-03-27T09:30:00-05:00,22.64062,22.8125,22.1875,22.42187,39900,102560,54.28322119165633,48.06805533416434,NaN,NaN,87.99493738192373,106.7717645920712,0.275120727799342,0.08263477985217804,-0.19248594794716395,5051800,5102320,66.89599967987644,46.51630293299648,NaN,NaN,2.212219493514047,-11.528798370061523
2000-03-28T09:30:00-05:00,22.15625,22.5625,21.9375,22,114000,106805,50.64683474390729,49.221921746470386,NaN,NaN,58.6652832764501,92.81305870160546,0.21617284286537744,0.07773010563455784,-0.1384427372308196,4937800,5051400,62.07929591422091,49.38229067797537,NaN,NaN,2.171562486338061,-9.57160396200444
2000-03-29T09:30:00-05:00,22.125,22.45312,21.95312,22.45312,27500,102195,54.196006645808666,50.64345022110142,NaN,NaN,61.079858963996514,86.30984813197425,0.1980725288053873,0.10914792377591453,-0.08892460502947278,4965300,5030060,60.12541286894012,52.14306291638468,NaN,NaN,3.1968908433504986,-7.747533275525163
2000-03-30T09:30:00-05:00,22.51562,23.29687,22.375,23.0625,103600,98175,58.516623628073496,52.21919131201144,NaN,NaN,95.77498285489898,82.4367714685134,0.21604422998167688,0.18113068244762331,-0.03491354753405356,5068900,5023100,59.46800535820945,54.970000459891075,NaN,NaN,5.416429939776472,-5.866967101910644
2000-03-31T09:30:00-05:00,23.14062,23.48437,22.9375,23.04687,152600,97685,58.36455240128093,53.50939125318316,NaN,NaN,102.15908636688027,81.1348297688299,0.21530397864045228,0.2342164257665118,0.018912447126059516,4916300,4988020,56.13638099418416,57.62822522124923,NaN,NaN,7.148833844002985,-4.007566966780126
2000-04-03T09:30:00-04:00,23.4375,23.79687,23.375,23.79687,114700,102375,63.293935603190455,55.35240363934823,NaN,NaN,125.76894283038125,88.68963085852141,0.2512442398004023,0.3329677468765624,0.0817235070761601,5031000,4983860,55.737595532987044,60.117443440540264,NaN,NaN,10.212588409317712,-1.976116198766149
2000-04-04T09:30:00-04:00,24.15625,24.53125,23.15625,23.57812,185500,101730,61.024564536052914,56.127133783783854,NaN,NaN,128.49291087091314,102.65515637741404,0.2458950894306517,0.38909236886447474,0.14319727943382304,4845500,4965400,53.90752695770315,61.63667602407259,NaN,NaN,12.069564747084739,0.030409650641120667
2000-04-05T09:30:00-04:00,23.85937,23.96875,23.25,23.39062,30400,97620,59.06957188250328,56.064694856404365,NaN,NaN,111.57720749409953,112.75462608343464,0.21638080447037383,0.41367328502179035,0.19729248055141652,4815100,4935360,50.97444272342853,61.8309612433469,NaN,NaN,13.04992203232849,1.8903399908821734
2000-04-06T09:30:00-04:00,23.35937,23.73437,23.23437,23.25,22600,93130,57.57972869355838,56.424038438882185,NaN,NaN,99.27671074384253,113.45497166122337,0.1757660653499172,0.41700006223881303,0.24123399688889582,4792500,4880080,46.01299501057137,61.00887175890053,NaN,NaN,13.451307899354337,3.541906834949625
2000-04-07T09:30:00-04:00,23.5,23.5,22.875,22.875,43700,93930,53.69067066748853,56.378561574458004,NaN,NaN,64.41166996699572,105.90548838124644,0.11496467788842774,0.3849398442494305,0.26997516636100277,4748800,4846580,43.264772975306606,59.512400093349186,NaN,NaN,12.701288029834965,4.850389862790387
2000-04-10T09:30:00-04:00,23.1875,23.75,22.95312,23.4375,42600,93710,58.24627481499198,56.53191399035449,NaN,NaN,85.52867321068548,97.85743445730728,0.10426503160059403,0.4003064558617453,0.29604142426115126,4791400,4798660,39.61944669434059,57.35380629343439,NaN,NaN,13.348728305462176,6.0644382117435
2000-04-11T09:30:00-04:00,23.8125,24.39062,23.75,24,393100,112545,62.24595828320812,57.30497564663033,NaN,NaN,144.92494372642759,101.14384102841018,0.1252914380894538,0.45265572187296854,0.32736428378351473,5184500,4866460,46.489197861256265,55.62337325037409,NaN,NaN,15.118193661797033,7.357831847465433
2000-04-12T09:30:00-04:00,24.0625,25.15625,24.0625,24.625,240800,102355,66.12842675291061,58.02756687534038,NaN,NaN,183.92321082462857,115.61304169451599,0.16880392030767444,0.5383691841681078,0.3695652638604333,5425300,4988500,56.158342768426735,54.68696325694896,NaN,NaN,17.878869633982998,8.86083724553937
2000-04-13T09:30:00-04:00,24.125,24.375,23.92187,23.9375,613200,121320,58.94740052665392,58.30241216937749,NaN,NaN,109.55519572405524,117.66873869055853,0.1399838209059484,0.5445450399928689,0.40456121908692044,4812100,4992420,56.430673096793555,53.80714917401748,NaN,NaN,17.982547267298838,10.163938677219294
2000-04-14T09:30:00-04:00,23.375,23.625,22.375,22.625,145200,125320,48.188801122229215,57.8670964501327,NaN,NaN,-21.396473356284137,100.50711002590255,0.02713276656370589,0.4384771772915528,0.4113444107278469,4666900,4976040,54.896184307110346,52.95001950453419,NaN,NaN,14.239311743183903,10.746134829499953
2000-04-17T09:30:00-04:00,22.96875,22.96875,22.375,22.65625,52800,126585,48.43013730916049,57.70876091907935,NaN,NaN,-47.23923708296496,73.95352796717245,-0.046778278947389285,0.35287156204361025,0.39964984099099954,4719700,4961700,53.52398601225953,52.33892594010838,NaN,NaN,11.460048425276739,10.848122486039493
2000-04-18T09:30:00-04:00,22.53125,22.70312,22,22.23437,24000,125515,45.358426113492975,57.0775051667711,NaN,NaN,-85.37308567652727,27.89392208658149,-0.12121902302425547,0.24812606221068023,0.3693450852349357,4695700,4863940,45.224596588562946,51.274581920081445,NaN,NaN,8.168572157022718,10.46532958189424
2000-04-19T09:30:00-04:00,22.3125,22.54687,21.78125,21.95312,27500,120870,43.38294889083352,55.99652839982537,NaN,NaN,-110.00303481979881,-30.89132704230398,-0.18283850435193977,0.14079695479501098,0.32363545914695074,4668200,4712520,35.931171476092786,49.59337949993026,NaN,NaN,4.859580857645171,9.664508335572945
2000-04-20T09:30:00-04:00,22.09375,22.51562,22.09375,22.5,139000,126235,48.114906515982035,55.26441083658973,NaN,NaN,-78.20283968848652,-68.44293412481234,-0.179925623671839,0.098728429557152,0.278654053228991,4807200,4711540,35.879781500789505,48.14647953611635,NaN,NaN,3.5089804550858785,8.785147209789079
2000-04-24T09:30:00-04:00,22.3125,22.78125,22.3125,22.54687,19900,126630,48.51208571593312,54.208564416071354,NaN,NaN,-58.16708181555443,-75.7970558166664,-0.16821718989733409,0.06838256585732339,0.23659975575465747,4827100,4743580,38.95386944893974,46.9476419586844,NaN,NaN,2.54725813065368,7.8940201984840215
2000-04-25T09:30:00-04:00,22.70312,22.8125,22.28125,22.57812,231900,136230,48.79354034442421,53.33491983095502,NaN,NaN,-57.874799417759405,-77.92416828362528,-0.15222308019338332,0.046320905512928334,0.19854398570631165,5059000,4811440,44.97136860023869,46.30934493315122,NaN,NaN,1.8441283480725168,7.029749934139521
2000-04-26T09:30:00-04:00,22.57812,22.65625,22.15625,22.1875,29900,132025,45.4491425588763,52.36203202212453,NaN,NaN,-85.03079303218279,-77.85570975475639,-0.16095704014732318,-0.0026523144778423102,0.15830472566948087,5029100,4878120,50.16919985907816,46.251827585697626,NaN,NaN,0.2807290784183602,6.065604097607927
2000-04-27T09:30:00-04:00,22.1875,22.40625,22,22.10937,64400,133870,44.787894702650895,51.44832959420257,NaN,NaN,-101.69593497897638,-76.1942897865919,-0.16442299106840014,-0.04722401316601932,0.11719897790238082,4964700,4937420,54.30313498711571,46.84398044116507,NaN,NaN,-1.1983470420744102,5.027896791939021
2000-04-28T09:30:00-04:00,22.03125,22.46875,22.03125,22.28125,31200,130250,46.627596970469966,50.943824330129814,NaN,NaN,-83.52030832134365,-77.25778351316333,-0.14807555772442904,-0.06789546925315548,0.08018008847127356,4995900,4975160,56.76161748837992,47.80804076352746,NaN,NaN,-1.9682705672531224,4.028444312054429
2000-05-01T09:30:00-04:00,22.07812,22.375,22,22.25,21100,123675,46.3253642786065,50.092330720388,NaN,NaN,-79.9914386257889,-81.62265487521022,-0.13279222634352852,-0.08581019445813709,0.04698203188539143,4974800,5004700,58.63739727654046,49.16646580511316,NaN,NaN,-2.692110283464027,3.068365084123221
2000-05-02T09:30:00-04:00,22.25,22.9375,22.25,22.9375,27200,119300,53.47083762888586,49.46553638793641,NaN,NaN,-25.604857665141697,-75.16866652468669,-0.07280542472961102,-0.044024749026622345,0.02878067570298867,5002000,4993300,57.59889933280173,49.960015910223554,NaN,NaN,-1.3706618348172463,2.43421838141744
2000-05-03T09:30:00-04:00,22.84375,22.84375,22.25,22.5625,89400,114495,49.592702627246055,48.28441323610322,NaN,NaN,-38.09679558281787,-65.7818670348137,-0.055584290804150324,-0.040699687802199236,0.014884603001951087,4912600,4970000,55.43780973700585,49.90854926512207,NaN,NaN,-1.3135645265359512,1.8988208231383839
2000-05-04T09:30:00-04:00,22.65625,22.98437,22.45312,22.79687,100300,117990,51.93885124141073,47.78380257287157,NaN,NaN,-12.744891439540922,-47.99165832692661,-0.027055351531238732,-0.01893458641209733,0.008120765119141402,5012900,4979640,56.170517390961976,49.88996671470552,NaN,NaN,-0.6019054258908525,1.5415742161342072
2000-05-05T09:30:00-04:00,22.78125,23,22.76562,22.78125,10300,117375,51.765921477864,48.03931116970262,NaN,NaN,3.3925650993164,-30.609083642794598,-0.008826546232566653,-0.0029124176715669137,0.005914128560999739,5002600,4980980,56.27813301939396,49.9886773370115,NaN,NaN,-0.06107516698209631,1.3126243042604495
2000-05-08T09:30:00-04:00,22.875,23.0625,22.65625,22.65625,276500,129015,50.321982574261725,48.17444297435271,NaN,NaN,-2.189385517358589,-15.048673021108536,-0.0049695080417058845,-0.00029775649113261693,0.0046717515505732676,4726100,4931240,51.24808311582705,49.82611284440918,NaN,NaN,0.02086098326767506,1.1280866869757675
2000-05-09T09:30:00-04:00,22.96875,23.15625,22.85937,23.0625,1003200,177045,54.74055647190639,48.84459514281081,NaN,NaN,33.086482148329495,-3.3104050584142968,0.02359185305514705,0.03416156786950708,0.01056971481436003,5729300,5076700,61.956698046122916,51.02126294852061,NaN,NaN,1.3089517189085162,1.153924548680446
2000-05-10T09:30:00-04:00,22.8125,23.125,22.67187,22.78125,46200,159700,51.33627059438795,49.41268955020756,NaN,NaN,21.447777164302266,8.598509491009732,0.02221175692320041,0.038334410968360544,0.016122654045160133,5683100,5230800,69.58002009931738,53.4247521358938,NaN,NaN,1.4966267947091116,1.2028820123988266
2000-05-11T09:30:00-04:00,22.78125,23.09375,22.78125,23.07812,32700,149295,54.549307987694036,49.87228965532984,NaN,NaN,72.28773018549622,25.60503381601716,0.03898092510166176,0.06484881042223734,0.025867885320575573,5715800,5371380,74.58364662935813,56.189313930791556,NaN,NaN,2.5614634520797184,1.3969650752103826
2000-05-12T09:30:00-04:00,23.23437,23.23437,22.9375,23.15625,14000,119335,55.38420936981098,50.36315563060682,NaN,NaN,130.13324799999896,50.95317039615367,0.05219831183774508,0.09111577511775693,0.038917463280011846,5729800,5516820,78.52008558247203,59.01547222604386,NaN,NaN,3.680686422811399,1.7232109820105277
2000-05-15T09:30:00-04:00,23.125,23.78125,23.125,23.5625,41500,114150,59.545445285996465,51.13114884071913,NaN,NaN,196.42248777578774,90.67554505478294,0.0833175148623265,0.14306435685791996,0.05974684199559347,5771300,5725860,82.67370113032959,61.708495978193206,NaN,NaN,5.868247073116348,2.315358995025645
2000-05-16T09:30:00-04:00,23.75,23.78125,23.21875,23.3125,1223000,172660,56.07914301922212,51.890434587886695,NaN,NaN,155.13455081621794,115.08515878836063,0.08195567012601568,0.16219142965311306,0.08023575952709738,4548300,5489660,66.92580524138668,62.90539636264382,NaN,NaN,6.784876217312682,2.9538614553523646
2000-05-17T09:30:00-04:00,23.21875,23.59375,23.125,23.375,14000,172160,56.75687756186264,52.745361934973246,NaN,NaN,124.82298269000016,135.76019989350021,0.08006295045993701,0.18031444760201865,0.10025149714208163,4562300,5265500,56.0199279180621,63.02802442913999,NaN,NaN,7.73402503906116,3.6367419673107637
2000-05-18T09:30:00-04:00,23.3125,23.39062,23,23.1875,210200,181295,54.061717321312784,53.27637053146202,NaN,NaN,83.16352705899477,137.9353592681999,0.061799812551516245,0.17750126283147694,0.11570145027996069,4352100,4992760,46.16309634875285,62.27098720488092,NaN,NaN,7.824316153598885,4.2349668510662095
2000-05-19T09:30:00-04:00,23.10937,23.32812,23.0625,23.25,22200,175455,54.831669170895466,53.88396373805409,NaN,NaN,78.88270105126182,127.68524987845248,0.05004695918485977,0.1782601492610354,0.12821319007617563,4374300,4721660,38.846458115726385,60.8573486933942,NaN,NaN,8.10298274513115,4.787540550218344
2000-05-22T09:30:00-04:00,23.34375,23.34375,22.9375,23.125,51800,177050,52.921229128849475,53.84470598805149,NaN,NaN,57.457029827314166,99.89215828875777,0.030910850928710126,0.1668517537370633,0.13594090280835316,4322500,4431900,32.85290886060665,59.08977794538026,NaN,NaN,7.844666856019799,5.224272879618551
2000-05-23T09:30:00-04:00,22.9375,22.95312,22.60937,22.79687,52800,168095,48.17603874382899,53.74351571066456,NaN,NaN,-15.494584030967781,65.76633131932064,-0.00488352617222676,0.12983649509306971,0.13472002126529647,4269700,4376180,31.835712986220585,57.403913891752744,NaN,NaN,6.313313057151493,5.379850047837543
2000-05-24T09:30:00-04:00,22.5625,22.89062,22.5,22.70312,44700,168835,46.88260126505851,53.38235499806797,NaN,NaN,-39.740027446080184,32.85372929210456,-0.03427386847617245,0.09187768567008092,0.12615155414625337,4225000,4308720,30.60039789425477,55.57747678484509,NaN,NaN,4.661527331597737,5.2772325169461425
2000-05-25T09:30:00-04:00,22.45312,22.45312,21.71875,21.875,39700,167600,37.34474921786065,52.35227126521058,NaN,NaN,-183.38062430946093,-20.455100981586586,-0.1048972562259585,-0.004970016136194744,0.09992724008976375,4185300,4275360,29.98085473614003,53.69909976461266,NaN,NaN,0.012488299712772264,4.525126200198518
2000-05-26T09:30:00-04:00,21.75,21.76562,21.5,21.53125,28000,167440,34.23159829908137,51.20295810269771,NaN,NaN,-240.1531825571744,-84.26227770327384,-0.1665120794700709,-0.10821285924782487,0.058299220222246026,4157300,4231960,29.1538855878605,52.12094279832934,NaN,NaN,-4.967591453983819,3.1690236781724703
2000-05-30T09:30:00-04:00,21.71875,21.9375,21.46875,21.76562,11600,166965,38.025019135808954,50.008991150119314,NaN,NaN,-196.05616513495355,-134.96491669572737,-0.18197677564148224,-0.16917174932960677,0.01280502631187546,4168900,4201240,28.553512788816292,49.73500099423602,NaN,NaN,-7.963782679033041,1.5786227700002546
2000-05-31T09:30:00-04:00,21.78125,21.98437,21.57812,21.57812,15400,166375,36.22488570698476,48.929606515304805,NaN,NaN,-162.78393448516385,-164.4227867865666,-0.1942127772657144,-0.22996094527026756,-0.035748168004553146,4153500,4178000,28.08236427370359,46.77088272097789,NaN,NaN,-11.00548878506098,-0.21910745215135008
2000-06-01T09:30:00-04:00,21.23437,21.64062,21.23437,21.64062,14000,162605,37.29057717268726,47.6968400285186,NaN,NaN,-160.36841326690129,-188.54846395073082,-0.1873865981147952,-0.2699814156480471,-0.08259481753325194,4167500,4166500,27.83758410819169,43.43187825518029,NaN,NaN,-13.182626874115948,-2.0710387981462928
2000-06-02T09:30:00-04:00,21.70312,22,21.70312,22,29000,159040,43.171003335359124,46.8244681689149,NaN,NaN,-92.16923790421323,-170.30618666968127,-0.14959717294493666,-0.26959128371442276,-0.1199941107694861,4196500,4168740,27.969286945420976,39.82110692396236,NaN,NaN,-13.352050824052132,-3.6826119447042696
2000-06-05T09:30:00-04:00,22.0625,22.0625,21.71875,21.8125,31600,160105,41.010272339382794,45.50052724415678,NaN,NaN,-83.70431355513206,-139.0164128692728,-0.12894121091069627,-0.28117062440785645,-0.15222941349716018,4164900,4170260,28.065227713883957,35.92050167993053,NaN,NaN,-14.127188690744271,-5.174694336995698
2000-06-06T09:30:00-04:00,21.78125,21.9375,21.625,21.84375,8300,146695,41.53548399026542,44.461694456374154,NaN,NaN,-79.56116116878445,-115.717412076039,-0.10585299423981104,-0.28454565629692397,-0.17869266205711293,4173200,4171120,28.123560347150473,33.14891275891365,NaN,NaN,-14.613971166840573,-6.523162455544965
2000-06-07T09:30:00-04:00,21.84375,21.84375,21.3125,21.375,57500,99410,36.312801137266845,43.001403283188736,NaN,NaN,-96.24125699376454,-102.40887657775913,-0.11411818147573743,-0.32134038890178473,-0.2072222074260473,4115700,4163560,27.909305935697134,31.14101118874473,NaN,NaN,-16.618675273458013,-7.965378572389686
2000-06-08T09:30:00-04:00,21.23437,21.40625,21.14062,21.34375,56000,99900,35.98791996096337,41.71041775744949,NaN,NaN,-103.16544387558199,-90.96828269949526,-0.1134214737520512,-0.3489990496161113,-0.23557757586406008,4059700,4142000,27.271225007996705,29.791591807262147,NaN,NaN,-18.343777342632826,-9.448006968138706
2000-06-09T09:30:00-04:00,21.35937,21.51562,21.15625,21.3125,72400,101885,35.644487097535105,40.33990475220947,NaN,NaN,-90.43671609342186,-90.62177833733699,-0.1068856359770845,-0.3691846208354157,-0.2622989848583312,3987300,4100160,26.02760271338755,28.875959278523663,NaN,NaN,-19.865116033872322,-10.93616540610065
2000-06-12T09:30:00-04:00,21.1875,21.75,21.1875,21.4375,93600,105865,38.18557457747748,39.28735799854005,NaN,NaN,-72.43364006043518,-88.36764363839761,-0.08681744006820086,-0.3708207849435823,-0.2840033448753814,4080900,4083360,25.524287827612056,28.35248634759548,NaN,NaN,-20.48414457235878,-12.300162429851811
2000-06-13T09:30:00-04:00,21.5625,21.5625,20.82812,20.82812,40000,105790,31.628935185417376,38.105422030082075,NaN,NaN,-102.06377374344032,-92.8681661533288,-0.10598797368412705,-0.41648831198054026,-0.3105003382964132,4040900,4056900,24.713684566185307,27.843770031878673,NaN,NaN,-23.063401117212216,-13.837767956617583
2000-06-14T09:30:00-04:00,21.07812,21.64062,21.07812,21.375,56400,47460,41.36007866055675,37.71095612976052,NaN,NaN,-70.96070007311558,-87.812054769199,-0.07471625173873314,-0.40389565296982965,-0.3291794012310965,4097300,4053220,24.59668776073049,27.4149335937698,NaN,NaN,-22.23572703225731,-15.037476395994686
2000-06-15T09:30:00-04:00,21.42187,21.60937,21.28125,21.375,74100,50465,41.360078660556745,37.997765375667385,NaN,NaN,-62.06280035108467,-79.59152606429953,-0.04819792711218274,-0.38942681012132496,-0.3412288830091422,4097300,4060740,25.37415211846809,27.085883406793233,NaN,NaN,-21.584853445017618,-15.972815974426533
2000-06-16T09:30:00-04:00,21.29687,21.42187,21.07812,21.375,38700,41890,41.36007866055675,38.5069425443442,NaN,NaN,-75.98362561367207,-76.70090796834957,-0.025939221407527746,-0.3736529097685519,-0.3477136883610242,4097300,4082740,27.72208252003793,26.983611759091616,NaN,NaN,-21.060897681110006,-16.699684789667028
2000-06-19T09:30:00-04:00,21.26562,21.26562,20.6875,20.6875,62800,43920,33.80545222972121,38.20554490819507,NaN,NaN,-133.72365538824528,-88.95891103391159,-0.051332723596477836,-0.41187959285662146,-0.3605468692601436,4034500,4073460,27.331449825476057,26.89632154742446,NaN,NaN,-22.969263781099293,-17.59533893130021
2000-06-20T09:30:00-04:00,20.57812,20.71875,20.3125,20.3125,68900,44775,30.52979279120123,37.79875255706769,NaN,NaN,-196.8904270227714,-107.9242416897778,-0.08520251956730973,-0.46705001871928076,-0.381847499151971,3965600,4058400,26.674546499064206,26.795763134950217,NaN,NaN,-25.675387269225787,-18.749631551003862
2000-06-21T09:30:00-04:00,20.1875,20.39062,20.0625,20.21875,107200,47495,29.75358850360955,37.26039622356213,NaN,NaN,-217.53213704851,-137.23852908485668,-0.10446666987004027,-0.5124308364895214,-0.4079641666194811,3858400,4010620,24.65028509530252,26.568098919743843,NaN,NaN,-28.084218495632857,-20.083143971665148
2000-06-22T09:30:00-04:00,20.0625,20.46875,20.03125,20.21875,111100,50815,29.75358850360955,36.30200944986573,NaN,NaN,-187.72326541744502,-162.37062209812876,-0.1073454191800362,-0.5421459405945264,-0.43480052141449016,3858400,3962840,22.78794340477262,26.198002952554678,NaN,NaN,-30.00547864132444,-21.500620353045047
2000-06-23T09:30:00-04:00,20.125,20.34375,20.10937,20.23437,79800,52820,30.09700966696043,35.52249068754985,NaN,NaN,-154.8246165867846,-178.13882029275126,-0.0985617139571312,-0.5580026638609041,-0.45944094990377293,3938200,3931020,21.61665300549987,25.737390473384384,NaN,NaN,-31.480284729121504,-22.926286692484542
2000-06-26T09:30:00-04:00,20.34375,20.34375,19.76562,19.76562,34300,53135,25.99058466553015,34.41214073578304,NaN,NaN,-157.92640302813498,-182.9793698207292,-0.11361538425473394,-0.6014601802221904,-0.48784479596745645,3903900,3904900,20.67713005926477,25.205502595678265,NaN,NaN,-34.07928919928453,-24.51957276488454
2000-06-27T09:30:00-04:00,20,20.8125,20,20.5625,167200,60915,40.78256905016125,34.731409872418354,NaN,NaN,-80.86569223083818,-159.77442286234253,-0.061792219149576444,-0.565085069904427,-0.5032928507548505,4071100,3926000,23.567099477512045,24.895344991522183,NaN,NaN,-31.524419641753575,-25.52026517586583
2000-06-28T09:30:00-04:00,20.28125,20.57812,19.98437,20.51562,66100,63450,40.27261777061293,35.037459715964744,NaN,NaN,-82.13891551307367,-132.69577855525526,-0.02447456023817207,-0.5338860510525656,-0.5094114908143935,4005000,3955320,27.518820474421744,24.913030381981113,NaN,NaN,-29.691510783722137,-26.116157405559587
2000-06-29T09:30:00-04:00,20.1875,20.375,19.76562,20.14062,15300,63515,36.356428549335796,35.088312676807654,NaN,NaN,-100.43939034436498,-115.23900354063926,-0.019088994313679608,-0.5332727337064931,-0.5141837393928135,3989700,3981580,30.961621740368344,25.265460312479743,NaN,NaN,-29.377078812036128,-26.58200332077052
2000-06-30T09:30:00-04:00,20.14062,20.1875,19.64062,19.64062,18700,63000,31.901971729601584,34.63948390195937,NaN,NaN,-117.29937907190997,-107.73395603766433,-0.041933866208787585,-0.566601072153798,-0.5246672059450104,3971000,3988140,31.832698852553023,25.716061099975523,NaN,NaN,-30.598615775977695,-27.155805100085832
2000-07-03T09:30:00-04:00,19.96875,20.25,19.8125,20.1875,9300,61885,40.490289359660096,35.27243777154814,NaN,NaN,-79.21545096626586,-91.99176562529048,-0.014370452019776492,-0.542630270969731,-0.5282598189499546,3980300,4003420,33.92398781088092,26.37393990316807,NaN,NaN,-28.63815743408195,-27.367569719228136
2000-07-05T09:30:00-04:00,20.375,20.75,20.28125,20.28125,50200,63980,41.84432342891505,35.30702668357373,NaN,NaN,-32.67568155206331,-82.35376348953552,0.014458034759101124,-0.5101872755010781,-0.5246453102601792,4030500,3995300,33.33865432640823,26.998366086430764,NaN,NaN,-26.66323143369859,-27.266949964152488
2000-07-06T09:30:00-04:00,20.35937,20.35937,19.75,19.75,60500,64130,36.7425270011531,34.9772015650449,NaN,NaN,-86.53845157271721,-83.2336707014642,0.002649214943195477,-0.5213337915811849,-0.5239830065243803,3970000,3988300,32.813037095252184,27.529715013343914,NaN,NaN,-26.67468455403885,-27.18234061985054
2000-07-07T09:30:00-04:00,20,20,19.46875,19.65625,99500,66305,35.910448275267655,34.58794225180996,NaN,NaN,-110.53521034471339,-85.25283470153389,-0.006097053699470334,-0.5316043236487182,-0.5255072699492479,3870500,3964460,31.01934831351845,27.765233998592525,NaN,NaN,-26.95026473286558,-27.14918692170983
2000-07-10T09:30:00-04:00,19.65625,20.17187,19.65625,19.9375,35600,64465,40.279852330203504,35.050399401844416,NaN,NaN,-78.5847454815268,-77.50990798345727,0.011480239606859621,-0.5111569704406733,-0.5226372100475329,3906100,3951480,30.05599650125302,27.959844475433734,NaN,NaN,-25.78834016421053,-26.954780242067073
2000-07-11T09:30:00-04:00,20.1875,21,20.1875,21,45200,62045,53.24749301273413,36.67309227481105,NaN,NaN,46.8202273047039,-52.302772329263306,0.09446658487973297,-0.4045539789478667,-0.4990205638275997,3951300,3945680,29.613429590023912,28.16976469621657,NaN,NaN,-19.92624744095656,-25.950704127622714
2000-07-12T09:30:00-04:00,21.17187,21.1875,20.75,20.89062,34500,61770,51.995788191703475,38.26182082396061,NaN,NaN,83.25422539195175,-29.11679094046035,0.1390978230634745,-0.32514828499825654,-0.46424610806173106,3916800,3922940,27.88006943101206,28.400463577338684,NaN,NaN,-15.852054009551056,-24.50803982504105
2000-07-13T09:30:00-04:00,20.89062,21.25,20.89062,21.25,35500,60725,55.682025824252335,40.11385206114939,NaN,NaN,119.23396719154552,12.037692812392194,0.1869473159462457,-0.23056196312892396,-0.41750927907516966,3952300,3919400,27.60914353214781,28.744835015008338,NaN,NaN,-11.250829791502072,-22.614152677392624
2000-07-14T09:30:00-04:00,21.14062,21.14062,20.5625,20.70312,25000,58270,49.458102222328186,41.49678724367566,NaN,NaN,76.08270313966636,49.36127550926815,0.1760441122819718,-0.1974541387227049,-0.3734982510046767,3927300,3930760,29.96123865574907,29.340876847168996,NaN,NaN,-9.455590517208906,-20.734358083080664
2000-07-17T09:30:00-04:00,20.4375,20.625,20.03125,20.375,56800,59175,46.126700821465526,42.9350812548139,NaN,NaN,1.158316146690194,65.30988783491155,0.1424469325984578,-0.19543958525660443,-0.33788651785506224,3870500,3923640,29.318261234536394,29.95810050254554,NaN,NaN,-9.115605648543976,-19.07453630671828
2000-07-18T09:30:00-04:00,20.21875,20.375,20.0625,20.0625,49700,58520,43.14591223857817,43.10389148255796,NaN,NaN,-30.95498506288167,49.75484536139443,0.09705899461256223,-0.21656277458935946,-0.3136217692019217,3820800,3897540,27.02843729061344,30.205338917767072,NaN,NaN,-9.82175779301663,-17.752710804760902
2000-07-19T09:30:00-04:00,20.20312,20.32812,19.90625,20.10937,39900,57070,43.73321293129011,43.351076851177766,NaN,NaN,-39.18101845077015,25.267796592850047,0.06937308522133107,-0.22690541267525788,-0.29627849789658894,3860700,3886320,26.085254237295445,30.10294132940091,NaN,NaN,-10.19726705105222,-16.673361697088232
2000-07-20T09:30:00-04:00,20.1875,20.1875,19.75,19.90625,23700,52895,41.721786593219626,43.73431671145518,NaN,NaN,-71.42819900020567,-12.86463664550019,0.03812191245530844,-0.24862610732745338,-0.2867480197827618,3837000,3863260,24.214959992396757,29.62103691883151,NaN,NaN,-11.117093035626608,-15.879609031165144
2000-07-21T09:30:00-04:00,19.84375,20.23437,19.84375,20,31800,48930,43.02431022500874,44.52876946112712,NaN,NaN,-50.44077199914191,-38.169331673261844,0.02513300210089997,-0.25533176715663686,-0.28046476925753683,3868800,3851560,23.302065626393144,29.011705974105805,NaN,NaN,-11.495706140859697,-15.253337189692937
2000-07-24T09:30:00-04:00,20.21875,20.21875,19.78125,20.03125,33300,46605,43.47779416677651,44.74216266163544,NaN,NaN,-50.03767198131378,-48.40852929886263,0.020225536986932524,-0.25518284802387114,-0.27540838501080367,3902100,3857880,24.948008995717856,28.370564630165582,NaN,NaN,-11.681667856883267,-14.74309871357727
2000-07-25T09:30:00-04:00,20.10937,20.1875,19.78125,19.78125,12200,45500,40.68775247838293,44.659550450883145,NaN,NaN,-68.78281374522284,-55.97409503533087,0.0026458065778210416,-0.2721011267885274,-0.2747469333663484,3889900,3871700,28.558430095485875,28.029120042242557,NaN,NaN,-12.62226649284631,-14.440122682044276
2000-07-26T09:30:00-04:00,19.73437,19.9375,19.625,19.65625,13300,37805,39.3287869838354,44.844283306789016,NaN,NaN,-96.79118328928259,-67.49612800303336,-0.013983918049711774,-0.2922268309284881,-0.27824291287877634,3876600,3874880,29.40002662963741,27.785333580412928,NaN,NaN,-13.792566530349742,-14.347614660373628
2000-07-27T09:30:00-04:00,19.73437,19.89062,19.60937,19.875,6000,34800,42.9216360826081,45.34508243588476,NaN,NaN,-79.74851125613387,-69.16019045421899,-0.007177245698515411,-0.2872144700019206,-0.28003722430340516,3882600,3884000,31.878529162046775,27.846703641022092,NaN,NaN,-13.831440753427065,-14.273875530809834
2000-07-28T09:30:00-04:00,19.90625,19.9375,19.625,19.71875,81500,38110,41.05162862663198,45.400209314201085,NaN,NaN,-80.26477261100928,-75.12499057659247,-0.009953176308526046,-0.29247869468906273,-0.2825255183805367,3801100,3870460,30.184291522836546,27.855867571135203,NaN,NaN,-14.374095072915102,-14.288192608253443
2000-07-31T09:30:00-04:00,19.875,20.10937,19.76562,19.8125,9400,37645,42.665681143053376,44.64436560922389,NaN,NaN,-54.63424264479716,-76.04430470928915,-0.0026126766826235492,-0.2857913642338161,-0.2831786875511926,3810500,3852140,28.01481340992217,27.741680701127933,NaN,NaN,-14.40663590481887,-14.305113079191361
2000-08-01T09:30:00-04:00,19.89062,20.0625,19.76562,19.82812,33700,38865,42.945983346284905,43.99795097740827,NaN,NaN,-53.700836976241824,-73.02790935549294,0.005703685051915541,-0.2760490812362981,-0.28175276628821366,3844200,3843000,26.973187053714724,27.67690338846384,NaN,NaN,-14.362237255013083,-14.313273675737321
2000-08-02T09:30:00-04:00,19.96875,20.0625,19.71875,19.95312,20400,37375,45.25266929536992,43.25299693963097,NaN,NaN,-45.067808271838345,-62.683234352004106,0.02116311704270074,-0.25529886998483775,-0.2764619870275385,3864600,3840600,26.69253784469582,27.611431553645836,NaN,NaN,-13.734183293275828,-14.230546478242822
2000-08-03T09:30:00-04:00,20.10937,20.29687,19.95312,20.17187,7700,34735,49.128787948299504,43.229474491486066,NaN,NaN,-0.7488206655918191,-46.88329623389569,0.04622394907368366,-0.2186820506854339,-0.26490599975911755,3872300,3838540,26.438261990252897,27.35979036325325,NaN,NaN,-12.151241504325915,-13.933502910540406
2000-08-04T09:30:00-04:00,20.09375,20.09375,19.73437,19.98437,12000,30360,46.11499004399519,43.228638007381036,NaN,NaN,-45.74765376378801,-39.97987246445145,0.04995774275769993,-0.20245882131199266,-0.2524165640696926,3860300,3850380,30.53421858754794,27.446644459896934,NaN,NaN,-11.548774973617277,-13.592827490979959
2000-08-07T09:30:00-04:00,19.875,20.375,19.875,20.375,39200,30540,52.63416028949958,43.90637001101828,NaN,NaN,8.138512272571132,-27.425321480977782,0.07690947252626054,-0.1562797234118669,-0.23318919593812745,3899500,3868180,36.278580446742566,28.107368971049016,NaN,NaN,-9.128746317450242,-12.955101609047142
2000-08-08T09:30:00-04:00,20.39062,20.875,20.39062,20.875,102600,33410,59.40424458948282,45.0257294151749,NaN,NaN,116.11104918521549,6.537055751313687,0.12380534626301773,-0.07843251310935528,-0.202237859372373,4002100,3899760,44.97270462246431,29.456472569989646,NaN,NaN,-4.7760915720257175,-11.786671603758368
2000-08-09T09:30:00-04:00,20.98437,21.09375,20.82812,20.89062,50000,34185,59.598521773391056,46.30263907090143,NaN,NaN,164.13557190552822,48.37773178678701,0.14954928643635018,-0.015301251326935272,-0.16485053776328545,4052100,3937260,53.14750161315969,31.52308268575843,NaN,NaN,-1.2219560585104599,-10.27742652586581
2000-08-10T09:30:00-04:00,20.875,20.875,20.34375,20.57812,19300,33375,54.02779228984217,47.08860207553239,NaN,NaN,109.72358764324264,70.4722134485539,0.13940535962309153,0.009406161765578958,-0.12999919785751257,4032800,3969360,58.791010600835726,34.05800732679004,NaN,NaN,0.24996927961979842,-8.773512839367866
2000-08-11T09:30:00-04:00,20.4375,21,20.4375,21,35400,33895,59.527729702071916,48.23502604233921,NaN,NaN,160.53210927308575,111.72816605592865,0.1538480573927851,0.06231087388346879,-0.0915371835093163,4068200,4010940,64.71916443191296,36.89880414366112,NaN,NaN,3.298502848569055,-7.048939169662591
2000-08-14T09:30:00-04:00,21.125,21.125,20.73437,21,38800,32995,59.527729702071916,49.58073870117413,NaN,NaN,163.28525482447293,142.757514566309,0.15567001819203158,0.10305033923072315,-0.05261967896130841,4068200,4044680,68.65906068337436,39.76313489993887,NaN,NaN,5.721464843844093,-5.224595739161637
2000-08-15T09:30:00-04:00,20.9375,21.1875,20.8125,21.125,27300,31875,61.125865085569906,51.13767285129802,NaN,NaN,146.41162571440788,148.8176298721475,0.15710843988370438,0.14376587089332205,-0.013342568990382317,4095500,4063360,70.61556050092625,42.70710160503093,NaN,NaN,8.21503925990087,-3.3046478821527074
2000-08-16T09:30:00-04:00,21.3125,21.375,21.03125,21.125,30200,31390,61.125865085569906,52.43797492293815,NaN,NaN,139.21890458390493,143.83429640782282,0.14989577235970497,0.17402714645924888,0.024131374099543926,4095500,4072040,71.50569057800332,45.53761313474211,NaN,NaN,10.253308301878397,-1.3677969987196927
2000-08-17T09:30:00-04:00,21.375,21.375,20.98437,21.17187,60700,33240,61.782126434410706,53.91872476635092,NaN,NaN,118.45823161816483,145.58122520280727,0.14028836078188006,0.199491825076894,0.05920346429501395,4156200,4096720,73.92438365200691,48.661905429682854,NaN,NaN,12.143502514363908,0.5623886460065357
2000-08-18T09:30:00-04:00,20.96875,21.14062,20.70312,20.79687,24700,32885,53.93662266049719,54.72379201759691,NaN,NaN,68.50770472245263,127.17634429268064,0.10244110302902754,0.18725484308129836,0.08481374005227083,4131500,4109380,75.0923455898174,52.02458629967537,NaN,NaN,11.661700446747588,2.1480046175409715
2000-08-21T09:30:00-04:00,21,21,20.59375,20.6875,14400,31940,51.867872494009674,55.36106981386296,NaN,NaN,47.09632481081572,103.93855828994921,0.06559607462580867,0.16680883333453167,0.101212758708723,4117100,4119160,75.9871490702122,55.52558358656804,NaN,NaN,10.667017935050088,3.365006520042274
2000-08-22T09:30:00-04:00,20.71875,20.71875,20.46875,20.48437,21700,32415,48.17229610124072,55.56961458571088,NaN,NaN,15.982390257698999,77.85271119860744,0.025177650552617906,0.13268482189949538,0.10750717134687747,4095400,4119140,75.98113765882735,59.04619785900601,NaN,NaN,8.731399566021345,4.131634098039284
2000-08-23T09:30:00-04:00,20.48437,20.48437,20.25,20.39062,42100,33855,46.524705618025116,55.38360870497699,NaN,NaN,-15.354575359132,46.93801521000004,-0.008438717010292404,0.09695877508401196,0.10539749209430437,4053300,4110700,73.34420383043962,62.396622276162205,NaN,NaN,6.630629212982271,4.488633400173996
2000-08-24T09:30:00-04:00,20.40625,20.57812,20.28125,20.42187,20200,34565,47.173293590450605,55.4592018154381,NaN,NaN,-13.324038904140744,20.58156110553891,-0.02803302027397442,0.07035621675183634,0.09838923702581076,4073500,4094160,68.33880635093433,65.09694997354696,NaN,NaN,5.049224177829323,4.5687177969819
2000-08-25T09:30:00-04:00,20.5,20.5,20.28125,20.3125,61200,33550,45.111088352840575,54.92183953424816,NaN,NaN,-31.25325695753949,0.6293687695404742,-0.046721546494632935,0.03998730390751959,0.08670885040215252,4012300,4070320,61.79294100860719,66.91940429939442,NaN,NaN,3.121279780882973,4.361940937539196
2000-08-28T09:30:00-04:00,20.28125,20.5,20.28125,20.28125,40800,35120,44.51232874538667,53.85813125966986,NaN,NaN,-39.95928770905905,-16.78175373443448,-0.05877074203403833,0.013245422859604616,0.07201616489364294,3971500,4041200,54.878293028026874,67.62694632836318,NaN,NaN,1.3329993455538531,3.9292349958270045
2000-08-29T09:30:00-04:00,20.25,20.375,20,20,28500,34860,39.43869701307775,52.41814377679034,NaN,NaN,-89.74120852217284,-37.926473490408846,-0.08184736053233312,-0.030293035771773447,0.05155432476055967,3943000,4010720,48.73149152143077,67.31151703609682,NaN,NaN,-1.7531250092052797,3.1174692808223927
2000-08-30T09:30:00-04:00,20.0625,20.28125,19.89062,20.04687,12000,34440,40.65271901416992,51.46278139995661,NaN,NaN,-104.33412297444862,-55.722383013472175,-0.08949964108807117,-0.06032022659952929,0.029179414488541874,3955000,3991060,45.21368662675193,66.34170818080511,NaN,NaN,-4.02982105449085,2.096427804349072
2000-08-31T09:30:00-04:00,19.90625,20.375,19.90625,20.26562,13200,34715,46.0849604790397,50.50258359831145,NaN,NaN,-82.82175551965712,-69.62192633657544,-0.07591013240603645,-0.06570825101900368,0.010201881387032763,3968200,3970000,41.737906886824184,64.70018978472736,NaN,NaN,-4.576277579935809,1.1431841780226606
2000-09-01T09:30:00-04:00,20.15625,20.15625,19.9375,20.0625,8900,34560,42.22048327750742,49.266351710842564,NaN,NaN,-112.93834014298727,-85.958942973665,-0.07646880954027871,-0.08538413053831562,-0.008915320998036914,3959300,3959400,40.068295576360164,62.65799227708349,NaN,NaN,-6.172965234006028,0.09801997630427661
2000-09-05T09:30:00-04:00,20,20.53125,20,20.46875,565600,60880,51.059867993267034,48.547351918535206,NaN,NaN,-56.15183328062873,-89.19745208797893,-0.046803150984148195,-0.06741925972822216,-0.020616108744073963,4524900,4070080,58.66247895899223,61.804200738373915,NaN,NaN,-4.896271473859903,-0.6154502308620347
2000-09-06T09:30:00-04:00,20.65625,20.84375,20.60937,20.8125,46600,58080,57.04768746621957,48.25605351715304,NaN,NaN,33.777760237025824,-64.4936583361392,-0.0036305173418765824,-0.02515425542141969,-0.02152373807954311,4571500,4195780,70.03364899464539,61.6990549109912,NaN,NaN,-1.788041034210255,-0.7829632027689233
2000-09-07T09:30:00-04:00,20.1875,20.1875,19.53125,19.8125,60200,58590,41.240109089092904,46.788766563916056,NaN,NaN,-141.45549778337588,-71.91793329792465,-0.04000186525570752,-0.07152606964917751,-0.03152420439346999,4511300,4307040,76.25882227976078,61.86580052725934,NaN,NaN,-4.930455177167099,-1.375462056254377
2000-09-08T09:30:00-04:00,19.71875,19.71875,19.375,19.46875,767900,96020,37.40334470855176,45.6078181387771,NaN,NaN,-173.37520851721075,-90.02862389743538,-0.08235167940464996,-0.13446380364928245,-0.05211212424463249,3743400,4262080,69.93627601039381,61.49750984301479,NaN,NaN,-8.896495616378445,-2.449895421986387
2000-09-11T09:30:00-04:00,19.46875,19.6875,19.28125,19.34375,456600,117080,36.088524297727076,44.48072183904263,NaN,NaN,-165.60175512262182,-100.5613068933623,-0.11208082303467751,-0.19221315303797937,-0.08013233000330186,3286800,4127580,55.19373427486079,60.01226592906112,NaN,NaN,-12.369111548878088,-3.86692629725663
2000-09-12T09:30:00-04:00,19.3125,19.3125,19.10937,19.21875,589700,144625,34.77217093610993,43.52357004153329,NaN,NaN,-177.09384273828817,-124.74970878489418,-0.13208566918498266,-0.24523941648453018,-0.11315374729954752,2697100,3762020,34.13324343932818,57.023130627668316,NaN,NaN,-15.520862495959154,-5.531774325642704
2000-09-13T09:30:00-04:00,19.09375,19.25,19.09375,19.125,28900,144705,33.777060765165416,42.61302398061474,NaN,NaN,-158.87580133146756,-163.28042109859285,-0.142651475021749,-0.29146809107673377,-0.14881661605498478,2668200,3381360,23.90451077447976,53.49172398081405,NaN,NaN,-18.331289802832803,-7.360276536669861
2000-09-14T09:30:00-04:00,19.01562,19.15625,18.75,18.78125,51400,145765,30.347642671415358,41.41119177211222,NaN,NaN,-170.57207320733917,-169.10373618338554,-0.1623764806408716,-0.3517872168560743,-0.18941073621520269,2616800,3002460,18.092616623444272,49.90271042885047,NaN,NaN,-21.874221602561786,-9.433697260368707
2000-09-15T09:30:00-04:00,18.625,18.625,18.375,18.375,25900,144025,26.87484204871801,40.10860275038919,NaN,NaN,-189.16533161891908,-172.2617608037272,-0.19042679299564785,-0.4274442274597625,-0.23701743446411466,2590900,2771960,15.60673274698874,46.603695553020586,NaN,NaN,-26.10625638245582,-11.815491420666865
2000-09-18T09:30:00-04:00,18.4375,18.4375,18.125,18.3125,34900,144535,26.374789982948045,38.81306426735785,NaN,NaN,-172.60373346491076,-173.662156472185,-0.19985345948181787,-0.486834258816387,-0.2869807993345691,2556000,2625800,14.268025479737418,43.70296215671419,NaN,NaN,-29.586009367277942,-14.354136841611304
2000-09-19T09:30:00-04:00,18.17187,18.17187,17.75,17.8125,36400,145635,22.73093361879853,37.61965259633791,NaN,NaN,-175.7711231935162,-173.39761256323058,-0.22457774556336207,-0.5677029812887717,-0.34312523572540965,2519600,2590300,13.954923657962638,41.2189215950379,NaN,NaN,-33.91376467238193,-17.14836938886425
2000-09-20T09:30:00-04:00,17.75,17.84375,17.375,17.59375,37900,146445,21.341733918585263,36.240296518081855,NaN,NaN,-171.6730593517539,-175.95706416728785,-0.23913361925353904,-0.6420422597923334,-0.4029086405387944,2481700,2553000,13.6168103465386,38.962001860736954,NaN,NaN,-37.89661553615087,-20.11240455276234
2000-09-21T09:30:00-04:00,17.46875,17.78125,17.40625,17.53125,22500,145465,20.94781861720425,34.444786385093614,NaN,NaN,-148.60692258825074,-171.56403404347014,-0.23603654223886616,-0.6979543183373771,-0.4619177760985109,2459200,2521480,13.323045135300973,36.9323688784853,NaN,NaN,-41.176194029760225,-23.121517335190607
2000-09-22T09:30:00-04:00,17.78125,17.78125,17.375,17.5,23700,145640,20.74167416789649,32.910585734407114,NaN,NaN,-129.68483017564375,-159.6679337548151,-0.21950501459231653,-0.7362990443389066,-0.5167940297465901,2435500,2490400,13.024664251064507,35.00068092667846,NaN,NaN,-43.86941029493544,-26.085502043725583
2000-09-25T09:30:00-04:00,17.625,17.625,17.375,17.45312,26800,143920,20.417074097095195,30.72181474182341,NaN,NaN,-118.03245503023265,-148.7536780678795,-0.19591681731046862,-0.7616900513846758,-0.5657732340742072,2408700,2460940,12.733556589332778,31.720043614559934,NaN,NaN,-46.17263726551774,-28.95509278969589
2000-09-26T09:30:00-04:00,17.39062,17.60937,17.25,17.28125,30300,143395,19.228961012364493,28.02047713797662,NaN,NaN,-109.89799330692384,-135.579052090561,-0.17667220423481067,-0.7866134893677206,-0.6099412851329099,2378400,2432700,12.44638145086877,27.606667361433036,NaN,NaN,-48.49172862325784,-31.746040765919027
2000-09-27T09:30:00-04:00,17.20312,17.40625,17.14062,17.20312,16300,142785,18.696334030478752,26.410207490932752,NaN,NaN,-105.18754982776937,-122.28195018576412,-0.15477396051118886,-0.803408735771896,-0.6486347752607071,2362100,2408780,12.19549471280483,23.03071539236475,NaN,NaN,-50.58645052257452,-34.437527874012666
2000-09-28T09:30:00-04:00,17.20312,17.84375,17.20312,17.71875,21100,143240,32.069576085298436,26.029224017843234,NaN,NaN,-74.60443838330576,-107.48145334477513,-0.09411527739598247,-0.7662788720056852,-0.6721635946097028,2383200,2393580,12.029554652466842,18.894521009655683,NaN,NaN,-48.49612230489163,-36.44589850699538
2000-09-29T09:30:00-04:00,17.73437,18.35937,17.73437,18.15625,164600,150810,40.94533239710513,26.376138882084522,NaN,NaN,-37.08324251765355,-88.9611358131771,-0.017113696506575904,-0.6935557152429226,-0.6764420187363467,2547800,2416040,13.89394296287297,15.944535915942266,NaN,NaN,-43.71928735238537,-37.484954056336804
2000-10-02T09:30:00-04:00,18.125,18.125,17.64062,17.75,22100,151470,36.21367159336683,26.479103214745727,NaN,NaN,-49.15561950662107,-75.18576870845476,0.01228759771378607,-0.6610825215941141,-0.6733701193079001,2525700,2439440,15.893887398405724,14.641724770162094,NaN,NaN,-41.11920501342558,-38.00413276449234
2000-10-03T09:30:00-04:00,17.8125,18.8125,17.8125,18.73437,109700,128675,50.99201432692001,27.708742754871057,NaN,NaN,3.210494295417696,-52.564071187986464,0.09903080373182394,-0.5495816146431203,-0.6486124183749442,2635400,2490840,20.274295159198687,14.382423654784876,NaN,NaN,-32.8898246671737,-37.27351732201825
2000-10-04T09:30:00-04:00,18.98437,19.375,18.875,18.90625,46100,128650,53.037971941546324,29.329480559880412,NaN,NaN,68.17766941117495,-17.89102734019755,0.1650906620626008,-0.44224909079669317,-0.607339752859294,2681500,2554720,25.46955379133611,14.909347738205726,NaN,NaN,-25.874690522056838,-35.645113493452335
2000-10-05T09:30:00-04:00,19.10937,19.10937,18.5625,18.71875,13700,126325,50.558361910189575,31.021160549985524,NaN,NaN,53.26917282753635,7.6836949019708785,0.19141256479755486,-0.36807404686235046,-0.5594866116599053,2667800,2611640,29.855726173559802,15.927132982960801,NaN,NaN,-21.217447887854103,-33.5840184069383
2000-10-06T09:30:00-04:00,18.75,19,18.46875,18.5625,24900,89175,48.52252355475057,32.60314151939999,NaN,NaN,48.45897386933541,24.79213817936867,0.19300568322127754,-0.3182295076333084,-0.5112351908545859,2642900,2630660,31.310425065800203,17.144447239108143,NaN,NaN,-18.182378525264294,-31.383784138127726
2000-10-09T09:30:00-04:00,18.75,19.0625,18.53125,18.60937,50900,68890,49.183543083439986,34.49261362401723,NaN,NaN,62.183742771168845,47.060010634926655,0.19153850969615388,-0.27181205373439354,-0.4633505634305474,2693800,2664280,33.91915055457277,18.57046344600887,NaN,NaN,-15.581161577773498,-29.126266629505693
2000-10-10T09:30:00-04:00,18.75,18.85937,18.51562,18.70312,19900,40400,50.55131227925275,36.57901207835062,NaN,NaN,63.23924129318954,59.06576003448102,0.19078533319769425,-0.2248688969334296,-0.41565423013112385,2713700,2679940,35.15451759470815,20.10887110659241,NaN,NaN,-13.052344734540611,-26.82999207308211
2000-10-11T09:30:00-04:00,18.46875,18.84375,18.20312,18.20312,36300,40770,43.78277085059462,38.21008009502136,NaN,NaN,36.58303435090659,52.746833022427346,0.1521925827017433,-0.2254135017539447,-0.377606084455688,2677400,2679120,35.1174963754826,21.66561762374824,NaN,NaN,-12.89007540673249,-24.838575406460734
2000-10-12T09:30:00-04:00,18.0625,18.125,17.75,17.875,19600,39180,39.99793053486944,39.58552697837657,NaN,NaN,-23.8469225649517,37.32361394392974,0.10252791842663606,-0.2494461864223929,-0.35197410484902897,2657800,2677120,35.02062526083046,23.23675769587438,NaN,NaN,-13.964057122810111,-23.285072794510643
2000-10-13T09:30:00-04:00,17.5,17.625,17.15625,17.46875,59800,40875,35.86412611181923,40.688887836571155,NaN,NaN,-84.61922959754543,10.707973250553568,0.04330734092220162,-0.29783992869627696,-0.3411472696184786,2598000,2668140,34.55965681691866,24.795764854987656,NaN,NaN,-16.249147152546886,-22.279940559944393
2000-10-16T09:30:00-04:00,17.3125,17.875,17.28125,17.45312,12800,39770,35.7112050879756,41.86619098482909,NaN,NaN,-62.49126533238973,-14.227028370158148,0.006031492314892639,-0.33360790422486275,-0.3396393965397554,2585200,2646420,33.4140270534358,26.293453826599585,NaN,NaN,-18.092564745398086,-21.681744015009205
2000-10-17T09:30:00-04:00,17.46875,17.8125,17.1875,17.29687,31000,39500,34.143857704438474,42.96958553296907,NaN,NaN,-70.60429524248107,-40.995735677292274,-0.02452355065739792,-0.3702938348615028,-0.3457702842041049,2554200,2614520,31.749367271590444,27.69015900936998,NaN,NaN,-20.095569704327623,-21.455147684911836
2000-10-18T09:30:00-04:00,17.25,17.5,17,17.5,20500,38630,37.95624949762653,43.39006220527822,NaN,NaN,-80.04242758743784,-64.32082806496115,-0.026273690863538035,-0.3786123977835274,-0.35233870691998936,2574700,2593980,30.68919461707638,29.022990435413522,NaN,NaN,-20.673313508944027,-21.343457088345005
2000-10-19T09:30:00-04:00,17.60937,17.60937,17.21875,17.46875,45100,39760,37.59567108968749,43.150800683319815,NaN,NaN,-65.80511168606293,-72.7124658891834,-0.024775431807462223,-0.38330799667931714,-0.3585325648718549,2529600,2568340,29.37075890929931,30.12847728872969,NaN,NaN,-21.246518308685282,-21.32960869125076
2000-10-20T09:30:00-04:00,17.25,17.375,17.04687,17.23437,16200,39385,34.916489162966144,43.058144795434046,NaN,NaN,-88.43364890752113,-73.47534975117854,-0.034226494071895874,-0.4013156824617248,-0.3670891883898289,2513400,2551420,28.500607935587283,31.0289573270998,NaN,NaN,-22.5121868654124,-21.498548430416708
2000-10-23T09:30:00-04:00,17.28125,17.4375,17.0625,17.35937,30500,39570,37.475594037768644,42.09268620335182,NaN,NaN,-77.73776157220692,-76.52464899914199,-0.027032137389290667,-0.4008793601264422,-0.37384722273715154,2543900,2543160,28.063503015641004,31.58532931684568,NaN,NaN,-22.869657617327825,-21.69442117140401
2000-10-24T09:30:00-04:00,17.375,18.0625,17.375,18.0625,132200,44665,49.50347011087112,41.84022178687501,NaN,NaN,-14.580681311269549,-65.31992621289967,0.0271746230406113,-0.3398789439363874,-0.3670535669769987,2676100,2567540,31.407358033169515,32.009458191262354,NaN,NaN,-19.380395991391218,-21.363846145687898
2000-10-25T09:30:00-04:00,17.90625,17.9375,17.625,17.9375,72100,47455,47.74503379684318,41.63926977877884,NaN,NaN,-19.080657669542983,-53.127572229320705,0.05509498100345217,-0.2981848407226835,-0.35327982172613565,2604000,2573400,32.22286923582317,32.17853983856688,NaN,NaN,-17.079192236811345,-20.751752730134104
2000-10-26T09:30:00-04:00,18,18.25,17.90625,18.25,51800,48990,52.306216498702625,41.909533560489706,NaN,NaN,17.299494605773436,-36.50665097095343,0.09287055516552056,-0.23719162776923497,-0.33006218293475553,2655800,2598640,35.7652779508808,32.496743616072635,NaN,NaN,-13.66890650648282,-19.739917555326777
2000-10-27T09:30:00-04:00,18.125,18.25,17.6875,18.1875,12800,41400,51.34099091828073,42.06363697726404,NaN,NaN,5.070543258903186,-17.80581253766857,0.11069963518261428,-0.19168763895648766,-0.30238727413910194,2643000,2624560,39.2753103241177,32.87932645675442,NaN,NaN,-11.197689382179494,-18.519599244877163
2000-10-30T09:30:00-05:00,18.60937,19.73437,18.59375,19.625,156700,48130,66.60502092432162,43.21033045191182,NaN,NaN,148.2554565001575,27.392831076804317,0.21056619812747632,-0.03917952647975653,-0.24974572460723285,2799700,2675720,45.594537928125696,33.62504219485567,NaN,NaN,-2.6254576847900903,-16.249007593436154
2000-10-31T09:30:00-05:00,19.875,19.92187,19.32812,19.76562,76200,46455,67.67331553720425,44.916797929526794,NaN,NaN,163.55483787661854,63.01993491438193,0.2733733209795184,0.0919709266171651,-0.18140239436235325,2875900,2715680,49.97356728109844,34.686190116685374,NaN,NaN,4.246324420854582,-13.32110301996605
2000-11-01T09:30:00-05:00,19.875,19.90625,19.4375,19.60937,28500,45575,65.1783152001237,46.71539683418781,NaN,NaN,149.53778506465622,96.74362346122177,0.2900912286244921,0.18121164141826185,-0.10887958720623023,2847400,2764360,54.75159237897061,36.09554491083824,NaN,NaN,8.775413402232468,-10.164457816794833
2000-11-02T09:30:00-05:00,19.42187,19.46875,19.1875,19.46875,44500,47115,62.92967288335478,48.648650175011774,NaN,NaN,112.85033173893795,115.85379088785467,0.27738122222637995,0.23784694057674471,-0.039534281649635225,2802900,2793780,57.3997154989639,37.726977673841475,NaN,NaN,11.65618525414101,-7.047223092375427
2000-11-03T09:30:00-05:00,19.28125,19.5,19.15625,19.5,12600,46500,63.23324380963994,50.61451008370209,NaN,NaN,104.09338125253106,135.65835848658025,0.25722878292361484,0.2820016970048833,0.024772914081268485,2815500,2828280,60.3315610823957,39.64965867591004,NaN,NaN,14.029801421877918,-4.036219590339235
2000-11-06T09:30:00-05:00,19.65625,19.75,19.5,19.51562,212000,54555,63.394603319566436,52.70384905621123,NaN,NaN,110.88389228011279,128.1840456425713,0.23188424851488737,0.3146282247248777,0.08274397620999034,3027500,2873840,63.868027720272046,41.94384870795873,NaN,NaN,15.990073474369332,-1.1753205810951544
2000-11-07T09:30:00-05:00,19.76562,19.84375,19.60937,19.75,42500,55685,65.81871091360493,54.694024871638256,NaN,NaN,110.08523033008403,117.4901241332644,0.2180462528839311,0.3553017923149042,0.13725553943097313,3070000,2912660,66.60029735079078,44.508927474652616,NaN,NaN,18.377903418739344,1.6179971331669165
2000-11-08T09:30:00-05:00,19.79687,20.125,19.5625,19.96875,37300,55735,67.95186271420798,56.86232427338972,NaN,NaN,105.26812920745543,108.63619296182424,0.2106513018353448,0.40056966672515415,0.18991836488980934,3107300,2964640,69.88420984726244,47.40274539879283,NaN,NaN,21.043977673018546,4.393137210288577
2000-11-09T09:30:00-05:00,19.96875,19.96875,19.26562,19.6875,34300,56470,62.54717990897224,58.83594504096158,NaN,NaN,77.94675665559471,101.6554779451556,0.17529343302592237,0.4090351561722123,0.23374172314628994,3073000,3018660,72.86964375101559,50.571962242752,NaN,NaN,21.786388065754345,6.877887332497972
2000-11-10T09:30:00-05:00,19.75,19.75,19.1875,19.40625,32800,55120,57.61238213068272,60.2742870475983,NaN,NaN,58.38210374346206,92.51322244334179,0.12386293781276675,0.38857039541224836,0.2647074575994816,3040200,3063600,75.08262932429176,53.930471264798484,NaN,NaN,20.95563202707898,8.888993717438115
2000-11-13T09:30:00-05:00,19.375,19.625,19.28125,19.48437,16100,55285,58.589674830990944,60.923301670464,NaN,NaN,53.91358581143772,81.11916114960677,0.08770634844818503,0.3743403931597129,0.28663404471152787,3056300,3069360,75.36004885156926,57.06994918039846,NaN,NaN,20.546342569817753,10.554329267778064
2000-11-14T09:30:00-05:00,19.5,19.64062,19.23437,19.64062,212300,64350,60.548912399019336,61.83786442776229,NaN,NaN,51.90613657828128,69.48334239924621,0.06780470908997688,0.371389931073999,0.3035852219840221,3268600,3109080,77.24172786212443,60.28558193941998,NaN,NaN,20.745015556988147,12.010141594808076
2000-11-15T09:30:00-05:00,19.73437,20,19.60937,19.75,79400,67295,61.907599272913814,62.5236774830631,NaN,NaN,67.80311682914628,61.990339923584386,0.05598895975547591,0.373571421678367,0.3175824619228911,3348000,3157220,79.30455137411575,63.39553004107962,NaN,NaN,21.285337250364233,13.335169545601811
2000-11-16T09:30:00-05:00,19.6875,19.6875,19,19.15625,33300,66705,51.53250522465592,62.53735707637561,NaN,NaN,24.064901068472814,51.213968806160004,0.0048609666180267075,0.3236586701954245,0.3187977035773978,3314700,3205560,81.15200361394615,66.3867224189245,NaN,NaN,18.58258135399846,14.08479980394419
2000-11-17T09:30:00-05:00,19.0625,19.6875,18.9375,19.14062,66300,69210,51.28883025959429,61.44334345746652,NaN,NaN,15.544220016747682,42.64639206081712,-0.031343776765043185,0.27961798262109383,0.310961759386137,3248400,3247200,82.59345411059851,69.029502146244,NaN,NaN,16.341962833785008,14.40725166535002
2000-11-20T09:30:00-05:00,19.14062,19.14062,18.78125,18.92187,11200,68245,47.876685115716214,60.02929842736023,NaN,NaN,-31.194484720706452,25.624777954388286,-0.06918820890702343,0.22447649825235771,0.29366470715938114,3237200,3283380,83.7558999391208,71.4425259075313,NaN,NaN,13.403803346810731,14.263901905558694
2000-11-21T09:30:00-05:00,18.78125,18.98437,18.75,18.76562,31600,63215,45.54585710104954,58.62697999171207,NaN,NaN,-61.42351014519718,2.9588486096926303,-0.10193020061715408,0.16625195638793855,0.2681821570050926,3205600,3270780,81.70936747378732,73.3680812714468,NaN,NaN,10.233557538157502,13.68813842450138
2000-11-22T09:30:00-05:00,18.875,18.89062,18.67187,18.75,21900,60705,45.308386180045105,57.368316655761376,NaN,NaN,-91.91906687114077,-28.98558813036478,-0.12055069459803444,0.11749378875754957,0.238044483355584,3183700,3237920,76.46212322803346,74.72968182352318,NaN,NaN,7.566699408226827,12.813647136462158
2000-11-24T09:30:00-05:00,19.09375,19.09375,18.92187,19,3900,58310,49.818131799100456,56.41009436929427,NaN,NaN,-67.92140146059891,-47.382848636179126,-0.11211798303657516,0.09789700455986505,0.21001498759644022,3187600,3212500,72.57915353574128,75.60450985590501,NaN,NaN,6.457002650110668,11.905555066983375
2000-11-27T09:30:00-05:00,19.07812,19.15625,18.84375,19,23700,58855,49.818131799100456,55.440346403546705,NaN,NaN,-96.39714575629256,-69.77112179078718,-0.10286977941524844,0.08142776332737967,0.1842975427426281,3187600,3200340,70.72879196655265,76.09456444492506,NaN,NaN,5.544178415685258,10.996786973940786
2000-11-28T09:30:00-05:00,19.03125,19.29687,18.9375,19.03125,27200,52380,50.410916205751874,54.339789638700054,NaN,NaN,-67.36238406026145,-77.00470165869817,-0.09136648425526167,0.070089437423551,0.16145592167881267,3214800,3195860,70.02052144928538,76.3388661662461,NaN,NaN,4.927961859803374,10.129811957635441
2000-11-29T09:30:00-05:00,19.17187,19.46875,19.07812,19.46875,79300,52535,57.90755839292935,53.62233933003729,NaN,NaN,-2.7146212608015325,-65.26292388181905,-0.05291859452272063,0.09530767852541189,0.14822627304813252,3294100,3213560,71.24566286051454,76.43611281004982,NaN,NaN,6.485768984308174,9.60923439001726
2000-11-30T09:30:00-05:00,19.34375,19.42187,19.04687,19.26562,73100,54765,53.83797363354625,53.00025316750687,NaN,NaN,-22.138510541057975,-51.306812615802485,-0.04036075461780922,0.097775329775871,0.13813608439368022,3221000,3221020,71.76930425538094,76.3575171317902,NaN,NaN,6.661594399827746,9.18814296284733
2000-12-01T09:30:00-05:00,19.64062,20.0625,19.51562,19.90625,176600,61370,62.73316411424253,53.36602330918971,NaN,NaN,115.53020339773047,-14.616491644136607,0.009250183256800854,0.14969881346468128,0.14044863020788043,3397600,3263020,74.57643246926617,76.32136021357408,NaN,NaN,9.766860658003187,9.270816919298166
2000-12-04T09:30:00-05:00,20.25,21.0625,20.25,20.96875,403900,80935,72.2752672447641,54.343565624459224,NaN,NaN,259.89909343118035,56.64275619335798,0.10638627255544383,0.2734314709021852,0.1670451983467414,3801500,3385800,80.6376700404926,76.69833315564004,NaN,NaN,16.598604291420596,10.317643686744228
2000-12-05T09:30:00-05:00,20.98437,21.125,20.5,21.125,136200,77145,73.35570939291402,55.25833683830884,NaN,NaN,228.9635411029083,115.90794122599193,0.17014093807103464,0.3797213709355347,0.20958043286450007,3937700,3530380,85.13261737394905,77.26196812077036,NaN,NaN,22.159557853155263,12.009345710517232
2000-12-06T09:30:00-05:00,21.14062,21.21875,20.625,20.65625,147600,82400,65.15271180278616,55.490130590442575,NaN,NaN,177.20613059251565,151.89209159665535,0.16935682344925634,0.4212764621760705,0.25191963872681417,3790100,3629580,87.30949506289586,77.8337498128261,NaN,NaN,23.741306324722338,13.685340083975104
2000-12-07T09:30:00-05:00,20.5,20.5,20.01562,20.03125,25800,81825,56.13858712112577,55.81913644019043,NaN,NaN,82.5729829889458,172.83439030265612,0.11780464791596928,0.3991754486217758,0.2813708007058065,3764300,3738240,89.17857059508141,78.40707602576433,NaN,NaN,21.642994541307704,14.822147863594047
2000-12-08T09:30:00-05:00,20.26562,20.65625,20.04687,20.375,29800,81600,59.46070210344967,56.402841571894385,NaN,NaN,92.63182640435305,168.25471490398064,0.09868934677285063,0.4047324841718698,0.30604313739901917,3794100,3817540,90.30124103125928,78.95763223438294,NaN,NaN,21.2034969294765,15.733769158720111
2000-12-11T09:30:00-05:00,20.46875,20.48437,20.125,20.375,24200,81170,59.46070210344967,57.230271356732494,NaN,NaN,78.11298719011148,131.89749365576685,0.07874465084184401,0.4044739509513242,0.3257293001094802,3794100,3816060,90.11333965875302,79.41173507149954,NaN,NaN,20.87409124442417,16.468100885249264
2000-12-12T09:30:00-05:00,20.1875,20.75,20.1875,20.28125,48500,82790,58.06953804131585,58.124819995322945,NaN,NaN,77.09949090254072,101.52468361569333,0.053163259273005636,0.39218337420073723,0.3390201149277316,3745600,3777640,85.15941679015198,79.65816716552558,NaN,NaN,20.1709162918725,16.99707451476687
2000-12-13T09:30:00-05:00,20.29687,20.4375,20.07812,20.4375,56500,75000,59.759381209989584,59.157033926033264,NaN,NaN,61.090942965936904,78.3016460903776,0.041223161029312894,0.3905490662143727,0.3493259051850598,3802100,3780040,85.2140990572785,80.28330829618595,NaN,NaN,20.11196937311741,17.442059494531232
2000-12-14T09:30:00-05:00,20.4375,20.48437,20.10937,20.25,29500,72505,56.80110016918352,59.6558173810392,NaN,NaN,52.77542163872451,72.34213382033333,0.01642780298616764,0.3698606589177693,0.3534328559316017,3772600,3781700,85.25456918168084,81.18869512803879,NaN,NaN,19.170670132246105,17.689003871347644
2000-12-15T09:30:00-05:00,19.9375,20.0625,19.71875,19.96875,52800,73480,52.595231999076574,59.8541816810375,NaN,NaN,13.852556008327609,56.58627974112825,-0.02114551747941168,0.32700095908233706,0.34814647656174874,3719800,3766840,83.06282998071643,82.06969784333619,NaN,NaN,17.08689745461947,17.602988668957906
2000-12-18T09:30:00-05:00,19.45312,19.89062,19.39062,19.75,67600,73545,49.523718897598215,59.79081044474081,NaN,NaN,-13.178861908226448,38.32790992146068,-0.06072136279509316,0.2722447730678823,0.33296613586297547,3652200,3738460,78.89145308218309,82.7033358171146,NaN,NaN,14.402729173718647,17.145808741066585
2000-12-19T09:30:00-05:00,19.8125,20.4375,19.70312,20.375,152600,80615,57.212230642778046,59.74114417687286,NaN,NaN,34.42766634670302,29.793545010293133,-0.04549317056940122,0.2760996726512239,0.32159284322062515,3804800,3750300,79.35721606519972,83.28273247459211,NaN,NaN,14.409192088017772,16.754863504916756
2000-12-20T09:30:00-05:00,19.90625,20.09375,19.60937,19.60937,19500,80010,47.6393183692712,59.298383086567505,NaN,NaN,-16.963872695680717,14.18258187796961,-0.08535622603999149,0.2148975606706358,0.3002537867106273,3785300,3746940,78.82566312735416,83.78675810830448,NaN,NaN,11.041165792742705,15.938620974606177
2000-12-21T09:30:00-05:00,19.78125,20.45312,19.75,20.3125,143300,86080,55.07388167877791,58.75129148403431,NaN,NaN,25.85009284319026,8.797516118862761,-0.06373234501967062,0.22058835543603905,0.2843207004557097,3928600,3778140,80.15493158470875,84.18522233083608,NaN,NaN,10.863160853950294,15.213555243083908
2000-12-22T09:30:00-05:00,20.625,21.375,20.35937,21.35937,200900,95930,63.40516299767975,58.11771260924257,NaN,NaN,132.34621458977813,32.49624783515286,0.017378739685098954,0.30604412506208334,0.2886653853769844,4129500,3860080,83.14720262442899,84.36447465826011,NaN,NaN,14.01365908555583,15.042141506294183
2000-12-26T09:30:00-05:00,21.39062,21.39062,21,21.29687,25200,96005,62.6580917649658,57.35359706438913,NaN,NaN,152.31501398973165,65.59502301474447,0.06068626273819511,0.3645232137997283,0.3038369510615332,4104300,3950500,85.70809674488547,84.40558032761273,NaN,NaN,16.05476479898387,15.186801976678424
2000-12-27T09:30:00-05:00,21.5,21.75,21.0625,21.64062,85400,98915,65.09412543509677,57.349412323839886,NaN,NaN,172.01818371086642,93.11312648757715,0.10381660346156202,0.4336077053884857,0.3297911019269237,4189700,4027480,87.45577522500625,84.41602891062061,NaN,NaN,18.533524840571587,15.664905242948876
2000-12-28T09:30:00-05:00,21.65625,22,21.20312,21.84375,86600,99280,66.48547388145613,58.08847566386349,NaN,NaN,169.3959456051447,130.38509014774223,0.135364267077752,0.4989964357741137,0.36363216869636167,4276300,4125680,89.26001200290172,84.42184615403633,NaN,NaN,20.95404840236877,16.420497122866003
2000-12-29T09:30:00-05:00,21.98437,21.98437,21.3125,21.42187,55900,98420,61.04327094050516,58.20151629508173,NaN,NaN,133.1372706899248,151.84252571708913,0.11780315181137346,0.5108861084605785,0.393082956649205,4220400,4184040,90.16532393115735,84.41213778974335,NaN,NaN,21.17166481861373,17.09923536511568
2001-01-02T09:30:00-05:00,21.75,21.75,20.8125,21,251800,102180,56.098213045469805,57.961338505226024,NaN,NaN,73.92505758617527,140.15829431636857,0.07011432898171738,0.48072586787635174,0.41061153889463436,3968600,4151860,85.86721645347731,84.10884327508079,NaN,NaN,19.72023106837258,17.47366332272381
2001-01-03T09:30:00-05:00,21.20312,21.35937,20.5625,21.125,85600,86265,57.20445021635984,57.89954651772916,NaN,NaN,48.798029422381084,119.45489740289845,0.04078213069040593,0.4615892022576418,0.42080707156723585,4054200,4141840,84.51625078642772,84.06290284624335,NaN,NaN,18.909356822081996,17.678762394060694
2001-01-04T09:30:00-05:00,20.875,21.89062,20.875,21.82812,262400,92575,62.871732618095265,58.121857332593855,NaN,NaN,103.0958040506342,105.670421470852,0.06129446841745201,0.4974251570890509,0.4361306886715989,4316600,4167220,85.15341598551989,84.05856834111773,NaN,NaN,20.051675570929962,18.017749990756304
2001-01-05T09:30:00-05:00,21.4375,21.625,21,21.375,43400,87365,57.579793816927875,58.17747830743274,NaN,NaN,73.22777949515147,86.43678824885338,0.03804486692833209,0.48368677233201396,0.44564190540368187,4273200,4166600,85.06133014773351,84.04476555297865,NaN,NaN,19.263257190935732,18.195679590781936
2001-01-08T09:30:00-05:00,21.34375,21.79687,21.14062,21.4375,25600,87355,58.1036201796539,58.570934606045405,NaN,NaN,78.29311659833552,75.4679574305355,0.021403864146623985,0.4723967355869618,0.45099287144033784,4298800,4182280,85.4887308376518,84.21804418561689,NaN,NaN,18.80391159159057,18.282569876611742
2001-01-09T09:30:00-05:00,21.29687,21.3125,20.5625,20.5625,174500,94590,48.98391518566072,58.53237719804987,NaN,NaN,4.931490058311833,61.669243924962814,-0.050100491696343785,0.38836725681990814,0.4384677485162519,4124300,4213420,86.32547514740608,84.74904576170422,NaN,NaN,15.32400038540651,17.85991709215385
2001-01-10T09:30:00-05:00,20.625,20.75,20.1875,20.75,68100,96785,50.7671576983869,58.072014844879085,NaN,NaN,-25.299434791147114,46.849751082257185,-0.08432330090857298,0.33306362238053566,0.41738692328910865,4192400,4241060,87.03981157799846,85.29780258404699,NaN,NaN,13.113187317249423,17.181812838596073
2001-01-11T09:30:00-05:00,20.1875,20.1875,19.84375,20.1875,177400,103230,45.615770053248205,57.92747567944887,NaN,NaN,-77.6498326719504,10.700623737740258,-0.1410558007504455,0.2410671723510518,0.3821229731014973,4015000,4180740,77.52226550130817,85.20470275361514,NaN,NaN,9.525970396165219,16.08812106110595
2001-01-12T09:30:00-05:00,20,20,19.46875,19.71875,135200,107165,41.808534360373656,56.97995087099142,NaN,NaN,-107.12041758198417,-25.369015677686868,-0.20261852652061685,0.12884981495072623,0.3314683414713431,3879800,4102060,67.20022673225897,84.27936669272586,NaN,NaN,5.263246423678511,14.541710398616317
2001-01-16T09:30:00-05:00,19.96875,20.39062,19.59375,20.375,52400,108310,48.31269634604909,55.90191753873209,NaN,NaN,-63.73960398852285,-53.77555979505854,-0.19172484411083435,0.09181228633280014,0.2835371304436345,3932200,4028740,59.279156987931664,82.57450629011892,NaN,NaN,3.7663944437638306,13.002379547923105
2001-01-17T09:30:00-05:00,20.48437,20.48437,20,20.26562,73000,109320,47.36248584079075,54.80937425843387,NaN,NaN,-53.35379083852524,-65.43261597442594,-0.1844116918476665,0.05302251563405136,0.23743420748171787,3859200,3975720,54.29517686588667,80.33072629876186,NaN,NaN,2.2872304686757263,11.471643965173481
2001-01-18T09:30:00-05:00,20.09375,20.23437,19.82812,20.15625,31800,107530,46.380203851996654,53.47266557392671,NaN,NaN,-77.3837473673708,-75.8494784896707,-0.1793051643150352,0.013302752087923864,0.19260791640295907,3827400,3902720,48.27678522957796,77.53222701337411,NaN,NaN,0.8012906292551247,9.947307774328001
2001-01-19T09:30:00-05:00,19.78125,19.9375,19.40625,19.59375,62900,103045,41.6014056117601,51.695232126091284,NaN,NaN,-116.6477285475803,-83.64905766479667,-0.2043584242920016,-0.06284011396204292,0.14151831032995868,3764500,3852620,44.621176084906644,74.34373873351731,NaN,NaN,-1.986977338891394,8.242409901010944
2001-01-22T09:30:00-05:00,19.5,19.84375,19.15625,19.75,34900,103815,43.34757639897194,50.43125394455319,NaN,NaN,-120.33794540200671,-86.29256322880119,-0.20066720144589142,-0.10931569147740561,0.09135150996848582,3799400,3836540,43.48309076748461,71.0092935075407,NaN,NaN,-3.742648718139215,6.5302586697037786
2001-01-23T09:30:00-05:00,20.125,20.125,19.8125,19.8125,15700,97435,44.06800231923535,49.571953178393585,NaN,NaN,-82.11386299267319,-89.96741502963125,-0.18467853848050825,-0.13949666313214948,0.045181875348358755,3815100,3813120,41.81044443964347,67.86238122083827,NaN,NaN,-4.9687287208869435,4.887546185333676
2001-01-24T09:30:00-05:00,19.90625,20.09375,19.75,19.89062,35700,89175,45.00929999187384,48.700871019501726,NaN,NaN,-74.10571454312759,-94.11779977055171,-0.16040247876737238,-0.15532122311085672,0.005081255656515654,3850800,3811440,41.68656850715265,64.80311820089005,NaN,NaN,-5.728679579659397,3.37094250462038
2001-01-25T09:30:00-05:00,19.75,20.34375,19.75,20.15625,44500,90140,48.20145370930859,47.652993954588396,NaN,NaN,-51.798802527551565,-89.00081080258788,-0.11987259065310137,-0.14475948265986105,-0.024886892006759687,3895300,3825020,43.152746878096295,61.80307040750265,NaN,NaN,-5.509387048132119,2.1023239970843086
2001-01-26T09:30:00-05:00,20.26562,20.28125,19.71875,19.95312,31100,87425,46.00229933026005,46.82603006268355,NaN,NaN,-56.279049540887634,-76.92707500124934,-0.10092171570273566,-0.15103903663517926,-0.0501173209324436,3864200,3844960,45.32647561984773,58.964866512653664,NaN,NaN,-5.917353269144055,0.9566558161945424
2001-01-29T09:30:00-05:00,19.69,20.00999,19.66,19.89,234500,94820,45.310512702741406,45.91223667147551,NaN,NaN,-64.66620021352271,-65.79272596355254,-0.08732445221272361,-0.15927288619834812,-0.0719484339856245,3629700,3811020,42.35755801325915,55.88406845376848,NaN,NaN,-6.4418104638608105,-0.10026793809907941
2001-01-30T09:30:00-05:00,19.84,20.64,19.72,20.64,87900,96420,54.13608204577975,46.28024859005545,NaN,NaN,-4.982186608566021,-50.36639068673111,-0.025705070795999554,-0.10407977248062394,-0.07837470168462439,3717600,3791520,40.70775970984612,52.62566020822849,NaN,NaN,-4.34144264108827,-0.7061500385261067
2001-01-31T09:30:00-05:00,20.67999,20.95,20.67,20.85001,48300,86245,56.26440399426426,46.67290903976097,NaN,NaN,61.81921857756572,-23.181404062592446,0.02838114077014854,-0.04289827572193872,-0.07127941649208726,3765900,3774540,39.27331039858447,49.213767266841764,NaN,NaN,-1.9472813958894628,-0.8834545181494433
2001-02-01T09:30:00-05:00,21.22,21.22,20.73,20.96001,33200,83625,57.38002518332277,47.51321297762343,NaN,NaN,81.9466771821298,3.5676918793438235,0.06846332791304352,0.014299743399217135,-0.05416358451382638,3799100,3755300,37.654210608199215,46.36604906019112,NaN,NaN,0.3628001479993553,-0.7054181372710435
2001-02-02T09:30:00-05:00,21.08,21.19,20.81,20.89,86600,74835,56.3940475859946,48.55503535088208,NaN,NaN,91.37227602279613,33.09795699208057,0.08602302993093625,0.05336520289984392,-0.03265782703109232,3712500,3724960,35.190462661659424,44.07963734086259,NaN,NaN,2.0271279932162747,-0.31505440434428383
2001-02-05T09:30:00-05:00,21,21.08,20.87,21.08,112900,78310,58.47925681255707,49.281218241346934,NaN,NaN,104.70672857811543,66.97254275040821,0.10494273289306574,0.09852058908523986,-0.006422143807825877,3825400,3764100,40.590862362470375,42.744759153329646,NaN,NaN,4.0360043080624175,0.30652541171381636
2001-02-06T09:30:00-05:00,21.06,21.06,20.75,20.89999,19200,77990,55.75878113525439,49.880953619522906,NaN,NaN,100.41793432847017,88.05256693781544,0.09987069650167163,0.11841622681926367,0.018545530317592034,3806200,3781820,42.910246747251875,41.93154985914145,NaN,NaN,5.047502552414279,0.9838078603853111
2001-02-07T09:30:00-05:00,21.05,21.05,20.72,20.89999,176300,78080,55.75878113525439,50.55085199689846,NaN,NaN,96.56029650193291,95.00078252268888,0.0912871793542252,0.13265450451037353,0.041367325156148334,3806200,3789880,43.981535846703736,41.62474633179329,NaN,NaN,5.891154696296503,1.6848574083726242
2001-02-08T09:30:00-05:00,21,21,20.59,20.62,34000,76375,51.44185260417038,51.25374106778491,NaN,NaN,69.01941832187183,92.41533075063728,0.06287632661047557,0.1199627334192428,0.057086406808767226,3772200,3784500,43.39616406961081,41.53724547355787,NaN,NaN,5.506717048515603,2.230837356964478
2001-02-09T09:30:00-05:00,20.45,20.75,20.45,20.60001,17800,68395,51.1374449495492,51.810160249968995,NaN,NaN,42.97606334665167,82.73608821540839,0.03997671260749544,0.10705729756813653,0.0670805849606411,3754400,3792880,44.63229462111361,41.619331463102796,NaN,NaN,5.1050393543157355,2.641437642300372
2001-02-12T09:30:00-05:00,20.45,20.69,20.35001,20.60001,149100,69090,51.1374449495492,52.31512043784856,NaN,NaN,29.61805027969142,67.71835255572358,0.022916471967873137,0.09572617492048252,0.07280970295260938,3754400,3778680,42.921785986764554,41.69871300218288,NaN,NaN,4.7650660365053765,2.944813127186801
2001-02-13T09:30:00-05:00,20.39,20.94,20.39,20.53999,454700,89205,50.104986736163475,52.67909806244067,NaN,NaN,37.676298769792226,55.170025443987996,0.006527995972506043,0.08096969791824193,0.07444170194573589,3299700,3677380,33.158835094513265,41.08958918699435,NaN,NaN,4.218051970400225,3.1267043905030043
2001-02-14T09:30:00-05:00,20.67999,20.67999,20.31,20.31,15600,86335,46.25147495594864,52.5398138657721,NaN,NaN,6.260965787069285,37.110159301015265,-0.019442286908123968,0.05013884331058094,0.0695811302187049,3284100,3572960,26.474109212421524,39.89825792516044,NaN,NaN,2.739907797469007,3.0714477343552904
2001-02-15T09:30:00-05:00,20.33,21.14,20.33,21.09,32700,86380,58.03834893695189,53.39953169482152,NaN,NaN,67.41281564590702,36.7888387658223,0.01444265961230802,0.08763445473408993,0.07319179512178191,3316800,3481880,22.258957790785217,38.250578080227406,NaN,NaN,4.746477209601692,3.3107376593904907
2001-02-16T09:30:00-05:00,20.82001,21.07001,20.50999,20.62,42400,85355,50.80810390267307,53.79221678053092,NaN,NaN,43.085869077846965,36.810799912061356,0.004262401929225723,0.07851979753331406,0.07425739560408834,3274400,3385880,18.851897700735705,36.571602343618586,NaN,NaN,4.253650057436353,3.4454394305398997
2001-02-20T09:30:00-05:00,20.78,21.11,20.55,20.55,33300,85275,49.812781846376986,53.48340962343074,NaN,NaN,38.64739518886636,38.616668893896346,-0.007486055483050036,0.0648998262502758,0.07238588173332583,3241100,3283220,16.026783280748788,34.80867545582592,NaN,NaN,3.554485626793338,3.461017458576105
2001-02-21T09:30:00-05:00,20.39999,20.63,20.10001,20.2,62800,87630,45.0597165217358,52.683074803964416,NaN,NaN,-55.476255235818854,19.986158092774126,-0.03745344018777583,0.02556908149860604,0.06302252168638187,3178300,3258940,15.437544534485284,33.10612075124741,NaN,NaN,1.4626756269067522,3.175540054051912
2001-02-22T09:30:00-05:00,20.2,20.52,20.16,20.35001,49700,88330,47.37733873591894,51.96859720057843,NaN,NaN,-57.811341480595786,7.171696639241114,-0.045274321683451,0.0064296195820681135,0.05170394126551912,3228000,3247720,15.160162927991252,31.499403059803978,NaN,NaN,0.43116811216253403,2.7834869194962866
2001-02-23T09:30:00-05:00,20.27,20.35001,20,20.25,86800,90445,45.984592508070314,51.225064695012406,NaN,NaN,-95.65510457563653,-25.441887405067597,-0.05465672345587825,-0.016616963054328693,0.038039760401549556,3141200,3212600,14.294376100420664,30.006825448286925,NaN,NaN,-0.8285752329513075,2.2674780405752015
2001-02-26T09:30:00-05:00,20.28,21.03999,20.28,21,62600,92020,56.348104517742065,51.07283953109705,NaN,NaN,38.6102022622151,-26.337020768193973,-0.010155788731180157,0.025345024487574364,0.03550081321875452,3203800,3198480,13.949447671592964,28.103867256081394,NaN,NaN,1.3873409193528223,2.1417441661148615
2001-02-27T09:30:00-05:00,20.95,21.17999,20.84,21.03,18700,81230,56.70592274580624,51.14049250327933,NaN,NaN,102.24245254436151,-13.618009297094943,0.01985979403174759,0.06032555575843901,0.04046576172669142,3222500,3194760,13.854594787555342,26.028463544674498,NaN,NaN,3.241993354694873,2.298922621626292
2001-02-28T09:30:00-05:00,21.28,21.35001,20.94,21.12,33100,78490,57.82289418238116,51.287929149502666,NaN,NaN,131.9071238625472,23.858666522578268,0.04300656770734457,0.09422397136087213,0.05121740365352756,3255600,3210220,16.398829191367568,24.058270212150486,NaN,NaN,5.090128613306285,2.6976663347234338
2001-03-01T09:30:00-05:00,21.17999,21.24001,20.88,21.14,41100,78130,58.08170910696765,51.762204613988196,NaN,NaN,105.48002616497273,56.516940051691975,0.05606945565926669,0.12130422322761092,0.06523476756834423,3296700,3223960,18.697057619741344,22.294048322874097,NaN,NaN,6.667602651300361,3.264800094234423
2001-03-02T09:30:00-05:00,21.35001,21.75,21.17999,21.64,92200,81080,64.02512976225503,52.68275352918147,NaN,NaN,204.99548249435134,116.64705746568958,0.0926318662264272,0.18102460035137824,0.08839273412495104,3388900,3273500,26.538477519482583,21.001632815614737,NaN,NaN,9.964783390775807,4.221940565168906
2001-03-05T09:30:00-05:00,21.8,22.09,21.7,22.03,112100,82355,67.85375169677226,53.8767754396974,NaN,NaN,250.47114277410347,159.01924556806725,0.13477559054838992,0.2568622223104384,0.12208663176204851,3501000,3332940,34.67894123177379,20.412858190258255,NaN,NaN,14.08452972206823,5.6308818732973815
2001-03-06T09:30:00-05:00,22.10001,22.13,21.77,21.98,252300,89325,66.87116201856796,55.07435938844058,NaN,NaN,207.06253264172386,179.98326158753974,0.14982137762276,0.3093633537904985,0.15954197616773852,3248700,3338180,35.35898142279552,20.570011499421273,NaN,NaN,17.098213171982685,7.269072058823854
2001-03-07T09:30:00-05:00,22.14999,22.64,22.14999,22.63,135400,95135,72.45538845357227,56.94606749541369,NaN,NaN,225.5025683177449,198.70235047857926,0.1914248690312086,0.39882306245674926,0.20739819342554067,3384100,3363880,38.7281951261867,21.445303350404494,NaN,NaN,21.776209611294313,9.341520280605348
2001-03-08T09:30:00-05:00,22.60001,22.85001,22.21001,22.71001,99000,91270,73.05740962259526,58.01885754438821,NaN,NaN,189.19152445154543,215.4446501358938,0.2106815650446629,0.4707501497313693,0.2600685846867064,3483100,3401160,43.34150734091557,22.95119974684238,NaN,NaN,25.687534531901246,11.676665173647619
2001-03-09T09:30:00-05:00,22.83,22.86,22.28999,22.52,30300,91085,69.18987232322405,59.331841002999006,NaN,NaN,151.1819019252562,204.68193402207478,0.1972100233214179,0.5065811138384788,0.3093710905170609,3452800,3413940,44.8738279529643,24.809909050572994,NaN,NaN,27.75344823010436,13.973348467427153
2001-03-12T09:30:00-05:00,22.39999,22.39999,21.56,21.62,217200,101055,54.478688554776525,59.665120053598976,NaN,NaN,68.100318113089,168.20776908987187,0.11817187204540014,0.4570859305738111,0.33891405852841094,3235600,3360860,40.031330552698115,26.524519569997945,NaN,NaN,24.551810522855494,15.484557332488343
2001-03-13T09:30:00-05:00,21.73,21.73,21.02,21.44,118900,99545,52.09307672877635,60.16750292553045,NaN,NaN,17.417549930165897,130.27877254756032,0.0478605309808689,0.39873972225449705,0.35087919127362815,3116700,3334460,37.84392101629174,28.12497503298412,NaN,NaN,21.208156497049472,16.302214355997076
2001-03-14T09:30:00-05:00,20.89999,21.23,20.67999,20.89,73700,80495,45.53213715744986,60.03570281278265,NaN,NaN,-32.45632294619895,78.68699429477154,-0.037016797270755686,0.3046081946851835,0.3416249919559392,3043000,3266240,32.848839513975534,29.388451931982996,NaN,NaN,16.00516920063571,16.259779333802594
2001-03-15T09:30:00-05:00,21.02,21.02,20.42999,20.42999,52600,82345,40.89312418241294,59.672026503807125,NaN,NaN,-66.43737076915596,27.56121525063125,-0.12074707396544121,0.19069114949913768,0.3114382234645789,2990400,3167700,27.25320264401452,30.31408239938256,NaN,NaN,10.014971710188911,15.36766395900064
2001-03-16T09:30:00-05:00,20.39999,20.62,20.2,20.25,90700,85245,39.20979924200411,58.447861841254415,NaN,NaN,-89.62750588761666,-20.60066631194332,-0.18122369227584845,0.0849086081197683,0.26613230039561675,2899700,3057080,22.599184793636894,30.93192076524284,NaN,NaN,4.715518084865889,13.845928834124246
2001-03-19T09:30:00-05:00,20.3,20.89999,20.3,20.73,51900,85720,45.63669243609839,57.65720253341815,NaN,NaN,-59.33651173453237,-46.08803228146759,-0.18142301834901256,0.039353527459351056,0.22077654580836362,2951600,3000280,20.649274377745343,31.417255021684987,NaN,NaN,2.3905950727558043,12.209452582500184
2001-03-20T09:30:00-05:00,20.88,21.42999,20.53999,20.85001,73500,87730,47.141372844021085,56.89423672353529,NaN,NaN,-30.397527074522873,-55.65104768240535,-0.1663914774517486,0.012787198993677862,0.17917867644542645,3025100,2981960,20.048427220067907,31.677940595163584,NaN,NaN,1.040131950210981,10.613835349316012
2001-03-21T09:30:00-05:00,20.64999,20.64999,20.07001,20.2,55300,87355,40.588539744055,55.644724626184384,NaN,NaN,-95.99036939103088,-68.35785697137172,-0.19136314007885907,-0.0600252486531474,0.13133789142571167,2969800,2967320,19.558650219979526,31.739482923752025,NaN,NaN,-2.391794710923415,8.755888197853237
2001-03-22T09:30:00-05:00,19.84,19.94,19.03,19.56,126900,91215,35.374631075570406,53.598260434278345,NaN,NaN,-165.63222404507016,-88.19682762655457,-0.2390240097457418,-0.16744212075646558,0.07158188898927623,2842900,2937820,18.573984583509628,31.170590571182522,NaN,NaN,-7.194724046633437,6.4772293057837125
2001-03-23T09:30:00-05:00,19.60001,19.92,19.28999,19.75,26000,88175,37.9240526623679,51.46042478896374,NaN,NaN,-144.16356894350065,-99.10404023773137,-0.24489412824191928,-0.23453577131312286,0.010358356928796414,2868900,2931660,18.366058371482694,30.0053846525903,NaN,NaN,-10.117369817366713,4.106572288190796
2001-03-26T09:30:00-05:00,19.92,20.27,19.77,19.95,77900,88940,40.58124651045719,49.58257368124155,NaN,NaN,-102.95213689800475,-107.82716527042585,-0.22306655232077796,-0.26847483347217604,-0.045408281151398076,2946800,2930700,18.33161702349699,28.789144338354696,NaN,NaN,-11.60835435767219,1.8615827673532261
2001-03-27T09:30:00-05:00,20.06,20.46001,20.06,20.45,19000,88955,46.721376560621124,47.74442997460218,NaN,NaN,-67.12699931680075,-115.17305971888143,-0.16536912279075383,-0.25211968463984036,-0.08675056184908653,2965800,2918840,17.885385121107035,27.300372195134717,NaN,NaN,-10.860810400595506,0.04409802907483584
2001-03-28T09:30:00-05:00,20.10001,20.39,19.8,20.39,73200,90960,46.10566927432197,45.81930566401123,NaN,NaN,-70.88991564251688,-110.15296896917862,-0.12357474058599123,-0.24121898758157556,-0.11764424699558433,2892600,2903400,17.295141568258074,25.43991749708775,NaN,NaN,-10.460211820848144,-1.456517663771304
2001-03-29T09:30:00-05:00,20.12,20.17999,19.8,20.14,40000,90905,43.531507640097736,43.986565329502206,NaN,NaN,-75.75407387278393,-92.17733893472136,-0.10578271522355248,-0.24987264102502493,-0.14408992580147245,2852600,2905340,17.662819921764495,23.49627406628777,NaN,NaN,-10.905167710753505,-2.80632481334019
2001-03-30T09:30:00-05:00,19.88,20.19,19.82001,19.97,53000,88945,41.82158838845079,43.082486746193226,NaN,NaN,-72.96500162037071,-77.93762547009537,-0.09862107618533397,-0.2673662710331399,-0.16874519484780595,2799600,2891480,17.07865316063294,21.856797109711685,NaN,NaN,-11.778258795830144,-4.088029667981612
2001-04-02T09:30:00-04:00,20.48,20.66,19.96001,20.08,11800,83930,43.37159888881673,42.45952404333896,NaN,NaN,-49.203013159913745,-67.18780072247718,-0.08040405905219561,-0.26925026866305046,-0.18884620961085485,2811400,2864400,15.9674762873085,20.294193914784312,NaN,NaN,-12.055678093186591,-5.226265157296609
2001-04-03T09:30:00-04:00,19.92,19.92,19.5,19.67,36900,73160,39.18145275244718,42.00590372869591,NaN,NaN,-87.84813742726341,-71.33202834456974,-0.08921463931827694,-0.300364508758701,-0.21114986944042408,2774500,2826140,14.529170028367389,18.98564609438373,NaN,NaN,-13.536798541332193,-6.413484212158835
2001-04-04T09:30:00-04:00,19.7,20.3,19.7,20.05,33900,68085,44.5303424829192,42.26570503587493,NaN,NaN,-56.53597629121009,-68.46124047430837,-0.06388443622104939,-0.2910054147167358,-0.2271209784956864,2808400,2809300,13.934221223391305,18.03429027862493,NaN,NaN,-13.210656832875758,-7.384508872261252
2001-04-05T09:30:00-04:00,20.69,20.87,20.44,20.71001,15500,63910,52.36632245950521,43.205456694267866,NaN,NaN,20.747836573064326,-49.160858385138724,-0.0004681130328897942,-0.22770611978679867,-0.22723800675390887,2823900,2803560,13.727874967087331,17.400625291014247,NaN,NaN,-10.366469800834617,-7.810503290628875
2001-04-06T09:30:00-04:00,20.75999,20.75999,20.22,20.47,20500,63420,49.62115880744266,43.490061435078175,NaN,NaN,13.541802214560978,-31.859497618152382,0.02605935706059309,-0.1946638104281675,-0.22072316748876059,2803400,2804320,13.909658569755123,16.919224161872087,NaN,NaN,-8.890544760811052,-7.964794929226329
2001-04-09T09:30:00-04:00,20.64999,21.10001,20.64,20.81,36700,54395,53.351814610196406,43.9336644183764,NaN,NaN,88.57896392854234,-4.303102200461166,0.06503048351818594,-0.13943506309102816,-0.2044655466092141,2840100,2810060,15.360238370679312,16.5843535297729,NaN,NaN,-6.464119377792693,-7.750412707592953
2001-04-10T09:30:00-04:00,21.39999,21.75,21.32001,21.72,922500,94575,61.55720304328221,45.431426082606926,NaN,NaN,211.27259445407444,55.5210441758064,0.14598597261529586,-0.02198308084009426,-0.16796905345539012,3762600,3007680,47.905268844147436,18.609112002927752,NaN,NaN,-1.3523454668488923,-6.8364031017723725
2001-04-11T09:30:00-04:00,21.89999,21.94,21.21001,21.45,60100,93895,58.28151683739182,47.06763220845131,NaN,NaN,179.12838457558263,102.65391634916496,0.1733750514651543,0.04874976087605276,-0.12462529058910155,3702500,3186500,62.10456997493007,21.71843953088635,NaN,NaN,1.6556727288276938,-5.623249411686649
2001-04-12T09:30:00-04:00,21.45,21.45,21.02,21.35001,34300,92980,57.070329611961625,48.435223419136584,NaN,NaN,122.48914739265872,123.00217851308382,0.17620844556742013,0.09563526637017361,-0.08057317919724652,3668200,3355360,70.32892467481653,25.430072838267343,NaN,NaN,3.6516273211973433,-4.29826702127465
2001-04-16T09:30:00-04:00,21.45,21.86,21.33,21.39,29500,89920,57.45117397890876,49.6402182383117,NaN,NaN,133.58706214082625,147.01123049833686,0.17203386288220338,0.1344691494055077,-0.037564713476695676,3697700,3534220,76.2167760944677,29.564727057622388,NaN,NaN,5.358598355240524,-2.9187148246296246
2001-04-17T09:30:00-04:00,21.32001,21.5,21.2,21.36,65000,90575,57.04234479896529,50.37743025533628,NaN,NaN,99.20799735465847,149.1370371835601,0.1588269563732137,0.16096898198982146,0.0021420256166077567,3632700,3692740,80.00400896448285,34.001771617863525,NaN,NaN,6.630966233425263,-1.5544746734789265
2001-04-18T09:30:00-04:00,21.60001,22.48,21.21001,22.25,102900,92045,64.99969157565738,51.727003276860216,NaN,NaN,150.24713582820002,136.9319454583852,0.19900134409054346,0.2508937057297871,0.05189236163924363,3735600,3687340,79.53935703924722,38.44778700864846,NaN,NaN,10.405305702412287,0.1540653802198182
2001-04-19T09:30:00-04:00,22.2,22.2,21.81,21.89,39800,91270,60.14641914006517,52.91378266971503,NaN,NaN,126.78593152700859,126.46345484867041,0.19030244098313734,0.2897704128681653,0.09946797188502796,3695800,3686000,79.41609758073233,42.85873541286045,NaN,NaN,12.039347505803716,1.8519628267318036
2001-04-20T09:30:00-04:00,22,22.17,21.72,21.83,20900,85970,59.351020220647705,54.16588494344338,NaN,NaN,107.1524201434269,123.39610939882405,0.1701382782829926,0.3121408197387687,0.14200254145577612,3674900,3687340,79.45039223268954,47.31385963229307,NaN,NaN,13.105980942614009,3.4596797004292617
2001-04-23T09:30:00-04:00,21.89999,21.96001,21.67999,21.67999,16000,85470,57.310399464056076,55.161513555960475,NaN,NaN,85.0662023791661,113.691937446492,0.13771294424567898,0.31414372176287486,0.17643077751719588,3658900,3679580,78.63334522560885,51.78999312788595,NaN,NaN,13.39373710937708,4.878830758850379
2001-04-24T09:30:00-04:00,21.92999,21.98,21.75,21.78,23900,82770,58.338826556565266,56.52989739911177,NaN,NaN,81.83156252437715,110.21665048043573,0.11494415179443923,0.3201109672602449,0.20516681546580567,3682800,3689600,78.93458458096444,56.39037988164288,NaN,NaN,13.920852865428238,6.170548202647216
2001-04-25T09:30:00-04:00,21.73,21.75,21.45,21.7,31300,83385,57.152731080567634,57.431496584658085,NaN,NaN,57.06376590029086,91.57997649485391,0.0876716716184259,0.31475640498883806,0.22708473337041216,3651500,3672780,76.9727819488622,60.89313421917651,NaN,NaN,14.03732797922481,7.294373885015443
2001-04-26T09:30:00-04:00,21.75,22.39999,21.75,22.39999,180100,88730,64.04161238369208,58.265445864957144,NaN,NaN,100.07834758104755,86.2384597056617,0.10858335383128326,0.3628139256595162,0.25423057182823294,3831600,3699940,77.92676872857622,65.4787694878543,NaN,NaN,16.22196525930141,8.56974408134201
2001-04-27T09:30:00-04:00,22.45,22.58,22.22,22.42,71600,90310,64.21871355905783,59.308128347215366,NaN,NaN,114.24121841273546,87.6562193595234,0.1149574921403495,0.39792743700366984,0.28296994486332033,3903200,3745600,79.46686203407128,70.16142687816259,NaN,NaN,18.037153223267907,9.922231101617138
2001-04-30T09:30:00-04:00,22.42999,22.62,22,22.10001,123500,93835,59.19760755397362,59.7256849860566,NaN,NaN,93.53379876289596,89.34973863626938,0.08992561963052109,0.3953769694014717,0.3054513497709506,3779700,3769760,80.25200689520713,74.79655320134314,NaN,NaN,18.16413018232433,11.09964525600388
2001-05-01T09:30:00-04:00,22.05,22.39,21.98,22.35001,14000,93945,61.716108678689146,59.73703538858566,NaN,NaN,88.86521684763468,90.75646950092089,0.08269175161732745,0.4088160392926099,0.32612428767528245,3793700,3791940,80.97137498682642,77.15841792582022,NaN,NaN,19.001105644934277,12.228425311565365
2001-05-02T09:30:00-04:00,22.39999,22.5,22.08,22.35001,200700,102135,61.71610867868915,59.98236337724976,NaN,NaN,96.04747682487778,98.55321168583826,0.07084965214945554,0.41468635286210187,0.3438367007126463,3793700,3820380,81.88270224210555,78.5711416591899,NaN,NaN,19.683014854475473,13.293366674838238
2001-05-03T09:30:00-04:00,22.2,22.34,22,22.31,26100,101745,61.01706272309716,60.26427288518801,NaN,NaN,78.96240436203684,94.33002304203612,0.054025159486315255,0.4113681500705404,0.35734299058422514,3767600,3807580,80.02507696201988,79.26372396541869,NaN,NaN,20.067322272365395,14.261074617342118
2001-05-04T09:30:00-04:00,22.14999,22.7,22,22.69,26100,102275,65.06444785856337,60.80807816230619,NaN,NaN,110.38385313871822,93.55854998723268,0.0616406897133574,0.4343938527259219,0.3727531630125645,3793700,3785680,76.81418138938199,79.30639577219829,NaN,NaN,21.54401534868522,15.301494721819704
2001-05-07T09:30:00-04:00,22.7,22.87,22.42,22.42,105600,106530,60.27585203682706,61.0390429650106,NaN,NaN,123.30382097368081,99.51255442938965,0.04255356104550301,0.42594511431944326,0.38339155327394026,3688100,3767360,74.13448022088738,78.88714371908432,NaN,NaN,21.478791880052633,16.18396574442441
2001-05-08T09:30:00-04:00,22.64999,22.64999,22.45,22.48,51300,107260,60.96340869335397,60.750737044846076,NaN,NaN,108.82330966022072,103.50417299190686,0.02869314281005425,0.4192579817865081,0.39056483897645383,3739400,3756500,72.51942145598443,78.38571974885129,NaN,NaN,21.611565782895276,16.959337178491676
2001-05-09T09:30:00-04:00,22.75,22.89,22.52,22.7,43900,63330,63.460705553181775,60.987471788640114,NaN,NaN,126.45632889589632,109.58594340611057,0.028980740176926756,0.4267907641976123,0.39781002402068555,3783300,3754420,72.19501202720235,77.86992792359912,NaN,NaN,22.415272740720347,17.738756544524342
2001-05-10T09:30:00-04:00,23,23.22,23,23.17999,162000,68425,68.23530711713518,61.6220637098178,NaN,NaN,181.0815691344017,130.00977636058354,0.05464686474840913,0.46611860495619695,0.4114717402077878,3945300,3789960,74.30970355385082,77.50273587511064,NaN,NaN,24.57713064150604,18.715667129807443
2001-05-11T09:30:00-04:00,23.14999,23.14999,22.50999,22.72,22900,67855,60.12671688759766,61.82322924007077,NaN,NaN,114.17577075208467,130.76815988325683,0.03476241895265508,0.4549247638986067,0.4201623449459516,3922400,3815700,75.74831038225601,77.29666195772832,NaN,NaN,23.977441103231524,19.467349126010884
2001-05-14T09:30:00-04:00,22.59,22.89999,22.59,22.88,9700,66865,61.82597904720793,62.07231156083096,NaN,NaN,104.55457105983533,127.01830990048775,0.026857216423819774,0.45373386547572636,0.4268766490519066,3932100,3864500,78.23657316695113,77.2468039995845,NaN,NaN,23.99605291022765,20.11430680947042
2001-05-15T09:30:00-04:00,22.74001,23.19,22.74001,23.05,63400,66785,63.600914189749524,62.532896068629675,NaN,NaN,130.17861108479678,131.28937018540296,0.02745173888675856,0.4611913226603548,0.4337395837735962,3995500,3915720,80.49825799662905,77.49862371728214,NaN,NaN,24.538075271215114,20.746273732576807
2001-05-16T09:30:00-04:00,23.17999,24.25,23.17999,24.25,117100,67495,73.10650045737772,63.18038807389293,NaN,NaN,243.7104409339918,154.74019259302204,0.09901218412395102,0.557504813928535,0.458492629804584,4112600,3981580,82.9515860393422,77.8575392394797,NaN,NaN,28.53222914035065,21.8585530765445
2001-05-17T09:30:00-04:00,24.42,24.63,24.37,24.5,100600,70535,74.59500767714744,63.92155193947077,NaN,NaN,262.8547783174846,171.09483442963864,0.15044892870778964,0.6465537906893211,0.4961048619815314,4213200,4035160,84.64406805083844,78.22733966924878,NaN,NaN,32.208052563455446,23.337053003246062
2001-05-18T09:30:00-04:00,24.59,24.59,24.10001,24.38,140000,76490,72.52015032987867,64.8731621377497,NaN,NaN,195.01630825074304,187.2629419293703,0.16262068928294648,0.6993807235852145,0.536760034302268,4073200,4065320,85.51573362435562,78.60332014990226,NaN,NaN,34.408768507137815,24.91872664665917
2001-05-21T09:30:00-04:00,24.35001,24.59,24.10001,24.59,188600,85120,73.88890704529095,65.74264773536412,NaN,NaN,167.31407315427367,199.81484234825797,0.17023303838255166,0.7495513322804577,0.579318293897906,4261800,4131260,87.22335933361441,79.04989046038712,NaN,NaN,36.63865030559579,26.59300145507869
2001-05-22T09:30:00-04:00,24.45,24.45,23.96001,24.12,490200,108435,65.96908184083858,66.04643153266049,NaN,NaN,119.18927564213082,197.6169752597248,0.1308045778560567,0.7428240162179769,0.6120194383619202,3771600,4086480,80.29978449323254,78.93682490689618,NaN,NaN,35.96921631825756,27.9324607212471
2001-05-23T09:30:00-04:00,23.86,23.99001,23.62,23.71001,66100,110175,59.93416989163623,65.969082044699,NaN,NaN,70.17180038707127,162.90924715034072,0.0674903221548071,0.6963823410554291,0.628892018900622,3705500,4005060,69.4978692826731,78.18488150122856,NaN,NaN,33.39677985755068,28.71307774071904
2001-05-24T09:30:00-04:00,23.60001,23.62,22.94,23.06,406200,121480,51.83750691595262,65.02430054879824,NaN,NaN,11.86723641439169,112.71173876972212,-0.022947389077114577,0.6002077825542287,0.6231551716313433,3299300,3822280,52.44276960026767,76.44406637343468,NaN,NaN,28.311382690573332,28.655692733555366
2001-05-25T09:30:00-04:00,23.02,23.25999,23,23.09,35400,119670,52.15873986004701,64.44450682188537,NaN,NaN,-0.49650939626382273,73.60917524032075,-0.0821957111888656,0.5204105326452613,0.6026062438341269,3334700,3674580,43.214001020765174,74.23546071628309,NaN,NaN,24.490605836827516,28.060680319737102
2001-05-29T09:30:00-04:00,23.3,23.42,23.17,23.39999,65700,116780,55.46419691566729,64.05170598062203,NaN,NaN,16.412279706113683,43.42881655068875,-0.10073358514607023,0.4766892624015391,0.5774228475476093,3400400,3502300,35.39075459956334,71.58341308368158,NaN,NaN,22.343494237072278,27.243939450784985
2001-05-30T09:30:00-04:00,23.3,23.3,22.8,22.92,37300,117945,49.73421365541666,63.071242273638816,NaN,NaN,-23.243170930313752,14.942327236199821,-0.14296823875305054,0.39871254910629617,0.5416807878593467,3363100,3420600,32.395592469094865,68.74059740095962,NaN,NaN,18.613915143714923,26.01107883548926
2001-05-31T09:30:00-04:00,23.03999,23.33,22.95,22.95,34100,109615,50.08133183740114,61.774529753657816,NaN,NaN,-20.62813936311464,-3.2176607138373496,-0.16496934052407375,0.33546911220425457,0.5004384527283283,3397200,3358940,30.31065972678455,65.59780855616917,NaN,NaN,15.778619735677186,24.549298964087537
2001-06-01T09:30:00-04:00,23.16,23.25999,22.7,23.14,363200,126470,52.32674723399785,61.217389064114975,NaN,NaN,-32.106728761762525,-12.012453749068193,-0.16254828517567982,0.29725309625872853,0.45980138143440835,3760400,3451160,36.85616747753324,62.819798348688984,NaN,NaN,14.08630457297205,23.05458547964247
2001-06-04T09:30:00-04:00,23.25,23.39999,23.23,23.39999,24300,126380,55.29036735314281,60.75055965739604,NaN,NaN,0.76064424707613,-11.761023020400202,-0.14010973188995463,0.28466421657196506,0.4247739484619197,3784700,3541160,42.52933116704722,60.269281062981555,NaN,NaN,13.525892772508849,21.693343664337668
2001-06-05T09:30:00-04:00,23.42,23.67,22.98,23.67,43400,123270,58.19683067552027,60.36455369209394,NaN,NaN,8.027838973121211,-13.437911166998697,-0.10534207332996243,0.29309635679946666,0.3984384301294291,3828100,3626700,47.36932426740998,57.90292865375162,NaN,NaN,13.911719927113852,20.581683130448553
2001-06-06T09:30:00-04:00,23.56,23.8,23.25,23.25,33000,122355,52.481704750895766,58.89135399877381,NaN,NaN,1.0169433748176653,-8.585888305972414,-0.10846407886826737,0.2628583315440949,0.37132241041236225,3795100,3713100,51.78604955948346,55.67681890519028,NaN,NaN,12.507517836426988,19.42823094558833
2001-06-07T09:30:00-04:00,23.24001,23.66,23.24001,23.52,25100,121415,55.506670963600065,57.527901376377564,NaN,NaN,1.3044129117359395,-4.199377851002297,-0.09088953151946644,0.2577104960130292,0.34860002753249564,3820200,3797700,55.70572695653106,53.60979454131119,NaN,NaN,12.24015624042089,18.40136313056441
2001-06-08T09:30:00-04:00,23.52,23.52,23.17999,23.42999,14600,114045,54.266439666296925,56.22406490040744,NaN,NaN,-15.685309600639503,-0.9150940187776925,-0.08403191411607408,0.24356013488740302,0.3275920490034771,3805600,3806740,56.11627486543756,51.50983320138847,NaN,NaN,11.66062424914074,17.43840043321817
2001-06-11T09:30:00-04:00,23.39,23.39,22.89999,23.10001,87100,117255,49.86741961432706,54.50824436962431,NaN,NaN,-58.255009228211534,-12.718224713835225,-0.09937374747313699,0.2033748646620559,0.3027486121351929,3718500,3793500,55.3077259365637,49.23014510159913,NaN,NaN,9.852719282010465,16.354731697331356
2001-06-12T09:30:00-04:00,23.07001,23.07001,22.67999,22.89999,25300,118035,47.361207269285764,53.17911047165625,NaN,NaN,-99.16456611294414,-34.15670573104829,-0.11930528577479105,0.15361700491670405,0.2729222906914951,3693200,3766520,53.61252048205228,47.32391195794339,NaN,NaN,7.592517244480884,15.102986775495575
2001-06-13T09:30:00-04:00,23,23.14,22.94,22.98,17200,115725,48.47668347307357,52.36071858461606,NaN,NaN,-77.49833394559603,-49.859761195131036,-0.12292593676715588,0.11926486973255024,0.24219080649970612,3710400,3749580,52.5239659405836,46.111490290651275,NaN,NaN,6.036321061924216,13.807748816413952
2001-06-14T09:30:00-04:00,22.81,22.81,22.38,22.39999,24700,111105,41.59531651931564,51.62913355628485,NaN,NaN,-145.66466172410063,-79.25357612229836,-0.15797420047827807,0.044723055901858544,0.2026972563801366,3685700,3722680,50.76141669303868,45.99139365442063,NaN,NaN,2.4858223388436196,12.190330748189618
2001-06-15T09:30:00-04:00,22.11,22.34,22.06,22.23,34600,107805,39.81160711123337,50.74719550279816,NaN,NaN,-186.46969866028493,-113.41045393422743,-0.18435682141293006,-0.027748770386025967,0.1566080510269041,3651100,3691780,48.738192313591256,46.38597874676535,NaN,NaN,-0.999020973727471,10.306137645058605
2001-06-18T09:30:00-04:00,22.10001,22.31,22.00999,22.00999,110900,106350,37.5662703845411,49.46877217914629,NaN,NaN,-185.64412299078666,-138.88827668674247,-0.20669693780869253,-0.10176312123396158,0.10493381657473094,3540200,3656120,46.437862645511636,47.17505789290452,NaN,NaN,-4.617854740631346,8.174138732817184
2001-06-19T09:30:00-04:00,22.21001,22.27,21.98,22.06,102500,102045,38.41649812076228,48.66036392667098,NaN,NaN,-171.75014432244006,-153.40539232864165,-0.2076290351432409,-0.1546024773543202,0.05302655778892071,3642700,3646020,45.7788252989251,48.13100309503524,NaN,NaN,-7.345028995441528,5.957114771637368
2001-06-20T09:30:00-04:00,22.06,22.44,22.06,22.25999,91200,82095,41.82815196016059,48.07085107829665,NaN,NaN,-127.49754787032498,-163.40523511358742,-0.18504953700047427,-0.17828536346167212,0.00676417353880214,3733900,3650720,46.161729447327936,49.26322236078834,NaN,NaN,-8.731491606883798,3.85874243184863
2001-06-21T09:30:00-04:00,22.07001,22.28,22,22.14999,42600,80920,40.49917976688668,47.22602483064585,NaN,NaN,-123.50846889611331,-158.97399654798997,-0.16827815319166223,-0.20358351795077567,-0.03530536475911343,3691300,3651840,46.259123120577634,49.93486204957723,NaN,NaN,-10.266685789372428,1.8408241145313364
2001-06-22T09:30:00-04:00,22.11,22.22,21.78999,21.8,227100,71965,36.52303894479197,45.88550137290651,NaN,NaN,-130.70257254261728,-147.82057132445644,-0.17095842776746034,-0.24900339946843886,-0.07804497170097852,3464200,3614460,43.434988994552555,49.99955189439903,NaN,NaN,-12.78600099906393,-0.24872233026798707
2001-06-25T09:30:00-04:00,21.8,21.86,21.50999,21.55,62400,73315,33.958369401370646,44.154182710467246,NaN,NaN,-143.61116554761242,-139.41397983582158,-0.17891934351193944,-0.3016941510909028,-0.12277480757896338,3401800,3586780,41.41850927482663,49.57449368064308,NaN,NaN,-15.714690998606557,-2.4581464257449253
2001-06-26T09:30:00-04:00,21.50999,21.94,21.32001,21.75,58900,72975,37.72581697144062,43.100190726220454,NaN,NaN,-121.08919970123524,-129.28179091158063,-0.16064699638633617,-0.3235835530618836,-0.1629365566755474,3460700,3550380,38.8633699791028,48.651445139187324,NaN,NaN,-17.130749701063746,-4.5542326079333275
2001-06-27T09:30:00-04:00,21.85001,22.11,21.7,21.95,23300,72275,41.33018267682863,42.087584420022495,NaN,NaN,-81.6797372634735,-120.11822879021031,-0.12652386794615272,-0.3210913916082383,-0.19456752366208557,3484000,3500400,35.61453983489274,47.21636034478458,NaN,NaN,-17.300739391272764,-6.375162148410389
2001-06-28T09:30:00-04:00,22.08,22.16,21.97,21.97,11800,71160,41.69361338591216,41.18952539999501,NaN,NaN,-62.496839100747934,-107.91590283113723,-0.09545337363627326,-0.31388424070742715,-0.2184308670711539,3495800,3461300,33.27127597410791,45.58457470968961,NaN,NaN,-17.33977570412108,-7.9415355135119166
2001-06-29T09:30:00-04:00,22,22.22,22,22.06,72900,56645,43.392931729785886,40.72706197967064,NaN,NaN,-50.99168964460863,-91.97372625153551,-0.06324018389921254,-0.29748109694516955,-0.234240913045957,3568700,3482200,35.70637151682931,44.18447796542288,NaN,NaN,-16.912028142205774,-9.223034460468181
2001-07-02T09:30:00-04:00,21.96001,22.39999,21.96001,22.28999,25500,56705,47.59606933184031,40.743837841281675,NaN,NaN,-32.37357878422468,-69.72620889885796,-0.02292147151275531,-0.26289275243690113,-0.23997128092414582,3594200,3520680,40.04453040979028,43.21533581740415,NaN,NaN,-15.36392609339225,-10.100304693743048
2001-07-03T09:30:00-04:00,22.16,22.22,21.91,22.22,103700,59720,46.465377795224455,40.600173150006746,NaN,NaN,-40.18318094156177,-53.545005146923266,0.0012722717915529258,-0.23838094118470465,-0.23965321297625758,3490500,3526640,40.711800502120475,42.37160971465679,NaN,NaN,-14.353684964867833,-10.707930446760875
2001-07-05T09:30:00-04:00,22.10001,22.23,21.96001,22.13,139700,65055,44.9854638744601,40.84232653251706,NaN,NaN,-37.26478208085632,-44.662014110399824,0.012811029647698952,-0.22363942591663388,-0.23645045556433283,3350800,3500000,38.64165345055311,41.505912340193525,NaN,NaN,-13.873186352365337,-11.160109861847227
2001-07-06T09:30:00-04:00,22.03999,22.17999,21.83,21.87,44500,66025,40.929798531415244,40.92219734824433,NaN,NaN,-58.27936075089328,-43.81851844042889,0.004934805262060388,-0.23028194898675736,-0.23521675424881774,3306300,3462100,35.84881769118776,40.585242724307555,NaN,NaN,-14.542785175442688,-11.643349192360864
2001-07-09T09:30:00-04:00,21.95,22.13,21.8,22.07001,50300,67810,45.035041431385345,41.4556809944475,NaN,NaN,-48.24645416731415,-43.26947134497,0.014648046948480181,-0.2169066955632175,-0.2315547425116977,3356600,3419680,32.97602591709577,39.62368295799214,NaN,NaN,-13.980886315275983,-11.977283067063023
2001-07-10T09:30:00-04:00,22.22,22.22,21.83,21.83,92700,68090,41.32369210237923,41.66333770742013,NaN,NaN,-55.125725865874955,-47.81990076130005,0.006762406729669268,-0.2231017340996111,-0.22986414082928036,3263900,3353620,29.069272004645583,38.43014343697217,NaN,NaN,-14.538209523419866,-12.34312970368543
2001-07-11T09:30:00-04:00,21.99001,22.13,21.77,21.89999,59300,69790,42.803954178466,41.73303786587053,NaN,NaN,-59.873563500784535,-51.757977273144604,0.008027569460979989,-0.2198296790030554,-0.22785724846403538,3323200,3320160,27.30474650226533,37.08321608375341,NaN,NaN,-14.591661954027883,-12.664348596591495
2001-07-12T09:30:00-04:00,21.87,22.37,21.87,22.37,36200,70740,51.62899516801995,42.52802468023719,NaN,NaN,66.8348409684057,-30.938052663292247,0.04047200170568463,-0.17726724633192958,-0.2177392480376142,3359400,3321880,27.548207899295832,35.746722139376146,NaN,NaN,-11.92813006398716,-12.559174520505161
2001-07-13T09:30:00-04:00,22.45,22.45,22.22,22.39,15200,70265,51.968607525175926,43.63127957883604,NaN,NaN,147.4064400865599,10.199107504198395,0.06194737451528798,-0.14030502989350424,-0.20225240440879222,3374600,3335540,29.565715129281358,34.756059720428205,NaN,NaN,-9.676891696685827,-12.147419831388113
2001-07-16T09:30:00-04:00,22.17999,22.28999,21.95,22.03,64700,71770,45.74301932014652,44.47304028732003,NaN,NaN,24.044893766392924,24.65737709093981,0.05102987600001532,-0.13846505940877307,-0.1894949354087884,3309900,3326200,28.971668769339416,33.866999684321975,NaN,NaN,-9.527742190759822,-11.773180168441215
2001-07-17T09:30:00-04:00,21.98,22.03999,21.77,21.94,11200,66785,44.31378687348106,44.9436095660372,NaN,NaN,-56.956647194446624,24.291192825225473,0.03749592842607677,-0.14262502487619244,-0.1801209533022692,3298700,3333160,30.098772276983198,33.240956991313425,NaN,NaN,-9.82686369676036,-11.495134958201092
2001-07-18T09:30:00-04:00,21.96001,22.5,21.85001,22.48,100100,66665,53.66778066126268,45.82486656492535,NaN,NaN,108.90353498627341,58.04661252263706,0.06315118056642285,-0.10118197759424064,-0.1643331581606635,3398800,3348280,32.600922484351585,33.025698609131915,NaN,NaN,-7.047080409458577,-10.859698594095018
2001-07-19T09:30:00-04:00,22.67999,22.78,22.45,22.53,18600,63035,54.43105263565483,46.734683654192686,NaN,NaN,219.20534879720088,88.5207140883961,0.08060998357089005,-0.06357067869705091,-0.14418066226794096,3417400,3359880,34.536968036170734,33.11610518499354,NaN,NaN,-4.597034523009842,-9.965032298225708
2001-07-20T09:30:00-04:00,22.63,22.63,22.25,22.38,43500,63080,51.68044649671383,47.326648994687545,NaN,NaN,132.9514641974589,85.6297189105759,0.07906893252398288,-0.04534449661296236,-0.12441342913694524,3373900,3359740,34.52407846574681,33.031655681344795,NaN,NaN,-3.381380430766802,-9.024510602874436
2001-07-23T09:30:00-04:00,22.03999,22.08,21.94,21.94,4100,51930,44.566136830197394,47.110225244570195,NaN,NaN,-33.881702713712684,74.04439961455478,0.047012588890014265,-0.06564769302442741,-0.11266028191444168,3369800,3371720,36.70110551880619,32.79283961770308,NaN,NaN,-4.57639976763938,-8.389066197840856
2001-07-24T09:30:00-04:00,21.8,21.8,21.13,21.28,180000,57810,36.458699148439926,46.39546248408558,NaN,NaN,-238.76783928033973,37.68216119737616,-0.0166367396938102,-0.13345620653170442,-0.11681946683789422,3189800,3349940,34.45795970305994,32.34613670348447,NaN,NaN,-8.58533757718189,-8.417104966318147
2001-07-25T09:30:00-04:00,21.05,21.8,21.03,21.73,76300,58680,43.94620100722576,46.32122942214027,NaN,NaN,-186.1904504953028,-21.336635898939086,-0.025875810873848964,-0.14916423043020544,-0.12328841955635647,3266100,3323400,31.899437932217126,31.86454988074618,NaN,NaN,-9.241737155938717,-8.534909564835372
2001-07-26T09:30:00-04:00,21.69,21.7,21.45,21.61,9500,57990,42.50772661185661,46.43393857074323,NaN,NaN,-144.59533825139656,-94.09677330865857,-0.03684435160590163,-0.1693438590637335,-0.13249950745783187,3256600,3291240,29.08159024848956,31.38117649198202,NaN,NaN,-10.2421467888204,-8.778800596833234
2001-07-27T09:30:00-04:00,21.72,21.86,21.60001,21.67,25300,58665,43.5034921454433,46.324542193175944,NaN,NaN,-92.71805890189079,-139.2306779285285,-0.03675074610059534,-0.17843794008357605,-0.1416871939829807,3281900,3272840,27.580446630583353,30.995777971516848,NaN,NaN,-10.70579294234857,-9.05408521762114
2001-07-30T09:30:00-04:00,21.60001,21.7,21.49001,21.52,32900,56665,41.56527275236129,46.34179795388894,NaN,NaN,-117.71372810818717,-155.9970830074234,-0.04304645561579806,-0.19549526350272828,-0.15244880788693022,3249000,3248680,25.70427227181989,30.755420847743583,NaN,NaN,-11.687928961766517,-9.430348609641907
2001-07-31T09:30:00-04:00,21.64999,22.14,21.64999,22,23900,56585,49.34300362348447,46.808872914247395,NaN,NaN,-14.767938538767288,-111.19710285910892,-0.012713592723420819,-0.16834079879120623,-0.1556272060677854,3272900,3265300,29.26879768093903,30.895710217648848,NaN,NaN,-10.008176481626007,-9.512895448496778
2001-08-01T09:30:00-04:00,22.10001,22.10001,21.73,21.89999,107200,56760,47.91208852593215,46.543379582669694,NaN,NaN,-17.86274017354754,-77.53156079475787,0.002001344603790367,-0.15312552531304746,-0.15512686991683783,3165700,3245220,27.549060655848564,30.895771128831182,NaN,NaN,-9.109564008508315,-9.455276671355568
2001-08-02T09:30:00-04:00,21.95,22.03999,21.67999,21.75,31700,51360,45.76841937158053,46.10050900027003,NaN,NaN,-39.315452490424995,-56.47558364256355,0.0029617191194912795,-0.15142472101747373,-0.154386440136965,3134000,3220700,25.573084442366465,30.61058322262298,NaN,NaN,-9.020650687397719,-9.393187245075875
2001-08-03T09:30:00-04:00,21.92,21.92,21.64999,21.7,11000,49685,45.04489917594157,46.05064327568396,NaN,NaN,-53.83026466474917,-48.698024795135225,0.0016250335642022107,-0.15235514818171225,-0.15398018174591446,3123000,3188920,23.245858169497325,30.201596751205688,NaN,NaN,-9.158633912468847,-9.359679626132014
2001-08-06T09:30:00-04:00,21.89999,21.92999,21.7,21.73,23400,48340,45.60056674808267,46.142556123869795,NaN,NaN,-41.748696596772014,-33.50501849285219,0.004020375848650837,-0.1489547119351009,-0.15297508778375174,3146400,3168400,21.862413633986776,29.613285419563088,NaN,NaN,-9.117623998533047,-9.325100250760732
2001-08-07T09:30:00-04:00,21.78,21.78,21.52,21.57001,38300,45620,43.097810696875364,45.3875582692707,NaN,NaN,-78.74330373591698,-46.30009153228214,-0.0035045681175260024,-0.15735579793065924,-0.15385122981313323,3108100,3135440,19.82182980199329,28.70049308510892,NaN,NaN,-9.776507182501787,-9.389586955295169
2001-08-08T09:30:00-04:00,21.62,21.8,21.33,21.38,85300,46920,40.27092536834474,44.376120607319976,NaN,NaN,-97.58806282502542,-62.24515606257771,-0.018760703968793396,-0.17730210977412497,-0.15854140580533158,3022800,3106860,18.232674241337094,27.535900671192234,NaN,NaN,-11.145631521352175,-9.640450464731884
2001-08-09T09:30:00-04:00,21.31,21.44,21.19,21.19,44800,47350,37.61408586116844,43.37138056192388,NaN,NaN,-137.2269577368498,-81.82745711186269,-0.03801945164878087,-0.20606572036630766,-0.1680462687175268,2978000,3075660,16.6621958772203,26.260051914868914,NaN,NaN,-13.09245025570616,-10.133593292013924
2001-08-10T09:30:00-04:00,21.25,21.73,21.12,21.73,6800,46930,48.09517239417579,43.62345453077948,NaN,NaN,-71.27893780610441,-85.31719174013372,-0.0121038348948318,-0.18317606233606654,-0.17107222744123474,2984800,3048020,15.39692447391657,24.7383246973768,NaN,NaN,-11.660884804759629,-10.351777793834739
2001-08-13T09:30:00-04:00,21.64999,21.8,21.45,21.8,17100,44550,49.28462828078073,44.53959232594668,NaN,NaN,-27.98981518504158,-82.56541545778764,0.010800943953448716,-0.15757104749942386,-0.16837199145287257,3001900,3019120,14.184100574555742,23.290191902483645,NaN,NaN,-10.142800314989685,-10.321923868285445
2001-08-14T09:30:00-04:00,21.62,21.84,21.62,21.7,10800,44530,47.60624495118805,44.801024036229705,NaN,NaN,-16.075597971372325,-70.0318743048787,0.0197442611914172,-0.14369166496360108,-0.16343592615501829,2991100,2995720,13.27247130604421,21.959694286328435,NaN,NaN,-9.370416289825584,-10.18599421421975
2001-08-15T09:30:00-04:00,21.7,21.95,21.7,21.82001,169500,48000,49.815039772363875,45.32297497626593,NaN,NaN,19.966936100431923,-46.52087451978724,0.0334635043541717,-0.12160654571230367,-0.15507005006647537,3160600,3023280,19.80959780360996,21.297409111694176,NaN,NaN,-8.085001384088299,-9.88585238134383
2001-08-16T09:30:00-04:00,21.60001,21.74001,21.57001,21.58,15200,47830,45.66847070806047,45.477616302167164,NaN,NaN,-29.82231399392425,-25.039945771202134,0.02640511454192568,-0.12206365688906828,-0.14846877143099396,3145400,3056760,27.00739642449915,21.25647695411673,NaN,NaN,-8.165217279553707,-9.640047366802383
2001-08-17T09:30:00-04:00,21.49001,21.78999,21.49001,21.71001,9900,46150,48.18452501212693,45.95042003500756,NaN,NaN,-3.8462867337620734,-11.553415556733668,0.030247348736551022,-0.11065958551030519,-0.1409069342468562,3155300,3090860,33.54966114575183,21.8168618736833,NaN,NaN,-7.507599771751193,-9.335411996080785
2001-08-20T09:30:00-04:00,21.67,21.73,21.53999,21.73,20900,46990,48.57882863334166,45.89583610714022,NaN,NaN,5.8932407399668065,-4.776804371731997,0.033630307413630434,-0.09886904997981816,-0.1324993573934486,3176200,3125720,39.51774504771995,22.54892954273908,NaN,NaN,-6.85813791308956,-8.98151569851061
2001-08-21T09:30:00-04:00,21.94,22.10001,21.73,21.83,53100,40645,50.60387984032556,46.08810691531118,NaN,NaN,111.89442076556963,20.817199375656394,0.04157746181877493,-0.08052753011997993,-0.12210499193875486,3229300,3173360,46.57895540382091,23.90820773902282,NaN,NaN,-5.75068141325253,-8.519967943473741
2001-08-22T09:30:00-04:00,21.83,21.98,21.56,21.78,39400,38800,49.55308145221048,46.358439921070456,NaN,NaN,45.12553958203338,25.848920071976686,0.042301349698749005,-0.06922830481531861,-0.11152965451406761,3189900,3179220,47.39255169214191,25.466741114006776,NaN,NaN,-5.090696945411486,-8.030072086607705
2001-08-23T09:30:00-04:00,21.78,21.98,21.7,21.95,10400,38845,53.11766208647142,46.93506584325116,NaN,NaN,92.69173787525075,50.35173044581169,0.0524033593670728,-0.046025455305226615,-0.09842881467229941,3200300,3190200,48.961062848586536,27.303541448227435,NaN,NaN,-3.5385389321048093,-7.388424493107291
2001-08-24T09:30:00-04:00,22,22.42999,21.92999,22.25,110700,43115,58.66797535808262,47.86845217253687,NaN,NaN,216.18863577440342,94.35871494744478,0.07603068848852375,-0.003390454061644732,-0.07942114255016848,3311000,3221340,53.22090172249967,29.543433454549785,NaN,NaN,-0.4994251973926233,-6.404281736576624
2001-08-27T09:30:00-04:00,22.47,22.5,22.28999,22.28999,10700,42005,59.35867765216166,49.029942669343036,NaN,NaN,236.07163183672648,140.39439316679673,0.09013032209163147,0.03324176006437085,-0.056888562027260614,3321700,3250440,56.845629535006324,32.18799057833643,NaN,NaN,2.214038949413286,-5.173093067149494
2001-08-28T09:30:00-04:00,22.2,22.25,21.95,22.08,29600,42290,54.2335558441204,50.027273417612726,NaN,NaN,119.62659680230372,141.94082837414354,0.08136048979728767,0.044812050219348976,-0.0365484395779387,3292100,3263000,58.34587693814842,35.05321934239438,NaN,NaN,3.1704367472302915,-3.9811602365238103
2001-08-29T09:30:00-04:00,22.33,22.33,21.8,21.8,19700,37915,48.25120059194985,50.78706732695425,NaN,NaN,72.4171518059395,147.39915081892477,0.0540629367762708,0.0310302313923998,-0.023032705383870998,3272400,3279500,60.29852394478777,38.17009991864921,NaN,NaN,2.2344813697786736,-3.0932114356234557
2001-08-30T09:30:00-04:00,21.8,21.82001,21.69,21.72,18200,37240,46.667280556871304,50.68507505286107,NaN,NaN,-13.17973426887462,126.22485639009969,0.029223862576615973,0.013497122836898967,-0.015726739739717006,3254200,3290280,61.566172542547314,41.467903352122825,NaN,NaN,0.9930681963750339,-2.5094572024808146
2001-08-31T09:30:00-04:00,21.57001,21.92999,21.57001,21.91,35500,38465,50.79826748944799,50.79319213919445,NaN,NaN,8.415139221870174,84.67015707959304,0.024391982724288802,0.014763238665643996,-0.009628744058644806,3289700,3286020,60.740803302421135,44.79338211839893,NaN,NaN,1.125262560460718,-1.9902115220605956
2001-09-04T09:30:00-04:00,21.64999,22.31,21.64999,21.91,31400,38865,50.79826748944797,51.02119374907017,NaN,NaN,59.46370258784601,49.34857122981693,0.020172569423288888,0.015586967720466305,-0.004585601702822583,3289700,3279620,59.45129976870929,48.09186986573214,NaN,NaN,1.2326010502229834,-1.5298097260200842
2001-09-05T09:30:00-04:00,22.2,22.2,21.83,22.19,26200,38260,56.55029227478955,51.50228321352915,NaN,NaN,89.70117331878657,43.363486533113516,0.034381195411439566,0.038390892561476875,0.00400969715003731,3315900,3284380,60.12926574777502,50.97184614745822,NaN,NaN,3.029002852597468,-0.8785507862175769
2001-09-06T09:30:00-04:00,22,22,21.64,21.64,21800,35085,45.33804879286782,51.478681648158236,NaN,NaN,-23.566741254190553,24.166707921087514,0.006348297095037379,0.011945068518834034,0.005596771423796655,3294100,3288720,60.77325802948079,53.38369340495691,NaN,NaN,0.9932887064290196,-0.6111451444109203
2001-09-07T09:30:00-04:00,21.25,21.60001,20.96001,20.96001,74800,36585,35.869084508708724,50.599007326485506,NaN,NaN,-230.05119663529544,-19.20758455219665,-0.05500136662209351,-0.06315493685382023,-0.008153570231726723,3219300,3281740,59.119368152453255,55.210101048292735,NaN,NaN,-4.526731089949888,-1.1705145652022013
2001-09-10T09:30:00-04:00,21,21,20.55,20.55,55700,39030,31.585528867240257,49.38520020033541,NaN,NaN,-316.69338001010016,-84.22928839859071,-0.1166624305741778,-0.15398160844944897,-0.03731917787527117,3163600,3256520,53.458474758969494,56.205867456239126,NaN,NaN,-10.710780065434221,-2.5334096366639187
2001-09-17T09:30:00-04:00,19.3,19.7,18.7,19.03,48700,40610,21.3881085238431,47.298359392015236,NaN,NaN,-422.3660815179927,-180.59524521975845,-0.24585737068156338,-0.3446408912272254,-0.09878352054566203,3114900,3221560,46.77260683309098,56.21969970118699,NaN,NaN,-21.75529576726642,-5.279393369607133
2001-09-18T09:30:00-04:00,19,19.3,18.89999,19,32300,41685,21.24233896041494,45.27616349974413,NaN,NaN,-272.8391954356581,-253.1033189706474,-0.31495994600161387,-0.4924834530476794,-0.1775235070460655,3082600,3174900,39.64578022736924,55.66635888227466,NaN,NaN,-29.24927217340559,-8.70366177014977
2001-09-19T09:30:00-04:00,19.02,19.03999,18.42,18.7,67200,36570,19.789822519714605,42.895603530690074,NaN,NaN,-219.9026251717985,-292.3704957541689,-0.35928823187464826,-0.6266337968893758,-0.26734556501472756,3015400,3119160,33.147951935445306,54.536850959907426,NaN,NaN,-35.468913245315534,-12.52726912374488
2001-09-20T09:30:00-04:00,18.64999,18.67,17.99001,17.99001,55600,38590,16.852804762237398,39.90880563098683,NaN,NaN,-195.72937002667294,-285.5061304324445,-0.4111104245171714,-0.7812335956611918,-0.3701231711440204,2959800,3067260,28.469185362023723,52.768871219873425,NaN,NaN,-41.80263278953511,-16.709463933143482
2001-09-21T09:30:00-04:00,17.05,17.77,17.05,17.64999,19200,39055,15.654567909810865,36.7870835065332,NaN,NaN,-185.34249017274658,-259.23595246497376,-0.4403654228720959,-0.9205799497341403,-0.48021452686204436,2940600,3022660,25.180038588910207,50.50704329515228,NaN,NaN,-47.10190333260573,-21.051240990209518
2001-09-24T09:30:00-04:00,18.05,18.60001,18,18.49001,31800,39600,29.07170480554076,34.98980843234895,NaN,NaN,-116.66122928410078,-198.09498201819537,-0.37763106780451317,-0.9522533616176858,-0.5746222938131726,2972400,2994160,23.32550796811286,48.005588368721156,NaN,NaN,-46.19033102856708,-24.64253956711774
2001-09-25T09:30:00-04:00,18.38,18.67999,18.2,18.53999,23900,38140,29.787361741126006,33.67096280014725,NaN,NaN,-96.24985900911908,-162.77711473288758,-0.3100860162299469,-0.9622298141006063,-0.6521437978706593,2996300,2976900,22.256419769059775,45.288295213312026,NaN,NaN,-45.265274817273124,-27.588644602854224
2001-09-26T09:30:00-04:00,18.53999,18.78,18.17,18.39,102400,41290,28.846702607045515,32.3980643751597,NaN,NaN,-85.14612260934963,-135.82581422039783,-0.2551214059786002,-0.9710455553439097,-0.7159241493653095,2893900,2952600,20.810279236701163,42.37715997718015,NaN,NaN,-44.8675467876234,-30.057059200678392
2001-09-27T09:30:00-04:00,18.42999,18.78,18.23,18.59,44200,42980,31.933349781568054,31.050570253168267,NaN,NaN,-72.50636971188719,-111.18121415744065,-0.18800629086956433,-0.9509320129522649,-0.7629257220827006,2938100,2948260,20.55341284798955,39.50663208757789,NaN,NaN,-43.53791152204639,-31.982895246588107
2001-09-28T09:30:00-04:00,18.67999,19.32001,18.67999,19.2,28000,38845,40.42240654717891,30.30943732872048,NaN,NaN,-45.30232905029905,-83.17318193295118,-0.09020001341471429,-0.8756757388510934,-0.7854757254363791,2966100,2953360,21.7753202511863,36.8154906934691,NaN,NaN,-39.48387554697927,-33.0544638609297
2001-10-01T09:30:00-04:00,19.2,19.25999,18.84,19.25999,27100,39665,41.199087819265365,29.212922724754463,NaN,NaN,-38.130325355262706,-67.46700114718357,-0.013179045869715522,-0.8019495327735235,-0.788770486903808,2993200,2957520,22.81808522987059,34.15040637076165,NaN,NaN,-36.07513292177338,-33.4859880124788
2001-10-02T09:30:00-04:00,19.27,19.42999,19.13,19.34,40700,40220,42.2798677853092,28.994481224214564,NaN,NaN,-25.871282560835503,-53.39128585752684,0.04808419305334488,-0.728665245587127,-0.7767494386404719,3033900,2965040,24.770359466476734,31.578770759118502,NaN,NaN,-33.01403790427965,-33.41856656845035
2001-10-03T09:30:00-04:00,19.17999,19.58,19.17999,19.58,12100,39840,45.51492826397202,29.683470063876232,NaN,NaN,-14.40937321578374,-39.24393597881367,0.10635986716884516,-0.6437996046794154,-0.7501594718482606,3046000,2995460,32.23728972438508,29.658622299970773,NaN,NaN,-29.466324806948474,-32.85396060252151
2001-10-04T09:30:00-04:00,19.61,19.69,19.24001,19.24001,45600,41210,41.929702923078004,30.42233963929321,NaN,NaN,-12.558135095943888,-27.25428905562501,0.1224520639193234,-0.5970943919491063,-0.7195464558684297,3000400,3007920,35.079639666338494,28.345848364782846,NaN,NaN,-27.471697558649133,-32.08506588196831
2001-10-05T09:30:00-04:00,19.48,19.58,19.22,19.58,28000,40835,46.47058067861137,32.21394479320523,NaN,NaN,-2.2901886189255305,-18.651860969350306,0.15437653676196794,-0.5265757849159698,-0.6809523216779377,3028400,3020380,37.885490143829685,27.711054315549895,NaN,NaN,-24.3757937145798,-30.983741286627097
2001-10-08T09:30:00-04:00,19.38,19.44,19.00999,19.17,14400,39985,42.18646405448112,33.70995372849568,NaN,NaN,-11.829133827377952,-13.39162266377335,0.14633637487687468,-0.4980318530818444,-0.6443682279587191,3014000,3024540,38.835962994872084,27.653210227514382,NaN,NaN,-23.005938473020333,-29.84405517039756
2001-10-09T09:30:00-04:00,19.02,19.42999,19.02,19.35001,29300,40140,44.601260497156396,35.48219929831294,NaN,NaN,4.882146530245499,-7.240936845557149,0.1509881623897289,-0.4556330249715579,-0.6066211873612868,3043300,3026420,39.28809961452407,28.09179220459143,NaN,NaN,-21.148454624361012,-28.60182652096377
2001-10-10T09:30:00-04:00,19.45,19.88,19.45,19.88,52500,41675,51.08003493791161,37.92700145371824,NaN,NaN,73.01101429867384,10.24314065733439,0.18534193693221734,-0.3749437661960151,-0.5602857031282324,3095800,3036380,41.74502915717332,29.040066761387834,NaN,NaN,-17.452752564537978,-27.009101670045798
2001-10-11T09:30:00-04:00,19.88,20.59,18.92,20.53,86500,42260,57.62533576242245,40.9249134431905,NaN,NaN,123.36452266937683,37.42767221039853,0.2437477859630029,-0.25560097067447884,-0.49934875663748174,3182300,3072760,49.744964849547536,30.794704351433356,NaN,NaN,-11.978269801863417,-24.86183997459117
2001-10-12T09:30:00-04:00,20.35001,20.47,20.10001,20.2,23800,40665,53.697251486827255,42.68388106328239,NaN,NaN,162.5346007619658,70.3926300865768,0.2510704171490238,-0.18551073520120198,-0.43658115235022577,3158500,3098780,54.55220286379094,33.02518255826751,NaN,NaN,-8.746104857074204,-22.559592100660176
2001-10-15T09:30:00-04:00,19.92999,20.24001,19.92999,20.21001,767500,76605,53.80012721650762,44.39907859723822,NaN,NaN,128.87971158595275,98.53439916924295,0.2471176162171223,-0.1276841320788229,-0.3748017482959452,3926000,3281180,73.60961676423152,36.69326805792264,NaN,NaN,-6.180906893857234,-20.219779928259754
2001-10-16T09:30:00-04:00,20.08,20.45,20.06,20.38,33900,76685,55.604072140749366,46.31031927821707,NaN,NaN,130.2160509647532,123.60118005614447,0.245951124055109,-0.06736284322705899,-0.313313967282168,3959900,3464500,81.84804330178477,41.05310834828574,NaN,NaN,-3.523395714908243,-17.834582183495254
2001-10-17T09:30:00-04:00,20.55,20.55,19.96001,19.99001,155500,81100,50.71184424273987,47.65164031115791,NaN,NaN,104.39608480033287,129.87819415647627,0.2102949979498262,-0.05044521984488526,-0.26074021779471146,3804400,3606220,85.5925299088455,45.69875956691832,NaN,NaN,-2.685197150953902,-15.670384321703633
2001-10-18T09:30:00-04:00,20.10001,20.10001,19.78,19.96001,43500,80495,50.344893328784266,48.360389366986865,NaN,NaN,73.88680300259857,119.98265022312064,0.1773850064726326,-0.03900895970392071,-0.21639396617655332,3760900,3721940,87.80472057232495,50.415145304142506,NaN,NaN,-2.113009960844538,-13.73361655586662
2001-10-19T09:30:00-04:00,19.74001,19.75999,19.55,19.71001,43000,81685,47.27493190604808,48.79437823032849,NaN,NaN,34.661161936789796,94.40796245808542,0.13347725276233527,-0.04954740022363424,-0.1830246529859695,3717900,3833820,89.48563829971002,55.177113380559604,NaN,NaN,-2.5037005776153,-12.12934284468786
2001-10-22T09:30:00-04:00,19.7,20.27,19.7,20.17,20300,81110,52.95885791029614,49.55716323925613,NaN,NaN,76.5039383427367,83.93280780944222,0.12998371322519137,-0.02054501145448029,-0.15052872467967165,3738200,3796260,85.23801645300715,59.49623173674035,NaN,NaN,-1.1642890735511604,-10.562906591668332
2001-10-23T09:30:00-04:00,20.2,20.53999,20.2,20.42999,40800,81955,55.855537356916166,50.29577817446643,NaN,NaN,112.63592149210945,80.41678191491347,0.1389443653547071,0.023151732013712234,-0.11579263334099488,3779000,3760080,81.2378453861775,62.996271426868375,NaN,NaN,0.8335636702038441,-8.934839411400878
2001-10-24T09:30:00-04:00,20.45,20.48,20.17999,20.37,32500,78460,55.01375318285331,51.230353193021806,NaN,NaN,98.41914076441459,79.22139310772982,0.13450427296911888,0.052337707870403705,-0.08216656509871516,3746500,3748500,79.94466415701818,66.20091603334551,NaN,NaN,2.228019548726064,-7.3401452742398865
2001-10-25T09:30:00-04:00,20.09,20.36,20,20.33,20600,77280,54.424777992532384,51.79851014401616,NaN,NaN,74.57377746039333,79.35878799928877,0.1228667631709824,0.07141688886501285,-0.05144987430596955,3725900,3741500,79.12471426241808,69.14657489895896,NaN,NaN,3.2199360445771243,-5.831562228694599
2001-10-26T09:30:00-04:00,20.45,20.69,20.38,20.67999,29100,77335,58.60110768088982,52.97098468875964,NaN,NaN,120.71253128919771,96.56906186977035,0.13193632157509386,0.11347052766289778,-0.018465793912196084,3755000,3748920,79.36629681159074,72.04159874301028,NaN,NaN,5.286141229800955,-4.243318877480949
2001-10-29T09:30:00-05:00,20.60001,20.60001,20.17999,20.17999,14700,76715,51.360218552635,53.45376740700811,NaN,NaN,71.92917667031062,95.65410953528513,0.0989641422943014,0.10523938395568067,0.006275241661379265,3740300,3749340,79.3808424944871,74.90536609157907,NaN,NaN,4.995649857305054,-2.9234662010829484
2001-10-30T09:30:00-05:00,19.89999,20.17,19.85001,20.03,8800,75120,49.38874459887996,53.332960954220134,NaN,NaN,13.724637500040593,75.87185273687138,0.0634807336524049,0.08562615872688539,0.02214542507448049,3731500,3739840,78.04074212970518,77.49791701818849,NaN,NaN,4.172510793799027,-1.9097552018140946
2001-10-31T09:30:00-05:00,20.10001,20.10001,19.72,19.72,15500,75290,45.5012353066264,52.466953778806136,NaN,NaN,-24.825895398076064,51.22284550437323,0.017927284191833412,0.044554530314272256,0.026627246122438844,3716000,3733740,77.14022201281988,79.45472110127936,NaN,NaN,2.293158989907496,-1.3093388887110105
2001-11-01T09:30:00-05:00,19.92,20.28,19.66,20.14999,17900,73905,51.234919204299935,52.29107290148276,NaN,NaN,7.5284051204841465,37.813771036391394,0.015633688470900953,0.046169356711065035,0.03053566824016408,3733900,3735340,77.21449067487767,81.07345594492843,NaN,NaN,2.381598393794874,-0.7820621340673127
2001-11-02T09:30:00-05:00,20.00999,20.57001,20.00999,20.46001,22200,73615,54.91764765214993,52.37089578974292,NaN,NaN,76.81236613937016,29.033738006425885,0.03288292760241943,0.07163932774318837,0.03875640014076894,3756100,3735560,77.22544714938094,81.33172954386767,NaN,NaN,3.5918906341985246,-0.15721173860076454
2001-11-05T09:30:00-05:00,20.71001,20.75999,20.42999,20.53999,59300,75860,55.84410579726526,52.38804105092262,NaN,NaN,128.40780548830767,40.3294637700253,0.04672144116538049,0.09715820159749455,0.050436760432114064,3815400,3750580,78.00313413868493,81.05709317507481,NaN,NaN,4.848359934361116,0.5578699289652184
2001-11-06T09:30:00-05:00,20.58,20.97,20.45,20.97,143100,81550,60.539418823585486,53.09001066384017,NaN,NaN,179.1345698859897,73.41145024721511,0.07992834952157682,0.15034719733408508,0.07041884781250826,3958500,3795980,80.20358706448356,80.67216868619182,NaN,NaN,7.404112991607064,1.5359046521997675
2001-11-07T09:30:00-05:00,20.88,21.14,20.8,20.96001,242200,91035,60.37878689770216,53.8067173473343,NaN,NaN,200.28135966639894,118.43290126011011,0.09527228654199293,0.18950920598999943,0.0942369194480065,3716300,3796040,80.20640516210177,80.12943187117587,NaN,NaN,9.408474349413696,2.6605574660874716
2001-11-08T09:30:00-05:00,21.14999,21.2,20.82001,20.98,82500,90835,60.60404335990069,54.7587967368952,NaN,NaN,177.18531725563813,152.36428368714093,0.10031181340776359,0.21962668620771097,0.11931487279994739,3798800,3809020,80.84178396251974,79.51201370423371,NaN,NaN,11.113910909726865,3.868179386607385
2001-11-09T09:30:00-05:00,20.82001,21.05,20.75,21.03999,9200,90105,61.31483883143968,55.35565251697688,NaN,NaN,138.4427826211054,164.69036698348796,0.10095263093142798,0.24550566146423236,0.14455303053280438,3808000,3819400,81.3571637400358,79.23480993902147,NaN,NaN,12.737042179452724,5.13515978558529
2001-11-12T09:30:00-05:00,20.89999,20.89999,20.58,20.75,46700,54065,56.05030606254078,55.36956456737864,NaN,NaN,81.80820818372231,155.37044752257088,0.0762378324937178,0.23985032114995164,0.16361248865623385,3761300,3808580,78.97231005215895,79.07298598659158,NaN,NaN,12.74181419287449,6.221824700912318
2001-11-13T09:30:00-05:00,20.95,21.39,20.95,21.31,76000,56170,62.70898578054732,55.9192240386425,NaN,NaN,151.38497821606862,149.82052918858668,0.09099683039149259,0.27735852664559957,0.18636169625410698,3837300,3784340,73.75611288949004,78.63094661033958,NaN,NaN,14.749378706607153,7.440046701725866
2001-11-14T09:30:00-05:00,21.60001,21.78,21.55,21.66,55800,51185,66.15985994676609,56.75744417823062,NaN,NaN,190.07365289437635,147.77898783418217,0.11611443845500813,0.33150474432286714,0.215390305867859,3893100,3819700,76.22326382586978,78.42370015058611,NaN,NaN,17.564275335340245,8.88636507795649
2001-11-15T09:30:00-05:00,21.75,22,21.7,21.75,92200,53620,67.00538625525465,57.35774979068525,NaN,NaN,182.16561811250833,148.77504800555622,0.1295506752858481,0.37732864997516913,0.24777797468932103,3985300,3857000,78.51747859310511,78.36307027783714,NaN,NaN,20.11072394271542,10.489844915779194
2001-11-16T09:30:00-05:00,22,22,21.69,21.86,88500,55895,68.05594391169392,58.5503016020466,NaN,NaN,160.87646695947603,153.26178487323034,0.13594198627877985,0.41770545753779587,0.281763471259016,4073800,3910160,81.28856323884973,78.4993360452916,NaN,NaN,22.530036023958363,12.209872216947646
2001-11-19T09:30:00-05:00,21.98,22.22,21.94,22.09,39800,56870,70.19299552234597,60.03631952515131,NaN,NaN,164.60094755417194,169.82033274732026,0.14493091152916937,0.46292711067047776,0.3179961991413084,4113600,3980620,84.19805671325759,78.93914422983107,NaN,NaN,25.240081271116576,14.071330653257494
2001-11-20T09:30:00-05:00,21.81,22.07001,21.81,22,29900,56325,68.26838034124317,61.66254417048109,NaN,NaN,127.81483839717416,165.10630478354136,0.13432477747132648,0.4859021709804665,0.35157739350914,4083700,4029900,85.8547210093114,79.56160844386618,NaN,NaN,26.959352040739454,15.912476565754917
2001-11-21T09:30:00-05:00,21.98,22.10001,21.85001,21.85001,22300,55815,65.06645110622789,62.65051073490451,NaN,NaN,110.15707084812765,149.12298837429162,0.10785825594019421,0.4864002134343828,0.37854195749418856,4061400,4063560,86.8674671685953,80.25110676484601,NaN,NaN,27.53503073559273,17.572841447160318
2001-11-23T09:30:00-05:00,21.78,22.27,21.78,22.27,38000,56685,69.39503068883181,63.684609523238926,NaN,NaN,112.70187093940936,135.2302389396718,0.1089671308401084,0.514750871044324,0.40578374020421565,4099400,4086380,87.51983940912388,80.98642049768479,NaN,NaN,29.33830223956925,19.253621560361594
2001-11-26T09:30:00-05:00,22.05,22.19,21.84,22,45300,57495,63.912303148502154,64.26090933404156,NaN,NaN,90.25824532648706,121.10659461307402,0.08301969295369677,0.5095583563963366,0.42653866344263985,4054100,4082440,86.71885186599714,81.60897176392139,NaN,NaN,29.24034193682895,20.68029589985693
2001-11-27T09:30:00-05:00,21.92999,22.28,21.91,22.17,64000,59960,65.74729045669983,64.6329001649783,NaN,NaN,90.78313468849038,106.3430320399377,0.069364643357186,0.5132444676391223,0.44387982428193634,4118100,4083340,86.74868570732232,82.07647880983845,NaN,NaN,29.69632042158881,21.968299402961485
2001-11-28T09:30:00-05:00,22.08,22.17,21.86,21.95,79200,63480,61.396427135323044,64.70558875337979,NaN,NaN,70.7141434647448,94.92289305345182,0.03908305991927502,0.49273364918103013,0.4536505892617551,4038900,4074380,84.70858702192074,82.39806322839694,NaN,NaN,28.78592910839618,22.94224650373787
2001-11-29T09:30:00-05:00,22,22.08,21.71001,21.94,34000,64405,61.19818401782943,64.74802737180326,NaN,NaN,56.201492864808976,84.13177745678809,0.013280329023283188,0.4702510005408591,0.4569706715175759,4004900,4063080,82.0866870567691,82.48698487798617,NaN,NaN,27.990434513684537,23.663416219444535
2001-11-30T09:30:00-05:00,21.99001,22.23,21.86,22.22,18800,64450,64.64088368272402,64.98560200403786,NaN,NaN,72.73853133847662,76.13910953660155,0.010114331872277615,0.46961358635792294,0.4594992544856453,4023700,4047940,78.57740343993343,82.288430570836,NaN,NaN,28.270336983542364,24.321547757172798
2001-12-03T09:30:00-05:00,21.8,22.02,21.67999,21.67999,87800,67730,54.58248503390935,64.88075764484991,NaN,NaN,29.637370956178607,64.01493466253986,-0.031051607426936745,0.4206847452019744,0.45173635262891115,3935900,4024300,73.30752521863228,81.88380308272694,NaN,NaN,25.325452033890343,24.464962653846733
2001-12-04T09:30:00-05:00,21.88,22.10001,21.8,22.10001,70100,68270,59.819563292351376,64.67437032426447,NaN,NaN,55.005314773546566,56.859370679551105,-0.0325395430325911,0.4110619238381723,0.4436014668707634,4006000,4001880,68.60803544416409,81.51608326520366,NaN,NaN,24.45192164680203,24.46309965284035
2001-12-05T09:30:00-05:00,22.27,22.86,22.27,22.60001,103400,66285,64.99430956820663,64.59111672579594,NaN,NaN,143.0282033628668,71.3221826591755,-0.00390177361786348,0.43872424984843406,0.44262602346629754,4109400,4015980,69.91429802837652,81.065442851097,NaN,NaN,25.454686407955375,24.604754903571067
2001-12-06T09:30:00-05:00,22.64999,23,22.53,22.64999,32100,55780,65.47298851639803,64.48165974444905,NaN,NaN,165.85044761371643,93.251973608957,0.013406632737455848,0.45938431438811733,0.4459776816506615,4141500,4043300,72.31787321105777,80.62261389523648,NaN,NaN,26.38949720756476,24.85971808985588
2001-12-07T09:30:00-05:00,22.47,22.57001,22.12,22.17,21800,52745,57.360743271952586,63.717716841610375,NaN,NaN,81.86416158493283,95.07709965824822,-0.011145325169898412,0.4320460251882885,0.4431913503581869,4119700,4062500,73.89623284722263,80.09459029583455,NaN,NaN,24.489683924650908,24.80685606625517
2001-12-10T09:30:00-05:00,22,22.17,21.73,21.78999,33100,53940,51.88014913518872,62.40965638538486,NaN,NaN,-10.849676612741373,86.97969014446423,-0.05424160174436521,0.3753893481777304,0.4296309499220956,4086600,4092640,76.19117227733236,79.52266997898275,NaN,NaN,21.027404883798635,24.266934468761377
2001-12-11T09:30:00-05:00,21.67999,22.14,21.64,21.96001,16600,52435,53.9979248536663,61.39033813627223,NaN,NaN,-27.786114753585228,70.42140423903787,-0.0714766627530164,0.3402851214808251,0.4117617842338415,4103200,4112080,77.56142599929234,78.93029176398139,NaN,NaN,18.927745196416588,23.504193144140693
2001-12-12T09:30:00-05:00,21.84,21.89,21.47,21.78999,38600,50565,51.554457201849864,60.42519571453094,NaN,NaN,-110.85142597896002,19.645478370672514,-0.09313657311426116,0.2953410678410151,0.38847764095527626,4064600,4103120,75.40729180818491,78.11170780966636,NaN,NaN,16.44340490783806,22.495509110383175
2001-12-13T09:30:00-05:00,21.5,21.62,21.19,21.27,1424300,118990,44.867332296451366,58.67321725793233,NaN,NaN,-221.40645034139627,-57.805901220350016,-0.13855643575024024,0.21528209626747596,0.3538385320177162,2640300,3802880,37.6614449964375,74.55039392304592,NaN,NaN,12.013041844272378,20.99801378665306
2001-12-14T09:30:00-05:00,21.27,21.49001,21.2,21.2,66500,117705,44.03919878857056,57.25370980365151,NaN,NaN,-208.73247017009817,-115.9252275713562,-0.16745448322764211,0.14452042798316356,0.31197491121080567,2573800,3493700,24.217779959655687,70.08603164402153,NaN,NaN,8.243172935491389,19.17589366505854
2001-12-17T09:30:00-05:00,21.37,21.67999,21.36,21.56,49300,115745,49.229262892892756,56.073850691951,NaN,NaN,-122.91776307924432,-138.3388448646568,-0.15665883556244042,0.11615136675775517,0.2728102023201956,2623100,3201000,17.755894312185475,65.15797511579747,NaN,NaN,6.63854512476447,17.384843873587958
2001-12-18T09:30:00-05:00,21.67,22.24001,21.67,22.24001,47200,116115,57.287519199098085,55.780357267934924,NaN,NaN,24.512727559712253,-127.87907640199731,-0.10077052669272576,0.14684704395428838,0.24761757064701415,2670300,2914420,13.857276509399043,60.09716722204592,NaN,NaN,7.946267080052835,16.036475760225798
2001-12-19T09:30:00-05:00,21.78,21.91,21.62,21.84,61200,117680,52.05369201245209,55.12717926755084,NaN,NaN,-45.778847631434374,-114.86456073249217,-0.08824344573428825,0.13731326347915385,0.2255567092134421,2609100,2623320,11.17353982809638,55.031942419997854,NaN,NaN,7.244778288093366,14.780518978492594
2001-12-20T09:30:00-05:00,21.75,21.85001,21.63,21.63,2338600,233495,49.49703943576667,54.04547610705389,NaN,NaN,-63.503657649139015,-83.28400219404071,-0.09122391370327654,0.11152681708434642,0.20275073078762296,270500,2149360,8.341057042452235,50.015060534463494,NaN,NaN,5.838545807849016,13.503094239829226
2001-12-21T09:30:00-05:00,21.75,21.75999,21.22,21.42999,380600,250625,47.12309222522141,53.51266233500475,NaN,NaN,-111.11217129836328,-63.75994241969374,-0.1029225156393399,0.07409758623844809,0.177020101877788,-110100,1612580,6.371191874818479,45.23389386704822,NaN,NaN,3.937817059097922,12.136626071153325
2001-12-24T09:30:00-05:00,21.38,21.53999,21.25999,21.47,366000,266660,47.6638405822845,52.64439642714283,NaN,NaN,-107.11939582275758,-60.600268968396406,-0.1039201181013889,0.047119954251051865,0.15104007235244077,255900,1139140,5.203860055908322,40.705024196458524,NaN,NaN,2.5883834271092487,10.772591407718457
2001-12-26T09:30:00-05:00,21.48,21.55,21.31,21.31,16800,264300,45.65319089322934,51.26288795035873,NaN,NaN,-101.82020335798916,-85.86685515193668,-0.1106855614065525,0.012683120594250141,0.12336868200080264,239100,652900,4.3269988823529815,36.0202171145997,NaN,NaN,0.8724428030384257,9.358284464192739
2001-12-27T09:30:00-05:00,21.31,21.62,21.31,21.53,139900,267335,48.8483632767766,50.0754147189572,NaN,NaN,-72.64260633568274,-91.23960689278636,-0.09620853285856938,0.0031080159275909125,0.0993165487861603,379000,206880,3.70953319679775,31.119621399295422,NaN,NaN,0.3457738192185763,8.070782943482143
2001-12-28T09:30:00-05:00,21.75,21.77,21.56,21.69,158700,273570,51.10006326775149,49.6282232900857,NaN,NaN,-29.49863594818983,-84.4386025525965,-0.0727858253684309,0.008334267075621682,0.08112009244405258,537700,260320,5.450466898329324,26.230638117231617,NaN,NaN,0.5514783952476772,6.996596579448648
2001-12-31T09:30:00-05:00,21.7,21.92,21.42,21.42,1594000,352330,47.314958378599094,49.30213823604358,NaN,NaN,-44.06645189286459,-71.02945867149677,-0.07225969847729619,-0.009204530652567655,0.06305516782472853,-1056300,71080,5.098901036806836,21.152618742908366,NaN,NaN,-0.36670393551586317,5.944696505882289
2002-01-02T09:30:00-05:00,21.44,21.66,21.44,21.58,40700,349975,49.69303320470957,48.99464597540382,NaN,NaN,-46.12687244312646,-58.83095399557055,-0.05850599525509485,-0.010077326244140039,0.048428669010954814,-1015600,-183220,4.663579201759944,15.945629685941771,NaN,NaN,-0.4598410500265246,5.029762569323887
2002-01-03T09:30:00-05:00,21.61,22,21.47,21.98,138100,353375,55.14411064633574,49.25104979286709,NaN,NaN,12.14924248767015,-36.03706482643869,-0.021732908985170454,0.02126253277949175,0.042995441764662204,-877500,-406540,4.315163984355635,10.867620555668253,NaN,NaN,1.097513363251336,4.468012682742095
2002-01-04T09:30:00-05:00,22.25999,22.50999,22.14999,22.39999,232400,359825,60.04011796777619,50.334820197961726,NaN,NaN,142.23564747559018,6.938585935815894,0.028865823468002358,0.07907772109966515,0.0502118976316628,-645100,-611360,4.01862317493088,8.464561854132066,NaN,NaN,4.015536448869156,4.403373220760247
2002-01-07T09:30:00-05:00,22.57001,22.67,22.39999,22.39999,419400,379190,60.04011796777619,51.477742996476415,NaN,NaN,186.7464840694583,50.18760993934551,0.05860916225850267,0.12347335045479113,0.06486418819628846,-645100,-847920,3.7021782584206164,6.999161732615278,NaN,NaN,6.339741828477291,4.679997307576968
2002-01-08T09:30:00-05:00,22.44,22.44,22,22.02,258600,391030,53.8702717737164,51.80924363082096,NaN,NaN,107.81830668504462,80.56456165492736,0.049337893159142526,0.12653655464521663,0.0771986614860741,-903700,-817400,4.744350455407144,6.069765742845397,NaN,NaN,6.54366257660436,4.94623520315231
2002-01-09T09:30:00-05:00,22.25,22.28,21.89,21.89,207100,399730,51.905107920217574,51.42478568232949,NaN,NaN,70.02682799725501,103.79530174300365,0.03194036565844975,0.11712411855913629,0.08518375290068654,-1110800,-836440,4.7101036096246105,5.416396250004366,NaN,NaN,6.134341738099758,5.115964708144802
2002-01-10T09:30:00-05:00,21.89999,21.89999,21.28999,21.50999,39600,400880,46.55842712045045,51.03226676147223,NaN,NaN,-39.537176844932226,93.45801787648317,-0.005666388722033899,0.07810076699814417,0.08376715572017807,-1150400,-891020,4.607431155822667,4.947388487699096,NaN,NaN,4.138257025021607,4.976292181984346
2002-01-11T09:30:00-05:00,21.50999,21.53999,21.25,21.25,50200,401460,43.27408524766213,50.58777003375048,NaN,NaN,-86.54211693317515,47.70246499473011,-0.04629617592866002,0.02589693580935304,0.07219311173801306,-1200600,-1002120,4.397307232081047,4.665692072672584,NaN,NaN,1.4322112958673745,4.469994912539065
2002-01-14T09:30:00-05:00,21,21.11,20.55,20.55,47200,332605,35.92584807126323,49.78796687989632,NaN,NaN,-207.99430922999827,-31.245693665161202,-0.11466575286863762,-0.07113907934778396,0.043526673520853654,-1247800,-1122660,4.174843772304456,4.508810065350152,NaN,NaN,-3.57002010888338,3.3214213380501443
2002-01-15T09:30:00-05:00,20.60001,20.88,20.55,20.64999,20000,330280,37.55695544420935,49.066046512890956,NaN,NaN,-193.4120936984325,-91.49177374185663,-0.1455232070831062,-0.1383773353330291,0.007145871750077103,-1227800,-1187480,4.056011719066362,4.426820898432871,NaN,NaN,-7.0184759757753,1.844293150360795
2002-01-16T09:30:00-05:00,20.39999,20.5,20.06,20.16,122600,333945,33.10899411711797,48.17003245745443,NaN,NaN,-230.90101439774338,-151.6773422208563,-0.18857065923824418,-0.22856745229772812,-0.03999679305948395,-1350400,-1235400,3.966133761243256,4.401044818353605,NaN,NaN,-11.513498636713727,-0.06396281922127933
2002-01-17T09:30:00-05:00,20.02,20.25,19.69,20.25,153000,339235,34.640157713954764,47.155160631538585,NaN,NaN,-211.38955940661134,-186.04781873319212,-0.19955854985464563,-0.289444980377791,-0.08988643052314535,-1197400,-1244800,3.947654319863716,4.4180534700011735,NaN,NaN,-14.6103755114567,-2.1420217752549107
2002-01-18T09:30:00-05:00,20.00999,20.35001,20.00999,20.07001,95600,340955,33.01264374557519,45.86320209424027,NaN,NaN,-161.89979086292956,-201.119353519143,-0.20665142176521176,-0.34820070772966005,-0.1415492859644483,-1293000,-1263280,3.9090926139612066,4.307955306832024,NaN,NaN,-17.668105643784088,-4.360033756473364
2002-01-22T09:30:00-05:00,20.35001,20.44,20.14999,20.22,20500,225050,35.722836494569066,45.035193388238135,NaN,NaN,-121.20374888492826,-183.761241450129,-0.18940159824600736,-0.3783012837719575,-0.18889968552595013,-1272500,-1268220,3.8981307806779313,4.222186002822817,NaN,NaN,-19.39692850676839,-6.508161577944082
2002-01-23T09:30:00-05:00,20.24001,20.59,20.24001,20.55,110300,211535,41.345534291468596,44.43894346586377,NaN,NaN,-85.97909389734976,-162.27464148991245,-0.1458790068624323,-0.3712484441039905,-0.2253694372415582,-1162200,-1255100,4.662778317555478,4.222128796808212,NaN,NaN,-19.192244044184754,-8.320173358835607
2002-01-24T09:30:00-05:00,20.77,21.16,20.77,20.97,554000,220935,47.625121563046825,43.90187281705742,NaN,NaN,-29.447222457687403,-121.98388310190128,-0.08209460221904624,-0.327987690015366,-0.24589308779631974,-608200,-1106660,13.088524565344557,4.848797409735992,NaN,NaN,-17.02565321921706,-9.5638133388901
2002-01-25T09:30:00-05:00,21.02,21.73,21.02,21.59,275400,233865,55.24276062737652,43.5592044356003,NaN,NaN,19.92997302142766,-75.71997661629348,0.0039964735169189525,-0.24089749590017107,-0.24489396941709002,-332800,-933740,21.762888815318362,6.116244955477954,NaN,NaN,-12.489175070293944,-9.981722157662077
2002-01-28T09:30:00-05:00,21.77,21.77,21.48,21.57001,45700,229155,54.96517894890599,43.19670879139529,NaN,NaN,35.56839234941896,-36.226339973823755,0.058704126654627986,-0.17151381109880504,-0.23021793775343302,-378500,-750840,29.749509441795098,7.976768611433274,NaN,NaN,-9.038798869016567,-9.847018830712718
2002-01-29T09:30:00-05:00,21.47,21.64999,21.17,21.28999,535400,247990,51.09231744511067,42.99828348220916,NaN,NaN,13.10792376837992,-9.364005443162117,0.07414508722631527,-0.13753657872053893,-0.2116816659468542,-913900,-679120,32.65273944150465,9.970224967583095,NaN,NaN,-7.321086161077119,-9.486171306479061
2002-01-30T09:30:00-05:00,21.09,21.47,21.08,21.46001,135700,175075,53.24636528143485,43.09408757943896,NaN,NaN,11.106929109158752,10.053199158139597,0.09271651472442571,-0.09578602254132207,-0.18850253726574778,-778200,-602320,35.71638147422752,12.184959100769017,NaN,NaN,-5.245295089921678,-8.880331846970863
2002-01-31T09:30:00-05:00,21.17999,21.96001,21.17999,21.92,1334600,239770,58.563681447923244,43.95160574568702,NaN,NaN,47.19322976962774,25.381289603602625,0.13057040161304462,-0.025289535249441997,-0.15585993686248661,556400,-369400,44.03189262427925,15.00099206280163,NaN,NaN,-1.715756154669772,-7.856821033784993
2002-02-01T09:30:00-05:00,22.10001,22.10001,21.75,21.82001,152800,240505,57.04492893504305,44.935237437642805,NaN,NaN,67.89698070945674,34.97469114120844,0.1424915854414642,0.022254544939343646,-0.12023704050212056,403600,-222120,48.56282347153012,18.15567179419085,NaN,NaN,0.6860183674268399,-6.636415405040445
2002-02-04T09:30:00-05:00,21.85001,21.87,21.50999,21.62,326100,245190,54.0267347024058,46.228157911295845,NaN,NaN,50.262593366833805,37.91353134469141,0.1308259153552444,0.043295353691934935,-0.08753056166330946,77500,-130920,51.197484613175675,21.51443185425308,NaN,NaN,1.8091957564893588,-5.429899524821902
2002-02-05T09:30:00-05:00,21.57001,21.69,21.32001,21.34,3021200,375280,50.035567039545164,47.119487310962676,NaN,NaN,34.595338314685655,42.211014253952555,0.09958504223791541,0.03695074113408481,-0.0626343011038306,-2943700,-536880,41.104677400447166,24.160765117208854,NaN,NaN,1.5783941372136685,-4.428714715959678
2002-02-06T09:30:00-05:00,21.39999,21.61,21.35001,21.39999,765300,400615,50.87293736028969,48.38834039976066,NaN,NaN,41.13095505981881,48.21581944408457,0.07918290235342038,0.03634432683794486,-0.042838575515475506,-2178400,-816920,35.85392470327264,26.438464470210953,NaN,NaN,1.6293069567722833,-3.5632830484265403
2002-02-07T09:30:00-05:00,21.35001,21.53,21.3,21.35001,1864700,483495,50.11929786104411,49.4939932674099,NaN,NaN,39.41955119801561,46.66108372976215,0.05944528202224474,0.031468027012330424,-0.02797725500991432,-4043100,-1736820,24.694606464410825,27.920389623392886,NaN,NaN,1.4634590327810009,-2.845177036825463
2002-02-08T09:30:00-05:00,21.38,21.78,21.38,21.78,1571100,560070,56.13933093918615,51.14589949552497,NaN,NaN,71.30576221352368,47.34284003057553,0.07165392462612975,0.061590150772747876,-0.010063773853381877,-2472000,-2311940,20.416229600740124,29.099470836734238,NaN,NaN,3.0734305740569208,-1.9996616638422655
2002-02-11T09:30:00-05:00,21.84,22.46001,21.83,22.37,1880400,651580,62.777524498596875,53.07837721009839,NaN,NaN,130.73414060762184,63.43714947873311,0.11329401931577357,0.1315537502913351,0.018259730975561515,-591600,-2445760,19.566768919039134,30.21865927518861,NaN,NaN,6.689566796820949,-0.7583433123189494
2002-02-12T09:30:00-05:00,22.25,22.39999,22.13,22.22,785800,688510,60.27965719065526,54.43081456004029,NaN,NaN,122.35537362989918,80.98915654177581,0.12371504420805189,0.17290353623562638,0.049188492027574485,-1377400,-2132500,27.20253472861303,31.828641875978434,NaN,NaN,8.876743336601786,0.6180976375268699
2002-02-13T09:30:00-05:00,22.22,22.53999,22.22,22.46001,625900,718805,62.82825270873854,55.51675249901827,NaN,NaN,130.85390033208566,98.93374559622919,0.1386298290752455,0.22247577837163135,0.08384594929638586,-751500,-1847120,33.40496917131354,33.27981649069051,NaN,NaN,11.50382213884517,2.173201137715198
2002-02-14T09:30:00-05:00,22.5,22.5,22.25999,22.41,3685000,896925,61.936495241691915,55.9948764000408,NaN,NaN,125.13194001289112,116.07622335920428,0.13675499368507343,0.25478969140272767,0.11803469771765424,-4436500,-1925800,32.58076889641045,34.052522210768515,NaN,NaN,13.37419428584895,3.7733430160200196
2002-02-15T09:30:00-05:00,22.60001,22.78,22.49001,22.5,2898600,1034205,62.95552200502783,56.56561518976379,NaN,NaN,140.15713812520647,129.84649854154083,0.13307845037356558,0.2843827606846112,0.15130431031104563,-1537900,-1738980,36.581863811104064,34.540547522862006,NaN,NaN,15.218539982119491,5.40837115403423
2002-02-19T09:30:00-05:00,22.53999,22.57001,22.07001,22.07001,1359600,1097405,55.33357267176617,56.86856199166776,NaN,NaN,86.65105093218882,121.02988060645423,0.09497750220148352,0.2700261880629,0.1750486858614165,-2897500,-2200160,31.596807746511118,34.46512383036247,NaN,NaN,14.617615769451318,6.723977527665242
2002-02-20T09:30:00-05:00,22.25999,22.44,22.17999,22.39,1129500,1152855,59.28413259548293,57.29983108552834,NaN,NaN,90.40541731181001,114.63988934283641,0.08494281720683389,0.2812272073699589,0.196284390163125,-1768000,-2278280,30.83040009463727,34.11612516039174,NaN,NaN,15.29326949228037,7.948162094038832
2002-02-21T09:30:00-05:00,22.47,22.99001,22.47,22.60001,3098600,1302270,61.67962832930811,57.52239871991298,NaN,NaN,128.19683638846305,114.10847655411189,0.08581328847762698,0.30355100076015873,0.21773771228253175,1330600,-1861860,39.28454875142239,33.77702916947339,NaN,NaN,16.584383226859643,9.18190797015609
2002-02-22T09:30:00-05:00,22.58,22.91,22.58,22.8,1044600,1326800,63.86020037157788,58.0092038225226,NaN,NaN,124.3191628821666,113.945921127967,0.09263823005108196,0.3335354998463842,0.24089726979530224,2375200,-499520,57.56001454221586,34.41968567452237,NaN,NaN,18.325256980406174,10.488100685906101
2002-02-25T09:30:00-05:00,23,23.03,22.75,22.92,1867800,1406420,65.14194505886226,58.803147419412355,NaN,NaN,127.29863722510612,111.37422094794692,0.09752162734417225,0.3627993039755175,0.26527767663134527,4243000,656660,66.71640136196373,35.52817972800724,NaN,NaN,20.14537904563837,11.867711880153568
2002-02-26T09:30:00-05:00,22.96001,23.07001,22.78999,22.96001,532000,1430735,65.58026905368955,59.913483277565525,NaN,NaN,118.54529153877334,117.75306906926383,0.09560506009667097,0.38478400175218397,0.289178941655513,4775000,2191160,74.56105985945715,37.91792133222224,NaN,NaN,21.76531013509017,13.281654488001653
2002-02-27T09:30:00-05:00,23.06,23.28,22.95,23.09,2008600,1504395,67.03079866152216,61.06761622765355,NaN,NaN,129.9882943450869,125.66964447591917,0.0950512865538608,0.407993049847839,0.3129417632939782,6783600,3901480,80.17081389395014,41.08341341727063,NaN,NaN,23.54890373864761,14.748404380951076
2002-02-28T09:30:00-05:00,23.14,23.28999,23.02,23.08,1985000,1596860,66.79758465747472,62.2589224273986,NaN,NaN,124.37910766970738,124.90609873216806,0.08623023956084197,0.4207295627450307,0.33449932318418873,4798600,4595080,81.91275556124285,45.17042406704435,NaN,NaN,24.96943820715058,16.20855207040815
2002-03-01T09:30:00-05:00,22.97,23.42,22.95,23.42,1607700,1610515,70.54937336401629,63.28821117202932,NaN,NaN,128.3329636605861,125.70885888785196,0.09482948577003547,0.4530361803967331,0.35820669462669763,6406300,5401300,83.70468403716865,49.69102795536067,NaN,NaN,27.33155830581429,17.797552961180454
2002-03-04T09:30:00-05:00,23.53999,24.07001,23.5,24.06,567100,1631230,76.03814199538975,64.23539813608595,NaN,NaN,179.9868252687678,136.24649649658429,0.13282581114054387,0.5242389585523775,0.3914131474118336,6973400,5947380,84.80292032673586,54.35075305591044,NaN,NaN,31.37675528169716,19.737439006968554
2002-03-05T09:30:00-05:00,23.75,23.83,23.36,23.37,1945600,1712205,62.51139479117492,64.3948079646945,NaN,NaN,120.31516465074719,136.60047111897907,0.10207559628244545,0.5190076427648904,0.416932046482445,5027800,5997940,84.9043628238241,58.47231220556837,NaN,NaN,30.383834569622696,21.25835265877629
2002-03-06T09:30:00-05:00,23.5,23.87,23.42999,23.8,1172000,1619745,66.50977419305332,64.6577737850027,NaN,NaN,128.85328737811415,136.37346972558453,0.10109149147013075,0.5432964108201084,0.44220491934997763,6199800,5881180,83.51789110666797,62.05180662952226,NaN,NaN,30.954658975549847,22.643539275458227
2002-03-07T09:30:00-05:00,23.8,23.81,23.58,23.64,616400,1612300,63.78374233999993,64.78972000631042,NaN,NaN,115.04982646635432,134.50761348491392,0.08093296655936377,0.5433711275491824,0.4624381609898186,5583400,6038140,83.89854109660268,65.71736178667885,NaN,NaN,30.481110769314213,23.76319234600908
2002-03-08T09:30:00-05:00,23.74001,23.86,23.37,23.53999,1269100,1582520,62.07119077201234,64.72655348966644,NaN,NaN,95.44675529002326,127.93037181080135,0.0534569888379145,0.5292593970372117,0.4758024081992972,4314300,5619740,78.6820769349785,68.7245198669556,NaN,NaN,29.55559587898746,24.59067856500599
2002-03-11T09:30:00-05:00,23.5,23.63,23.36,23.50999,118700,1509900,61.53744355662956,65.16968712429954,NaN,NaN,76.19349536762418,107.17170583057262,0.027180944964484255,0.5097785894049025,0.48259764444041825,4195600,5064180,72.25771473678654,71.62887036626098,NaN,NaN,28.65790534608303,25.17171096230271
2002-03-12T09:30:00-05:00,23.35001,23.7,23.32001,23.55,684500,1450105,62.006672568095766,65.36415426520047,NaN,NaN,71.59148776595259,97.42697045361369,0.007440353791519749,0.49189808667981794,0.4844577328882982,4880100,5034640,71.92145345566234,74.5639456063342,NaN,NaN,28.060112237615147,25.584339715918773
2002-03-13T09:30:00-05:00,23.46001,23.58,23.24001,23.25,126400,1417135,56.4461172046992,64.99033204201412,NaN,NaN,42.51520381575725,80.15935374114233,-0.02888470977844959,0.4483518456652362,0.4772365554436858,4753700,4745420,68.5574988970117,76.65487061673343,NaN,NaN,25.88737115651975,25.627629921718913
2002-03-14T09:30:00-05:00,23.27,23.64999,23.25,23.57001,85000,1390090,60.51384231560476,64.75130646658747,NaN,NaN,57.198703754088655,68.58912919868916,-0.034066955655626896,0.4346528608741522,0.4687198165297791,4838700,4596480,66.82412342515369,77.31659267980044,NaN,NaN,25.195377325550787,25.565879550837753
2002-03-15T09:30:00-05:00,23.58,23.74001,23.5,23.71001,75600,1209620,62.178087735653165,64.53960237207254,NaN,NaN,75.67164071668324,64.63410628402119,-0.030867997028305283,0.43013482024439753,0.4610028172727028,4914300,4716480,67.53630416100157,77.375157165446,NaN,NaN,25.107582426549918,25.500408533082346
2002-03-18T09:30:00-05:00,23.85001,23.95,23.67999,23.8,122400,1070810,63.25029141706301,64.37317539802777,NaN,NaN,94.6912724188851,68.33366169427337,-0.025704723444092747,0.42887191296758687,0.4545766364116796,5036700,4884700,68.55535437844499,76.94617820251655,NaN,NaN,25.340250388076214,25.47752879808147
2002-03-19T09:30:00-05:00,23.8,24.13,23.8,24.02,290400,1017350,65.8026373566878,64.28544959053961,NaN,NaN,119.2816121318517,77.87168656745318,-0.011225401895998355,0.4405448840416817,0.45177028593768004,5327100,4974100,69.11030685384475,76.15614198536616,NaN,NaN,26.277273693672974,25.591778068880256
2002-03-20T09:30:00-05:00,23.92,24.14999,23.86,23.91,338600,977805,63.43050722668642,64.04494405976901,NaN,NaN,113.8172829596982,92.13210239624138,-0.012700236025724787,0.4358949909055241,0.44859522693124887,4988500,5021060,69.41564681175515,75.26349136040277,NaN,NaN,26.396127922800016,25.706685190868793
2002-03-21T09:30:00-05:00,23.91,23.91,23.39999,23.52,323300,839040,55.75610990114224,62.98828238384944,NaN,NaN,33.563365844969894,87.40503481441763,-0.04193751207086993,0.3961733368426614,0.43811084891353136,4665200,4986360,68.87388214144173,74.20414836785083,NaN,NaN,24.19996273020298,25.49143912505939
2002-03-22T09:30:00-05:00,23.53,23.59,23.31,23.33,399000,806760,52.42810516956219,61.30185118200462,NaN,NaN,-25.05707474541644,67.2592917219977,-0.07418396570150199,0.3453808917866539,0.41956485748815586,4266200,4856740,66.77731168108009,72.91660489316114,NaN,NaN,21.33841455395369,24.898149900615717
2002-03-25T09:30:00-05:00,23.39999,23.39999,23.03,23.03,149600,720850,47.59723332934314,60.23655393473092,NaN,NaN,-105.74866812401727,27.171303613417212,-0.113476963917439,0.2777186525913571,0.3911956165087961,4116600,4672720,63.80766066952858,71.40969759642574,NaN,NaN,17.349462467089438,23.819765981540534
2002-03-26T09:30:00-05:00,23,23.56,22.92999,23.46001,381800,713340,54.122563365605366,59.35175316134178,NaN,NaN,-68.9507068277719,-10.475160178507505,-0.10828062615177914,0.2558448338190722,0.36412545997085133,4498400,4506980,61.169167088455005,69.8133601665534,NaN,NaN,15.864835975079874,22.68334740918901
2002-03-27T09:30:00-05:00,23.58,23.96001,23.53,23.95,245800,625200,60.20369447202534,59.096035456486455,NaN,NaN,81.59325594251067,-16.91996558194501,-0.07139705818103514,0.27487913724455737,0.3462761954255925,4744200,4458120,60.37655199476435,68.13321808785066,NaN,NaN,16.6037961444663,21.814840085657195
2002-03-28T09:30:00-05:00,23.92,24,23.69,23.71001,1050400,578470,56.26955869790739,58.681633165478964,NaN,NaN,70.44019373970985,-9.544600002997019,-0.0630089356775222,0.2675150258286898,0.330523961506212,3693800,4263840,57.20256882745502,66.59896750874184,NaN,NaN,15.908817324012803,20.971122548279425
2002-04-01T09:30:00-05:00,23.52,23.62,23.25,23.58,1213200,558745,54.20313715765106,58.15775413698049,NaN,NaN,-48.212932321799165,-14.175771518273567,-0.06575864881023047,0.24832565049342392,0.3140842993036544,2480600,3906720,51.81084376649045,65.13847672514926,NaN,NaN,14.693982480518288,20.074388252884976
2002-04-02T09:30:00-05:00,23.60001,23.60001,23.42,23.48,245100,542645,52.60297626102317,57.48606154361818,NaN,NaN,-36.91076271746943,-0.4081904369640014,-0.07328015168447116,0.22248410969806542,0.2957642613825366,2235500,3530500,46.80562937310867,63.344489290681146,NaN,NaN,13.221055417144331,19.095340704922027
2002-04-03T09:30:00-05:00,23.60001,23.63,23.05,23.14999,1646100,527670,47.608025791856,56.85476929984366,NaN,NaN,-112.76000564721032,-9.170050200851687,-0.09790991088038042,0.17337687278206104,0.27128678366244147,589400,2748700,38.48538116396276,61.19648088117765,NaN,NaN,10.381179323249826,17.850460507540284
2002-04-04T09:30:00-05:00,22.71001,22.94,22.63,22.86,673500,502745,43.68273947315976,55.65254766824045,NaN,NaN,-232.83645883421417,-72.05599315619665,-0.12919452162288816,0.10979363163383127,0.23898815325671943,-84100,1783040,31.125541294851757,58.64658215758465,NaN,NaN,6.718290757071347,16.260150543187578
2002-04-05T09:30:00-05:00,23.07001,23.31,23.07001,23.17,1252000,534525,48.56492111708375,54.680178624056914,NaN,NaN,-101.8866986743974,-106.52137163901811,-0.12442585283631272,0.08345583721132854,0.20788169004764126,1167900,1277860,28.098223426084175,55.82957639080484,NaN,NaN,5.131492749325576,14.670342286921578
2002-04-08T09:30:00-04:00,23.07001,23.31,22.95,23.27,256300,483885,50.06864720614836,53.73863260899158,NaN,NaN,-92.99798866175225,-115.47838290700872,-0.11042778612097842,0.06984695739641822,0.18027474351739664,1424200,1066580,26.91899776603188,52.85555091848962,NaN,NaN,4.302790067252444,13.189263398397417
2002-04-09T09:30:00-04:00,23.25,23.39999,23.10001,23.25,531300,504515,49.75534479039716,52.592397425685114,NaN,NaN,-64.18991971853207,-120.93421430722124,-0.09878514577127845,0.056793311303298566,0.15557845707457701,892900,798060,25.45674049845394,49.73743903596171,NaN,NaN,3.544172644436479,11.811393290688711
2002-04-10T09:30:00-04:00,23.37,23.8,23.35001,23.75,107200,475650,56.99961901352351,52.13304826760204,NaN,NaN,41.082767137803074,-90.16565975021857,-0.055818830966473915,0.08580491836648463,0.14162374933295854,1000100,880200,26.767228698057878,46.69112345641191,NaN,NaN,5.104088381335212,10.853206875066782
2002-04-11T09:30:00-04:00,23.88,23.91,23.48,23.48,322200,485440,52.59013530229111,51.90690722482696,NaN,NaN,34.662811564938885,-36.665805670387954,-0.04448418780700164,0.0860185145742065,0.13050270238120815,677900,1032600,29.252372743291573,43.86101564225833,NaN,NaN,5.061294547407228,10.025790828258273
2002-04-12T09:30:00-04:00,23.67,23.67,23.28999,23.36,267600,494570,50.712409388778056,51.78435752619953,NaN,NaN,-14.931694128564375,-19.27480476122135,-0.043895806316650215,0.07563294448539537,0.11952875080204559,410300,881080,28.22677504483127,41.107405882526265,NaN,NaN,4.46093063328946,9.230810800405585
2002-04-15T09:30:00-04:00,23.42999,23.42999,23.16,23.3,137500,497665,49.755817993824095,51.93854214509103,NaN,NaN,-48.94983335638447,-10.46517370014779,-0.04614471012993586,0.06184786313962576,0.10799257326956162,272800,650800,26.694927225710487,38.45649635082497,NaN,NaN,3.6942846720309586,8.439878496352067
2002-04-16T09:30:00-04:00,23.34,23.75,23.34,23.71001,433400,513215,55.88034080188849,52.06409767625411,NaN,NaN,37.77226631237209,9.92726350603304,-0.019953964850718847,0.08305011720616307,0.10300408205688191,706200,613460,26.444322314058326,35.97615029551093,NaN,NaN,4.876230346119935,7.9307859034617625
2002-04-17T09:30:00-04:00,23.73,23.85001,23.73,23.82001,174800,507435,57.3813023611489,51.862498239762935,NaN,NaN,100.95926725069629,21.902563528611683,0.0035887811666573954,0.10749005851520366,0.10390127734854626,881000,589640,26.274867659886837,33.54031570016254,NaN,NaN,6.298154993288188,7.697552916294109
2002-04-18T09:30:00-04:00,23.92,23.92999,23.5,23.56,287600,504885,52.80810394130767,51.61525147143438,NaN,NaN,70.04059046039862,28.97811930770363,0.0006163095508200378,0.10467166428707131,0.10405535473625127,593400,572740,26.14684994670867,31.322050065823515,NaN,NaN,6.16459404598158,7.4785587919637475
2002-04-19T09:30:00-04:00,23.55,23.73,23.53,23.60001,677100,522575,53.42325526023507,51.55954562161895,NaN,NaN,56.038284359766244,43.17211500536975,0.00032560588593248674,0.10446236209366688,0.1041367562077344,1270500,744780,29.8916340560571,29.756392229363993,NaN,NaN,6.232026144645928,7.300482699489773
2002-04-22T09:30:00-04:00,23.53999,23.53999,22.94,23.00999,561500,530700,44.260716266648224,50.96366990773503,NaN,NaN,-79.24519766158946,37.11304214432876,-0.03847676327201924,0.05604080211771034,0.09451756538972958,709000,832020,31.780652629257673,28.683179604803207,NaN,NaN,3.382883515677497,6.7408256732308764
2002-04-23T09:30:00-04:00,22.88,22.97,22.67,22.73,766600,561550,40.69394127389206,50.46980672788046,NaN,NaN,-169.6200738378476,-4.365425885715183,-0.07951032731701002,-0.004870343756532947,0.07463998356047707,-57600,679260,30.243971091373623,28.09450745676113,NaN,NaN,-0.1733601972385411,5.753084834592388
2002-04-24T09:30:00-04:00,22.83,22.94,22.50999,22.59,809700,582945,39.00151801673856,50.13543376670752,NaN,NaN,-167.01442935889023,-57.960165207632485,-0.1106762589827043,-0.0637053401679033,0.046970918814801,-867300,329600,27.023074328723382,27.801474102037673,NaN,NaN,-3.6075939151514484,4.4158450132004115
2002-04-25T09:30:00-04:00,22.44,22.55,22.3,22.53999,1114200,626365,38.387358812197974,49.40846503064425,NaN,NaN,-186.46147203729174,-109.26057770717057,-0.1280283750550047,-0.11306455000395488,0.014963825051049817,-1981500,-185380,23.118092011843913,27.445750429591943,NaN,NaN,-6.567608133786096,2.8467802779166247
2002-04-26T09:30:00-04:00,22.60001,22.75,22.48,22.61,322000,589945,39.81614538526545,48.676143472009755,NaN,NaN,-135.44933467816057,-147.55810151475592,-0.12786143395830316,-0.14486296739682913,-0.01700153343852597,-1659500,-771380,19.640158736055312,26.92583335602219,NaN,NaN,-8.61172430722054,1.2098510514684586
2002-04-29T09:30:00-04:00,22.5,22.52,22.17,22.23,745600,566565,35.06325338044634,47.62670837129899,NaN,NaN,-166.08166283972452,-164.92539455038292,-0.1451498033796425,-0.1984387876630791,-0.0532889842834366,-2405100,-1394200,16.75503629753392,26.30428305595647,NaN,NaN,-11.898719819119602,-0.6628019300441215
2002-04-30T09:30:00-04:00,22.14999,22.78,22.14999,22.59,439300,576275,42.11314260969773,46.56338862816858,NaN,NaN,-110.68263813801666,-153.13790741041674,-0.12491664138762294,-0.20943478601796528,-0.08451814463034234,-1965800,-1775840,15.274365677911845,25.48336426880319,NaN,NaN,-12.60797191659908,-2.369254785266258
2002-05-01T09:30:00-04:00,22.60001,22.84,22.36,22.62,104500,499195,42.671695497870495,45.85492864213854,NaN,NaN,-81.78017075862043,-136.0910556903628,-0.10300148496998116,-0.21327000084281877,-0.11026851587283762,-1861300,-1974640,14.552909287737407,24.433402593406463,NaN,NaN,-13.011788890417058,-3.8896168002878007
2002-05-02T09:30:00-04:00,22.72,23.17999,22.72,23.11,406500,485845,50.989897265937614,45.87474920479279,NaN,NaN,-19.621348224298078,-102.72303092776406,-0.05159002916906397,-0.17475605233416758,-0.12316602316510361,-1454800,-1869300,16.795526720537637,23.61688485595692,NaN,NaN,-10.720464704323996,-4.865452215150114
2002-05-03T09:30:00-04:00,23.10001,23.35001,23.03999,23.25999,539200,450205,53.22710107026448,46.12269799596711,NaN,NaN,15.621961738472638,-72.50877164443742,-0.005966997582050743,-0.13062477014266705,-0.1246577725606163,-915600,-1720520,19.98956748841526,23.137930589007258,NaN,NaN,-8.137951081148245,-5.332952053149847
2002-05-06T09:30:00-04:00,23.3,23.39999,23.07001,23.12,263200,450550,50.89208655203862,45.76639412097783,NaN,NaN,12.108262108263563,-36.87078665483978,0.015144080984463598,-0.1057276713300368,-0.1208717523145004,-1178800,-1475260,25.094327612257658,23.041502396021492,NaN,NaN,-6.697135756224981,-5.527835439303438
2002-05-07T09:30:00-04:00,23.14999,23.53999,23.13,23.3,458400,446905,53.704356900202484,45.50375515948166,NaN,NaN,32.27357294221693,-8.279544438793067,0.040171362471432354,-0.07065754922520995,-0.1108289116966423,-720400,-1226180,29.98024505059111,23.306172209643226,NaN,NaN,-4.633731451101421,-5.400106298131721
2002-05-08T09:30:00-04:00,23.58,23.69,23.48,23.55,1569800,520035,57.356986706697974,45.828675357009544,NaN,NaN,74.3748087490176,22.95145146273454,0.07071695043464314,-0.02243272365333837,-0.09314967408798151,849400,-684040,39.26606234451521,24.243258809486548,NaN,NaN,-1.7389240771765984,-4.877080266566704
2002-05-09T09:30:00-04:00,23.52,23.8,23.52,23.57001,153700,511610,57.64503257677677,46.13023087961967,NaN,NaN,83.65121626501276,43.6059643605967,0.08828145305854716,0.017202142235202444,-0.07107931082334472,1003100,-192460,46.229320687059065,25.41023642598669,NaN,NaN,0.6872253700255244,-4.082179461339243
2002-05-10T09:30:00-04:00,23.57001,23.67999,23.46001,23.49001,93500,502905,56.015913710234834,46.96988783987585,NaN,NaN,67.75408601523361,54.032389215948896,0.09020528677825278,0.04167729764947126,-0.04852798912878152,909600,172580,50.74537369761228,26.76485935944059,NaN,NaN,2.269764672312593,-3.1747588708175525
2002-05-13T09:30:00-04:00,23.39999,23.66,23.3,23.66,88600,500460,58.687622640466834,48.2551507946312,NaN,NaN,63.69012775455588,64.34876234520736,0.09797318337890246,0.07393849009484654,-0.024034693284055907,998200,607980,55.54160321788089,28.57183308276254,NaN,NaN,4.396037201013233,-2.093216574841726
2002-05-14T09:30:00-04:00,23.87,24.07001,23.82001,24.02,380600,497820,63.71442070059695,50.02035812919251,NaN,NaN,125.09735720016845,82.91351919679767,0.12089951299850382,0.12708969796407388,0.006190184965570052,1378800,1027820,59.624350710740195,30.900495681478027,NaN,NaN,7.849334088318817,-0.6728521943902201
2002-05-15T09:30:00-04:00,24.05,24.24001,23.92999,24.08,221700,500165,64.48994608195292,51.88482864846072,NaN,NaN,136.47709031457498,95.33397550990914,0.13270416509323446,0.1720703913321131,0.03936622623887866,1600500,1178040,61.00424152248263,33.606649217952224,NaN,NaN,10.917101883534679,0.9828555310276226
2002-05-16T09:30:00-04:00,24.10001,24.2,23.92,24,353800,503475,62.56973191649539,53.51008482926286,NaN,NaN,122.46340232571215,103.09641272204901,0.12768221323899018,0.19896899278761637,0.0712867795486262,1246700,1226760,61.464236800342356,36.594083365401296,NaN,NaN,12.95938912299367,2.693788901308486
2002-05-17T09:30:00-04:00,24.09,24.11,23.8,24.11,589300,499085,64.15036049435372,55.5877353373991,NaN,NaN,110.29271193411134,111.60413790582456,0.12421127356353104,0.22655087150303999,0.10233959793950895,1836000,1412040,63.24012637206987,39.914446942153866,NaN,NaN,15.142483637826015,4.472173863668132
2002-05-20T09:30:00-04:00,24,24,23.82001,23.99001,104400,476230,61.118450670817516,56.945257341764794,NaN,NaN,89.0121608352481,116.66854452196301,0.10693390354764126,0.2360069773740605,0.12907307382641925,1731600,1558720,64.62981149852484,43.43983592934051,NaN,NaN,16.19405583874966,6.146728431536921
2002-05-21T09:30:00-04:00,23.96001,24.17999,23.83,23.95,229200,449360,60.0984773106239,58.19002747124718,NaN,NaN,86.4364776957393,108.93636862107716,0.08676905151055753,0.23753438821461614,0.15076533670405862,1502400,1583440,64.8708422118116,47.03397399534581,NaN,NaN,16.807631083230728,7.669714524636037
2002-05-22T09:30:00-04:00,23.98,24.06,23.88,24.03,317200,424735,61.48261534326967,58.93950733391375,NaN,NaN,79.2996455333876,97.5008796648397,0.07331245016182178,0.24240589940633583,0.16909344924451405,1819600,1627260,65.32196840092416,50.500148401087706,NaN,NaN,17.698133798066852,9.102345849411867
2002-05-23T09:30:00-04:00,24.10001,24.42,23.95,24.42,439700,391010,67.41659095236338,59.95304232549224,NaN,NaN,107.02734194192665,94.4136675880826,0.084382249542787,0.2745712611729978,0.1901890116302108,2259300,1829780,67.40529602283328,53.88698615354614,NaN,NaN,20.276418593538516,10.698641955715674
2002-05-24T09:30:00-04:00,24.38,24.44,24.09,24.09,136800,381750,59.11735725912208,60.540561661712495,NaN,NaN,94.1378027340076,91.18268574806186,0.06410338240605634,0.27031823963778123,0.2062148572317249,2122500,1887080,67.99122314211345,56.95105011996441,NaN,NaN,20.05514194873136,12.035284811860771
2002-05-28T09:30:00-04:00,24.19,24.19,23.86,23.95,359500,362445,55.969456208431865,60.702354469443165,NaN,NaN,58.94245783235367,85.16874514748297,0.03721808169524929,0.2527374593507865,0.21551937765553722,1763000,1893360,68.05899273412368,59.67096066878816,NaN,NaN,18.9087110773943,13.017202849794133
2002-05-29T09:30:00-04:00,23.95,23.95,23.71001,23.78999,376000,359280,52.5268214059201,60.357342662244754,NaN,NaN,21.99806740330616,72.28106308899635,0.0062395493075927955,0.2233188142900282,0.2170792649824354,1387000,1870280,67.49342050733752,61.68720053756118,NaN,NaN,16.890828451552796,13.570577935759657
2002-05-30T09:30:00-04:00,23.7,23.81,23.37,23.58,366300,372370,48.32579824751355,59.691683067297376,NaN,NaN,-34.219306628626796,49.57727265659346,-0.028884423571291007,0.18097373551832163,0.20985815908961264,1020700,1710500,63.55584111237128,62.924809139369195,NaN,NaN,13.856235463148364,13.611386153958044
2002-05-31T09:30:00-04:00,23.67,23.85001,23.55,23.71001,177700,360930,50.94185925550844,59.32925060624548,NaN,NaN,-19.00404921231915,24.370994425744303,-0.043001582399579824,0.15610618109013785,0.19910776348971768,1198400,1498320,58.66156733501892,63.4902515420411,NaN,NaN,12.091503407830368,13.394260047368377
2002-06-03T09:30:00-04:00,23.7,23.81,23.27,23.34,419300,354935,44.09918260915087,58.2872191754372,NaN,NaN,-83.00415870708208,-11.057397862473639,-0.07502413131478841,0.10532759934623215,0.18035173066102056,779100,1229640,53.08670512196444,63.31490167804707,NaN,NaN,8.288043549427583,12.66480054766255
2002-06-04T09:30:00-04:00,23.22,23.38,23.08,23.22,241000,353825,42.123017755529844,56.74497610793241,NaN,NaN,-148.29342616398327,-52.504574661741024,-0.10046470762039877,0.05477084613552208,0.15523555375592085,538100,984660,48.55564163779093,62.524279601407834,NaN,NaN,4.547189205473478,11.505141784492682
2002-06-05T09:30:00-04:00,23.27,23.41,23.17,23.39999,104500,336130,46.029626091488645,55.42638182289925,NaN,NaN,-122.33292429863802,-81.37077300212987,-0.10107255360056402,0.028894861755215828,0.12996741535577985,642600,835780,45.9867963746237,61.45160494798934,NaN,NaN,2.5877916102612093,10.23123461674533
2002-06-06T09:30:00-04:00,23.48,23.48,23.00999,23.03999,337600,274520,40.1868790890511,53.82760662093894,NaN,NaN,-144.01573825764635,-103.33005932793378,-0.12031439650234373,-0.0204255802721498,0.09988881623019392,305000,692640,43.598547381965936,60.17548427524817,NaN,NaN,-1.0671718163946144,8.617176554868195
2002-06-07T09:30:00-04:00,22.85001,23.16,22.85001,23.05,156300,274650,40.41336685151978,52.132107075022226,NaN,NaN,-155.5345838803318,-130.6361662615363,-0.12633958383763066,-0.05803566356684442,0.06830392027078626,461300,545220,41.22402163991317,58.602905365808404,NaN,NaN,-3.8789818960234457,6.832011061883675
2002-06-10T09:30:00-04:00,23.08,23.21001,22.92999,23.10001,315100,285730,41.603089178624224,50.738152682722706,NaN,NaN,-127.25106415383812,-139.48554735088751,-0.12092431721659712,-0.08285147624996014,0.038072840966636975,776400,544680,41.215166733819466,56.93043073975802,NaN,NaN,-5.829910681177605,5.023165098589207
2002-06-11T09:30:00-04:00,23.25,23.27,22.8,22.84,764100,319505,37.41981542257607,49.11824826214786,NaN,NaN,-130.81867450986834,-135.9905970200645,-0.12813141407608455,-0.12209142662846872,0.00603998744761583,12300,439520,39.43854101901106,55.11383779741512,NaN,NaN,-8.824831335383445,3.044879893735971
2002-06-12T09:30:00-04:00,22.7,23.03999,22.7,23.03,138200,307385,42.00864761220096,47.727250567071515,NaN,NaN,-120.05890471088124,-135.5357931025132,-0.11386153159722119,-0.13628692704891066,-0.022425395451689468,150500,341100,37.79641327606034,53.147726717067705,NaN,NaN,-10.000239606180655,1.1812913937478817
2002-06-13T09:30:00-04:00,22.98,23.06,22.60001,22.62,132800,302940,35.89242749015622,45.47552460548529,NaN,NaN,-128.84112647097172,-132.50087074517825,-0.12490943019498803,-0.1785621831954245,-0.05365275300043647,17700,283640,36.83218356644975,50.963932970183166,NaN,NaN,-13.061275361160277,-0.8533609998104268
2002-06-14T09:30:00-04:00,22.50999,22.64,22.25,22.63,485000,309500,36.13665629635771,43.83404596528783,NaN,NaN,-146.32209644954898,-130.65837325902166,-0.12415876172296283,-0.20885120515414002,-0.08469244343117718,502700,291920,37.081275251095974,48.756079549396205,NaN,NaN,-15.397119293156786,-2.931040756002764
2002-06-17T09:30:00-04:00,22.52,23,22.52,23,166500,288360,44.55348041702126,43.01861912304422,NaN,NaN,-87.54249993795527,-122.71666041584508,-0.09279498936248516,-0.20068618013428363,-0.10789119077179847,669200,270480,36.67795722541988,46.51457701306022,NaN,NaN,-14.775521230019608,-4.6231093951480275
2002-06-18T09:30:00-04:00,22.98,23.14,22.92999,23.10001,183100,292295,46.60203568971703,42.59542014331543,NaN,NaN,-50.60830737604764,-106.67458698908095,-0.060906289835290534,-0.18402405306591163,-0.1231177632306211,852300,438480,42.00125489931435,44.69370804105857,NaN,NaN,-13.629307645926433,-5.909709145259228
2002-06-19T09:30:00-04:00,23.10001,23.35001,23,23.05,455000,303585,45.69291740146232,42.407357225740334,NaN,NaN,-34.73489219755002,-89.60978448641471,-0.03979534262363946,-0.17286194151017042,-0.13306659888653097,397300,487840,43.504029551727115,43.26143578672684,NaN,NaN,-12.967644561600519,-6.917985633307984
2002-06-20T09:30:00-04:00,22.95,23.28,22.95,23.07001,427500,309100,46.14561841503501,42.06476859427795,NaN,NaN,-35.56152178546419,-70.9538635493132,-0.021987138044509857,-0.1605505214421683,-0.13856338339765845,824800,649260,48.228298144441254,42.51620227311416,NaN,NaN,-12.299618854649017,-7.6867903792138454
2002-06-21T09:30:00-04:00,23,23.03,22.44,22.67,514500,312840,39.12441858118224,41.7094283065659,NaN,NaN,-98.70668154129626,-61.430780567662666,-0.03393714609493767,-0.18098481601633054,-0.14704766992139287,310300,610780,47.214720701922126,42.0967748145397,NaN,NaN,-13.823268644343514,-8.563430131375227
2002-06-24T09:30:00-04:00,22.63,22.81,22.55,22.69,220800,317040,39.619098506617284,41.53057693164357,NaN,NaN,-102.34461163245497,-64.39120290656261,-0.037031179539947945,-0.1933366443463278,-0.15630546480637986,531100,583160,46.45996368410118,41.9470835321333,NaN,NaN,-14.905157945574132,-9.469391247689357
2002-06-25T09:30:00-04:00,22.99001,23.11,22.8,22.84,298000,313965,43.338034843950915,41.338320413962315,NaN,NaN,-46.50007050806448,-63.56955553296598,-0.026031567480080675,-0.1888449241564807,-0.1628133566764,829100,578520,46.32598571401541,41.97131134208984,NaN,NaN,-14.745873423118,-10.223174415607735
2002-06-26T09:30:00-04:00,22.48,22.7,22.42,22.64,443800,317355,39.81669620121032,41.31187877911655,NaN,NaN,-122.04995141607772,-81.03256737667152,-0.02905180042546812,-0.19912810720823515,-0.17007630678276703,385300,576120,46.25169062899218,42.16082157402029,NaN,NaN,-15.645761444806597,-10.997829705493286
2002-06-27T09:30:00-04:00,22.78,22.85001,22.53999,22.82001,140500,306065,44.210516009059425,41.5831037189408,NaN,NaN,-74.39111913525858,-88.79848684663041,-0.016383509651826278,-0.1905556938475499,-0.1741721841957236,525800,516320,44.343423117317144,42.38363596526343,NaN,NaN,-15.104508412535703,-11.584498092213632
2002-06-28T09:30:00-04:00,22.92,23.38,22.86,23.19,148300,304595,51.97190755203311,42.32373360275572,NaN,NaN,56.76514842896182,-57.70412085257878,0.01761537222059925,-0.15215296891997454,-0.1697683411405738,674100,589080,47.19797794141585,42.810979622948885,NaN,NaN,-12.11280298979079,-11.659970220438941
2002-07-01T09:30:00-04:00,23.14999,23.24001,23.05,23.05,87600,288010,49.18366306590507,43.16400843442208,NaN,NaN,57.399223553765815,-25.755353815334633,0.030615058416395058,-0.13149951812007998,-0.16211457653647504,586500,600160,47.63839748196601,43.396683656017096,NaN,NaN,-10.50777203170691,-11.495370479191509
2002-07-02T09:30:00-04:00,23.17,23.17,22.50999,22.59,338200,292870,41.33653495118825,43.11600038720689,NaN,NaN,-61.49805560915306,-28.754950835552346,0.009279960220184125,-0.1505146262612449,-0.15979458648142902,248300,484000,43.538344549563774,43.80682160412448,NaN,NaN,-11.69038965166982,-11.523230360974125
2002-07-03T09:30:00-04:00,22.39999,22.60001,22.02,22.37,95600,292425,38.197645645139886,43.28065882684858,NaN,NaN,-184.03861826001088,-41.152684204338975,-0.017162006145849368,-0.18124709416374074,-0.16408508801789137,152700,437480,41.98007246778485,44.17452795421984,NaN,NaN,-13.719387870995456,-11.83696714812003
2002-07-05T09:30:00-04:00,22.55,23.03,22.5,22.94,180300,284560,49.00267982337022,44.19966050734947,NaN,NaN,-13.023035203637798,-28.87906741801482,0.005036343125416676,-0.15778965911112053,-0.1628260022365372,333000,398920,40.68038643942559,44.43160732481481,NaN,NaN,-11.616013742879725,-11.805402375942844
2002-07-08T09:30:00-04:00,23,23.11,22.89999,23,72700,280380,49.993754662184294,44.58825152486112,NaN,NaN,52.023762376240256,-29.827344628559132,0.02399933837706253,-0.13282682926520906,-0.15682616764227159,405700,345240,38.875970417658976,44.5886082671176,NaN,NaN,-9.670450339232087,-11.500409227841308
2002-07-09T09:30:00-04:00,23.10001,23.14999,22.67999,22.75999,160300,272640,46.131676138177475,44.55465441403687,NaN,NaN,5.859805709902623,-40.13522819733178,0.020739768193811375,-0.13090145740000736,-0.15164122559381873,245400,277020,36.651014086307434,44.20644820904568,NaN,NaN,-9.356331677918622,-11.19411243499521
2002-07-10T09:30:00-04:00,22.55,22.61,22.02,22.09,268400,247855,37.43737949555634,43.964973135043586,NaN,NaN,-191.4418941190612,-66.1239958993134,-0.023765192641461513,-0.18134771639564562,-0.1575825237541841,-23000,222760,34.93826275788895,43.594607723771524,NaN,NaN,-12.279653660300923,-11.349189752896025
2002-07-11T09:30:00-04:00,21.89999,21.98,21.5,21.75999,579200,269905,34.034845551816645,43.09991793052799,NaN,NaN,-270.6496331938333,-83.4461988860779,-0.07003804666751318,-0.24513008208857556,-0.1750920354210624,-602200,71780,30.646692357264712,42.338778738973204,NaN,NaN,-15.884643912359628,-11.99711177567654
2002-07-12T09:30:00-04:00,21.74001,21.89999,21.39999,21.53999,250400,275785,31.95011597643166,42.587467744474374,NaN,NaN,-228.2234776514428,-126.48628737563891,-0.1078130703532739,-0.30985837336265476,-0.20204530300938087,-852600,-165340,25.374956017290188,40.77879554721377,NaN,NaN,-19.47122726063363,-13.06484255924184
2002-07-15T09:30:00-04:00,21.05,21.21001,20.21001,21.05,824200,292745,27.85736601395284,41.747343994998346,NaN,NaN,-275.45270509635503,-191.98158087015796,-0.15526599270864974,-0.39612779389519304,-0.2408618011865433,-1676800,-581840,19.145303414444967,38.82774838509547,NaN,NaN,-24.009515478528122,-14.628367261997022
2002-07-16T09:30:00-04:00,20.83,21.05,20.39,20.67,933100,331075,25.165074636801165,40.44927540877336,NaN,NaN,-215.58525682261592,-236.27059337666165,-0.19892408640821224,-0.48951690919680857,-0.2905928227885963,-2609900,-1152900,14.051582149899033,36.52243384480145,NaN,NaN,-28.69398629335236,-16.6377414093335
2002-07-17T09:30:00-04:00,20.89999,21.27,20.7,20.82001,137400,328790,28.1184636736607,39.61368737109125,NaN,NaN,-152.93226040540043,-228.56866663392947,-0.2036376373799188,-0.5451398695134948,-0.341502232133576,-2472500,-1642800,11.279156403191095,34.02439568581566,NaN,NaN,-31.342375423422126,-18.738403411346162
2002-07-18T09:30:00-04:00,20.89999,21.11,20.50999,20.50999,57600,308920,25.848082177620455,38.302084954559895,NaN,NaN,-145.66092621339214,-203.57092523784127,-0.2125883198390558,-0.6072376319323958,-0.39464931209334,-2530100,-2028380,9.663143358544943,31.547232845903356,NaN,NaN,-34.29214572249632,-20.960366598653327
2002-07-19T09:30:00-04:00,20.23,20.39,19.59,19.60001,189400,297015,20.592284883785865,36.06068333539938,NaN,NaN,-178.58969150856257,-193.64416800926523,-0.2615290584637669,-0.7215606351730486,-0.4600315767092817,-2719500,-2401760,8.407021842291769,28.776450267394495,NaN,NaN,-39.00510629015971,-23.538186554582808
2002-07-22T09:30:00-04:00,19.60001,19.60001,18.53,18.69,216200,282100,16.893011974949843,33.754208257474005,NaN,NaN,-197.44532073384244,-178.0426911367627,-0.3323750720712684,-0.8755004167983671,-0.5431253447270987,-2935700,-2653540,7.681860705311095,25.922411926204855,NaN,NaN,-44.57764783494084,-26.543823880348242
2002-07-23T09:30:00-04:00,18.72,19.14,18.5,18.57001,130300,277575,16.472805276840674,31.97822756644918,NaN,NaN,-173.24790453541314,-169.57522067932217,-0.36206224177045065,-0.995703146940162,-0.6336409051697114,-3066000,-2744760,7.431747393407122,23.343369272193662,NaN,NaN,-48.832374627124366,-29.727902558459117
2002-07-24T09:30:00-04:00,18.2,19.82001,18.16,19.67999,953900,310370,33.06071716062641,31.611304103269646,NaN,NaN,-124.65819119579676,-163.92040683740143,-0.2850765699433865,-0.9899866175989445,-0.704910047655558,-2112100,-2672680,9.927334803660855,21.053888010470523,NaN,NaN,-45.93313157078488,-32.04293527450565
2002-07-25T09:30:00-04:00,19.81,20.39,19.56,20.22,87400,292550,39.36924642469638,30.923201717650084,NaN,NaN,-71.00161688069362,-148.9885449708617,-0.18099055045218904,-0.9311482357207943,-0.7501576852686053,-2024700,-2571600,13.451103506221799,19.10893922952739,NaN,NaN,-41.188753447184965,-33.34948072774555
2002-07-26T09:30:00-04:00,20.2,20.31,19.88,20.31,160800,293565,40.377757710242435,30.23634479251138,NaN,NaN,-58.71485472099515,-125.01357761334823,-0.09368099202129576,-0.867258925295225,-0.7735779332739292,-1863900,-2400480,19.213131653488517,17.704450746372355,NaN,NaN,-37.31972691499608,-33.91665875449563
2002-07-29T09:30:00-04:00,20.5,21.42,20.49001,21.32001,645500,318425,50.35730794558407,30.538175635897566,NaN,NaN,-6.1479182114096105,-86.75409710886167,0.03746290112532802,-0.7267493068672692,-0.7642122079925973,-1218400,-2057020,29.376203135888957,17.18482139277104,NaN,NaN,-30.107226266957614,-33.37245411341877
2002-07-30T09:30:00-04:00,21.38,21.38,20.38,20.52,203200,324205,44.06574931173163,31.01163062276723,NaN,NaN,-18.93986899725185,-55.89249000122943,0.07360989308295784,-0.6721998416388999,-0.7458097347218577,-1421600,-1728140,37.48595869104764,17.36679967371095,NaN,NaN,-26.60200481237025,-32.40524707041184
2002-07-31T09:30:00-04:00,20.55,20.59,20.06,20.56,907900,352690,44.43952491658397,31.754822005964893,NaN,NaN,-36.127116059506726,-38.18627497397143,0.10175948667002621,-0.6186103763843249,-0.7203698630543511,-513700,-1408460,44.194062793809245,18.334468990606986,NaN,NaN,-23.88482869951755,-31.18804444599837
2002-08-01T09:30:00-04:00,20.60001,20.67,20.2,20.42999,953600,395590,43.42383131254377,32.57437310140147,NaN,NaN,-29.774318760987576,-29.940815350030228,0.11233924620336189,-0.5799458053001487,-0.6922850515035106,-1467300,-1296980,46.35583957466543,19.8331035304195,NaN,NaN,-22.10871391359474,-29.890997227083563
2002-08-02T09:30:00-04:00,20.47,20.47,19.39,19.57001,203000,396725,37.34377256090622,33.251973569041,NaN,NaN,-68.42523687030346,-31.8828917798919,0.0645109417361367,-0.6116463743333398,-0.6761573160694765,-1670300,-1258260,47.12201533555283,21.831440096212923,NaN,NaN,-22.642836062136034,-28.855545632091058
2002-08-05T09:30:00-04:00,19.5,19.82001,18.88,18.89999,535800,419880,33.41784585757847,33.84145722766795,NaN,NaN,-105.34201470234335,-51.72171107807865,-0.005443397008342066,-0.6829615623299041,-0.6775181653215621,-2206100,-1455800,43.69334570403673,23.948708921508473,NaN,NaN,-24.46463038413589,-28.22827202524032
2002-08-06T09:30:00-04:00,19.10001,19.89999,19.10001,19.7,217000,422715,41.34667351640788,34.78632935929275,NaN,NaN,-68.77285381038583,-61.688308040705444,0.008227503590510055,-0.6672337858334245,-0.6754612894239346,-1989100,-1569300,41.81092348653329,26.129549427461484,NaN,NaN,-23.18003746146481,-27.507095658986675
2002-08-07T09:30:00-04:00,20.10001,20.19,19.50999,20.19,292300,423910,45.61826346164332,36.198485165294386,NaN,NaN,-26.576072014381808,-59.77809923168045,0.053793566815118266,-0.6082193309050368,-0.662012897720155,-1696800,-1805920,38.123408967774715,28.16242554240647,NaN,NaN,-20.658790394980144,-26.52876633555717
2002-08-08T09:30:00-04:00,19.95,20.60001,19.95,20.60001,69500,398425,48.96736238448812,38.225276415344545,NaN,NaN,23.329484887408547,-49.157338502001224,0.11173487038412455,-0.5223443097399993,-0.6340791801241239,-1627300,-1837920,37.63993174602313,30.250490535530137,NaN,NaN,-17.49868930565648,-25.238755331285642
2002-08-09T09:30:00-04:00,20.39999,20.89,20.39999,20.84,47600,388285,50.874429134097674,40.65252049814082,NaN,NaN,68.08823349552128,-21.85464442883623,0.16329041040267112,-0.42996616712078506,-0.5932565775234562,-1579700,-1819800,38.118493586168825,32.42453574130569,NaN,NaN,-14.365511218320744,-23.685434743719227
2002-08-12T09:30:00-04:00,20.82001,20.82001,20.42,20.74001,37600,348955,50.03546399310587,43.04985326358833,NaN,NaN,64.05845201589459,12.025448914811353,0.1860719497210377,-0.360666640372159,-0.5467385900931967,-1617300,-1702040,41.27273925239022,34.84174944551877,NaN,NaN,-12.127147692029448,-22.034250879192115
2002-08-13T09:30:00-04:00,20.58,20.87,20.39,20.39999,307100,317655,47.18583333428909,44.05879013313567,NaN,NaN,53.04288615812045,36.38859690851261,0.17388200745172477,-0.3293860807785407,-0.5032680882302655,-1924400,-1689100,41.62485364951832,37.10585793450859,NaN,NaN,-11.103246531503357,-20.47267882952229
2002-08-14T09:30:00-04:00,20.39999,20.71001,19.7,20.66,70800,314325,49.5518935057203,44.786122067494524,NaN,NaN,34.67280764327272,48.638372840043516,0.17830783550294127,-0.2803832938515889,-0.45869112935453016,-1853600,-1720460,40.98352621010234,39.07245955621433,NaN,NaN,-9.5539410596691,-18.91285914811469
2002-08-15T09:30:00-04:00,20.8,20.8,20.34,20.64999,222300,322560,49.46002674359123,45.434855569876575,NaN,NaN,65.90312734516054,57.153101331593916,0.17527765206119705,-0.23959406427803387,-0.4148717163392309,-2075900,-1810180,39.12618171043572,40.49482027456771,NaN,NaN,-8.323474677973863,-17.400089938094574
2002-08-16T09:30:00-04:00,20.63,20.63,19.95,20.28,62700,316225,46.0608722413157,45.127967305285985,NaN,NaN,24.42518171061687,48.42049097461304,0.14436045644061413,-0.2344211457884633,-0.3787816022290774,-2138600,-1921960,36.8834651926603,41.0310532786228,NaN,NaN,-8.205634422221216,-16.08659629296981
2002-08-19T09:30:00-04:00,20.24001,20.7,20.23,20.7,105700,310700,50.24137857184114,45.56908368100809,NaN,NaN,52.662744937485996,46.14134955893132,0.1476712418881861,-0.19419254986884482,-0.3418637917570309,-2032900,-2005080,35.26473790749593,40.87239465122626,NaN,NaN,-6.909434284115329,-14.77557314884774
2002-08-20T09:30:00-04:00,20.48,20.53999,20.3,20.36,128300,310600,47.061537684420735,45.75637030728215,NaN,NaN,24.910583693551906,40.51488906601761,0.12342390878660814,-0.1875839057737707,-0.31100781456037885,-2161200,-2052440,34.33997005156854,40.168530883923346,NaN,NaN,-6.705795900470106,-13.622747827650937
2002-08-21T09:30:00-04:00,20.60001,20.7,20.33,20.61,51700,265490,49.588059385279024,46.19667231247752,NaN,NaN,46.231886566824386,42.82670485072794,0.12054587973410563,-0.1603254648927468,-0.2808713446268524,-2109500,-2103620,33.32299712363957,39.23761356599293,NaN,NaN,-5.8184330514665845,-12.507845716767457
2002-08-22T09:30:00-04:00,20.66,20.92999,20.61,20.82001,33600,262800,51.674530801625416,47.22029790110032,NaN,NaN,89.66201737734816,47.57848285716547,0.12838577068609403,-0.1203891312692349,-0.24877490195532892,-2075900,-2103620,33.32299712363955,38.25196940799913,NaN,NaN,-4.483992445959504,-11.361580963794893
2002-08-23T09:30:00-04:00,20.62,20.75999,20.47,20.53,336600,271590,48.67832051215586,48.310331804998704,NaN,NaN,44.14061958805296,51.52157043265269,0.11032974081450089,-0.11086272593720281,-0.2211924667517037,-2412500,-2158400,32.141410608182085,37.42683118686665,NaN,NaN,-4.168182161791156,-10.333952563508644
2002-08-26T09:30:00-04:00,20.52,20.75999,20.39,20.75999,21800,240405,51.09983322138788,49.00698606964013,NaN,NaN,62.25337627379025,53.43969669991354,0.10992289776854236,-0.08378884454102575,-0.1937117423095681,-2390700,-2229960,30.61427220967353,36.62707038137666,NaN,NaN,-3.228334787763903,-9.318864309830824
2002-08-27T09:30:00-04:00,21.10001,21.12,20.85001,20.85001,101600,235325,52.05341579124331,49.4666398074687,NaN,NaN,125.99779346751696,73.65713865470654,0.11141645556437901,-0.05444117285409433,-0.16585762841847335,-2289100,-2255540,30.064376218865775,36.05142518502603,NaN,NaN,-2.1839786614696366,-8.29959493149351
2002-08-28T09:30:00-04:00,20.64,20.64,20.14999,20.28,26600,191260,45.94393501750034,49.250680709826725,NaN,NaN,-2.02365213780592,64.00603091378049,0.07164733973428788,-0.0762984537506135,-0.1479457934849014,-2315700,-2296780,29.155144430727205,35.445368948219176,NaN,NaN,-2.970886496075827,-7.538350869290984
2002-08-29T09:30:00-04:00,20.03999,20.41,19.95,20.22,1451300,216145,45.34068601201645,48.855413343963775,NaN,NaN,-34.48273392575265,39.17708065316032,0.040484690177081395,-0.09733993076354963,-0.13782462094063103,-3767000,-2635000,23.009193128180684,34.36613320122002,NaN,NaN,-3.788613838150475,-7.002674150556626
2002-08-30T09:30:00-04:00,20.2,20.73,20.2,20.45,20000,206995,48.15109351339687,48.72081545255599,NaN,NaN,17.640603152643337,33.87707736607839,0.0347648542373864,-0.09436855314389803,-0.12913340738128443,-3747000,-2901900,19.513433364920417,32.81189706640075,NaN,NaN,-3.7300178039071508,-6.535151815320987
2002-09-03T09:30:00-04:00,20.25,20.25,19.78,19.85001,184300,189420,42.07370823285603,48.35566365959648,NaN,NaN,-131.5943849773567,-4.8924748841509995,-0.007755334711561979,-0.1388275757707369,-0.13107224105917492,-3931300,-3210020,16.41322963552973,31.011066779687276,NaN,NaN,-5.467212202040914,-6.382589013423833
2002-09-04T09:30:00-04:00,19.82001,19.92999,19.71001,19.92999,33200,180230,43.1045924695548,47.89514215701324,NaN,NaN,-176.99185623774252,-65.4904048252029,-0.027700520576767224,-0.16569789178013394,-0.13799737120336672,-3898100,-3531820,13.92494106666237,29.07831069801299,NaN,NaN,-6.610100830718518,-6.415090701608788
2002-09-05T09:30:00-04:00,19.64,19.72,19.38,19.39,244300,177830,38.166033947641615,47.088428385873975,NaN,NaN,-250.07415927176805,-115.10050625199533,-0.07195247420605883,-0.22793796396094024,-0.1559854897548814,-4142400,-3897160,11.747493185928349,27.122690089119608,NaN,NaN,-9.12658664599014,-6.802447265091838
2002-09-06T09:30:00-04:00,19.55,20,19.55,19.78,30800,175895,43.225380906744135,46.885893290547436,NaN,NaN,-144.984600883387,-137.2008796435222,-0.06960589502040898,-0.24299285853039265,-0.17338696350998367,-4111600,-3966080,11.385791642064035,25.30142769264845,NaN,NaN,-9.788756275977976,-7.229062838075572
2002-09-09T09:30:00-04:00,19.81,20.12,19.72,20.07001,264800,186755,46.71671494294581,46.634131602769195,NaN,NaN,-87.01921510587121,-158.13284329522511,-0.04439775207895588,-0.22888415360867853,-0.18448640152972265,-3846800,-3986040,11.277494317137013,23.588053150479958,NaN,NaN,-9.3031868895928,-7.525366274006605
2002-09-10T09:30:00-04:00,20.08,20.25999,19.99001,20.17999,158200,192785,48.02210788978123,46.70274376029494,NaN,NaN,-41.216439419331586,-140.05725418362007,-0.01756977894429096,-0.20644862521008633,-0.18887884626579537,-3688600,-3937500,13.433879652063723,22.09476097908675,NaN,NaN,-8.525642131556726,-7.668262825085193
2002-09-11T09:30:00-04:00,20.3,20.49001,20.3,20.3,75300,181195,49.47666469337103,46.69478699658723,NaN,NaN,11.94223561968013,-102.27043581213556,0.009547241939618312,-0.17694479384127249,-0.1864920357808908,-3613300,-3880540,16.013506639985067,20.85836880168286,NaN,NaN,-7.466936833263106,-7.63950196911061
2002-09-12T09:30:00-04:00,20.31,20.31,19.91,19.91,55800,180445,45.06332727550061,46.2225581732926,NaN,NaN,-57.405602040171516,-63.73672436581624,0.002854506490243297,-0.18292390266808667,-0.18577840915832997,-3669100,-3785880,20.26590767631015,19.925719555445045,NaN,NaN,-7.800567289132474,-7.662511300542304
2002-09-13T09:30:00-04:00,19.96001,19.96001,19.42999,19.78999,133500,176005,43.76950141173732,45.871928237548424,NaN,NaN,-112.73997874174198,-57.28779993748723,-0.007455059917095774,-0.1950972340546997,-0.18764217413760392,-3802600,-3724080,23.006750152988445,19.273243808645496,NaN,NaN,-8.444081445587882,-7.774164178405958
2002-09-16T09:30:00-04:00,19.7,19.82001,19.53999,19.63,155900,180665,42.03672880915333,45.224563636674525,NaN,NaN,-109.80195212008442,-61.844347340329875,-0.02202558000227861,-0.2151741491404522,-0.19314856913817358,-3958500,-3746420,22.702940540787168,18.70814868943933,NaN,NaN,-9.473242095907569,-8.016889595191902
2002-09-17T09:30:00-04:00,19.82001,19.88,19.25999,19.25999,87800,179770,38.26392045821665,44.23959968431547,NaN,NaN,-130.60567568727896,-79.72219459391935,-0.05185575756768249,-0.2579682660977767,-0.2061125085300942,-4046300,-3817960,21.71407331246479,18.11169848183926,NaN,NaN,-11.477208381981887,-8.511220850447614
2002-09-18T09:30:00-04:00,19.12,19.24001,18.8,19.10001,88400,177775,36.72901365299901,43.581391015422525,NaN,NaN,-175.5748894600763,-117.22561960987063,-0.07616483192052456,-0.3013185484307499,-0.22515371651022534,-4134700,-3922240,20.32440701166047,17.480931523334487,NaN,NaN,-13.609885769438709,-9.239601553160627
2002-09-19T09:30:00-04:00,18.96001,19.03,18.67999,18.67999,252400,187810,32.98762707219703,42.699029662578276,NaN,NaN,-185.42313650793324,-142.829126503423,-0.11216061413549505,-0.36535448417959415,-0.2531938700440991,-4387100,-4065840,18.562645203818263,17.163320957308603,NaN,NaN,-16.632675799153223,-10.295755016873855
2002-09-20T09:30:00-04:00,18.67999,18.95,18.64999,18.92999,321700,202215,37.094991747321515,41.909308107858614,NaN,NaN,-156.40304438691243,-151.5617396324571,-0.11057969220689001,-0.3914184853027116,-0.2808387930958216,-4065400,-4118400,17.949358103847658,17.0516012958034,NaN,NaN,-18.02051235343394,-11.399291779239581
2002-09-23T09:30:00-04:00,18.78,18.78,18.41,18.58,105600,190665,33.957091970139956,41.32954980337889,NaN,NaN,-165.4577439712205,-162.6928980026843,-0.12356722127011854,-0.4352978196834698,-0.31173059841335127,-4171000,-4160900,17.447393854000325,17.125470168551303,NaN,NaN,-20.172901375423113,-12.65266457869437
2002-09-24T09:30:00-04:00,18.07001,18.12,17.7,17.8,1211800,250165,28.22644534186476,40.26682500854388,NaN,NaN,-212.9789402117764,-179.1675509075838,-0.17216574436874366,-0.5269377788742808,-0.3547720345055372,-5382800,-4428200,14.668864042239235,17.178607523949648,NaN,NaN,-24.088179881378018,-14.28630962193489
2002-09-25T09:30:00-04:00,18.00999,18.35001,17.94,18.24001,307600,260465,34.90069039742323,40.03358618352828,NaN,NaN,-150.712084722556,-174.19498996007974,-0.16228634515191764,-0.5576299659454342,-0.3953436207935166,-5075200,-4616300,13.089176023275854,17.274442012331615,NaN,NaN,-25.181730404603236,-15.842798305173226
2002-09-26T09:30:00-04:00,18.32001,18.52,18.2,18.5,948300,306550,38.53754846304979,39.698741008978686,NaN,NaN,-108.50440368999284,-158.81124339649165,-0.12739058399796904,-0.5545818507909779,-0.42719126679300884,-4126900,-4564260,15.79105711544264,17.589103831858658,NaN,NaN,-24.891707372891346,-17.135499600561527
2002-09-27T09:30:00-04:00,18.35001,18.42999,17.92,17.97,60700,237020,34.327422637097314,38.813791558560936,NaN,NaN,-119.57957471646114,-151.44654946240138,-0.12876931262142138,-0.5881529075697856,-0.45938359494836417,-4187600,-4588700,15.546614572199275,17.894040992934535,NaN,NaN,-26.035299549302525,-18.406899593238812
2002-09-30T09:30:00-04:00,17.55,17.83,17.25999,17.69,358200,253930,32.31864884941022,37.69211591282016,NaN,NaN,-145.83830525791052,-147.52266171973938,-0.13656400618578107,-0.6300886026805905,-0.49352459649480945,-4545800,-4663660,14.79037759245439,17.99093370296244,NaN,NaN,-27.6219620211195,-19.72333708293605
2002-10-01T09:30:00-04:00,17.88,18.8,17.78,18.78999,478800,268655,45.749634699093235,37.42589948465746,NaN,NaN,-60.494321550739215,-117.02573798753193,-0.059592496674550244,-0.5680152173379973,-0.5084227206634471,-4067000,-4400500,28.026729359584863,18.849021040076714,NaN,NaN,-24.208556840784023,-20.36408276262862
2002-10-02T09:30:00-04:00,18.23,18.41,17.75,17.92999,350000,284495,39.199970824072004,37.00708830955541,NaN,NaN,-89.81344602038402,-104.84601024709755,-0.05847230653949076,-0.5815131038378105,-0.5230407972983198,-4417000,-4268860,33.5845137591369,19.800350045992907,NaN,NaN,-23.759994122678606,-20.849212956921473
2002-10-03T09:30:00-04:00,17.82001,18.14,17.77,17.77,159200,280240,38.10698374618299,36.60262276201581,NaN,NaN,-91.75888334464524,-101.49690617802801,-0.06014670305973624,-0.5982241761229901,-0.5380774730632538,-4576200,-4358720,31.78044276347495,20.427042375313373,NaN,NaN,-23.802951685330314,-21.27117563240845
2002-10-04T09:30:00-04:00,17.89999,17.95,17.32001,17.55,50400,281220,36.5959410740634,36.213995066652245,NaN,NaN,-106.65418639817086,-98.91182851436997,-0.06717752922598097,-0.62204938459573,-0.554871855369749,-4626600,-4446520,30.080210638942134,20.9539902394673,NaN,NaN,-24.341120776391058,-21.709739224405965
2002-10-07T09:30:00-04:00,17.39999,17.53,16.98,17.03,84200,272190,33.24081275657143,35.855201659391874,NaN,NaN,-130.10430272840662,-95.76502800846919,-0.09618928216510314,-0.675108458076128,-0.5789191759110248,-4710800,-4479520,29.442638819865607,21.506030632853076,NaN,NaN,-25.918746596141162,-22.311025991796708
2002-10-08T09:30:00-04:00,17.16,17.42,16.67999,17.3,226000,275580,36.49633102313388,35.838581471544366,NaN,NaN,-124.39378619885629,-108.5449209380926,-0.08682222088833425,-0.6874469520214426,-0.6006247311331083,-4484800,-4563080,27.833879215023302,22.042421504521847,NaN,NaN,-26.13532544431127,-22.857354485013072
2002-10-09T09:30:00-04:00,17.10001,17.10001,16.60001,16.63,230400,283335,32.288548033861034,35.78864725452037,NaN,NaN,-144.860565180023,-119.5543447700204,-0.11368181779756503,-0.7427270033800646,-0.6290451855824996,-4715200,-4622720,26.712003440132406,22.624518521401427,NaN,NaN,-27.72887435801395,-23.553285895441768
2002-10-10T09:30:00-04:00,16.73,17.39,16.53,17.39,610200,311055,40.64774946976147,36.042415663266084,NaN,NaN,-106.90919690589664,-122.58440748227068,-0.07032119465993292,-0.7169466789074157,-0.6466254842474828,-4105000,-4528480,31.416092982059695,23.586428155559428,NaN,NaN,-26.206588497094664,-23.932329124249325
2002-10-11T09:30:00-04:00,17.53,18.28,17.53,18.09,57300,307245,47.122761257132545,36.98282061233698,NaN,NaN,-18.07486284461345,-104.86854277155919,0.011110282894523094,-0.6327376306293289,-0.643847913523852,-4047700,-4412700,36.78454356038591,24.96765313458697,NaN,NaN,-22.64140348572449,-23.747911175888635
2002-10-14T09:30:00-04:00,18.07001,18.12,17.95,18.06,57700,302335,46.88668040948669,38.315694545738545,NaN,NaN,-1.3786480433513766,-79.12341183454815,0.06552284466089497,-0.5619443576977332,-0.6274672023586282,-4105400,-4291620,41.90587087691824,26.91315362277833,NaN,NaN,-19.98847737400498,-23.21084920419097
2002-10-15T09:30:00-04:00,18.35001,19.00999,18.35001,19.00999,1025800,349235,54.636918366748674,39.725425114976076,NaN,NaN,101.37458046532274,-33.96973850171234,0.16253940960217605,-0.42429294035590814,-0.5868323499580842,-3079600,-4010580,51.689148082862424,29.67029448417737,NaN,NaN,-14.940537698101569,-22.029376131892484
2002-10-16T09:30:00-04:00,18.98,19.03999,18.5,18.53999,122800,350955,50.695567588631015,40.5938550525176,NaN,NaN,93.9160304864951,13.785580631591277,0.19018266507302506,-0.34910401861680285,-0.5392866836898279,-3202400,-3708020,59.58079945128555,32.79813322245186,NaN,NaN,-12.150781938119136,-20.618148389924862
2002-10-17T09:30:00-04:00,19.10001,19.2,18.98,19.07001,939000,385285,54.66704422588541,42.04668516600246,NaN,NaN,141.3051402799546,63.42844806876152,0.2362804444292954,-0.24393612815320864,-0.48021657258250405,-2263400,-3339700,66.70992742735521,36.452655569248684,NaN,NaN,-8.506734207475755,-18.887946363860703
2002-10-18T09:30:00-04:00,18.95,19.08,18.67999,18.95,37100,371055,53.613982143958694,43.567780401327354,NaN,NaN,116.421456209215,90.32771187952721,0.24950671312771072,-0.16833318117286566,-0.4178398943005764,-2300500,-2990260,71.79311184448213,40.52427944439353,NaN,NaN,-5.969687310409742,-17.04248078479628
2002-10-21T09:30:00-04:00,18.85001,19.60001,18.75999,19.60001,60700,368810,58.29949353193705,44.46419888938762,NaN,NaN,155.2236413091314,121.64816975002377,0.2900086141358705,-0.0553291266307383,-0.3453377407666088,-2239800,-2617140,76.00603667551096,43.95137282410253,NaN,NaN,-2.2646694863155985,-14.931364885013325
2002-10-22T09:30:00-04:00,19.45,19.45,19.09,19.14,680400,342240,54.13216961117826,45.53078451703807,NaN,NaN,123.77988734480344,126.12923112591992,0.27398330499668977,-0.002858609520746569,-0.27684191451743634,-2920200,-2585260,76.33131648261367,47.00471587577944,NaN,NaN,-0.5069820822379281,-12.870738770331126
2002-10-23T09:30:00-04:00,19.2,19.38,18.78,19.11,57800,329750,53.861766468397285,46.65612614005338,NaN,NaN,95.2431540947884,126.39465584757856,0.25018567908186584,0.03589018433489599,-0.21429549474696985,-2978000,-2540380,76.8079810705337,50.220968611997925,NaN,NaN,0.8022003086226279,-10.917461759052019
2002-10-24T09:30:00-04:00,19.12,19.14999,18.48,18.48,667900,315730,48.39465784451415,47.498891623657,NaN,NaN,52.343478044815164,108.60232340055067,0.18390320440045071,0.015583510753593544,-0.16831969364685717,-3645900,-2816880,67.7547150817893,52.912004643629864,NaN,NaN,0.25590586666694254,-9.321266383949311
2002-10-25T09:30:00-04:00,18.38,19.02,18.36,19.02,56700,315530,52.8155870470125,48.89708978725993,NaN,NaN,56.3158236931831,96.58119689734431,0.16871420049386893,0.04257305697047897,-0.12614114352338995,-3589200,-3074620,60.585981354244495,55.136529110371214,NaN,NaN,1.16412725648539,-7.8233530067443535
2002-10-28T09:30:00-05:00,19,19.02,18.69,18.73,60400,300640,50.32232176309179,49.88466055439979,NaN,NaN,52.27871046633927,75.99221072878586,0.13299263214840013,0.04009964666211019,-0.09289298548628992,-3649600,-3356580,53.87095169646875,56.99632000190303,NaN,NaN,1.1511117262006816,-6.541286616323634
2002-10-29T09:30:00-05:00,18.64999,18.73,18.3,18.64,501800,301790,49.54069810565067,51.11695698809905,NaN,NaN,26.42232577833037,56.52069841549125,0.09873464948749347,0.030525326373076922,-0.06820932311441655,-4151400,-3602820,48.78557636026324,58.57300378191237,NaN,NaN,0.9123358443907582,-5.47648340765015
2002-10-30T09:30:00-05:00,18.64999,18.77,18.41,18.63,71400,287860,49.44879400204586,51.74560302611936,NaN,NaN,28.286239219100988,43.12931544035378,0.07207025090628749,0.021878490518442817,-0.050191760387844675,-4222800,-3851780,44.238574376525975,59.48889531008854,NaN,NaN,0.6923517840805644,-4.595221237402905
2002-10-31T09:30:00-05:00,18.74001,18.87,18.53999,18.7,113600,285580,50.14599113301415,51.96154801725377,NaN,NaN,34.81232374860835,39.623084581112415,0.05650430597380991,0.020438622079417712,-0.0360656838943922,-4109200,-3944440,42.645435409303346,59.907530442154076,NaN,NaN,0.6927010949926444,-3.839803761346398
2002-11-01T09:30:00-05:00,18.52,19.12,18.52,19.10001,56900,285905,54.046325220096655,52.47295121801162,NaN,NaN,52.041444590819296,38.76820876063965,0.069642331823948,0.0509872308855428,-0.018655100938405198,-4052300,-4037060,41.053942982757555,59.84667844971403,NaN,NaN,1.753656346857878,-3.0407380316029298
2002-11-04T09:30:00-05:00,19.25,19.42999,19,19.03999,89500,286170,53.371607936917556,52.38257190159511,NaN,NaN,76.29810704729235,43.57208807683027,0.07056596460022474,0.06955235481187572,-0.0010136097883490167,-4141800,-4135500,39.37214951697049,58.9668928378646,NaN,NaN,2.465041069618188,-2.254198159999913
2002-11-05T09:30:00-05:00,19,19.21001,18.95,19.2,25300,276135,54.985031634514094,52.688962190586764,NaN,NaN,71.769852123236,52.641593345811394,0.07766640053600676,0.09606939088165944,0.018402990345652678,-4116500,-4128520,39.56121055760016,57.53692220260136,NaN,NaN,3.498219148550557,-1.4324242587784175
2002-11-06T09:30:00-05:00,19.14999,19.78999,19.12,19.7,64700,267850,59.67993616569623,53.047025900573246,NaN,NaN,141.46653710441794,75.2776529228748,0.10978647052718311,0.15563607850463157,0.045849607977448456,-4051800,-4094320,40.53960290051134,55.6676133078268,NaN,NaN,5.740074934224919,-0.4077815169207981
2002-11-07T09:30:00-05:00,19.59,19.59,19.2,19.28999,30100,238845,54.64674693862058,53.12079481447766,NaN,NaN,108.41080417271539,89.9973490076962,0.09757963746402534,0.16782415480748014,0.0702445173434548,-4081900,-4088860,40.704635314608645,53.44700784140726,NaN,NaN,6.3119464125147555,0.5521796158557094
2002-11-08T09:30:00-05:00,19.21001,19.58,18.88,19,38900,237925,51.3482662265739,52.6242785783803,NaN,NaN,55.71745486276759,90.73255106208586,0.06566645496051475,0.15232758604409824,0.08666113108358349,-4120800,-4102560,40.401628132848465,50.90383580264565,NaN,NaN,5.866600579072993,1.3113826106010356
2002-11-11T09:30:00-05:00,18.95,18.95,18.35001,18.45,67800,238430,45.712546337027845,52.022876915940984,NaN,NaN,-101.38578392394923,55.19577286783753,0.006331758261047274,0.09457582890989258,0.0882440706488453,-4188600,-4111920,40.18155059887598,48.321709668092964,NaN,NaN,3.7754156939015173,1.6633873367868186
2002-11-12T09:30:00-05:00,18.39999,18.94,18.39999,18.7,17900,188035,48.48049057452115,51.638500066378406,NaN,NaN,-72.09667540607911,26.42246736197452,-0.01604008975024332,0.06819395846104115,0.08423404821128447,-4170700,-4122760,39.910405907693516,45.68616858503295,NaN,NaN,2.8178576475143196,1.8283116668907473
2002-11-13T09:30:00-05:00,18.55,18.94,18.46001,18.67999,84700,186130,48.26835567017812,51.62947848249727,NaN,NaN,-68.53566000780984,-15.577972060471035,-0.03126641985096959,0.04515102339757249,0.07641744324854208,-4255400,-4163480,38.84986577705011,43.6215364918373,NaN,NaN,1.9776580453463015,1.8496468638129693
2002-11-14T09:30:00-05:00,18.85001,19.3,18.85001,19.25,39200,141140,54.39071058673774,51.741987306763356,NaN,NaN,47.761527390956395,-27.70782741682284,-0.0034909278717585035,0.07205378340884394,0.07554471128060244,-4216200,-4190340,38.13009896649227,42.01754489271214,NaN,NaN,3.013904032299989,2.015969316453972
2002-11-15T09:30:00-05:00,19.2,19.44,19.17,19.3,58500,142210,54.89497619382589,52.06860548038721,NaN,NaN,82.4507580477692,-22.36116677982252,0.016603369085985364,0.09629892263808415,0.07969555355209879,-4157700,-4197720,37.922210223887035,40.87834907324201,NaN,NaN,4.0041708218514795,2.2999981029393304
2002-11-18T09:30:00-05:00,19.42,19.42999,19.03,19.08,53300,141840,52.16222848106152,52.25585765005942,NaN,NaN,54.893821574524864,8.894754319872296,0.013561253895543232,0.09664712092152783,0.0830858670259846,-4211000,-4202200,37.7875256580638,40.092774023084914,NaN,NaN,4.086890320869086,2.5552684197864384
2002-11-19T09:30:00-05:00,19.02,19.31,18.94,19.08,53800,110510,52.16222848106152,52.44967439856054,NaN,NaN,39.35450177291014,31.18498975567014,0.010186133701643951,0.09581853415303954,0.08563240045139558,-4211000,-4210260,37.52927816656061,39.613538579515954,NaN,NaN,4.1550853556098835,2.7838136963326447
2002-11-20T09:30:00-05:00,19,19.28999,18.92,19.28999,130700,114155,54.660768950056394,52.77215852834927,NaN,NaN,52.39497716306565,55.37111718984524,0.02015707676656535,0.11082874640960227,0.09067166964303693,-4080300,-4175240,39.46507358970698,39.38636987811621,NaN,NaN,4.882426009669919,3.083615455380827
2002-11-21T09:30:00-05:00,19.3,20.07001,19.28999,20.07001,106300,86075,62.496493059694885,53.375741945463425,NaN,NaN,186.85064611737332,83.18894093512863,0.07430242126491432,0.18354969622417983,0.1092472749592655,-3974000,-4126800,42.136012582210085,39.46366056379139,NaN,NaN,7.95754575268099,3.779891212137993
2002-11-22T09:30:00-05:00,20,20.24001,19.8,19.83,88600,87670,59.11129751573838,53.78571977252206,NaN,NaN,191.30543068824386,104.95987546322355,0.08803175447999395,0.21928696805925796,0.131255213579264,-4062600,-4107780,43.195825632238105,39.73678028631051,NaN,NaN,9.543996656197574,4.603334847003648
2002-11-25T09:30:00-05:00,19.78999,20.10001,19.7,20.02,120900,90695,60.91612094714751,54.20936900913873,NaN,NaN,166.37568234937783,127.25624761819415,0.10295099191996965,0.25994395347922605,0.1569929615592564,-3941700,-4053920,46.20077687360928,40.2110350231683,NaN,NaN,11.404081399423733,5.574870068777946
2002-11-26T09:30:00-05:00,19.95,19.95,19.60001,19.83,238500,77530,58.151856070235226,54.10022043089152,NaN,NaN,119.59875999692026,143.30509926299618,0.0933485888102194,0.27367869757203067,0.18033010876181127,-4180200,-4047760,46.54904337759346,40.640280771531316,NaN,NaN,12.179754468545724,6.518424983030485
2002-11-27T09:30:00-05:00,19.89,20.49001,19.85001,20.49001,121100,80015,64.22494120914519,54.78437716450043,NaN,NaN,177.51602445257808,168.3293087208987,0.12291276241053342,0.33397106177497804,0.21105829936444462,-4059100,-4043520,46.80430294788784,41.075971316765546,NaN,NaN,14.791765866961226,7.70033082359202
2002-11-29T09:30:00-05:00,20.55,21,20.55,20.95,38300,76250,67.73888711570906,55.95513579943866,NaN,NaN,216.89666269426456,174.33851203627694,0.16243103251238233,0.41409709000492256,0.25166605749254023,-4020800,-4052880,46.27888594491234,41.49577544619867,NaN,NaN,18.17987705259637,9.197408856306927
2002-12-02T09:30:00-05:00,21.14999,21.14999,20.34,20.56,113300,79070,62.16378218667394,57.13022407441338,NaN,NaN,159.9664358198239,168.07071306259294,0.15150213519102246,0.4410437264813183,0.28954159129029583,-4134100,-4067180,45.43962321985974,41.87135206198322,NaN,NaN,19.261852354883505,10.635186498960724
2002-12-03T09:30:00-05:00,20.5,20.5,20.27,20.32001,67100,77950,58.94862724831312,57.877948122541376,NaN,NaN,102.61967793318861,155.3195121793551,0.1187548252470228,0.4379851228490743,0.3192302976020515,-4201200,-4119080,42.43199278219504,42.0514654101619,NaN,NaN,19.141760791172764,11.85041139784816
2002-12-04T09:30:00-05:00,20.17999,20.38,19.92,20.21001,227700,88070,57.48114087071002,58.536004208293654,NaN,NaN,70.11438041774913,145.42263626352087,0.08207381691496712,0.4218225687457604,0.3397487518307933,-4428900,-4168820,39.718634371131486,42.11352030973915,NaN,NaN,18.60131701732427,12.814826486344746
2002-12-05T09:30:00-05:00,20.17999,20.17999,19.91,20.05,30400,86355,55.32364347678681,58.60264227186858,NaN,NaN,50.37104825451971,119.9936410239092,0.04147153751284238,0.3915881737218463,0.3501166362090039,-4459300,-4248860,35.756290401452645,41.94396255509346,NaN,NaN,17.516539907784423,13.4864998322647
2002-12-06T09:30:00-05:00,19.85001,20.25,19.73,20.17,85700,89135,56.638116985953275,58.72715232844911,NaN,NaN,46.28918636410011,85.87214575787631,0.018314981972751554,0.37301036367494333,0.3546953817021918,-4373600,-4319420,32.66280858744847,41.56829100963357,NaN,NaN,16.981752407588054,13.985821628739465
2002-12-09T09:30:00-05:00,20,20.08,19.71001,19.71001,27300,88555,50.50400453619444,58.6087077609586,NaN,NaN,18.238772472221942,57.526613088355916,-0.029748377310911178,0.3175099100635528,0.34725828737446396,-4400900,-4372780,30.512897526544975,41.04867471452508,NaN,NaN,14.664367468795215,14.08275674874743
2002-12-10T09:30:00-05:00,19.85001,19.85001,19.60001,19.85001,47000,87515,52.20079392221634,58.61146243532679,NaN,NaN,3.6898812862392463,37.74065375896605,-0.05254551525815865,0.28157639330176565,0.3341219085599243,-4353900,-4403320,29.32325352618598,40.46253009735546,NaN,NaN,13.220819006260632,13.95962278553503
2002-12-11T09:30:00-05:00,19.83,20.12,19.66,20.07001,251600,99200,54.82178916105913,58.62296387896985,NaN,NaN,22.911662259985132,28.300110127413227,-0.05308603655455679,0.26776436286672833,0.3208503994212851,-4102300,-4338000,35.14728307724677,40.15411648932259,NaN,NaN,12.736138709303003,13.784839346073312
2002-12-12T09:30:00-05:00,20.11,20.13,19.88,19.88,31800,96555,52.16146948204799,57.88474790913792,NaN,NaN,17.438477215727996,21.7135959196549,-0.06569309322336753,0.23873403289207573,0.30442712611544326,-4134100,-4272960,40.41255522057459,40.03101239206291,NaN,NaN,11.56296391669173,13.467428570447371
2002-12-13T09:30:00-05:00,19.88,19.94,19.67,19.75999,151200,102155,50.4947871596974,57.269282883706424,NaN,NaN,-21.819607286712124,8.091837189492455,-0.08058537343817795,0.2036954093177208,0.28428078275589874,-4285300,-4255300,41.79437826435277,39.93090900864253,NaN,NaN,10.108427367542468,12.987571255746671
2002-12-16T09:30:00-05:00,19.71001,20.46001,19.71001,20.41,93600,103910,58.27190765599189,57.080410505766736,NaN,NaN,53.57912252805447,15.159907200658944,-0.04680476170260495,0.2257748306276426,0.27257959233024753,-4191700,-4213460,45.045877143966315,39.848416170810886,NaN,NaN,11.102624572993196,12.71829315821046
2002-12-17T09:30:00-05:00,20.47,20.56,20.25999,20.25999,260900,114290,56.0822404832125,56.932580820979396,NaN,NaN,80.68197626885924,30.558326197182943,-0.03523648961799647,0.22853398030775196,0.26377046992574843,-4452600,-4233200,43.80262568826979,39.652243478716336,NaN,NaN,11.273115293223569,12.511839177498048
2002-12-18T09:30:00-05:00,20.06,20.14,19.88,20.05,292400,126220,53.07563034069482,56.13620147323294,NaN,NaN,-6.600664393737956,24.655860866438324,-0.04194438202875922,0.2113399923897994,0.2532843744185586,-4745000,-4361740,36.699631456051385,38.93048122929945,NaN,NaN,10.530330278531176,12.228766477645639
2002-12-19T09:30:00-05:00,19.89999,20.14,19.74001,19.8,659800,152675,49.66210622162308,54.84500283794109,NaN,NaN,-55.8428189548954,9.999601632313645,-0.06221352647086137,0.17551746632998189,0.23773099280084325,-5404800,-4615880,27.280464552553227,37.57345112984523,NaN,NaN,8.883935942906556,11.750933544111485
2002-12-20T09:30:00-05:00,19.85001,20.02,19.77,19.99001,89100,151815,52.17945542948005,54.131836640998664,NaN,NaN,-48.69328005933486,4.624867077789096,-0.06169785144852677,0.1606086784901848,0.22230652993871156,-5315700,-4821960,22.285610256904405,35.91959306106271,NaN,NaN,8.220883058305303,11.246640617567744
2002-12-23T09:30:00-05:00,20,20.02,19.82001,19.89,38200,149295,50.74112016483339,53.545586135035826,NaN,NaN,-52.566635585822915,-16.60428454498638,-0.06654946376829568,0.13911970022834197,0.20566916399663765,-5353900,-5054400,18.231060005158227,34.190955005560085,NaN,NaN,7.260917083985463,10.677251541341704
2002-12-24T09:30:00-05:00,19.95,19.97,19.84,19.89999,215600,154030,50.88675523123908,53.074558589359334,NaN,NaN,-53.688515590806816,-43.47838291691959,-0.06733923556829971,0.12149511953626302,0.18883435510456273,-5138300,-5191540,16.341939287939567,32.521191071046374,NaN,NaN,6.508310537376986,10.081688540775316
2002-12-26T09:30:00-05:00,19.82001,20.14999,19.81,19.92,146500,149430,51.19798808648372,52.77986891862339,NaN,NaN,-40.56192954153659,-50.27063594647932,-0.06474879054801061,0.10789836691954946,0.17264715746756007,-4991800,-5240900,15.710916560168059,31.089378653811764,NaN,NaN,5.957571464064962,9.492528958388123
2002-12-27T09:30:00-05:00,19.81,19.88,19.62,19.7,89100,147830,47.62461346470384,52.136047238534154,NaN,NaN,-101.43651064301238,-59.389374284102715,-0.07534478842079986,0.07846617194156025,0.1538109603623601,-5080900,-5176120,20.07291836468157,30.190100780756982,NaN,NaN,4.515315557910086,8.781498472605547
2002-12-30T09:30:00-05:00,19.75999,19.81,19.53,19.75999,594600,175645,48.67653296168939,52.005513554640935,NaN,NaN,-115.05931086191796,-72.66258044461934,-0.07561029981177098,0.05929808559764638,0.13490838540941735,-4486300,-5010240,30.0547552785213,30.157376334469575,NaN,NaN,3.5578560174019653,8.035263836147893
2002-12-31T09:30:00-05:00,19.78,19.91,19.55,19.84,319500,185955,50.11556483901458,51.85656862012653,NaN,NaN,-91.23359843032603,-80.39597301351996,-0.06793698306757379,0.04998715657495012,0.1179241396425239,-4166800,-4772820,41.345570201000434,31.01611323981346,NaN,NaN,3.0980112188868136,7.329942033682024
2003-01-02T09:30:00-05:00,20.03999,20.37,19.85001,20.36,316900,198445,58.29914190139386,52.10495095872187,NaN,NaN,116.87435940931958,-46.283398013494676,-0.02745603456241827,0.08360409643950106,0.11106013100191933,-3849900,-4515140,50.6556358997254,32.12385272713336,NaN,NaN,5.0041697652617945,6.9976888524791345
2003-01-03T09:30:00-05:00,20.3,20.32001,20.14,20.25,62500,190185,56.198850405057854,52.39333531036544,NaN,NaN,133.01438995228455,-11.568134114730446,-0.008676526619747868,0.1002144727272345,0.10889099934698236,-3912400,-4299260,56.83694529603962,33.29702344680943,NaN,NaN,6.025277003088375,6.858772873994741
2003-01-06T09:30:00-05:00,20.39,20.77,20.39,20.64,298500,203590,61.495331275433614,53.17908846148945,NaN,NaN,234.20642326684316,55.560452667240654,0.027445093435182116,0.14319736614096001,0.1157522727057779,-3613900,-4005860,63.52461991775815,34.84918356490982,NaN,NaN,8.55413339634289,7.100967234330191
2003-01-07T09:30:00-05:00,20.74001,20.74001,20.48,20.57001,308500,214730,60.09100684961315,53.30902411817668,NaN,NaN,184.80414548554478,115.5331439367332,0.04312481827911274,0.16965829555466883,0.12653347727555608,-3922400,-3893080,65.72309347611167,36.32612758863449,NaN,NaN,10.236400567410884,7.548886281913147
2003-01-08T09:30:00-05:00,20.5,20.5,20.00999,20.03999,159200,221325,50.65682546057069,52.92149447370226,NaN,NaN,47.07788513023961,143.19544064884633,0.015713672074117918,0.14617556736820347,0.13046189529408556,-4081600,-3876040,66.05598809513614,37.91565347483923,NaN,NaN,8.841230988279893,7.733506954251253
2003-01-09T09:30:00-05:00,20.19,20.41,20.14999,20.35001,65200,222235,55.09748563101046,53.0659127087248,NaN,NaN,74.20900894544886,134.66237055607218,0.01630451595957602,0.1508425402435556,0.13453802428397957,-4016400,-3909340,64.73289766127522,39.91802963235522,NaN,NaN,9.064564112216454,7.923657976817711
2003-01-10T09:30:00-05:00,20.17999,20.60001,20.17999,20.57001,37000,211505,57.98698095313906,53.6605466181188,NaN,NaN,103.39843941271779,128.73918044815883,0.028633464345435816,0.17032985471577433,0.14169639037033852,-3979400,-3922740,64.17584763647079,42.55341413834934,NaN,NaN,10.166999666167792,8.24413536101058
2003-01-13T09:30:00-05:00,20.7,20.72,20.41,20.48,155700,217700,56.38818795315861,53.96117036981013,NaN,NaN,111.93268533857365,104.28443286250493,0.02782394996294768,0.17647632782402312,0.14865237786107544,-4135100,-4026980,59.860425942561086,45.23732954446767,NaN,NaN,10.57710004612099,8.577416030312067
2003-01-14T09:30:00-05:00,20.41,20.58,20.41,20.58,73400,213810,57.78091024616309,54.46401251847654,NaN,NaN,98.44961194356493,87.01352615410897,0.030884515624996306,0.1872580223923208,0.1563735067673245,-4061700,-4054840,58.72385235926623,48.12967185547539,NaN,NaN,11.325495611940035,8.96999882768749
2003-01-15T09:30:00-05:00,20.47,20.47,20.13,20.24001,26800,210470,51.732082914813404,54.52439306730327,NaN,NaN,32.694045894345564,84.13675830693015,0.008060806612163351,0.1664495150325287,0.15838870842036534,-4088500,-4056220,58.66443473227963,51.15270724435682,NaN,NaN,10.1433328651436,9.137617975895505
2003-01-16T09:30:00-05:00,20.2,20.48,20.2,20.35001,58800,200365,53.43070851007589,54.68387309755986,NaN,NaN,49.48763513910402,79.19248354566118,-0.0010912694318000737,0.15702462163061526,0.15811589106241533,-4029700,-4058880,58.54147817837358,54.21203307422864,NaN,NaN,9.667391690159432,9.213299935076066
2003-01-17T09:30:00-05:00,20.22,20.42,20.16,20.19,74400,189465,50.639040942248464,54.899189345955904,NaN,NaN,24.242940224553838,63.36138370802839,-0.018423384028744688,0.13508666102648448,0.15351004505522917,-4104100,-4083820,57.3282432036677,56.87312770558479,NaN,NaN,8.444333710824619,9.103447617325859
2003-01-21T09:30:00-05:00,20.22,20.22,19.73,19.75,92500,161100,43.853732885137255,54.554703626202176,NaN,NaN,-70.1127503615969,26.952296567994278,-0.05780032730331863,0.08125963592608088,0.1390599632293995,-4196600,-4096120,56.70409317833137,58.77665184128551,NaN,NaN,5.1915455672831605,8.54460446731976
2003-01-22T09:30:00-05:00,19.74001,19.83,19.5,19.50999,44200,158855,40.65376094139199,53.87886049065771,NaN,NaN,-131.93105970550513,-19.123837761819733,-0.0960357044553402,0.01901533266022426,0.11505103711556446,-4240800,-4131940,54.83186602913722,59.73995868615243,NaN,NaN,1.4281542678406023,7.527968724537023
2003-01-23T09:30:00-05:00,19.61,19.89999,19.61,19.8,25600,158225,45.80018671954724,52.986077977668664,NaN,NaN,-88.90241307231184,-43.44312955515121,-0.09750768545316454,-0.006833569700891218,0.09067411575227333,-4215200,-4157280,53.486459011596615,59.94216033700037,NaN,NaN,-0.17292191241719332,6.42784149068642
2003-01-24T09:30:00-05:00,19.73,19.83,19.28,19.36,163700,155630,40.116158365077816,51.83731426052723,NaN,NaN,-138.49856489073912,-81.04036956111983,-0.12222521131524348,-0.06210739839178103,0.06011781292346245,-4378900,-4227120,49.85554133459468,59.44348862546859,NaN,NaN,-3.470969496900626,5.013725635316843
2003-01-27T09:30:00-05:00,19.05,19.19,18.75999,18.75999,208000,158705,33.931899568063415,49.86849771000078,NaN,NaN,-211.4398779859159,-128.1769332032138,-0.17014974921499448,-0.15256937359528067,0.017580375619713824,-4586900,-4323680,45.27890713960966,58.140223427029404,NaN,NaN,-8.611623048760299,3.067247251877251
2003-01-28T09:30:00-05:00,18.75,19.03,18.75,18.92,75600,158030,36.732939469494355,48.200064325706585,NaN,NaN,-179.99821704899927,-150.15402654069425,-0.18121720264625346,-0.20894112768810302,-0.027723925041849548,-4511300,-4386620,42.53782405014548,56.48413275374611,NaN,NaN,-11.723602225335714,0.9542687551325417
2003-01-29T09:30:00-05:00,18.99001,19.16,18.62,19.07001,152300,135915,39.32986906985084,47.39099601208374,NaN,NaN,-149.8742412399433,-153.74266284758193,-0.16882832135295422,-0.23875932673304234,-0.0699310053800881,-4359000,-4410260,41.52110586111333,54.73164116560162,NaN,NaN,-13.378130258040708,-1.0932168181779223
2003-01-30T09:30:00-05:00,18.87,18.99001,18.60001,18.64999,1461200,193000,34.99813431158363,45.95532806069611,NaN,NaN,-151.7517063780562,-166.31252150873078,-0.17838009851923273,-0.292906128529129,-0.11452603000989628,-5820200,-4731260,30.767396136789372,52.30553391385263,NaN,NaN,-16.24381094872531,-3.2575874082561205
2003-01-31T09:30:00-05:00,18.67,18.99001,18.60001,18.85001,760500,215180,38.47341813919005,44.56150214541403,NaN,NaN,-122.02474280545097,-163.01775709167316,-0.16120706680355157,-0.31603486351433574,-0.15482779671078417,-5059700,-4867420,27.512422848632752,49.68671785757848,NaN,NaN,-17.45142342247351,-5.285278267430034
2003-02-03T09:30:00-05:00,18.78999,19.03,18.78999,18.89999,29600,213535,39.3460499860881,43.34420657633757,NaN,NaN,-97.41148737181095,-140.21207896885215,-0.13739146009098943,-0.32656712182452097,-0.18917566173353154,-5030100,-4956060,25.61275419984716,47.24045559024178,NaN,NaN,-18.145138650505256,-7.122401179297922
2003-02-04T09:30:00-05:00,18.7,18.85001,18.59,18.82001,302100,213715,38.40729591546541,41.960376981287745,NaN,NaN,-100.98178601238314,-124.40879276152893,-0.11864147017649962,-0.33747749945415606,-0.21883602927765644,-5332200,-5120240,22.512182330008983,44.65390773100911,NaN,NaN,-18.98555574010019,-8.817137545126817
2003-02-05T09:30:00-05:00,18.82001,19.11,18.75,18.77,20800,199330,37.799996873669464,40.96522797834889,NaN,NaN,-79.23071072739054,-110.2800866590184,-0.10186639289409588,-0.3461690203952763,-0.24430262750118042,-5353000,-5319040,19.442957763457954,41.85237366180757,NaN,NaN,-19.84681245777201,-10.392805389790416
2003-02-06T09:30:00-05:00,18.72,18.8,18.48,18.55,199300,201335,35.16573428454858,39.6605869622398,NaN,NaN,-95.83771537242154,-99.09728845789145,-0.09782472041721968,-0.366583528022705,-0.2687588076054853,-5552300,-5265460,22.509374979684182,39.27865200475832,NaN,NaN,-21.342374027502448,-11.957029480892135
2003-02-07T09:30:00-05:00,18.74001,18.74001,18.42,18.46001,94900,202820,34.11833708045492,38.4805366863974,NaN,NaN,-93.00196809517969,-93.29273351583723,-0.09345607373651416,-0.385578899776128,-0.29212282603961387,-5647200,-5382960,20.652745011343384,36.65897356244945,NaN,NaN,-22.88876171673007,-13.518705514583269
2003-02-10T09:30:00-05:00,18.45,18.63,18.36,18.55,79800,204960,36.165862938782766,37.93140311880067,NaN,NaN,-87.49502864758472,-91.30944177099198,-0.07741258920707328,-0.3888885625484555,-0.3114759733413822,-5567400,-5490420,19.10102868375641,33.973040384265516,NaN,NaN,-23.64416140706972,-14.965199213509905
2003-02-11T09:30:00-05:00,18.67,18.67,18.3,18.34,16400,197995,33.54579441419334,37.42369122400076,NaN,NaN,-89.20104385791998,-88.95329334009932,-0.07386079048177557,-0.4038019614436017,-0.3299411709618261,-5583800,-5540740,18.403729947174824,31.371030664125346,NaN,NaN,-25.03146067383069,-16.403236564984304
2003-02-12T09:30:00-05:00,18.39999,18.44,18.25,18.3,169600,202805,33.054580291108635,36.51329076482657,NaN,NaN,-96.76165244839459,-92.45948168430013,-0.06730738304158146,-0.4140753997638029,-0.34676801672222146,-5753400,-5620820,17.320100860784137,28.78771936763874,NaN,NaN,-26.323812381556877,-17.82046168163753
2003-02-13T09:30:00-05:00,18.35001,18.44,18.2,18.35001,192500,211090,34.34894311951224,36.10134681871475,NaN,NaN,-94.40962872163006,-92.17386435414184,-0.05331853079565957,-0.41341618021679594,-0.36009764942113637,-5560900,-5622540,17.296543686461135,26.462076678486344,NaN,NaN,-27.083887147869756,-19.14380817681356
2003-02-14T09:30:00-05:00,18.38,18.57001,18.07001,18.36,203100,218305,34.620879650909785,36.150559681775206,NaN,NaN,-95.66682307247855,-92.70683534960162,-0.03783506373329337,-0.4073914790877531,-0.3695564153544597,-5357800,-5564660,21.181496282314924,24.740833045822434,NaN,NaN,-27.657813089915045,-20.360094592970917
2003-02-18T09:30:00-05:00,18.60001,18.86,18.60001,18.77,81900,218680,44.73797176282311,36.722347702727255,NaN,NaN,-25.03437014201497,-80.21470364848767,0.0033874674790924653,-0.36532208100559416,-0.3687095484846866,-5275900,-5506360,25.002969729706166,23.488343451505337,NaN,NaN,-25.366107112438357,-21.07523923860912
2003-02-19T09:30:00-05:00,18.77,18.89999,18.46001,18.60001,49300,216520,41.84661822155023,36.90211549927722,NaN,NaN,-35.830639169031684,-69.54062271071002,0.021560464687813863,-0.3417589676249193,-0.36331943231273317,-5325200,-5454640,28.32311019176946,22.545629475123633,NaN,NaN,-24.174510514504295,-21.517992278022717
2003-02-20T09:30:00-05:00,18.64,18.66,18.33,18.41,185700,223595,38.82606784093034,37.17553932280199,NaN,NaN,-73.97917286426876,-64.98412679388485,0.02300703169369267,-0.33456064269561736,-0.35756767438931003,-5510900,-5406140,31.39047012277814,22.590134759837117,NaN,NaN,-23.98874269586811,-21.8709566234292
2003-02-21T09:30:00-05:00,18.38,18.71001,18.3,18.71001,68200,225725,45.513488966095615,37.67840152472382,NaN,NaN,-37.288556364793294,-53.55991232251749,0.04511345880530221,-0.3011758508826823,-0.3462893096879845,-5442700,-5382500,32.8978151273966,22.974805636891677,NaN,NaN,-21.801801800875666,-21.86107736306441
2003-02-24T09:30:00-05:00,18.71001,18.71001,18.25,18.25,50600,220070,38.55399194727682,37.62182595052302,NaN,NaN,-84.75572410946317,-51.37769252991443,0.030404706992020414,-0.308283425947959,-0.3386881329399794,-5493300,-5409600,32.029095957447666,23.43311576243457,NaN,NaN,-22.030008710164243,-21.8852104126501
2003-02-25T09:30:00-05:00,18.10001,18.21001,17.82001,18.21001,50100,212175,38.00986174921102,37.593437795790564,NaN,NaN,-174.9982263453536,-81.37046377058212,0.0201273680114874,-0.3135289229256202,-0.3336562909371076,-5543400,-5463100,30.32652888976247,23.991283373845537,NaN,NaN,-22.378206482336687,-21.955638422605325
2003-02-26T09:30:00-05:00,18.32001,18.46001,18.23,18.28999,613300,239060,39.838659423665945,37.739056549361734,NaN,NaN,-83.67919540229322,-90.94017501723442,0.020776638620802756,-0.3076854926611041,-0.3284621312819069,-4930100,-5384080,35.75833504457576,25.156667465353955,NaN,NaN,-22.120789463276687,-21.97923142841552
2003-02-27T09:30:00-05:00,18.35001,18.45,18.2,18.31,107600,236825,40.31308984088342,38.10672480338565,NaN,NaN,-78.99748837189158,-91.94383811875898,0.02436596113798023,-0.2980046798594316,-0.3223706409974118,-4822500,-5246400,43.95656468646168,26.688609587266633,NaN,NaN,-21.776510431956897,-21.95027128606429
2003-02-28T09:30:00-05:00,18.34,18.5,18.28999,18.35001,356300,181580,41.309704932172004,38.62039393565116,NaN,NaN,-51.82583829631557,-94.85129450506344,0.030830711337502925,-0.2838322518255332,-0.3146629631630361,-4466200,-5051100,53.09969707700835,29.00624902052842,NaN,NaN,-21.21697923595982,-21.845515278906507
2003-03-03T09:30:00-05:00,18.32001,18.57001,18.28,18.28,474400,167275,40.04955486997715,38.89780050216505,NaN,NaN,-47.703162450119564,-87.44078217319472,0.03166734221330386,-0.2750787853964063,-0.30674612760971015,-4940600,-4940560,57.34174211815502,31.73772855155689,NaN,NaN,-21.07427837421953,-21.735338578236938
2003-03-04T09:30:00-05:00,18.27,18.27,17.84,17.84,214400,176515,33.19577349353099,38.87279900783202,NaN,NaN,-187.28616229169873,-89.89836936246374,0.005248445644366717,-0.30018557055425177,-0.3054340161986185,-5155000,-4862880,60.07463708141716,34.71422191828849,NaN,NaN,-22.98974493958,-21.914539487000233
2003-03-05T09:30:00-05:00,17.83,17.94,17.67,17.91,133300,168075,35.09867437781902,39.018805728311335,NaN,NaN,-214.23037880254694,-116.00860604251447,-0.004333719008589976,-0.31085116495935594,-0.30651744595076597,-5021700,-4881200,59.11279830999402,37.69941459323205,NaN,NaN,-24.02076870788249,-22.2154293756977
2003-03-06T09:30:00-05:00,17.86,17.86,17.53,17.60001,131300,173600,30.90091198398771,38.772517790059574,NaN,NaN,-239.26056639203185,-148.06122164654252,-0.027100830025257205,-0.34039348348233744,-0.31329265345708024,-5153000,-4947300,55.65067724117186,40.43899556142567,NaN,NaN,-26.24213509212283,-22.79067304947272
2003-03-07T09:30:00-05:00,17.41,17.77,17.35001,17.7,52500,166260,33.65713849466681,38.703679136042226,NaN,NaN,-199.37253107293142,-177.5705602018657,-0.030712786321949792,-0.3516836363595175,-0.3209708500375677,-5100500,-5074160,49.641517953989336,42.47185425225956,NaN,NaN,-27.260749051318413,-23.429255335450677
2003-03-10T09:30:00-05:00,17.60001,17.64,17.36,17.36,132500,168140,29.36753528662537,37.605790816313814,NaN,NaN,-186.30771696580857,-205.2914711050035,-0.050138451270178075,-0.3836439141252903,-0.33350546285511223,-5233000,-5132640,47.11584238736983,44.05134515637839,NaN,NaN,-29.536187437019773,-24.301674207103403
2003-03-11T09:30:00-05:00,17.34,17.57001,17.22,17.23,275500,177925,27.90319188077703,36.60983179197287,NaN,NaN,-169.72380631544507,-201.77899990975277,-0.06494153190864649,-0.4146823777409203,-0.34974084583227383,-5508500,-5203340,44.1887213688296,45.18460309759697,NaN,NaN,-31.87215702275531,-25.38317175219653
2003-03-12T09:30:00-05:00,17.2,17.25,17.00999,17.25,145000,184355,28.493922818996296,35.8718214332633,NaN,NaN,-165.88071965224003,-192.10906807969138,-0.06635059984790698,-0.43267909564215756,-0.3663284957942506,-5363500,-5271700,41.50381549333419,45.90698490977955,NaN,NaN,-33.58015879387668,-26.55416990100798
2003-03-13T09:30:00-05:00,17.62,18.02,17.55,18.02,76700,179710,46.62604000903081,35.951289364901534,NaN,NaN,-40.090214748042705,-152.27499775089356,-0.011276220141055171,-0.38042377097056956,-0.3691475508295144,-5286800,-5298460,40.46726556020511,46.44765994069444,NaN,NaN,-28.908759003409436,-26.89053977277962
2003-03-14T09:30:00-05:00,18.11,18.32001,17.92999,18.12,470400,193605,48.45411302984001,36.658440870798906,NaN,NaN,6.787275399869478,-111.0430364563334,0.03358166632264176,-0.3271704679262122,-0.36075213424885394,-4816400,-5241640,43.683429706147834,47.280112351315886,NaN,NaN,-24.627713282814216,-26.567278845641702
2003-03-17T09:30:00-05:00,18.07001,18.73,18.02,18.73,269100,196905,57.92165576389441,38.08071187184771,NaN,NaN,69.55634043768595,-59.870224975634486,0.10215499735190747,-0.23305838755896957,-0.33521338491087704,-4547300,-5104500,50.61770730281079,48.729482237962195,NaN,NaN,-17.199776734934343,-25.229064258397795
2003-03-18T09:30:00-05:00,18.89999,19.17999,18.8,19.10001,2680600,326840,62.42940399419159,39.69433648402811,NaN,NaN,154.62205740757398,4.998947768969333,0.16644954922335636,-0.12715144838168158,-0.29360099760503794,-1866700,-4376140,71.02416465688732,51.24847006741302,NaN,NaN,-9.41787039462441,-22.97032227785874
2003-03-19T09:30:00-05:00,19.11,19.11,18.85001,19.03,33100,326030,61.095749581371805,41.17881217977729,NaN,NaN,141.1545307443394,66.40599784828524,0.19623139793659283,-0.0483117501842969,-0.24454314812088973,-1899800,-3683400,79.64119344526262,53.79737212161309,NaN,NaN,-3.937377356563407,-20.251330146245124
2003-03-20T09:30:00-05:00,18.87,19.09,18.74001,19.06,43000,318895,61.47553353452581,42.61922850851685,NaN,NaN,124.25301122230518,99.27464304235481,0.2087552927196837,0.016400967778714914,-0.1923543249409688,-1856800,-2997400,84.54324981027317,56.043340173989144,NaN,NaN,0.4409735191109548,-17.295286765479972
2003-03-21T09:30:00-05:00,19.14999,19.66,19,19.66,68500,318910,68.16840695711697,44.627717943312554,NaN,NaN,173.20360055661436,132.55790807370377,0.2457059858993095,0.1147781574331681,-0.1309278284661414,-1788300,-2391780,87.42250908025456,58.19196638556768,NaN,NaN,6.818921647396679,-13.850399849354737
2003-03-24T09:30:00-05:00,19.32001,19.35001,18.84,18.89,62100,319485,54.96989318244341,46.18301220680629,NaN,NaN,104.6938846242585,139.58541691101829,0.2080396936202843,0.12912178855921397,-0.07891790506107033,-1850400,-1852400,89.32904572913364,60.28156700326172,NaN,NaN,7.540431147328075,-10.794566849828621
2003-03-25T09:30:00-05:00,18.85001,19.13,18.85001,18.91,76500,320805,55.21245536563944,47.61971084879347,NaN,NaN,86.38967424476637,125.93894027845677,0.175521239580958,0.14048364441512717,-0.035037595165830826,-1773900,-1833840,89.38865166798834,62.44412795740417,NaN,NaN,8.158476417506664,-8.086989240209295
2003-03-26T09:30:00-05:00,18.92999,18.99001,18.75,18.86,588100,319545,54.42317968814837,49.29987282766208,NaN,NaN,67.95220459471935,111.29847504853274,0.14306673703847714,0.1437958261322656,0.0007290890937884584,-2362000,-1926280,86.78840452980855,64.66825133516394,NaN,NaN,8.377891492673431,-5.7348634212260485
2003-03-27T09:30:00-05:00,18.69,18.72,18.5,18.64,556600,341995,50.970562377061874,50.53654596211887,NaN,NaN,35.991418340286494,93.64615647212901,0.10117855582493547,0.1272022838749578,0.026023728050022326,-2918600,-2138640,80.96187112739972,66.90541941897897,NaN,NaN,7.447215963491,-3.851709223409327
2003-03-28T09:30:00-05:00,18.60001,18.67999,18.47,18.67999,71900,327775,51.57197795065676,52.12257758097826,NaN,NaN,32.90309869362521,65.58605609953118,0.07193472327816017,0.11594213214772253,0.044007408869562364,-2846700,-2350320,75.51936812847788,68.93424268620097,NaN,NaN,6.886254153152267,-2.3177144553290994
2003-03-31T09:30:00-05:00,18.35001,18.48,18.17999,18.38,267700,317440,46.92216134775474,53.4810754000481,NaN,NaN,3.0652465109365115,45.260328476866775,0.030288450409240733,0.08186797188111328,0.051579521471872544,-3114400,-2603120,69.50976379798577,70.74288857399783,NaN,NaN,4.958187327189326,-1.2782999149693244
2003-04-01T09:30:00-05:00,18.45,18.58,18.16,18.58,900800,351760,50.14918535554764,55.027879866944616,NaN,NaN,11.421343523746442,30.266662332662804,0.014890894889572036,0.07019314008383759,0.055302245194265555,-2213600,-2691060,67.49757027643119,72.59958534421905,NaN,NaN,4.312487614175668,-0.47961598223432567
2003-04-02T09:30:00-05:00,18.84,19.02,18.78,18.96001,131400,351665,55.66472585295115,55.6735002843675,NaN,NaN,62.2277672050546,29.121774854729853,0.02820657048810095,0.09056045830439174,0.062353887816290796,-2082200,-2635100,68.12981390435398,74.57548165451541,NaN,NaN,5.47844374304005,0.3715354070905852
2003-04-03T09:30:00-05:00,19.02,19.02,18.77,18.77,499300,370065,52.53483422691083,55.964980369872556,NaN,NaN,49.90144500420368,31.903780187513284,0.02237948015671433,0.0903282380121837,0.06794875785546937,-2581500,-2567680,68.91437005503934,76.37769167943623,NaN,NaN,5.472778984522035,1.1002844895807924
2003-04-04T09:30:00-05:00,18.88,18.96001,18.75,18.88,49400,369910,54.14237391903986,55.69503166666866,NaN,NaN,46.63895350042238,34.65095114887272,0.023954470661197297,0.097891846181966,0.0739373755207687,-2532100,-2504760,69.66490250870379,77.7382056227143,NaN,NaN,5.948037518565359,1.7928206365785875
2003-04-07T09:30:00-04:00,19.12,19.5,19.03,19.03,73200,366945,56.315082502671316,55.25829441727435,NaN,NaN,86.78740636111274,51.395383118907965,0.03258448789525403,0.11466798538983625,0.08208349749458221,-2458900,-2373660,71.22388291383491,77.75247121249627,NaN,NaN,6.984181429024855,2.534443606928054
2003-04-08T09:30:00-04:00,19.02,19.05,18.8,18.91,27400,354540,54.106498064920316,54.75906216609925,NaN,NaN,41.17070729442981,57.34525587304464,0.027879023571143427,0.1169322769585115,0.08905325338736807,-2486300,-2428200,69.62088871881443,77.03673516060711,NaN,NaN,7.215958798142995,3.2032314913873314
2003-04-09T09:30:00-04:00,19.00999,19.03,18.58,18.58,630100,378795,48.47615537418146,53.830535154646086,NaN,NaN,-7.575871773716047,43.38452807729051,0.0015965546370905054,0.0910489466837312,0.0894523920466407,-3116400,-2635040,63.760059138337276,75.55222154118312,NaN,NaN,5.731422507777936,3.5644016365859894
2003-04-10T09:30:00-04:00,18.58,18.69,18.55,18.64999,237400,386830,49.6723417808685,52.509387642056915,NaN,NaN,-47.212204808388975,23.96179811477198,-0.01130940383972831,0.07531563724698032,0.08662504108670863,-2879000,-2694540,62.139538108868585,73.74629504322698,NaN,NaN,4.853215942246763,3.7485179659661
2003-04-11T09:30:00-04:00,18.85001,18.92999,18.58,18.61,61400,366380,48.97274922447594,52.0810202164878,NaN,NaN,-39.87811114027182,6.65838518663314,-0.022147563286241984,0.05894058697890614,0.08108815026514812,-2940400,-2776200,59.889780273723204,71.64349036784051,NaN,NaN,3.9335451695427204,3.774950423619903
2003-04-14T09:30:00-04:00,18.62,18.99001,18.62,18.98,37700,354810,55.25239750262837,52.08387322627272,NaN,NaN,5.2653771437063455,-9.64602065684814,-0.00490642936776664,0.07495511355543982,0.07986154292320646,-2902700,-2864960,57.45484720639531,69.3625043348696,NaN,NaN,4.928991510023143,3.9398134359632233
2003-04-15T09:30:00-04:00,18.96001,19.31,18.86,19.31,859700,263765,59.982592051195454,52.480974109347514,NaN,NaN,106.56273634902264,3.432385154070431,0.026488929108238052,0.11297270430850403,0.08648377520026598,-2043000,-2776300,59.23759231260202,67.39458917649769,NaN,NaN,7.262304758516924,4.414455053470895
2003-04-16T09:30:00-04:00,19.39,19.39,19.02,19.05,360200,280120,55.04545910994585,52.772038161696365,NaN,NaN,98.26057696465149,24.599674901743942,0.027397289474304004,0.12073038704314598,0.09333309756884198,-2403200,-2633660,61.99664142524966,66.0399299120584,NaN,NaN,7.741433659092365,4.889737711416819
2003-04-17T09:30:00-04:00,19.14999,19.33,19.03999,19.32001,517100,303825,58.834858566515734,53.29081534854344,NaN,NaN,111.61051710451241,56.36421928432422,0.04291092834036141,0.14697175799429374,0.10406082965393233,-1886100,-2435080,65.4978985848724,65.32411065894372,NaN,NaN,9.335823662248446,5.524892847249909
2003-04-21T09:30:00-04:00,19.41,19.45,19.25,19.28999,2034000,402100,58.24698250515159,54.09973114550035,NaN,NaN,149.19394595392123,94.17863070316282,0.04752060587363148,0.16346158699597169,0.1159409811223402,-3920100,-2631020,59.65753828885583,64.62038026543443,NaN,NaN,10.440892738991273,6.227178546070103
2003-04-22T09:30:00-04:00,19.2,19.69,19.17999,19.69,225500,410270,63.48289359275777,55.05213887672965,NaN,NaN,179.22478163394373,128.9705116012103,0.07238944567321165,0.20642778821385477,0.13403834254064312,-3694600,-2789400,55.36045434761785,63.75344341337635,NaN,NaN,13.075902449631279,7.205567675150271
2003-04-23T09:30:00-04:00,19.7,19.91,19.58,19.84,443500,428620,65.24304956698313,55.736304856303285,NaN,NaN,199.91311595591108,147.64058752258796,0.09253262589939637,0.24970412491488858,0.1571714990154922,-3251100,-3031020,49.502416980061675,62.422915061641184,NaN,NaN,15.797242238589279,8.432949755641557
2003-04-24T09:30:00-04:00,19.78999,20,19.69,19.73,551400,426785,62.85055997076369,56.47314240943564,NaN,NaN,166.4983484320984,161.28814181607737,0.09185442229928764,0.27198952688960176,0.18013510459031412,-3802500,-3310880,43.730388553958655,60.624059240135416,NaN,NaN,17.337600617981227,9.705042735975795
2003-04-25T09:30:00-04:00,19.75,19.75,19.3,19.42999,138700,405890,56.7393412947163,56.65864007912681,NaN,NaN,91.07141389535325,157.18032117424553,0.06582598213683682,0.26241758226136014,0.1965916001245233,-3941200,-3721900,36.921341466272814,58.285233451390354,NaN,NaN,16.8235473883281,10.721971972026124
2003-04-28T09:30:00-04:00,19.38,19.84,19.38,19.77,399100,422250,61.32866300576428,57.01675297220487,NaN,NaN,110.43859885641888,149.42925175474505,0.06596750912414451,0.27905098652970395,0.21308347740555944,-3542100,-3646300,38.80862325760742,55.96985776165981,NaN,NaN,17.811483527325038,11.734759337068825
2003-04-29T09:30:00-04:00,19.87,20.02,19.72,19.94,421700,429950,63.418255963855906,57.68187853641456,NaN,NaN,140.6561744466913,141.71553031729457,0.0715044511230774,0.3024640413094062,0.23095959018632878,-3120400,-3531460,41.6638972192585,53.97292979740582,NaN,NaN,19.276158658552937,12.81210209728084
2003-04-30T09:30:00-04:00,19.95,20.19,19.82001,20.03999,55500,387685,64.62889174742398,58.835645420217595,NaN,NaN,144.06554453647368,130.54601603340708,0.07550203132394545,0.3253371293412606,0.24983509801731513,-3064900,-3494220,42.59925181711843,52.4614435601759,NaN,NaN,20.839025051844583,13.958805376504232
2003-05-01T09:30:00-04:00,19.98,19.98,19.64,19.89999,69100,384570,61.557156367415274,59.68456074782807,NaN,NaN,97.83358769019532,116.81306388502647,0.06283752407088278,0.3283820031059186,0.2655444790350358,-3134000,-3360520,45.94999418175699,51.30504756538222,NaN,NaN,21.248505572636873,15.000191118808894
2003-05-02T09:30:00-04:00,19.94,20.17,19.92999,20.16,389100,379060,64.89434580750796,60.821817646616076,NaN,NaN,123.70109426178972,123.33899995831378,0.06577792187290477,0.34776688137616674,0.28198895950326197,-2744900,-3121260,51.41566102711638,50.69975333348173,NaN,NaN,22.60257952152592,16.086246604911327
2003-05-05T09:30:00-04:00,20.11,20.23,20.03,20.11,74500,380315,63.748308754077954,61.428668450291056,NaN,NaN,115.01562910734093,124.25440600849818,0.05841099618508061,0.3550027047346127,0.2965917085495321,-2819400,-2976720,54.414653052967466,50.48259660823688,NaN,NaN,23.381109822971332,17.128369921777043
2003-05-06T09:30:00-04:00,20.17,20.34,20.10001,20.24001,95900,381450,65.45654904198405,61.81966537820454,NaN,NaN,116.30627710265188,119.38442653969028,0.0563245134258602,0.3669973503318573,0.3106728369059971,-2723500,-2897340,56.0202605684276,50.25278719793871,NaN,NaN,24.525962145134947,18.185168810828173
2003-05-07T09:30:00-04:00,20.2,20.24001,20,20.10001,327600,396460,62.064960703817334,62.321058349195354,NaN,NaN,90.86259495583163,108.74383662356188,0.04029730450232033,0.3610444675338975,0.3207471630315772,-3051100,-2894580,56.07818703751436,49.830040455957615,NaN,NaN,24.548244455922735,19.094179617270253
2003-05-08T09:30:00-04:00,19.98,20.14,19.88,19.89999,90500,369480,57.482333889860165,62.224449443719955,NaN,NaN,63.34053145372692,101.8452253762682,0.01245030938060221,0.3363100497573299,0.3238597403767277,-3141600,-2896100,56.03441483144701,49.154077330712944,NaN,NaN,23.24853019459908,19.68765827117437
2003-05-09T09:30:00-04:00,20.05,20.28,19.91,20.27,24700,358845,62.93442900779634,62.55926705105173,NaN,NaN,87.27080742803471,94.55916800951722,0.015004292888902093,0.3426151064878553,0.3276108135989532,-3116900,-2970500,53.81998426396999,48.73710918607825,NaN,NaN,23.710003597715453,20.26227903210881
2003-05-12T09:30:00-04:00,20.28,20.59,20.13,20.56,49500,358250,66.55437839560332,62.778658822683546,NaN,NaN,129.33190901286838,97.42242399062272,0.03133888770130561,0.36678442322558524,0.33544553552427964,-3067400,-3020100,52.335096327562,48.52101218464568,NaN,NaN,25.243081947812545,20.97382230578077
2003-05-13T09:30:00-04:00,20.5,20.53999,20.33,20.42,83600,360545,63.33839654188552,62.64261217803372,NaN,NaN,124.79647708320995,99.12046398673434,0.027941593146737942,0.37037252695770206,0.3424309338109641,-3151000,-3105600,49.78521694128611,48.541212181876,NaN,NaN,25.5264988270831,21.62420466596682
2003-05-14T09:30:00-04:00,20.46001,20.46001,20.16,20.3,45800,319850,60.633876604741225,62.48427765188926,NaN,NaN,92.44425517086123,99.43679602974025,0.013567493135058395,0.35939030022978713,0.34582280709472873,-3196800,-3134740,48.910560762773706,48.911224482505645,NaN,NaN,24.951326297947613,22.09950775624979
2003-05-15T09:30:00-04:00,20.37,20.42999,20.23,20.42,81700,305925,62.364511146387905,62.88607549843723,NaN,NaN,97.12446103291157,106.1935819455772,0.008352174448570948,0.3562630251554424,0.34791085070687144,-3115100,-3129440,49.085766040294054,49.78011195207859,NaN,NaN,24.97275021371673,22.509970964459352
2003-05-16T09:30:00-04:00,20.33,20.44,20.2,20.33,237500,291945,60.22599445346218,62.80731345898708,NaN,NaN,83.31730392426753,105.40288124482375,-0.004269947611667102,0.34257341619228754,0.34684336380395464,-3352600,-3176580,47.52465633064448,50.4026857430098,NaN,NaN,24.378445363521934,22.77689587861115
2003-05-19T09:30:00-04:00,20.28,20.28,19.91,19.95,88600,194675,52.10223191227565,61.999026026731336,NaN,NaN,5.171058056087878,80.57071105346765,-0.03937022847027183,0.2976305782161148,0.33700080668638666,-3441200,-3251340,45.07621505622089,50.64642273136427,NaN,NaN,21.328506504251884,22.56998311084554
2003-05-20T09:30:00-04:00,20.02,20.10001,19.71001,19.89,433000,205050,50.93398870263613,61.02081866638935,NaN,NaN,-47.662847835303744,46.0788460697649,-0.06620798393020372,0.254240826773632,0.32044881070383574,-3874200,-3395980,40.70663487954746,50.511235807252056,NaN,NaN,18.492368601016977,21.987466752298605
2003-05-21T09:30:00-04:00,19.92,20.09,19.8,20.02,462500,206000,53.3734130251625,60.43626557051415,NaN,NaN,-29.61709838009143,21.666575359574374,-0.07418381154023901,0.227719046278537,0.301902857818776,-3411700,-3438960,39.48187015984068,50.049226948543755,NaN,NaN,16.792703802311916,21.245357759443365
2003-05-22T09:30:00-04:00,20.10001,20.23,19.92999,20.19,2584600,307660,56.42439914486484,59.83126938032536,NaN,NaN,15.574823665767427,5.356647886145543,-0.06719745566242485,0.21790603824074495,0.2851034939031698,-827100,-2981360,55.00438134116246,50.30556411383275,NaN,NaN,16.21258396086552,20.526390073932244
2003-05-23T09:30:00-04:00,20.2,20.24001,20.08,20.22,210800,311265,56.9596281451521,59.346363622544935,NaN,NaN,30.640341856005715,-5.1787445275068205,-0.05998064569998113,0.21012768677819338,0.2701083324781745,-616300,-2434100,66.17750291446114,51.14576767536801,NaN,NaN,15.884127095493032,19.86320964844093
2003-05-27T09:30:00-04:00,20.24001,20.63,20.16,20.58,127800,297700,62.855601496874144,59.16058165503709,NaN,NaN,134.08379907107212,20.60380367549003,-0.031801171601157696,0.2303568679767274,0.2621580395778851,-488500,-1843560,73.75182415920905,52.4123079318524,NaN,NaN,17.353851651259795,19.50472993455791
2003-05-28T09:30:00-04:00,20.60001,20.64999,20.42,20.52,261700,289700,61.34723145462664,59.1093152800949,NaN,NaN,143.64481480531464,58.865336203613694,-0.018690857833202124,0.23879446728638243,0.25748532511958455,-750200,-1218760,79.08780299813924,54.05585192903989,NaN,NaN,18.126935743398302,19.30790219296368
2003-05-29T09:30:00-04:00,20.53999,20.64999,20.28999,20.35001,183500,296100,57.161922297009866,59.08642873774845,NaN,NaN,90.69913506426523,82.92858289248504,-0.022689570731497355,0.22912336170521286,0.2518129324367102,-933700,-723160,82.18200561911692,55.92353698530203,NaN,NaN,17.576303332934597,19.06053092724524
2003-05-30T09:30:00-04:00,20.39999,20.69,20.37,20.66,1107200,348005,62.22326751158801,59.035631488019284,NaN,NaN,131.41045044399635,106.09570824813082,-0.0065193545490530025,0.24366373925039397,0.250183093799447,173500,-523040,83.25914196736456,58.02633396411593,NaN,NaN,18.632712433051065,18.999413999503215
2003-06-02T09:30:00-04:00,20.8,21.12,20.75999,20.86,164700,336785,65.08918064279544,58.93097450567586,NaN,NaN,214.75270223057032,142.91818032304374,0.014440240276254568,0.2682333941447652,0.25379315386851065,338200,-332140,84.23800763020249,60.30511334287596,NaN,NaN,20.42248998111541,19.20271056830496
2003-06-03T09:30:00-04:00,20.85001,20.94,20.75,20.87,233400,344730,65.23121155514565,59.066175578051585,NaN,NaN,166.7969333072515,149.46080717027962,0.025144719900484447,0.2852240537441162,0.26007933384363174,571600,-120120,85.26828525244775,62.83961822224465,NaN,NaN,21.90039685042713,19.58809432289384
2003-06-04T09:30:00-04:00,20.83,21.27,20.83,21.22,242900,352080,69.85401142985224,59.72475663698809,NaN,NaN,199.73439911692344,160.67872403260137,0.050501041276157344,0.3232056354388284,0.27270459416267107,814500,192820,86.65483666929282,65.53563792985315,NaN,NaN,24.695912963823318,20.31778270016948
2003-06-05T09:30:00-04:00,21.25999,21.31,21.09,21.27,163500,343875,70.45829084034217,60.30288375798482,NaN,NaN,192.3205631053985,181.00300964082803,0.06445123170877098,0.3532686337986348,0.28881740208986384,978000,575160,88.12537371429865,68.3241813351392,NaN,NaN,27.143944292945303,21.2929486419946
2003-06-06T09:30:00-04:00,21.39999,21.55,21.16,21.23,550500,366875,69.26215924131984,60.94832409997465,NaN,NaN,176.300687265405,189.9810570051098,0.06463050106787704,0.3696055284247102,0.30497502735683313,427500,625960,88.30969545410724,71.23739841538654,NaN,NaN,28.815145756796262,22.36754822982341
2003-06-09T09:30:00-04:00,21.12,21.14,20.86,20.87,107000,370990,59.47593175636534,61.47501694598106,NaN,NaN,87.95846506911907,164.62220957281951,0.03560006788215653,0.34947511220952876,0.31387504432737223,320500,622420,88.20694502965996,74.31816484206077,NaN,NaN,27.356057693192287,23.080192438876107
2003-06-10T09:30:00-04:00,20.92,21.11,20.92,21.02,13400,369185,61.891998333751424,62.25773191963215,NaN,NaN,87.47584958592094,148.75799282855343,0.022249251096578715,0.3416866081980956,0.3194373571015169,333900,574880,86.74721885241262,77.6067779829797,NaN,NaN,26.857943585816034,23.61987117415324
2003-06-11T09:30:00-04:00,21.14,21.24001,21.03,21.22,25000,366255,64.89711980409129,63.08085383241279,NaN,NaN,99.78127885503713,128.76736877617614,0.02256615863011585,0.3476450553891617,0.32507889675904583,358900,483760,83.88188000442756,80.77820725759304,NaN,NaN,27.348950774746633,24.152596831380865
2003-06-12T09:30:00-04:00,21.39999,21.39999,21.17,21.39999,40800,366005,67.38945780946973,63.864072308456,NaN,NaN,110.66621350422643,112.43649885594172,0.03010469386930148,0.3627097640956727,0.3326050702263712,399700,368100,80.25808692218165,82.58204337052298,NaN,NaN,28.530879301455837,24.77806575567729
2003-06-13T09:30:00-04:00,21.35001,21.39999,21.06,21.12,24300,363135,60.2259362062809,64.09738002710806,NaN,NaN,80.25476015786388,93.22731343443351,0.012350959284407437,0.3480437693318805,0.3356928100474731,375400,357680,79.92309314950474,83.56387124445466,NaN,NaN,27.29137816183238,25.137110385128018
2003-06-16T09:30:00-04:00,21.14999,21.55,21.13,21.55,330700,367795,66.17307124411663,64.33434215191109,NaN,NaN,102.42251797155002,96.1201240149197,0.024956952869416238,0.3668890011342434,0.34193204826482715,706100,434800,80.56951432101891,84.05084911315537,NaN,NaN,28.18424893166976,25.57241589177684
2003-06-17T09:30:00-04:00,21.59,21.67,21.42999,21.63,1192400,422985,67.15698507687247,64.74932455350007,NaN,NaN,118.09702749929097,102.2443595975937,0.033537944611458315,0.38385447902915004,0.3503165344176917,1898500,747720,82.96605590707426,84.3278671780793,NaN,NaN,29.208428695946402,26.09184629237249
2003-06-18T09:30:00-04:00,21.64,21.64,21.38,21.41,27300,402700,61.83079450091789,65.08281542520778,NaN,NaN,97.83533649803245,101.85517112619277,0.019924574503941972,0.3752222525476192,0.35529767804367723,1871200,1050180,84.90416319671594,84.52230700505068,NaN,NaN,28.35182438865866,26.414700306127656
2003-06-19T09:30:00-04:00,21.5,21.57001,21.3,21.31,37800,381465,59.520055773655265,64.88972887249831,NaN,NaN,79.45754082042532,95.61343658943255,0.0007265512439255106,0.35620586709858415,0.35547931585465864,1833400,1336920,86.47523923766195,84.75202823864333,NaN,NaN,26.93588131252517,26.489154735613017
2003-06-20T09:30:00-04:00,21.22,21.28999,21.06,21.09,301700,267320,54.67865327868326,64.14611977506172,NaN,NaN,28.078057753717584,85.17809610860328,-0.02862520793221951,0.31969780593938424,0.34832301387160375,1531700,1568180,87.59643977435982,84.99191624894029,NaN,NaN,24.2046215473573,26.162792851576487
2003-06-23T09:30:00-04:00,21.05,21.07001,20.60001,20.7,247200,269140,47.32907402441435,62.86739566572377,NaN,NaN,-58.79674593660978,52.934243326971306,-0.0735862245623854,0.256340233168622,0.32992645773100737,1284500,1683860,88.12667491427295,85.19608693907067,NaN,NaN,19.315322892038814,25.18458285735682
2003-06-24T09:30:00-04:00,20.71001,20.85001,20.66,20.75,730600,299280,48.28873950370607,61.32701909957047,NaN,NaN,-75.0800041490103,14.298836997311053,-0.09772640060633797,0.20776845697308488,0.30549485757942285,2015100,1707180,88.23585351389033,85.30901671368477,NaN,NaN,15.740671531446173,23.835452667941013
2003-06-25T09:30:00-04:00,20.78,20.89,20.57001,20.61,66600,289525,45.77390396968561,59.56384860880929,NaN,NaN,-95.83353742320209,-24.43493778693586,-0.11945362710994861,0.15617782369198707,0.2756314508019357,1948500,1722640,88.31258072485446,85.32238864301019,NaN,NaN,11.995022888689492,22.14396269947651
2003-06-26T09:30:00-04:00,20.67999,20.95,20.58,20.92,830100,321855,51.76424001645888,58.31399723560493,NaN,NaN,-74.48639383417087,-55.2237247178551,-0.10953927877529615,0.1387073523328155,0.24824663110811165,2778600,1911680,89.23696518455525,85.38862219518504,NaN,NaN,10.591533929653501,20.493615732358936
2003-06-27T09:30:00-04:00,20.98,20.98,20.64,20.74001,54800,269235,48.419700636594726,57.524266441335605,NaN,NaN,-90.21081499386776,-78.88149926737216,-0.1113326857737506,0.10908077389092341,0.22041345966467402,2723800,2150100,90.28103097903492,85.53677119156896,NaN,NaN,8.369448068255428,18.761591780344148
2003-06-30T09:30:00-04:00,20.64999,20.83,20.53999,20.73,97500,265875,48.23305337987365,56.54862751605862,NaN,NaN,-106.93329571465648,-88.50880922298151,-0.10926879743286472,0.0838274628735931,0.19309626030645782,2626300,2418460,91.30359953944676,85.86222695492856,NaN,NaN,6.543690469693117,17.016177307394
2003-07-01T09:30:00-04:00,20.66,20.72,20.35001,20.67999,39500,256180,47.25302956441391,55.28833535608167,NaN,NaN,-127.71221689803869,-99.03525177278718,-0.10719908439930631,0.05909740480732495,0.16629648920663126,2586800,2532800,91.7040980775239,86.42095681729256,NaN,NaN,4.7608522248739416,15.265416581319705
2003-07-02T09:30:00-04:00,20.78,20.96001,20.67,20.94,53300,246700,52.640856013604825,54.23486379923417,NaN,NaN,-51.06422634227608,-90.08138955660198,-0.0852051378042415,0.05979006695132938,0.14499520475557087,2640100,2671120,92.17365869392219,87.2720690867026,NaN,NaN,4.757065058811497,13.764223506675675
2003-07-03T09:30:00-04:00,20.83,20.91,20.66,20.78999,28700,239960,49.49940087045262,53.46868270381787,NaN,NaN,-62.50114453618221,-87.68433969700425,-0.07784834540738958,0.04768477299633389,0.12553311840372347,2611400,2637680,90.83506869508116,88.05149591138664,NaN,NaN,3.8345778015404495,12.345702691656356
2003-07-07T09:30:00-04:00,20.73,21.10001,20.73,21.07001,545500,239710,54.90884682033012,52.664095244975975,NaN,NaN,-13.883678238129262,-72.41891234585654,-0.052430550809350746,0.05999492989203503,0.11242548070138578,3156900,2724300,91.19189734036446,88.8102375556256,NaN,NaN,4.675180001857383,11.24991373597079
2003-07-08T09:30:00-04:00,21.05,21.06,20.91,21.03999,46500,236685,54.23808715424659,51.74131682193127,NaN,NaN,-4.870409704585873,-52.00633514384242,-0.036691441384234816,0.06656117897109226,0.10325262035532708,3110400,2821120,91.58622129839104,89.42596365500539,NaN,NaN,5.161790841965318,10.380181893970008
2003-07-09T09:30:00-04:00,21.03999,21.03999,20.8,20.97,45500,238290,52.62403071930364,51.08369083753025,NaN,NaN,-21.244128284858522,-30.71271742120639,-0.030310979247883257,0.06536389629547301,0.09567487554335627,3064900,2916740,91.96863084818352,89.93056848725307,NaN,NaN,5.114551713323574,9.627949011020517
2003-07-10T09:30:00-04:00,20.83,20.83,20.5,20.61,58700,239975,45.17700317522012,50.059187080499164,NaN,NaN,-88.8923226821334,-38.27833668917786,-0.04856948612418284,0.03496301788812772,0.08353250401231056,3006200,2989960,92.25877447320403,90.34367814693465,NaN,NaN,2.801006995215123,8.652671580191175
2003-07-11T09:30:00-04:00,20.75999,20.81,20.67999,20.74001,50600,240465,48.03691546694357,49.584777236803475,NaN,NaN,-59.388762941608256,-37.65586037026307,-0.04993208720948386,0.02111739500045573,0.07104948220993959,3056800,3079040,92.60862601242378,90.7016914496535,NaN,NaN,1.7234755171933835,7.662786428334348
2003-07-14T09:30:00-04:00,20.92999,20.98,20.75,20.82001,68800,242690,49.77320953564449,49.759358344748485,NaN,NaN,-27.096498987530577,-40.29842452014334,-0.04371094811314127,0.016410797068513006,0.06012174518165427,3125600,3072780,92.29296461579223,90.99928357119059,NaN,NaN,1.3384411488200294,6.759308531260874
2003-07-15T09:30:00-04:00,20.95,20.95,20.61,20.67,35900,227950,46.62704684780377,49.64066601218404,NaN,NaN,-53.30430730747102,-49.98520404072037,-0.047641664745913574,0.0005696642492623027,0.04821132899517588,3089700,3068640,92.06945495661235,91.27311224567073,NaN,NaN,0.09229826569655623,5.806878493323115
2003-07-16T09:30:00-04:00,20.71001,20.77,20.47,20.58,45300,170595,44.79748884882921,49.57092207498001,NaN,NaN,-98.51302005272728,-65.43898239429413,-0.053791030217908264,-0.01902745877720946,0.034763571440698804,3044400,3064540,91.8322677785954,91.52451846379508,NaN,NaN,-1.4778895420517217,4.766197345412424
2003-07-17T09:30:00-04:00,20.42,20.67999,20.42,20.53999,117300,175095,43.97146995510568,49.014295642026205,NaN,NaN,-126.01174803422725,-72.86286746471289,-0.05769579624765107,-0.03735617386886503,0.02033962237878604,2927100,3048720,90.8596238588483,91.64042265481602,NaN,NaN,-3.0113769676301443,3.6551153006920574
2003-07-18T09:30:00-04:00,20.72,21,20.7,21,224200,184415,54.3855743468349,49.440429478471934,NaN,NaN,63.025799749986,-48.37995492639404,-0.027947387892093438,-0.01459461248633076,0.013352775405762678,3151300,3067620,90.98250479056529,91.69052792706819,NaN,NaN,-1.2415179869180952,2.955596259604893
2003-07-21T09:30:00-04:00,21,21.03999,20.83,20.92,867600,212710,52.55603119379887,49.74921360803802,NaN,NaN,96.5382524102413,-23.653004646839662,-0.013063761413063929,-0.0029769263605672336,0.010086835052496695,2283700,2899240,80.58799181616891,90.9251273754055,NaN,NaN,-0.3428564638886324,2.4843887276772465
2003-07-22T09:30:00-04:00,21.02,21.35001,20.87,21.35001,233900,212045,60.288951641272135,50.68035089924218,NaN,NaN,209.7937020219732,28.96659721904918,0.024300105148814352,0.040461966488514634,0.01616186133970028,2517600,2784820,74.3701319455721,89.68698693740893,NaN,NaN,3.0685488747727643,2.5678401772623203
2003-07-23T09:30:00-04:00,21.38,21.41,21.14999,21.39999,184600,184745,61.08292351592077,51.283355720836184,NaN,NaN,220.36901840421686,92.74300491043802,0.049487463418296365,0.07802119061257073,0.028533727194274373,2702200,2716380,70.84888597319133,88.16378888592816,NaN,NaN,6.027568944419754,3.0620871439990967
2003-07-24T09:30:00-04:00,21.52,21.92999,21.5,21.64999,283100,195570,64.86682330404184,52.381028751806845,NaN,NaN,285.66268434252373,175.0778913857882,0.0783744764250412,0.12650182272557586,0.04812734630053467,2985300,2728020,71.09951456365822,86.75410644796936,NaN,NaN,9.806834080280913,4.025622420610785
2003-07-25T09:30:00-04:00,21.72,22.14999,21.60001,22.14999,625600,185345,70.95034517396088,53.52685006278047,NaN,NaN,272.93580466186376,217.05989236816376,0.12384184106065654,0.20292964762635535,0.0790878065656988,3610900,2819940,73.06864877648792,85.45958869340677,NaN,NaN,15.436560909318944,5.655756490426236
2003-07-28T09:30:00-04:00,22.22,22.25,21.97,22.14999,487400,206975,70.95034517396088,54.720582778474345,NaN,NaN,228.06668007139754,243.365577900395,0.14512688198176438,0.2604964090429043,0.1153695270611399,3610900,3085380,77.7774030401888,84.4732445321066,NaN,NaN,19.743209516073932,7.668249779804478
2003-07-29T09:30:00-04:00,22.23,22.23,21.77,22.09,542600,229230,69.28106050399151,55.910370620237764,NaN,NaN,164.05785575665888,234.21840864733213,0.1459799186985272,0.2978444254342989,0.1518645067357717,3068300,3195520,79.38780920134607,83.57461441447536,NaN,NaN,22.691638340867545,9.81444814567063
2003-07-30T09:30:00-04:00,22.14999,22.14999,22,22.10001,339400,244225,69.41038767105232,57.641326655654346,NaN,NaN,142.52979288996414,218.6505635444816,0.1381163721232565,0.3245099718898423,0.18639359976658582,3407700,3336620,81.26128091100371,82.7890791600325,NaN,NaN,25.09859072683785,11.997897085837375
2003-07-31T09:30:00-04:00,22.25,22.60001,22.16,22.36,1046400,293880,72.6330658797363,59.398194542282404,NaN,NaN,152.41459844829012,192.00094636563486,0.14084000456519424,0.36244360547307863,0.2216036009078844,4454100,3630380,84.43350677446539,82.2051420716069,NaN,NaN,28.21985283349222,14.315319335502352
2003-08-01T09:30:00-04:00,22.35001,22.38,22.00999,22.13,141300,299510,66.007927666455,60.55781726591173,NaN,NaN,108.23409189843495,159.0606038129491,0.11846567844075573,0.3696856989588291,0.25122002051807335,4312800,3770760,85.68098931476439,81.73285812153348,NaN,NaN,28.89932942383655,16.398749348121523
2003-08-04T09:30:00-04:00,22.13,22.25999,21.82001,22.17999,1189000,331685,66.71849222803279,61.99292050735665,NaN,NaN,85.69979134097193,130.58722606686396,0.09913163771042771,0.375134567656108,0.27600292994568026,5501800,4148940,88.38213504604707,81.46947812792168,NaN,NaN,29.65993414910407,18.29320431969046
2003-08-05T09:30:00-04:00,22.2,22.2,21.77,21.77,828500,370785,56.320141746661264,62.81596714291608,NaN,NaN,58.73577391415612,109.52280969836343,0.05313592127062583,0.3424228315339626,0.28928691026333675,4673300,4469940,90.09082631902426,81.34508945223801,NaN,NaN,27.017044199953823,19.539467159728083
2003-08-06T09:30:00-04:00,21.75,21.92999,21.61,21.73,746900,405855,55.412740712542984,63.63320076844731,NaN,NaN,36.71671316468466,88.36019375330751,0.016331144401742825,0.3097008407655153,0.29336969636377247,3926400,4573680,90.57335203182058,81.32464146459317,NaN,NaN,24.626552730485717,20.266193669836316
2003-08-07T09:30:00-04:00,21.78,21.82001,21.50999,21.75,968300,451335,55.79622675416523,63.73396165468519,NaN,NaN,24.90526243405999,62.85832655046149,-0.008991724534183954,0.28213004069604253,0.2911217652302265,4894700,4661800,90.97535217857211,81.32413056373652,NaN,NaN,22.801692278379036,20.62840775677099
2003-08-08T09:30:00-04:00,21.87,22,21.75,21.97,184200,458015,59.883547101925686,64.25735564812283,NaN,NaN,45.853574005078265,50.38222297179019,-0.013006462662994711,0.2748636869014831,0.2878701495644778,5078900,4815020,91.64271184047965,82.11375342261587,NaN,NaN,22.389437470157837,20.879983430111967
2003-08-11T09:30:00-04:00,22.03999,22.16,21.89999,22.08,186400,463895,61.78617780659613,64.3643003742174,NaN,NaN,59.088430119101844,45.05995072741619,-0.01044551666283966,0.27481325373592824,0.2852587703987679,5265300,4767720,89.4437877463775,83.1904431226734,NaN,NaN,22.595046378523335,21.124992422742164
2003-08-12T09:30:00-04:00,22.11,22.21001,21.96001,22.2,1037600,513980,63.80304480569687,64.55859475205854,NaN,NaN,66.02250767751822,46.5172974800886,-0.003235324180347887,0.281214615173333,0.2844499393536809,6302900,5093640,91.0392646168454,84.63261302579154,NaN,NaN,23.35199984593324,21.44313634034089
2003-08-13T09:30:00-04:00,22.28,22.28,22.10001,22.17999,310100,527220,63.20401015912917,64.43982238456478,NaN,NaN,72.5649092095277,53.68693668905721,-0.0024167814306760294,0.2814289625653359,0.2838457439960119,5992800,5506920,92.57230771025797,86.16638396483438,NaN,NaN,23.8090075872691,21.78111794704492
2003-08-14T09:30:00-04:00,22.14999,22.60001,22.14999,22.53999,1069300,574820,68.86728488777212,64.29103236412273,NaN,NaN,113.08023319349122,71.32193084094345,0.018609548490876815,0.30710767960960794,0.2884981311187311,7062100,5940400,93.77524347872536,87.64542644356563,NaN,NaN,25.960759001436312,22.37820952624369
2003-08-15T09:30:00-04:00,22.64999,22.64999,22.3,22.45,166400,571930,66.12744419379023,63.94653943696768,NaN,NaN,120.6852632507148,86.28826869007075,0.02243976749637505,0.3165478404891999,0.2941080729928249,6895700,6303760,94.56921333324327,88.84484146449809,NaN,NaN,26.93807957341527,23.029619532982487
2003-08-18T09:30:00-04:00,22.62,22.8,22.49001,22.75,1132800,585190,70.36084898082414,64.02366718531287,NaN,NaN,167.5454907934647,107.97968082494333,0.04012811685734252,0.344268219064503,0.3041401022071605,8028500,6856400,95.50772175641262,89.99626378985998,NaN,NaN,29.145134760890222,23.903264565540734
2003-08-19T09:30:00-04:00,22.81,22.99001,22.75,22.99001,912800,619135,73.24213309266781,64.29736328685684,NaN,NaN,209.51960159736572,136.67909960891285,0.061655339598581715,0.3812092767053876,0.3195539371068059,8941300,7384080,96.18555092597673,91.06228307664377,NaN,NaN,31.976383232682142,25.05656723227522
2003-08-20T09:30:00-04:00,22.95,23.03999,22.86,22.95,294300,624620,71.9858390689572,64.25113280037262,NaN,NaN,187.49622861390586,159.66536348978846,0.06644945400233376,0.4026157546097231,0.33616630060738933,8647000,7914920,96.72148192571113,91.93999558744704,NaN,NaN,33.864247694298825,26.31480729827859
2003-08-21T09:30:00-04:00,23,23.3,23,23.09,487300,634830,73.68663006771408,64.79961154331968,NaN,NaN,184.20057911497722,173.88943267408567,0.07184063079218589,0.4259670890976217,0.3541264583054358,9134300,8329360,97.06785577340402,92.7533431916356,NaN,NaN,35.972997680321015,27.69454878142751
2003-08-22T09:30:00-04:00,23.05,23.14,22.71001,22.71001,413800,624240,62.580968713380784,64.50407414941597,NaN,NaN,108.46401550709334,171.44518312536135,0.04397513398481967,0.4090953757864604,0.3651202418016407,8720500,8694320,97.33488106213308,93.39282504992744,NaN,NaN,34.29350113784281,28.63725626091541
2003-08-25T09:30:00-04:00,22.62,22.64999,22.41,22.60001,1264200,663080,59.772544702230206,64.75067436052804,NaN,NaN,45.072432899127236,146.95057154649388,0.013855656672265848,0.382439812641973,0.3685841559697072,7456300,8579880,94.43086965087585,93.7028281450597,NaN,NaN,32.033960534064455,29.12249972850813
2003-08-26T09:30:00-04:00,22.55,22.64999,22.25,22.63,1067900,689345,60.29569497798159,65.09945680805937,NaN,NaN,32.65498679254297,111.57764858552932,-0.007195404269714711,0.3595899006325638,0.3667853049022785,8524200,8496460,92.26981142259066,93.82400381582899,NaN,NaN,30.375602579562184,29.301514421515854
2003-08-27T09:30:00-04:00,22.63,22.75999,22.53,22.71001,393600,692055,61.72578278213418,65.52299652434286,NaN,NaN,57.26612732738642,85.53162832822544,-0.01825046678925929,0.3439722214157044,0.36222268820496367,8917800,8550620,92.39155375271073,93.9251610711246,NaN,NaN,29.40637117055036,29.316493957092213
2003-08-28T09:30:00-04:00,22.78,23.00999,22.53,22.95,254500,652460,65.7147953878316,65.93951425905043,NaN,NaN,79.68307087770013,64.62812668077002,-0.012209560144337273,0.3469607380245421,0.35917029816887935,9172300,8558220,92.40961861847877,93.97994012669596,NaN,NaN,29.740000381775957,29.376994874904177
2003-08-29T09:30:00-04:00,22.89,23.00999,22.84,22.98,1413100,716050,66.1891767622555,66.25401418445466,NaN,NaN,91.09871302499586,61.15506618435053,-0.00914314870730576,0.34774136228474717,0.35688451099205293,10585400,8931200,93.25590798647809,94.2522344295603,NaN,NaN,30.147996752004104,29.487138000204165
2003-09-02T09:30:00-04:00,23.10001,23.28999,22.87,23.25,1281400,720670,70.18724487858428,66.7100284753752,NaN,NaN,113.37963148437879,74.81650590140084,0.0072352388060467066,0.36592855949961134,0.35869332069356463,11866800,9813300,94.74746859598336,94.51710614235586,NaN,NaN,31.73059789925129,29.80763227149661
2003-09-03T09:30:00-04:00,23.34,23.34,23.14999,23.25999,445600,701525,70.32705592599534,67.21881745872278,NaN,NaN,121.30826810462924,92.54716216381809,0.014489011548744268,0.376804585129495,0.3623155735807507,12312400,10570940,95.63950566474938,94.73619171053383,NaN,NaN,33.047607107563636,30.270485819506188
2003-09-04T09:30:00-04:00,23.13,23.14,22.94,23.05,1077100,718035,63.57770468286552,66.84099030122945,NaN,NaN,78.72909370452196,96.83975543924518,0.0015717646981420752,0.36428027945342834,0.36270851475528626,11235300,11034440,96.07829920637991,94.90069569108059,NaN,NaN,32.21456752912608,30.548211778023315
2003-09-05T09:30:00-04:00,22.96001,23.03999,22.8,22.96001,1888700,764055,60.881188468045806,66.46625774939056,NaN,NaN,53.1740525887623,91.53795178145762,-0.015656605742870033,0.34313775757669873,0.35879436331956877,9346600,11069300,96.1100048003204,95.01075222444324,NaN,NaN,30.728662186694557,30.57399040783349
2003-09-08T09:30:00-04:00,23.03,23.27,22.91,23.16,1422000,825945,64.48610497111511,66.04663317726849,NaN,NaN,84.08456522376056,90.13512222121058,-0.0161424345576201,0.3386163201225436,0.3547587546801637,10768600,11105940,96.14527980353799,95.0562920849522,NaN,NaN,30.489015615957015,30.561851151851137
2003-09-09T09:30:00-04:00,23.05,23.21001,23,23.07001,437900,838520,61.72950949621963,65.22430292037933,NaN,NaN,74.72845287979959,82.40488650029474,-0.02457794896890675,0.32403631846903025,0.348614267437937,10330700,10798720,88.86841766364807,94.53363970907158,NaN,NaN,29.479889504116468,30.407285202174755
2003-09-10T09:30:00-04:00,23.08,23.08,22.57001,22.63,395100,806395,50.38765613117073,63.68157556768029,NaN,NaN,-17.79461728362007,54.58430942264488,-0.05983540926878195,0.27382000585195954,0.3336554151207415,9935600,10323360,78.91578666151548,93.2618043330576,NaN,NaN,24.769628252006523,29.60190563786501
2003-09-11T09:30:00-04:00,22.7,22.78999,22.58,22.7,875900,834685,51.901708945449414,62.12550977323282,NaN,NaN,-51.417069366946514,28.555076808351185,-0.07737206757024345,0.23694033065793718,0.31431239822818063,10811500,10238600,77.25441514179099,91.84655857365665,NaN,NaN,21.46137283951448,28.43897238095779
2003-09-12T09:30:00-04:00,22.78,23.14999,22.60001,23.06,327800,797610,58.85591880101859,61.85943477949267,NaN,NaN,23.217326303876902,22.563731551374104,-0.06419890078209556,0.2340637722505612,0.29826267303265674,11139300,10597140,79.24490072191011,90.55441712078358,NaN,NaN,20.799555698777738,27.347627140646352
2003-09-15T09:30:00-04:00,23.19,23.19,22.91,22.97,473900,812985,56.65071743728767,61.63644711771106,NaN,NaN,49.41753599344832,15.630325705311657,-0.06103959618357935,0.22196317780318253,0.2830027739867619,10665400,10576500,78.81729822435832,89.43916201888946,NaN,NaN,19.561646282676712,26.235344160936403
2003-09-16T09:30:00-04:00,22.97,23.14,22.91,23.09,209700,766830,58.863839086870435,61.5341716969174,NaN,NaN,54.14586142852018,11.513807415055775,-0.050781571383881896,0.2195258097569095,0.2703073811407914,10875100,10685380,79.44732691130507,88.52327026808337,NaN,NaN,19.236041793674463,25.235443822756125
2003-09-17T09:30:00-04:00,23,23,22.75,22.75,1294200,785900,50.93006298671063,60.763048854387144,NaN,NaN,-33.49761651692528,8.373207568394736,-0.06585233278061842,0.18799196516501837,0.2538442979456368,9580900,10614440,77.82321520291363,87.48267465738357,NaN,NaN,16.319316993729878,23.961711418609518
2003-09-18T09:30:00-04:00,22.83,22.97,22.75,22.92,172900,779830,54.250337124450525,59.94415897843135,NaN,NaN,-12.851951531486419,16.086231135486756,-0.06331155311549974,0.1747048565512621,0.23801640966676185,9753800,10402900,73.02899548305821,86.09834443342496,NaN,NaN,14.993347662982718,22.680516596377117
2003-09-19T09:30:00-04:00,22.91,22.91,22.7,22.89999,364400,773685,53.78898277008634,59.05843083613356,NaN,NaN,-25.7523166154961,6.2923025516121545,-0.06184708703938427,0.16070755086753152,0.2225546379069158,9389400,10052920,65.80611502732341,84.13764493634247,NaN,NaN,13.805316633107056,21.412630887338537
2003-09-22T09:30:00-04:00,22.64999,22.7,22.44,22.53,255900,765790,45.999434755772434,57.33073011307557,NaN,NaN,-127.39099504635655,-29.069403656348822,-0.08332794716198066,0.11839470395443996,0.20172265111642063,9133500,9746540,60.19348451172793,81.6695032160385,NaN,NaN,10.171239494651552,19.806717831240395
2003-09-23T09:30:00-04:00,22.45,22.64,22.37,22.60001,2313500,818255,47.54732908711365,55.70360676744116,NaN,NaN,-134.2414554905709,-66.74686704016705,-0.0897947377111657,0.08947922897746352,0.17927396668862922,11447000,9860920,61.51321778694244,79.23191122476658,NaN,NaN,7.742686728750874,18.083284816599033
2003-09-24T09:30:00-04:00,22.67,22.67,22.16,22.25,2400500,884885,41.190441782837084,54.10451656029627,NaN,NaN,-191.08748140406337,-98.26484001759466,-0.11311203526198832,0.03788392261114382,0.15099595787313214,9046500,9754040,59.52722052579751,76.62111989043929,NaN,NaN,3.4719889615057684,15.995956837299996
2003-09-25T09:30:00-04:00,22.25,22.25,21.89,21.89,1929000,961655,35.877369640276015,52.318529501169856,NaN,NaN,-257.2519717737974,-147.14484406605686,-0.1461483061382099,-0.03168942479963022,0.11445888133857966,7117500,9226780,50.81180863341298,73.3855344499459,NaN,NaN,-2.087389001187876,13.412621717516014
2003-09-26T09:30:00-04:00,21.8,21.92999,21.78,21.83,2028300,1050345,35.06554306258032,50.21706079341737,NaN,NaN,-226.53895726096212,-187.30217219515006,-0.16406602460006198,-0.09062364941149781,0.07344237518856417,5089200,8366740,40.41703052757199,69.40494521594832,NaN,NaN,-6.704436506821114,10.538756256896425
2003-09-29T09:30:00-04:00,22,22.17999,21.83,22.17,777200,1018550,42.9442419065929,48.87525596558688,NaN,NaN,-144.48927482501176,-190.7218281508811,-0.1456674457099449,-0.10864193194886695,0.03702551376107794,5866400,7713320,34.62193771225964,65.53019664799199,NaN,NaN,-8.07825682309044,7.879182959755445
2003-09-30T09:30:00-04:00,22.06,22.06,21.7,21.83,1409700,1024965,37.98135452991058,47.98909156549687,NaN,NaN,-153.95191312228667,-194.66391967722427,-0.14853500493258448,-0.14864324240465265,-0.0001082374720681803,4456700,6315260,26.024091967833343,61.752218455586124,NaN,NaN,-10.95648062332953,5.188373876457591
2003-10-01T09:30:00-04:00,21.96001,22.22,21.91,22.2,759400,1040655,45.379046544165746,47.52318710826233,NaN,NaN,-93.85398681139218,-175.21722075869002,-0.11893236270555119,-0.14877369085400716,-0.029841328148455977,5216100,5549180,22.697835579905686,57.85531991545147,NaN,NaN,-10.777324742485547,2.907559788037143
2003-10-02T09:30:00-04:00,22.21001,22.39999,22.17999,22.36,219300,997765,48.25351637529185,46.76587264928184,NaN,NaN,-50.49735718808921,-133.86629784154837,-0.08366048517334351,-0.13441693461513537,-0.05075644944179186,5435400,5212760,21.404032716014,53.72382934360174,NaN,NaN,-9.65096559137889,1.1134847338348528
2003-10-03T09:30:00-04:00,22.64999,22.84,22.53,22.63,2446100,1025635,52.77042191882251,46.48870868367719,NaN,NaN,16.94252228208728,-85.1700019329385,-0.039473628699016806,-0.10009848531556287,-0.06062485661654606,7881500,5771220,28.672390244871806,50.14205020220986,NaN,NaN,-7.170747990536136,-0.0699770839324314
2003-10-06T09:30:00-04:00,22.55,22.71001,22.50999,22.62,131400,961105,52.587332928311085,46.04038681520866,NaN,NaN,12.369307576622116,-53.79828545261173,-0.009794361651762062,-0.07286780868124865,-0.06307344702948658,7750100,6147960,33.162825565631906,46.836014391804625,NaN,NaN,-5.306559141983299,-0.8180602350825553
2003-10-07T09:30:00-04:00,22.60001,22.73,22.44,22.72,141200,946270,54.29506389293654,46.28074402279623,NaN,NaN,21.532877193499896,-18.701327389454423,0.01627825953138009,-0.04272562261526147,-0.05900388214664156,7891300,6834880,40.516078087928314,44.17121888359139,NaN,NaN,-3.2607250215295274,-1.1670123474321228
2003-10-08T09:30:00-04:00,22.81,22.95,22.75,22.8,720200,962525,55.6706601986249,46.38219567095154,NaN,NaN,63.44190528230712,12.757851029285442,0.0374100803512767,-0.012241281707545681,-0.04965136205882238,8611500,7513960,46.75281615339514,42.294348931472605,NaN,NaN,-1.171208340177135,-1.1676117749671244
2003-10-09T09:30:00-04:00,23,23.07001,22.8,22.89,2595100,1048485,57.23022029223649,46.62799835110513,NaN,NaN,77.14721199243242,38.286764865389756,0.05489024975441731,0.018961450134199254,-0.035928799620218055,11206600,8668200,55.32650477123965,41.54580534175234,NaN,NaN,1.0240943213965876,-0.8545109040580228
2003-10-10T09:30:00-04:00,22.95,23,22.8,22.82001,203700,1042280,55.592260079034446,47.313200159909556,NaN,NaN,68.76179763405749,48.6506199357838,0.058830001412518707,0.03760870214543033,-0.021221299267088378,11002900,9292480,59.157014160698644,41.47177174525026,NaN,NaN,2.4118489701597285,-0.38788806488405836
2003-10-13T09:30:00-04:00,22.99001,23.13,22.95,23.06,131800,1025175,59.836954262025856,48.19103052954614,NaN,NaN,104.04627414626162,66.9860132497117,0.07372446721436052,0.07093428475086228,-0.0027901824634982454,11134700,9969400,62.874283658162646,41.56899073605171,NaN,NaN,4.885323367165394,0.365427853980149
2003-10-14T09:30:00-04:00,23.17999,23.21001,23,23.21001,243300,1026855,62.26493158268146,49.696351229535026,NaN,NaN,120.92600912317373,86.86463963564647,0.08879399674012986,0.10820231346166409,0.019408316721534223,11378000,10666740,66.279128097713,42.05126984833139,NaN,NaN,7.714734937199559,1.415328865868636
2003-10-15T09:30:00-04:00,23.32001,23.32001,23.05,23.19,859300,1005110,61.72886609694936,51.542886690725986,NaN,NaN,121.31567824043543,98.43939422727213,0.09213062449551648,0.13457159734092983,0.042440972845413344,10518700,11048180,68.00749906875657,43.27953345085592,NaN,NaN,9.894650377284133,2.6266605103565643
2003-10-16T09:30:00-04:00,23.16,23.44,23.07001,23.27,348100,1013870,63.09680251009666,53.54511950840572,NaN,NaN,125.62458979237127,108.13486978725992,0.09411080541392976,0.16007947961282554,0.06596867419889578,10866800,10980220,67.34519623892453,45.20297385880968,NaN,NaN,12.126639639639848,3.983800385968462
2003-10-17T09:30:00-04:00,23.37,23.37,23,23.05,350600,1013180,57.05702323349629,54.553175317470256,NaN,NaN,96.8554421208432,113.75359868461706,0.07577719067033387,0.16069016253681312,0.08491297186647925,10516200,10882880,66.34852091212377,47.46915837308569,NaN,NaN,12.444984069912541,5.192540912246187
2003-10-20T09:30:00-04:00,23.09,23.2,23.03,23.14,369200,1018845,58.79470888434672,56.03984348564426,NaN,NaN,84.3233162367666,109.80900710271803,0.06528312496691957,0.16651687807512872,0.10123375310820915,10885400,10833020,65.81125059961245,50.311098275355626,NaN,NaN,13.197439286971422,6.336097822921221
2003-10-21T09:30:00-04:00,23.14999,23.28999,23.13,23.2,182300,912285,59.957999591827566,57.08119727476297,NaN,NaN,88.11230432524447,103.2462661431322,0.058189529627635836,0.17397066514275394,0.11578113551511811,11067700,10770960,65.10457952222063,53.340151414092404,NaN,NaN,14.149021787441704,7.452229817852718
2003-10-22T09:30:00-04:00,23.05,23.05,22.75,22.81,257500,805135,50.064247863000155,57.2105352381707,NaN,NaN,30.28546665818599,85.04022382668231,0.02474856679732461,0.14671684401177387,0.12196827721444926,10810200,10829260,65.47958246864692,56.488404967851906,NaN,NaN,12.070103462120423,8.111926052748105
2003-10-23T09:30:00-04:00,22.78,22.99001,22.77,22.91,240300,720700,52.24042576580353,57.17267837009792,NaN,NaN,28.626253580300652,65.64055658426818,0.007760863267907495,0.13166935629933363,0.12390849303142613,11050500,10866000,65.72952584834886,59.13534322524311,NaN,NaN,10.974841272647158,8.520913941305112
2003-10-24T09:30:00-04:00,22.92999,22.92999,22.7,22.87,81800,623375,51.277801354595596,57.07914040054681,NaN,NaN,11.33162103070019,48.535792366239576,-0.006975894106171138,0.11518862539871222,0.12216451950488336,10968700,10956500,66.37535466743917,61.50766673251507,NaN,NaN,9.798906002403449,8.703484235747732
2003-10-27T09:30:00-05:00,22.85001,23.11,22.85001,23.03,197800,594405,54.860815680408955,57.11955124250913,NaN,NaN,41.28950800432221,39.9290307197507,-0.006749844627991372,0.11372721371989414,0.12047705834788551,11166500,11012720,66.79399482417881,63.38466078510438,NaN,NaN,9.799464168777842,8.860052797609177
2003-10-28T09:30:00-05:00,23.14999,23.27,23,23.23,258800,536860,58.92687840338336,57.35213825713473,NaN,NaN,80.72175378439584,38.450920611580976,0.005410843234234852,0.12724061239067908,0.12182976915644422,11425300,11084240,67.35089304026445,64.85595199130934,NaN,NaN,11.003333067909299,9.166235693366337
2003-10-29T09:30:00-05:00,23.14999,23.57001,23.14,23.53999,650100,531395,64.29531624925515,57.85678796835036,NaN,NaN,144.7582449950417,61.34547627895212,0.0314214203079651,0.1611065445414006,0.1296851242334355,12075400,11337280,69.31188479579059,65.85490770734869,NaN,NaN,13.792328917238086,9.827106153919445
2003-10-30T09:30:00-05:00,23.81,24.06,23.75,23.95,543500,547605,69.8993151737296,58.87872047511429,NaN,NaN,262.8965277777818,108.19953111844833,0.07106074915414015,0.2185110606761107,0.14745031152197055,12618900,11650960,71.58991427123527,66.74297200095846,NaN,NaN,18.25300510333583,11.030806003836071
2003-10-31T09:30:00-05:00,23.97,24.09,23.82001,23.91,617800,456190,68.7653679315041,59.51646430864845,NaN,NaN,224.2104867308756,150.77530425848343,0.08828380774345806,0.25780507120129315,0.16952126345783508,12001100,11857440,73.01016555186159,67.4669635647941,NaN,NaN,21.386350293261078,12.51016947375393
2003-11-03T09:30:00-05:00,23.91,24.3,23.81,23.96001,782203,488730.15,69.43302573027947,60.028471033476876,NaN,NaN,206.10499701300094,183.73840206021916,0.0960969324845021,0.2896424290634627,0.1935454965789606,12783303,12180800.6,75.10877983958252,68.09765297492763,NaN,NaN,24.110745005621073,14.16739454973495
2003-11-04T09:30:00-05:00,23.95,24.00999,23.81,23.92,130796,488209.95,68.17741663489068,60.48908178618698,NaN,NaN,147.62326597279537,197.11870449789907,0.09163862563624353,0.308093778624265,0.21645515298802148,12652507,12426242,76.596298285129,68.71113863323994,NaN,NaN,25.968764782492904,15.853304582986087
2003-11-05T09:30:00-05:00,23.89999,23.95,23.7,23.83,579900,481194.95,65.31609161306511,60.647602436399005,NaN,NaN,108.44326325956423,189.85570815080357,0.07632342703828149,0.31185943678587336,0.23553600974759187,12072607,12425683.4,76.5850807317864,69.37113038273007,NaN,NaN,26.72056049730004,17.405769713602368
2003-11-06T09:30:00-05:00,23.78999,23.89999,23.66,23.89999,670800,384979.95,66.49377963935939,61.32165646538923,NaN,NaN,92.01972492009368,155.68034757926597,0.06504241854754506,0.3168390329320232,0.25179661438447815,12743407,12450584.8,76.74855441104064,70.11398991836701,NaN,NaN,27.68096557652056,18.873654836876394
2003-11-07T09:30:00-05:00,23.89999,24.10001,23.89999,23.99001,677200,408654.95,67.99884572965648,61.979094811482774,NaN,NaN,108.01712893670211,132.44167602043126,0.05801135434450655,0.3243108073151113,0.26629945297060476,13420607,12734486.2,78.5843132628125,71.02635153716702,NaN,NaN,28.917595947596492,20.308503566979265
2003-11-10T09:30:00-05:00,24,24,23.63,23.64999,694200,436774.95,57.49373179180727,61.8030756829099,NaN,NaN,58.95103015116934,103.01088264806495,0.026436285130505444,0.29934480938373653,0.2729085242532311,12726407,12723107,78.3174106213425,71.97012518710429,NaN,NaN,26.887210867314394,21.24831889559857
2003-11-11T09:30:00-05:00,23.67,23.73,23.57001,23.59,1323200,490769.95,55.85422089698203,62.21664518533718,NaN,NaN,32.14590228102307,79.91540990971049,-0.0010566668669063084,0.2715876906695982,0.2726443575365045,11403207,12473247,72.49510024972965,72.47123360003876,NaN,NaN,24.73124369064757,21.745879580605568
2003-11-12T09:30:00-05:00,23.7,23.96001,23.61,23.96001,348800,465244.95,62.88444338229039,62.97693215794338,NaN,NaN,62.549293915649066,70.73661604092744,0.0028942028960660116,0.27626211115658705,0.27336790826052104,11752007,12409127,71.03563169936459,72.8502411608256,NaN,NaN,24.950803057172116,22.203725791543647
2003-11-13T09:30:00-05:00,23.8,23.95,23.8,23.94,147900,455234.95,62.30657086078265,63.76470140838531,NaN,NaN,65.10362180812649,65.35339541853402,0.0014495781329119661,0.275179880926661,0.27373030279374905,11604107,12181267,65.95418138769872,72.82015735512987,NaN,NaN,24.950144725481984,22.59607135353484
2003-11-14T09:30:00-05:00,23.92,24.17,23.77,23.8,717900,473599.95,58.2718520377794,64.0083468624832,NaN,NaN,62.36070194001527,56.222110019196656,-0.010961893817171608,0.26002793552228454,0.27098982933945615,10886207,11674387,56.30519584519093,72.0709574280593,NaN,NaN,23.729644428467143,22.758010364239453
2003-11-17T09:30:00-05:00,23.75,23.78,23.42999,23.64,621200,486199.95,53.970431125255736,63.654314914045514,NaN,NaN,7.818059920299839,45.995515973022755,-0.030847912155261004,0.2324299391453799,0.2632778513006409,10265007,11182107,48.83305669752662,70.74825483214946,NaN,NaN,21.372136200195982,22.56002834080467
2003-11-18T09:30:00-05:00,23.74001,23.74001,23.47,23.57001,176300,485899.95,52.15673626431009,62.787273486549445,NaN,NaN,0.0011811021316177654,39.56657173724446,-0.048561836870031405,0.20257555521310167,0.25113739208313307,10088707,10919207,45.37023163950936,69.03813674955795,NaN,NaN,18.885633107585438,22.035114736059064
2003-11-19T09:30:00-05:00,23.57001,23.64,23.45,23.58,331000,489574.95,52.40260634594758,61.53750857027929,NaN,NaN,-16.038106786280867,23.849091596858468,-0.05877092317631641,0.17767373811273757,0.23644466128905398,10419707,10652747,42.11083916452937,66.93248852765039,NaN,NaN,16.925026490980073,21.305102129619208
2003-11-20T09:30:00-05:00,23.49001,23.64,23.27,23.39999,179300,486524.95,47.65067884381582,60.02931649258728,NaN,NaN,-54.962121455267834,-0.16405705582039615,-0.07573235029046094,0.14177922342597782,0.21751157371643876,10240407,10380007,39.0208043312371,64.50467701189149,NaN,NaN,13.79893801716853,20.23279297069768
2003-11-21T09:30:00-05:00,23.41,23.55,23.39,23.46001,581400,511504.95,49.30148544050464,58.591349329031935,NaN,NaN,-63.767453895086206,-25.389688222840693,-0.08054610458008749,0.1168289429913294,0.19737504757141688,10821807,10367127,38.8757269483416,61.916601805374285,NaN,NaN,11.63699036210175,19.00482116946969
2003-11-24T09:30:00-05:00,23.58,23.78,23.57001,23.77,321000,517664.95,56.866891983688674,57.783454711088936,NaN,NaN,-5.410619113916846,-28.035424029684027,-0.061357505638983956,0.12067816552268695,0.1820356711616709,11142807,10542687,42.03897980522722,59.44822191395273,NaN,NaN,11.921131115328095,17.99286544744946
2003-11-25T09:30:00-05:00,23.77,24.16,23.77,24.11,648400,537144.95,63.33028401389394,57.64161131114813,NaN,NaN,97.74438354554118,-8.486783541002115,-0.026075580501998152,0.14944119553417323,0.17551677603617138,11791207,10883187,47.69298691493578,57.38450092703483,NaN,NaN,14.327500698956417,17.469241911950455
2003-11-26T09:30:00-05:00,24.3,24.42999,24.24001,24.39999,286700,518974.95,67.76679915475663,57.732541276533674,NaN,NaN,210.65057029969887,36.85095187619383,0.01431170305372187,0.19340640485332372,0.17909470179960185,12077907,11214827,52.5481918778183,55.65590360323324,NaN,NaN,17.94418234734028,17.537090545577573
2003-11-28T09:30:00-05:00,24.39999,24.5,24.39999,24.45,77500,495674.95,68.47514609182555,57.76656273097433,NaN,NaN,207.45603256040192,89.33458267932778,0.040434175989083165,0.2296374217859558,0.18920324579687264,12155407,11597827,57.459191876114986,54.14696636132627,NaN,NaN,21.01520759880007,18.033964410323645
2003-12-01T09:30:00-05:00,24.60001,25.17999,24.60001,25.17999,711900,500379.95,76.56931566775758,59.12910443639935,NaN,NaN,288.0916780756277,159.70640907347055,0.09954893616295735,0.3136394160005693,0.21409047983761198,12867307,12006927,61.98492004851091,52.9803598918383,NaN,NaN,27.216362489152303,19.345735564442023
2003-12-02T09:30:00-05:00,25.14999,25.22,25.03,25.14999,2435800,583059.8,75.70900407200409,60.54730323461521,NaN,NaN,242.71842874219266,209.33221864469246,0.12751605091331158,0.37348554347925145,0.24596949256593986,10431507,11864667,59.61004803390436,52.05999901927935,NaN,NaN,31.526595875606734,21.08585846603698
2003-12-03T09:30:00-05:00,25.27,25.5,25.17,25.36,558800,604460,77.60587794798116,61.598834275021694,NaN,NaN,211.3153990168018,232.0464217389446,0.1495205851926903,0.43287022405680275,0.28334963886411246,10990307,11704487,56.96360937288617,51.054854567388034,NaN,NaN,35.69691357381462,23.173152052862356
2003-12-04T09:30:00-05:00,25.36,25.56,25.28999,25.53,383100,594620,79.03319058698983,62.79359282689364,NaN,NaN,176.6615896359038,225.24862560618558,0.16374024311164181,0.4880249427536647,0.3242846996420229,11373407,11563587,54.66462448315125,50.248457645634645,NaN,NaN,39.554223196967,25.513305073448734
2003-12-05T09:30:00-05:00,25.5,25.5,25.25,25.3,520400,587100,72.31748027090775,63.79685198640281,NaN,NaN,133.81222425083325,210.51986394427186,0.1464348107186525,0.5073282130403385,0.360893402321686,10853007,11303107,50.59898820201659,49.84087138540791,NaN,NaN,40.50563971131336,27.65506716457225
2003-12-08T09:30:00-05:00,25.36,25.72,25.3,25.72,505200,578500,76.28103071684254,65.39046624294473,NaN,NaN,133.41419051000554,179.58436643114743,0.15142496874967726,0.5501746132587826,0.3987496445091053,11358207,11001287,46.301854604837345,49.660071235930104,NaN,NaN,42.733470903082065,29.809124841502225
2003-12-09T09:30:00-05:00,25.88,25.92999,25.67999,25.67999,2218600,654720,75.17678314147135,67.03475530559909,NaN,NaN,129.87803485047363,157.0162876528036,0.14042608692461223,0.5742822531648706,0.43385616624025836,9139607,10742907,42.93988729578483,49.486475211378355,NaN,NaN,44.08354238016774,31.84832734702587
2003-12-10T09:30:00-05:00,25.67999,25.75,25.3,25.38,595200,618320,67.30910431148922,68.09950516028064,NaN,NaN,91.28216168314049,133.00964018607135,0.10307078854029267,0.5626946519156242,0.4596238633753315,8544407,10253727,37.40266311196091,49.15017692190918,NaN,NaN,42.58856002607238,33.38264630117537
2003-12-11T09:30:00-05:00,25.38,25.67999,25.28,25.63,424600,622110,70.11596013996754,69.70416811000577,NaN,NaN,84.9082223530796,114.65896672950653,0.08601818308019865,0.5671465922255798,0.4811284091453812,8969007,9772847,32.90992771893161,48.713685735315934,NaN,NaN,42.27187513036923,34.65253613391735
2003-12-12T09:30:00-05:00,25.78,25.89,25.66,25.85001,2739600,751695,72.36472560506351,71.35154240747426,NaN,NaN,95.90021292765647,107.07656446487117,0.08047489339598102,0.5817220258903575,0.5012471324943765,11708607,9943967,35.86229556764579,48.4984406366948,NaN,NaN,42.74935898084739,35.809225112050214
2003-12-15T09:30:00-05:00,26.14999,26.14999,25.73,25.82001,806100,756105,71.57382375277135,72.4020375338373,NaN,NaN,93.87512132689515,99.16875062824909,0.06629753558117746,0.5841190519708483,0.5178215163896709,10902507,9852827,34.979383814074936,47.99418378018392,NaN,NaN,42.87839340367021,36.819106296567355
2003-12-16T09:30:00-05:00,25.87,25.88,25.57001,25.82001,499800,750035,71.57382375277135,72.99086180089998,NaN,NaN,76.17307201361855,88.42775806087806,0.04921513607576977,0.579340436484383,0.5301253004086133,10902507,10205407,41.02802999901647,47.51811542904682,NaN,NaN,42.98116247245218,37.69940003597947
2003-12-17T09:30:00-05:00,25.63,25.99001,25.63,25.97,284400,755440,73.26792279481398,73.38379920376121,NaN,NaN,80.01549044263534,86.17442381277702,0.04066724047380055,0.5809593510008639,0.5402921105270634,11186907,10733907,48.72754261174377,47.245211910041505,NaN,NaN,43.556889355271835,38.53618422444981
2003-12-18T09:30:00-05:00,25.95,26.25999,25.89999,26.19,881100,782945,75.56791295743105,73.89042540844733,NaN,NaN,97.7889276215226,88.75056486646562,0.042291887166569064,0.5931569694852747,0.5508650823187057,12068007,11353707,55.985359708140635,47.13993818375763,NaN,NaN,44.73958622667573,39.42238451048209
2003-12-19T09:30:00-05:00,26.17999,26.2,25.92999,26.05,513600,799660,71.36026163594615,73.5183501204608,NaN,NaN,90.02908952152934,87.5763401852402,0.027136568890570922,0.5847857934319194,0.5576492245413485,11554407,11322867,55.5638941957156,46.681293479986536,NaN,NaN,44.50433288972131,40.148377136087696
2003-12-22T09:30:00-05:00,26.19,26.34,26.12,26.31,418900,791535,74.23002631720982,73.4127088522612,NaN,NaN,111.98831080244707,91.1989780803506,0.0277235762784942,0.5923036948894662,0.564580118610972,11973307,11537027,57.93224266133488,46.56145023908871,NaN,NaN,45.16104758647713,40.86447291471476
2003-12-23T09:30:00-05:00,26.42,26.42999,26.19,26.37,1246000,837785,74.85616613763446,73.21630086580787,NaN,NaN,120.64216914049742,100.09279750572637,0.025320076114005774,0.5962302137534792,0.5709101376394734,13219307,12000387,62.579379494341524,46.962576676335516,NaN,NaN,45.880714502280576,41.58107885579559
2003-12-24T09:30:00-05:00,26.2,26.35001,26.2,26.27,320100,821370,71.72807113435171,72.69450661919086,NaN,NaN,107.88700122975777,105.66709966315086,0.010899643415626215,0.5845346919090062,0.57363504849338,12899207,12342847,65.60367445891454,47.74393738888996,NaN,NaN,45.590016071836,42.15378417237279
2003-12-26T09:30:00-05:00,26.35001,26.5,26.32001,26.48,140400,814055,74.16921788700753,72.82677359176942,NaN,NaN,125.60681439423786,111.23067701769392,0.009461806413716078,0.5854623065105251,0.576000500096809,13039607,12537167,67.22243348100184,48.93132633738891,NaN,NaN,46.04420973480602,42.70955925272039
2003-12-29T09:30:00-05:00,26.64999,26.94,26.5,26.89999,371400,828750,78.21969941985212,72.96524992769868,NaN,NaN,173.59878207429603,127.94461552824723,0.029616088525561635,0.613020610753761,0.5834045222281994,13411007,12908487,70.11655241352408,50.63237618086653,NaN,NaN,47.75969416322507,43.4310070970782
2003-12-30T09:30:00-05:00,26.95,27,26.61,26.74001,1002900,843300,73.49229930574414,72.84492965371817,NaN,NaN,153.53063566491164,136.25308050074017,0.025167540276573197,0.6148639475739159,0.5896964072973427,12408107,12995447,70.76752269264495,52.6200644234994,NaN,NaN,47.69244464690002,44.03978388990989
2003-12-31T09:30:00-05:00,26.8,26.83,26.58,26.69,377100,740365,72.02683119447295,73.18191014535986,NaN,NaN,122.41684358544278,136.60801538972925,0.012492281418402973,0.6053117590703465,0.5928194776519435,12031007,12757787,66.5037149653281,54.698710984454195,NaN,NaN,47.19744581343101,44.49087845041291
2004-01-02T09:30:00-05:00,26.85001,26.89999,26.5,26.56,1185100,771680,68.21872279033073,73.04639319181437,NaN,NaN,102.86641613244917,135.6038983702675,-0.009808109622571393,0.5805593406237293,0.5903674502463007,10845907,12347127,59.79916359785876,56.619370690091856,NaN,NaN,45.64917167308045,44.65634891079399
2004-01-05T09:30:00-05:00,26.8,27.10001,26.8,27.10001,1276000,816325,74.29769548127233,73.18446246868643,NaN,NaN,142.10027611204802,138.90259071382954,0.005808503902364204,0.597628080124256,0.5918195762218917,12121907,12163587,57.03175333190696,58.13147481611052,NaN,NaN,46.17478950450865,44.87326899561037
2004-01-06T09:30:00-05:00,27.08,27.08,26.64,26.86,1104500,845530,68.06606480027726,72.933908257794,NaN,NaN,107.68795901643328,125.720426102257,-0.00542018025782709,0.5850443508996079,0.590464531157435,11017407,11684867,50.47097104460732,59.238016761148536,NaN,NaN,44.53122860268993,44.82440608233602
2004-01-07T09:30:00-05:00,26.85001,26.85001,26.38,26.72,2960600,968300,64.65931048471873,72.44001445293311,NaN,NaN,67.15873158213779,108.44604528570224,-0.02649159250341726,0.5573500405281635,0.5838416330315808,8056807,10814607,41.19367221399644,59.249848347932826,NaN,NaN,42.09411853136599,44.43436500362601
2004-01-08T09:30:00-05:00,26.82001,27.03,26.8,27.02,1257400,920240,68.31856727729297,72.08648905882445,NaN,NaN,105.48233053084111,105.0591426747819,-0.024487486001048553,0.5532322755302701,0.5777197615313187,9314207,10271247,36.66236332967097,58.38804982778477,NaN,NaN,41.20013928511908,43.97233275812502
2004-01-09T09:30:00-05:00,26.75,26.78999,26.45,26.55,1684400,974700,58.15858426518742,70.84296558080705,NaN,NaN,41.134065188479305,92.71267248598791,-0.057208939174721696,0.5062085875629165,0.5634175267376382,7629807,9628027,32.153400750485716,56.68576704509513,NaN,NaN,36.83628925071717,42.95289797135247
2004-01-12T09:30:00-05:00,26.55,26.55,26.33,26.5,1431400,1025040,57.18429518696605,69.83039654873704,NaN,NaN,9.73589518925905,66.23979630143012,-0.08304657821447603,0.45960930396954325,0.5426558821840193,6198407,8443327,25.847953815438174,54.56319987507532,NaN,NaN,33.138529526429465,41.55084533636347
2004-01-13T09:30:00-05:00,26.55,26.56,26.05,26.16,1020600,939090,50.93560396949883,68.16650923818625,NaN,NaN,-38.218462643676496,37.05851196940815,-0.1215329667403674,0.39073967375856,0.5122726404989274,5177807,7275407,21.39379089018847,51.95331046285058,NaN,NaN,27.85685776322756,39.59456139734406
2004-01-14T09:30:00-05:00,26.28999,26.32001,26.10001,26.27,875500,942560,52.73509438595899,66.58643268449515,NaN,NaN,-50.197894362995214,13.587186780381552,-0.13693487938216392,0.3411040412712225,0.47803892065338643,6053307,6874707,20.113195497956795,48.92001160596595,NaN,NaN,24.20715851553698,37.39636098565733
2004-01-15T09:30:00-05:00,26.39999,26.39999,25.92999,26.07001,990400,967090,49.20191744423866,64.97742170662993,NaN,NaN,-81.4750911599144,-23.804297557769555,-0.1565312313669326,0.28237488144472067,0.43890611281165326,5062907,6024447,17.6930377148267,45.49782326710254,NaN,NaN,20.04141480059464,34.917082959219805
2004-01-16T09:30:00-05:00,26.16,26.17,25.95,26.06,801100,992925,49.02486881019923,63.18139677257219,NaN,NaN,-105.02126941692686,-53.03536447885078,-0.16524845740822985,0.23234554105136596,0.3975939984595958,4261807,5350847,16.04579065443609,41.8423487794907,NaN,NaN,16.68352730251856,32.31228929397677
2004-01-20T09:30:00-05:00,26.2,26.25,26.07001,26.16,660800,981910,50.924738359689044,61.23175669684626,NaN,NaN,-81.10314031561961,-71.20317157982652,-0.15929267082089305,0.1984781599334795,0.35777083075437255,4922607,5095687,15.458674814015978,37.938214665240125,NaN,NaN,14.434501238087382,29.758319571706856
2004-01-21T09:30:00-05:00,26.08,26.33,25.91,26.17999,378700,975165,51.315358724901444,59.64768951250035,NaN,NaN,-88.36676594383266,-81.23283223985774,-0.14919532741945452,0.17127667148005443,0.32047199889950895,5301307,5120387,15.779927914636673,34.01052932395381,NaN,NaN,12.69815150346101,27.321152704814594
2004-01-22T09:30:00-05:00,26.17999,26.17999,25.84,25.91,494000,978920,45.99080913087844,57.787973650815026,NaN,NaN,-120.73963216097388,-95.34117979945349,-0.1551972556919442,0.12647542928457867,0.28167268497652287,4807307,4871187,15.15425322762431,30.34271062840354,NaN,NaN,9.594128227285946,24.788720636596217
2004-01-23T09:30:00-05:00,25.88,25.94,25.35001,25.41,1087500,970995,38.10532764627701,55.63701685481119,NaN,NaN,-186.2334145541311,-116.29284447829681,-0.18530023947297342,0.050047385635306085,0.2353476251082795,3719807,4602567,14.487431186772412,27.106158313325945,NaN,NaN,4.113623944260582,21.835135394833983
2004-01-26T09:30:00-05:00,25.39999,25.64999,25.38,25.64999,592500,984615,43.14426830353646,53.41177205640149,NaN,NaN,-159.7912091289395,-127.24683242069935,-0.18128448000251515,0.008742025105135554,0.1900265051076507,4312307,4612667,14.639520942540301,24.07814171408547,NaN,NaN,1.107085402576008,18.873985395939986
2004-01-27T09:30:00-05:00,25.74001,25.74001,25.56,25.58,433500,999270,42.06861643572015,51.554811458933116,NaN,NaN,-126.11074977236993,-136.24835431204943,-0.17546328142928852,-0.029302596678959958,0.14616068475032856,3878807,4403907,14.082020051651568,21.478930928874348,NaN,NaN,-1.638382471186689,15.943647129207605
2004-01-28T09:30:00-05:00,25.55,25.95,25.28,25.37,1717900,1066595,38.932254556870724,49.71716460694398,NaN,NaN,-126.92189428941329,-143.95937998116554,-0.1773508202520596,-0.07552784056474593,0.10182297968731366,2160907,3775827,12.535318779477521,19.43190568355157,NaN,NaN,-4.9388773007664355,12.960429353497029
2004-01-29T09:30:00-05:00,25.5,25.64999,25.00999,25.21001,1199300,1076415,36.688106711038806,47.45784599506869,NaN,NaN,-149.24472704838973,-149.6603989586487,-0.1803753586662231,-0.12364621864546521,0.05672914002075788,961607,3006687,10.949317125990262,17.5952595261458,NaN,NaN,-8.38736036831692,9.910745107523608
2004-01-30T09:30:00-05:00,25.17999,25.53,25.14999,25.50999,1008800,1108000,43.28887270570453,46.39572374081991,NaN,NaN,-118.49011006467353,-136.1117380607572,-0.15418867234065023,-0.13600670040505491,0.018181971935595315,1970407,2656807,10.310264722596898,16.03503552415374,NaN,NaN,-9.338454218965762,7.160859489453699
2004-02-02T09:30:00-05:00,25.55,25.55,25.28,25.39,579100,1077700,41.42831255170647,45.27029640972994,NaN,NaN,-103.53123991153373,-124.85974421727603,-0.1375157827323889,-0.1537127564798908,-0.01619697374750191,1391307,2072607,9.330990539305745,14.855252433001422,NaN,NaN,-10.683181814312903,4.611710731772757
2004-02-03T09:30:00-05:00,25.32001,25.44,25.21001,25.25,267300,1027265,39.30560766372136,44.439582387888684,NaN,NaN,-106.9217915420682,-121.02195257121568,-0.12864354218513596,-0.17700140147892185,-0.0483578592937859,1124007,1521647,8.510053276884577,13.934985460622574,NaN,NaN,-12.439332650082946,2.175847391507656
2004-02-04T09:30:00-05:00,25.17999,25.25,24.92999,25.08,568300,1000455,36.837372204608634,43.304030803506514,NaN,NaN,-123.190283482102,-120.27563040975342,-0.1267470201157847,-0.20679163443851678,-0.08004461432273208,555707,1200607,8.06480732850983,13.074386305662076,NaN,NaN,-14.663160127583305,-0.2297251112196239
2004-02-05T09:30:00-05:00,24.98,25.5,24.98,25.39,790600,891955,43.77141734556898,42.916137939315824,NaN,NaN,-83.98187326705971,-107.22305965348741,-0.09840080133737827,-0.20304561599445492,-0.10464481465707665,1346307,1277547,9.289711083567667,12.474148689143574,NaN,NaN,-14.47248161372006,-2.264404611576829
2004-02-06T09:30:00-05:00,25.41,25.92,25.41,25.91,519100,855040,53.07691073195679,43.20556950515565,NaN,NaN,-7.557813008554713,-85.03660024226366,-0.04133639597339264,-0.15631530962381746,-0.11497891365042481,1865407,1256547,9.253472043199267,11.98898307405523,NaN,NaN,-11.11064578114955,-3.5281533500872175
2004-02-09T09:30:00-05:00,26,26.07001,25.86,25.92999,337300,787685,53.39620979251746,43.38210317892911,NaN,NaN,36.639736372755294,-57.002404985405875,-0.0010786541224835772,-0.11632723130352929,-0.11524857718104571,2202707,1418827,12.106853796858175,11.749567287115386,NaN,NaN,-8.394266921474907,-4.22331243171403
2004-02-10T09:30:00-05:00,25.95,26.14999,25.88,26.07001,1573300,794780,55.671595902220794,43.69326297730906,NaN,NaN,59.49749824497799,-23.718547027996628,0.03419711194598586,-0.07250218724856339,-0.10669929919454925,3776007,1949227,20.86517209062947,12.112799013972014,NaN,NaN,-5.4414916715002395,-4.397338037397774
2004-02-11T09:30:00-05:00,26.08,26.73,26.08,26.71001,1634200,825460,64.26080561726144,44.99826272633642,NaN,NaN,146.46777464921334,30.213064598266442,0.0963306715832518,0.013714040284515505,-0.0826166312987363,5410207,2920127,33.857875458736075,13.448772030479997,NaN,NaN,0.37975450414869155,-3.714896245748279
2004-02-12T09:30:00-05:00,26.7,26.78999,26.59,26.63,525500,807960,62.62706850876548,46.7498156450856,NaN,NaN,162.40928776367434,79.49129680441327,0.12587211882889918,0.07472351723738768,-0.051148601591511494,4884707,3627807,41.40897293218549,15.371739298009503,NaN,NaN,4.410935659134347,-2.554063116479332
2004-02-13T09:30:00-05:00,26.59,26.77,26.32001,26.42,386400,777760,58.42832674644293,47.8415341052932,NaN,NaN,122.18370466855195,105.43960033983458,0.12485430382229856,0.10491927818636171,-0.019935025635936854,4498307,4154387,46.31983668957782,17.634618994226468,NaN,NaN,6.409053715600185,-1.273617854753687
2004-02-17T09:30:00-05:00,26.62,26.75,26.59,26.7,577000,766555,62.07890276405588,49.27084027160289,NaN,NaN,135.28694713719668,125.16904249272287,0.13572197786860346,0.14971744669981746,0.013995468831214011,5075307,4728907,51.13236776089962,20.281072402029903,NaN,NaN,9.292972314048134,0.23589502650371585
2004-02-18T09:30:00-05:00,26.74001,26.83,26.50999,26.59,929700,780000,59.8551586346177,50.76533342001339,NaN,NaN,118.27160589909703,136.92386402354666,0.12827131803140993,0.17433461637047643,0.0460632983390665,4145607,4802827,51.73196663968069,23.08083296347299,NaN,NaN,10.935116692459086,1.7643552644973401
2004-02-19T09:30:00-05:00,26.73,27.06,26.64999,26.75999,777900,799960,62.113750548144374,52.58145083694951,NaN,NaN,129.10064897065163,133.4504388878343,0.12730560871332913,0.20519530923072793,0.0778897005173988,4923507,4705487,50.8472162477613,25.930682900742347,NaN,NaN,12.99930595304731,3.3693482200044786
2004-02-20T09:30:00-05:00,26.82001,26.83,26.25,26.53,1288800,839700,57.40778166897215,53.589944334325764,NaN,NaN,80.93685030718326,117.1559513965361,0.10463922041715308,0.20868872603884014,0.10404950562168706,3634707,4455487,48.550593469232304,28.662134954073448,NaN,NaN,13.313933066935608,4.790003198137497
2004-02-23T09:30:00-05:00,26.60001,26.67,26.46001,26.53999,930900,831870,57.5581984622813,54.74207904222397,NaN,NaN,74.86039246884584,107.69128895659489,0.08463594549172729,0.20984443748634618,0.1252084919946189,4565607,4468947,48.68498030276615,31.473134222892046,NaN,NaN,13.60963049426821,6.049949954727599
2004-02-24T09:30:00-05:00,26.45,26.87,26.45,26.66,1631500,883820,59.41255977765527,56.17828990750497,NaN,NaN,78.6444916540217,96.3627978599599,0.07417878009279744,0.2179319671106157,0.14375318701781825,6197107,4693307,50.98327491047238,34.50693576814832,NaN,NaN,14.3871252258606,7.240974993460885
2004-02-25T09:30:00-05:00,26.60001,26.77,26.56,26.7,1047800,914535,60.039262075185114,57.83556775540329,NaN,NaN,72.72735015032224,87.25394671020493,0.06497799336935381,0.22497567872951052,0.1599976853601567,7244907,5313167,56.747082435085176,37.984241132903705,NaN,NaN,15.203754280959709,8.378514891675003
2004-02-26T09:30:00-05:00,26.63,26.74001,26.5,26.7,616600,859470,60.039262075185114,58.99755666466158,NaN,NaN,62.887502958159956,74.0113175077066,0.05434619635993562,0.22793043081007625,0.17358423445014062,7244907,5777447,60.49419816125108,41.64170449559538,NaN,NaN,15.880493028120842,9.450226054024409
2004-02-27T09:30:00-05:00,26.75,26.98,26.7,26.84,1618600,880435,62.39615212557091,59.663216764205444,NaN,NaN,79.7326605085706,73.77047954798405,0.05218541315385214,0.2388160008924558,0.18663058773860366,8863507,6823207,67.35448084882702,45.79177655314022,NaN,NaN,17.101099670823793,10.543207999281464
2004-03-01T09:30:00-05:00,26.97,27.34,26.97,27.28,1852000,922595,68.65366700089268,60.75303513623225,NaN,NaN,116.55823578529834,82.11004821127456,0.07447372714777456,0.27972274667332186,0.2052490195255473,10715507,8053187,73.24036847953785,50.158456173331615,NaN,NaN,20.145313395481264,11.91493734159572
2004-03-02T09:30:00-05:00,27.28999,27.28999,26.89999,26.94,1025800,944930,60.303029047432034,61.08385178946162,NaN,NaN,93.40833615328857,85.06281711112793,0.06097035289325162,0.2814619606421118,0.2204916077488602,9689707,8751707,75.8980671453982,54.08937724867224,NaN,NaN,20.277184435429746,13.109544069286295
2004-03-03T09:30:00-05:00,26.89999,26.91,26.59,26.78,1721400,1017635,56.80162351365915,60.55105306777575,NaN,NaN,51.557108042242746,80.82876868951203,0.03708952675641933,0.26685351619438435,0.22976398943796503,7968307,8896387,76.42043416801086,57.12956001362044,NaN,NaN,19.30431492316367,13.99451133412592
2004-03-04T09:30:00-05:00,26.82001,26.96001,26.67999,26.92999,1312000,1054820,59.193608680210055,60.30580593716464,NaN,NaN,68.80846300998711,82.01296069987747,0.027654490264619025,0.2643321022687388,0.2366776120041198,9280307,9303467,77.87352279413805,59.734170718045625,NaN,NaN,19.2117660474913,14.73983343603526
2004-03-05T09:30:00-05:00,26.88,27.06,26.78,26.92,658200,1048200,58.95943813900334,60.34374246520468,NaN,NaN,83.56047322676659,82.77852324351666,0.017495815029638206,0.25854738079116757,0.24105156576152936,8622107,9255187,77.26536908252481,61.94456588897041,NaN,NaN,19.069790136666647,15.358398678982601
2004-03-08T09:30:00-05:00,26.8,26.94,26.61,26.63,377000,1041095,52.4702845287165,59.65741259125186,NaN,NaN,22.628754260399326,63.992626938536866,-0.0104933489551986,0.2279348795675311,0.2384282285227297,8245107,8761107,71.14233922098278,63.37384956469064,NaN,NaN,16.985382471502216,15.590824935056832
2004-03-09T09:30:00-05:00,26.57001,26.58,26.08,26.23,1601100,1104285,45.0974661351724,58.60329169843435,NaN,NaN,-146.66347370836485,15.978264966206183,-0.05518710618357919,0.16944434579325574,0.22463145197683493,6644007,8151967,64.3695650261277,64.27653516372256,NaN,NaN,12.694546695838987,15.177070900882853
2004-03-10T09:30:00-05:00,26.14999,26.17999,25.35001,25.5,4063900,1228815,35.33828923241907,56.690758747311115,NaN,NaN,-341.3695691654154,-62.60707047532544,-0.12894210471005024,0.06345382108927211,0.19239592579932235,2580107,7074327,54.48694338767112,64.53651567371612,NaN,NaN,4.957342585906288,13.717109713029059
2004-03-11T09:30:00-05:00,25.39999,25.81,25.24001,25.27,3400500,1317130,32.92102535673479,54.94170472500844,NaN,NaN,-295.31294680672727,-135.4313524386683,-0.18484305032747658,-0.03865788711002338,0.1461851632174532,-820393,5054187,41.59484633060682,64.03967659238573,NaN,NaN,-2.056311651017058,11.463763803879614
2004-03-12T09:30:00-05:00,25.60001,25.71001,25.39,25.67999,5414699,1561589.95,40.70698560816301,53.738046664,NaN,NaN,-195.4425341167439,-191.2319539073704,-0.1853590401625328,-0.0855136369857128,0.09984540317682,4594306,4248626.8,37.758265334025026,63.25919695176136,NaN,NaN,-5.124970524673134,9.093944614086364
2004-03-15T09:30:00-05:00,25.5,25.58,25.03,25.06,2133200,1648929.95,34.23556822330512,51.939690124403555,NaN,NaN,-200.11871768050642,-235.78144829555157,-0.2164422102904168,-0.170707359686201,0.0457348506042158,2461106,3091826.6,33.04467941881188,61.97786870235705,NaN,NaN,-10.252361311230823,6.3301866247553376
2004-03-16T09:30:00-05:00,25.31,25.49001,25.05,25.3,1952900,1717724.95,38.32312739194033,50.38853764702892,NaN,NaN,-151.70449187663948,-236.7896519292065,-0.20967899741498564,-0.21636389616451623,-0.006684898749530606,4414006,2645826.4,31.416299265658964,60.16852704739803,NaN,NaN,-12.742839080584156,3.605468666849696
2004-03-17T09:30:00-05:00,25.31,25.73,25.31,25.62,1713300,1756904.95,43.37662593330152,49.19834935118009,NaN,NaN,-98.53185254783132,-188.2221086056897,-0.17396562971974783,-0.22414193589921538,-0.05017630617946756,6127306,3355266.2,36.7551140021384,58.47287817888998,NaN,NaN,-12.932317398133378,1.242927800423543
2004-03-18T09:30:00-05:00,25.67999,25.7,25.42,25.61,438900,1739954.95,43.25734682491138,47.83129182970441,NaN,NaN,-83.71763145569882,-145.90304553548398,-0.1426423457893481,-0.2284792384161527,-0.08583689262680459,5688406,4657026,45.18671010299328,56.889465982759006,NaN,NaN,-13.115070116943938,-0.808214759200383
2004-03-19T09:30:00-05:00,25.60001,25.8,25.5,25.52,598100,1705419.95,42.134366170142734,45.93705605607941,NaN,NaN,-70.99683637077425,-121.01390598629004,-0.12049300196137579,-0.23645314507852433,-0.11596014311714854,5090306,4756226,45.77992222379223,54.92800553592003,NaN,NaN,-13.609599526300167,-2.636984011643209
2004-03-22T09:30:00-05:00,25.42999,25.42999,24.81,24.96001,1637000,1740724.95,35.89098048124505,44.19333830135177,NaN,NaN,-112.29706567700245,-103.44957558558924,-0.1349738471573354,-0.2846774520638178,-0.14970360490648238,3453306,4954666,47.0152362671047,52.86494618747049,NaN,NaN,-16.136228386143408,-4.565447493714666
2004-03-23T09:30:00-05:00,25.14999,25.38,25.00999,25.09,1413500,1729824.95,38.18090261301151,42.86328680844837,NaN,NaN,-91.58644618617129,-91.42596644749558,-0.12731413097418914,-0.3088462686242188,-0.18153213765002968,4866806,5045226,47.601947318064774,50.80648284104577,NaN,NaN,-17.42211245520647,-6.4021139167849235
2004-03-24T09:30:00-05:00,25.11,25.19,24.89,24.98,699400,1712404.95,36.97724342121123,41.27640357566275,NaN,NaN,-94.6992558216888,-90.65944710226708,-0.12120410131408418,-0.3330372642926349,-0.21183316297855073,4167406,4653246,45.26551650710563,48.47733953482917,NaN,NaN,-18.83011686623498,-8.177542909563503
2004-03-25T09:30:00-05:00,25.24001,25.67999,25.13,25.63,1780100,1770579.95,47.507924194911574,40.45843829394191,NaN,NaN,-46.850201380759685,-83.28596108727925,-0.0676080098299418,-0.296343175265978,-0.22873516543603617,5947506,4705066,45.64534117163821,46.21876611262298,NaN,NaN,-16.59006582986564,-9.379331898178094
2004-03-26T09:30:00-05:00,25.52,25.81,25.5,25.7,817200,1730509.95,48.50582308651045,40.17526247664147,NaN,NaN,-24.535622098174528,-73.9937182327593,-0.02391832311547737,-0.2586330693303829,-0.2347147462149055,6764706,5039946,48.149443359019685,44.576416408197055,NaN,NaN,-14.5085161793484,-10.112072509773853
2004-03-29T09:30:00-05:00,25.75,26.21001,25.75,26.07001,1247600,1700289.95,53.53418425409894,40.77788519942194,NaN,NaN,19.023825171532245,-47.72954006305237,0.030472387455449917,-0.19662426189559312,-0.22709664935104304,8012306,5951746,54.32015128373207,43.858601140883074,NaN,NaN,-11.085229706199032,-10.251094966406022
2004-03-30T09:30:00-05:00,26.13,26.31,25.98,26.25999,404100,1669204.95,55.91454497841416,42.2476177527073,NaN,NaN,49.27775968739861,-19.556698888338396,0.077160494789771,-0.1306460308638293,-0.2078065256536003,8416406,6661666,58.464840376863734,44.14273664011112,NaN,NaN,-7.521062950789305,-9.86109039274649
2004-03-31T09:30:00-05:00,26.2,26.35001,26.03999,26.13,250400,1595654.95,53.88064884520102,43.74473371616917,NaN,NaN,55.96603570004578,10.576359416008524,0.09597768963737816,-0.0878344136068776,-0.18381210324425576,8166006,7461386,62.583395679512925,45.64191873646155,NaN,NaN,-5.218119738615521,-9.19780887072778
2004-04-01T09:30:00-05:00,26.3,26.49001,26.19,26.32001,1020900,1581099.95,56.37844131998057,44.86412340987043,NaN,NaN,88.524110062536,37.65122170466766,0.11654240789244052,-0.0381340933787051,-0.15467650127114563,9186906,8109266,65.56260242210433,47.627942814181495,NaN,NaN,-2.5327628685382098,-8.245659441843555
2004-04-02T09:30:00-05:00,26.75,26.8,26.5,26.75999,756500,1586014.95,61.56880947131866,46.81649778472853,NaN,NaN,149.00533126018203,72.35941237633897,0.15281128115444026,0.03633760017190468,-0.11647368098253556,9943406,8745006,68.23530486062407,50.141558917168084,NaN,NaN,1.5059511096221585,-6.852572220205596
2004-04-05T09:30:00-04:00,26.75999,26.75999,26.50999,26.67,1076400,1620984.95,59.99639109393911,48.36458804915702,NaN,NaN,145.12924467056254,97.58049627614503,0.16285220515313648,0.08709157545888502,-0.07576062969425144,8867006,8915946,68.9334758455816,52.82135724430542,NaN,NaN,4.311386282828673,-5.257721005486415
2004-04-06T09:30:00-04:00,26.62,26.84,26.58,26.8,1197200,1600789.95,61.52507915538152,49.660906136448446,NaN,NaN,146.38500446295905,117.00194523125711,0.16959567159164537,0.13623395979530528,-0.03336171179634009,10064206,9245506,70.28930626969257,55.21665669198785,NaN,NaN,7.093020349412371,-3.493329383358017
2004-04-07T09:30:00-04:00,26.64,26.7,26.39,26.49001,1423000,1468744.95,56.0270565264146,50.5730282579844,NaN,NaN,98.82865592391015,125.57446927602999,0.14545317511567488,0.1484547570982535,0.003001581982578626,8641206,9340546,70.68662149005135,57.03807893392057,NaN,NaN,7.89064533262158,-1.8670472810752174
2004-04-08T09:30:00-04:00,26.53999,26.63,26.17999,26.34,1387900,1368114.95,53.53394996951242,51.38728424365366,NaN,NaN,70.66614194666356,122.00287565285551,0.11309557765360284,0.14437105404958217,0.031275476395979336,7253306,8953826,66.77368633056946,58.537633512976086,NaN,NaN,7.825862880207557,-0.48234582946339244
2004-04-12T09:30:00-04:00,26.42,26.67999,26.42,26.64,501100,1122435,57.597624772817134,52.93775883590881,NaN,NaN,85.94692597239776,109.39119459529866,0.10574597196998936,0.16345794135846603,0.057711969388476676,7754406,8516026,62.552141399533504,59.64741245100672,NaN,NaN,8.981835162957628,0.8696800265967533
2004-04-13T09:30:00-04:00,26.67,26.67999,26.00999,26.06,2467000,1139125,48.72544338156178,53.69094031937668,NaN,NaN,39.665707704200045,88.29848720202615,0.05805560890250784,0.13028148051661148,0.07222587161410364,5287406,7800106,56.28548481674659,60.26766512948399,NaN,NaN,7.159234166850317,1.768187760918691
2004-04-14T09:30:00-04:00,25.8,26.39999,25.8,26.14999,1664800,1124720,50.01203938704864,54.62199717407935,NaN,NaN,17.95118354355075,62.61172301814448,0.030205324378810433,0.10998252708761669,0.07977720270880626,6952206,7177706,51.45885892929587,60.710046731069,NaN,NaN,6.095188497622626,2.386330723304967
2004-04-15T09:30:00-04:00,26.25,26.38,26.06,26.3,1003400,1089225,52.16671138696068,54.95476768779714,NaN,NaN,32.49164681130219,49.34432119562287,0.02001186679347733,0.10479203620065292,0.08478016940717559,7955606,7040586,50.432790953303034,61.05200742975935,NaN,NaN,5.861540743332227,2.8827892975945755
2004-04-16T09:30:00-04:00,26.25,26.58,26.25,26.53,349800,1084770,55.344896285781765,55.443272916316516,NaN,NaN,57.88451233811606,46.78799527391336,0.026478887990412495,0.1178787793951912,0.09139989140477871,8305406,7251006,52.01404277608338,61.3280502452639,NaN,NaN,6.616352625926313,3.416155487356252
2004-04-19T09:30:00-04:00,26.58,26.62,26.35001,26.49001,849800,1097355,54.66480845841622,55.52403178805347,NaN,NaN,58.880040964658896,41.37461827236559,0.025758880787584607,0.12359849238925946,0.09783961160167486,7455606,7191246,51.51144729290966,61.127428531633726,NaN,NaN,7.0356297506632925,3.933223239257258
2004-04-20T09:30:00-04:00,26.53999,26.59,25.94,25.94,872900,1059150,46.24739657926348,54.83352118811414,NaN,NaN,-1.5993159274619488,33.121613546033196,-0.012035067213096967,0.08279577758530365,0.09483084479840062,6582706,7450306,53.60435299874324,60.780250861767975,NaN,NaN,4.788957860622629,4.0554710423094535
2004-04-21T09:30:00-04:00,25.8,25.81,25.46001,25.69,2214200,1099185,43.005849143437054,54.05674978084528,NaN,NaN,-110.21444395088854,7.488488047145333,-0.05191165418398966,0.02994127706841354,0.0818529312524032,4368506,6933566,49.05595386295674,59.81400501772824,NaN,NaN,1.8765244285108946,3.744192954623945
2004-04-22T09:30:00-04:00,25.78,26.57001,25.75,26.55,1454700,1136950,54.7544057546266,53.94074724046285,NaN,NaN,9.42679667490326,2.875518019865547,-0.02004727833390267,0.05679383333502486,0.07684111166892753,5823206,6507086,45.61574688793763,58.38922962243062,NaN,NaN,3.2297540972896632,3.6707016892904765
2004-04-23T09:30:00-04:00,26.60001,26.60001,26.00999,26.35001,899400,1092915,52.066540688442736,53.262013755971715,NaN,NaN,7.464436513714043,-7.208497145014855,-0.012487833744095539,0.06123131948880811,0.07371915323290365,4923806,5830766,40.736881142221606,56.425056499687585,NaN,NaN,3.389789091350547,3.6305713181562007
2004-04-26T09:30:00-04:00,26.34,26.56,26.17999,26.22,397100,1071910,50.336622264862875,52.57203026818055,NaN,NaN,-2.7698131193459905,-19.538467961815833,-0.016064105367160658,0.053639021523952835,0.06970312689111349,4526706,5244986,37.04149692905283,54.14705800564982,NaN,NaN,2.957726775909278,3.534450669263783
2004-04-27T09:30:00-04:00,26.24001,26.39999,26.16,26.27,808600,1049960,51.01075524371898,51.82100713163323,NaN,NaN,-24.240028240027296,-24.066610424328903,-0.014908123100409149,0.051067973015602064,0.06597609611601121,5335306,4995506,35.561902494175214,51.666529164541444,NaN,NaN,2.819316077074979,3.4322885846653826
2004-04-28T09:30:00-04:00,26.03,26.03,25.35001,25.38,2397500,1149630,40.478172063122486,50.71037252711237,NaN,NaN,-235.43265273567158,-49.11025218128551,-0.07080127963556111,-0.022525503428440175,0.04827577620712094,2937806,4709366,33.88984479220859,49.03818797183839,NaN,NaN,-0.9803137852060841,2.8019168175408873
2004-04-29T09:30:00-04:00,25.42,26.46001,24.81,25.07001,2319800,1253100,37.56852912596153,49.569985324001586,NaN,NaN,-223.72090929551445,-95.73979337536905,-0.12234546589283243,-0.1046560561589196,0.017689409733912833,618006,3668326,28.617831224853234,46.312769750001515,NaN,NaN,-5.068399069992494,1.6775859764646899
2004-04-30T09:30:00-04:00,25.05,25.2,24.86,24.92,954300,1249770,36.21200179479903,48.04244082557172,NaN,NaN,-245.78501184509642,-146.38968304713114,-0.15797337049488183,-0.17977730338468945,-0.021803932889807625,-336294,2616306,24.47439900965159,43.592931007867094,NaN,NaN,-8.760301230003785,0.1864592326834793
2004-05-03T09:30:00-04:00,24.97,25.07001,24.72,25,1159500,1269920,37.50793813869612,47.241190451081316,NaN,NaN,-198.64246231665751,-185.56421288659345,-0.16671883035271176,-0.23020247083069734,-0.06348364047798558,823206,1875606,22.053362351835375,41.14777940323058,NaN,NaN,-11.307755840409769,-1.4555714920441274
2004-05-04T09:30:00-04:00,25.10001,25.47,25.06,25.24001,1947700,1313485,41.357249664161785,46.62299118516082,NaN,NaN,-119.29089672243416,-204.57438658307484,-0.1475649928618377,-0.24793988155528268,-0.10037488869344499,2770906,1362726,20.538360367976495,38.939172363136336,NaN,NaN,-12.278863747852848,-3.0017561000168014
2004-05-05T09:30:00-04:00,25.28999,25.3,25.10001,25.14999,309400,1269095,40.35325561313778,45.77917291560205,NaN,NaN,-110.57855482604087,-179.6035670011487,-0.13265390522517145,-0.2661922702249093,-0.13353836499973787,2461506,1267466,20.259968433201564,36.783970754557664,NaN,NaN,-13.366019058615313,-4.4823650941023025
2004-05-06T09:30:00-04:00,24.87,24.99001,24.63,24.89999,738600,1234875,37.621737866892865,44.51323302853855,NaN,NaN,-133.95985898679655,-161.6513569394051,-0.13109095962913586,-0.2974020645361577,-0.16631110490702183,1722906,1488446,22.871718473234523,34.70237616149702,NaN,NaN,-15.101334381586105,-5.9993607065999885
2004-05-07T09:30:00-04:00,24.73,24.86,24.00999,24.00999,1520000,1241480,29.870052805515726,42.74217905333138,NaN,NaN,-169.22198929393772,-146.33875242917335,-0.1785208250878087,-0.3894621362667827,-0.21094131117897402,202906,1596286,24.176892372487885,32.74990795289547,NaN,NaN,-19.410895488063275,-7.9152942468090295
2004-05-10T09:30:00-04:00,23.75,24.16,23.59,23.97,3490800,1390965,29.57518267417575,41.5513066315394,NaN,NaN,-181.16981685106464,-142.8442233360548,-0.19951954595253496,-0.4603407436196427,-0.26082119766710776,-3287894,774066,21.227417339634712,30.437269691530577,NaN,NaN,-22.869167321223472,-10.051561828868236
2004-05-11T09:30:00-04:00,24.03,24.27,24.02,24.27,1897500,1362490,34.77694454378751,40.96352773156443,NaN,NaN,-131.68154459294934,-145.32235291015783,-0.18069883687042088,-0.4866947437551339,-0.305995906884713,-1390394,-58194,18.735846518946374,28.271547738386975,NaN,NaN,-24.15423795334123,-12.066229846650092
2004-05-12T09:30:00-04:00,24.25,24.25,23.72,24.23,3805700,1469535,34.41197405892683,39.510496896157306,NaN,NaN,-125.06800794898228,-148.22024353474612,-0.15919284969517478,-0.5049869690036815,-0.3457941193085067,-5196094,-1589714,15.20016780439235,26.099006375276605,NaN,NaN,-25.290745312059254,-13.955446341708544
2004-05-13T09:30:00-04:00,24.25,24.49001,24.10001,24.42,729500,1455840,37.75360744998032,38.488144521981425,NaN,NaN,-90.01945023091,-139.4321617835688,-0.12209026623439823,-0.49840695210150443,-0.3763166858671062,-4466594,-2827614,13.055582604233194,24.121770765420283,NaN,NaN,-25.26847370122889,-15.571593107354307
2004-05-14T09:30:00-04:00,24.48,24.5,24.23,24.33,2448200,1560760,36.7972436639195,37.52104605048546,NaN,NaN,-80.78290228275912,-121.7443443813331,-0.09474769456813598,-0.4947513040772762,-0.4000036095091402,-6914794,-4251154,11.113702224388021,22.269785429372796,NaN,NaN,-25.518265718670257,-16.9925463375423
2004-05-17T09:30:00-04:00,23.89999,24.19,23.78999,23.87,8442602,1940400.1,32.294354286156874,36.184160267802454,NaN,NaN,-106.36320459771619,-106.78302193066342,-0.09835243845115377,-0.5229441575730824,-0.42459171912192867,-15357396,-6665054.4,8.739803270889112,20.353921199138075,NaN,NaN,-27.089289995268008,-18.434938288645974
2004-05-18T09:30:00-04:00,24.05,24.34,23.96001,24.31,1553500,1974430.1,39.873518360215954,36.14097071759485,NaN,NaN,-76.04733573577082,-95.65618015922772,-0.06350533100264139,-0.5039733828752304,-0.44046805187258903,-13803896,-9147754.8,7.067674674169865,18.43805190499245,NaN,NaN,-26.10505669325147,-19.5306694893039
2004-05-19T09:30:00-04:00,24.60001,24.96001,24.27,24.36,1374100,1932425.1,40.68607768712289,36.3636527576778,NaN,NaN,-41.27465648343472,-78.89750986611821,-0.03112823842396889,-0.4793783499025501,-0.44825011147858124,-12429796,-10594495.2,6.310053604061395,16.844639217793034,NaN,NaN,-25.071245059840606,-20.32218028509486
2004-05-20T09:30:00-04:00,24.34,24.53,23.82001,24.3,674000,1893390.1,39.98771376966521,36.63334647016824,NaN,NaN,-65.21472376360646,-73.93656457265752,-0.008945559475135367,-0.45943206082250043,-0.45048650134736506,-13103796,-12321935.6,5.545646332787342,15.49258545515987,NaN,NaN,-24.419493411224103,-20.907510731684752
2004-05-21T09:30:00-04:00,24.62,24.85001,24.45,24.56,908700,1893855.1,44.43831000683672,37.12837303217828,NaN,NaN,-17.61494622458834,-61.30297336102336,0.026126646984685864,-0.4178281926165077,-0.4439548396011936,-12195096,-13377996,5.1360191538904445,14.284203798163805,NaN,NaN,-22.560721646925174,-21.14368371957624
2004-05-24T09:30:00-04:00,24.8,25.03,24.64,24.8,450500,1896525.1,48.253217023348135,37.62094212926302,NaN,NaN,16.324566153179195,-36.765419210844286,0.0661033153703442,-0.3613256953882633,-0.4274290107586075,-11744596,-12655436,10.032585852182564,13.533791332749951,NaN,NaN,-19.836083996140005,-20.95688375908535
2004-05-25T09:30:00-04:00,24.77,25.28999,24.63,25.28999,819300,1897060.1,55.04042783081719,38.670025859097265,NaN,NaN,65.60341005588198,-8.435270052513669,0.12286147741153508,-0.27385216399418866,-0.39671364140572374,-10925296,-12079716,13.848303641308604,13.075815276186164,NaN,NaN,-15.22476426734678,-20.13800954597984
2004-05-26T09:30:00-04:00,25.28999,25.39999,25.21001,25.36,556600,1805015.1,55.92985422693998,39.97774845624349,NaN,NaN,109.87151836326315,21.793964916825903,0.1600804293123549,-0.19661310476528016,-0.35669353407763504,-10368696,-11667496,16.57653781109221,12.626159514604568,NaN,NaN,-11.217493866943348,-18.863650163260342
2004-05-27T09:30:00-04:00,25.5,25.73,25.5,25.60001,316300,1704840.1,58.92951161796372,42.053424085704066,NaN,NaN,150.58462287146807,64.95383424384082,0.1935856510442105,-0.11471147027237194,-0.30829712131658243,-10052396,-11057216,20.586118838023907,12.369675690714287,NaN,NaN,-6.880036872835365,-17.151705407485345
2004-05-28T09:30:00-04:00,25.59,25.63,25.42,25.62,83500,1661300.1,59.17873099671338,44.16796325159961,NaN,NaN,128.76193779874362,94.22921104850721,0.20852439631488928,-0.04764162592297083,-0.2561660222378601,-9968896,-10611976,23.475860114580414,12.530278746067548,NaN,NaN,-3.279853545380942,-15.170012284327573
2004-06-01T09:30:00-04:00,25.59,25.63,25.38,25.56,619500,1634300.1,58.040305095415384,45.829631862430176,NaN,NaN,111.80266953760953,113.32483172539328,0.20546287591180334,0.0006625726518940667,-0.20480030325990928,-10588396,-10380736,25.002245744511697,12.977878690750787,NaN,NaN,-0.5783712214247475,-13.085492132484312
2004-06-02T09:30:00-04:00,25.59,25.66,25.31,25.61,1117300,1592780.1,58.75240542117748,47.56823410259094,NaN,NaN,107.22071491117478,121.64829269645183,0.19783127923082092,0.04248879577861686,-0.15534248345220406,-9471096,-10089896,26.97517801922868,13.81895084895338,NaN,NaN,1.8871550595126378,-10.946542533627605
2004-06-03T09:30:00-04:00,25.58,25.58,25.11,25.13,610800,1607850.1,49.98270882739904,48.44174134383513,NaN,NaN,72.8280906889487,114.23960716158895,0.15346104885869521,0.03648382762116498,-0.11697722123753024,-10081896,-10032536,27.380924093487153,14.842189526757235,NaN,NaN,1.6973069727241539,-9.140278318434497
2004-06-04T09:30:00-04:00,25.3,25.5,25.22,25.36,388900,1590365.1,53.55975618093017,49.639063666478755,NaN,NaN,76.4351212480098,99.4097068368973,0.13335048796722354,0.0497108887214992,-0.08363959924572434,-9692996,-9960656,27.921396828939265,16.04273914136804,NaN,NaN,2.5762809077952493,-7.466484143258819
2004-06-07T09:30:00-04:00,25.5,25.89999,25.5,25.88,387400,1533735.1,60.44698222762125,51.64996566229763,NaN,NaN,110.58071207399509,95.77346169194757,0.1477028365223926,0.10098894640726641,-0.04671389011512619,-9305596,-9827996,28.97207285038921,17.48790125418947,NaN,NaN,5.573415818361842,-5.603641291598725
2004-06-08T09:30:00-04:00,25.75,25.92,25.71001,25.89999,505200,1384455.1,60.68834225035793,53.13673879730778,NaN,NaN,108.03553140582196,95.02003406559007,0.15065738050670713,0.14160783551825773,-0.009049544988449398,-8800396,-9470396,31.85566871316516,19.258472256974848,NaN,NaN,8.030758125401238,-3.6558699463130164
2004-06-09T09:30:00-04:00,25.88,25.91,25.60001,25.60001,276000,1303380.1,55.240694320162866,54.17635427109634,NaN,NaN,83.68484310936203,90.31285970522751,0.12555000278359735,0.1478879584910473,0.022337955707449945,-9076396,-9391456,32.50706883891793,21.129687630893176,NaN,NaN,8.507572463249423,-1.9182353163755252
2004-06-10T09:30:00-04:00,25.75,26,25.60001,25.72,263000,1126245.1,56.906975059719095,55.38487293467163,NaN,NaN,85.37069738049415,92.8213810435366,0.11068547683326774,0.1606948017490346,0.05000932491576688,-8813396,-9137756,34.66853542723807,23.20989399478251,NaN,NaN,9.393576255664922,-0.3022622346554613
2004-06-14T09:30:00-04:00,25.67999,25.67999,25.32001,25.36,358100,1107675.1,50.796929788164576,55.83906006190933,NaN,NaN,42.08142376253994,85.95064154644263,0.07213607990296649,0.14017942479447498,0.0680433448915085,-9171496,-9033456,35.58190520607836,25.384600141367365,NaN,NaN,8.286332720166513,0.9246799017476779
2004-06-15T09:30:00-04:00,25.64999,25.75999,25.5,25.62,848100,1027670.1,54.58915435385008,56.291627014088036,NaN,NaN,59.79712604474337,75.79392434059228,0.06016482663079191,0.1432493781799984,0.08308455154920648,-8323396,-8837016,37.35821483416058,27.33643078293722,NaN,NaN,8.507922819947545,2.008000318633373
2004-06-16T09:30:00-04:00,25.72,25.72,25.39999,25.633,633200,637200,54.77683413738443,56.27279889312855,NaN,NaN,50.635559346912395,64.31392992881037,0.049579701004460644,0.14505917780478228,0.09547947680032164,-7690196,-8614976,39.39255124933911,29.161019897796542,NaN,NaN,8.739978044456603,2.9697114223224057
2004-06-17T09:30:00-04:00,25.69,25.73,25.57001,25.73,106300,564840,56.23042861228942,56.29426849208209,NaN,NaN,62.84958057427925,60.1468774217938,0.045665944702360683,0.1525619076782725,0.1068959629759118,-7583896,-8316476,42.11417852346214,30.985137091537258,NaN,NaN,9.344927706271,3.880456605743633
2004-06-18T09:30:00-04:00,25.56,26.03999,25.56,25.96001,1465700,569420,59.55055443038969,56.338628692969664,NaN,NaN,93.30751218234946,61.73424038216488,0.05452314455846499,0.17504989367399304,0.12052674911552805,-6118196,-7777436,46.76334154699836,32.85493871360686,NaN,NaN,10.829537706774712,4.873182477319501
2004-06-21T09:30:00-04:00,26,26.00999,25.85001,25.86,815100,576475,57.507917035968774,56.219284838630756,NaN,NaN,108.88676314370736,75.09530825839836,0.049735248579255154,0.182695809839597,0.13296056126034184,-6933296,-7329796,50.33097927896725,34.77316151106306,NaN,NaN,11.50006016296611,5.819879289554731
2004-06-22T09:30:00-04:00,25.85001,25.96001,25.63,25.95,355600,548820,58.8750008352242,56.27890596290281,NaN,NaN,93.37684582118686,81.81125221368707,0.04865849790883639,0.19378368364638732,0.14512518573755093,-6577696,-6980656,52.97782182590392,36.771416945448216,NaN,NaN,12.442248824195804,6.765932080217741
2004-06-23T09:30:00-04:00,26.03,26.33,25.97,26.27,741100,563350,63.38557184131958,56.60984642148439,NaN,NaN,193.87788658964158,110.4597176622329,0.06453142638924939,0.22578946872411265,0.16125804233486327,-5836596,-6609936,55.67858919595094,38.82166060092838,NaN,NaN,14.607142506968076,7.886104998324932
2004-06-24T09:30:00-04:00,26.2,26.39999,26.17999,26.25,441400,544455,62.921071080838885,57.53401515387295,NaN,NaN,197.47396068888122,137.38459368515328,0.0683509143797249,0.24669668530951938,0.17834577092979448,-6277996,-6348756,57.52935667309121,40.9751200709001,NaN,NaN,16.25435877342303,9.081569823338945
2004-06-25T09:30:00-04:00,26.36,26.5,26.22,26.32001,421500,537700,63.917859704632164,58.273879691280236,NaN,NaN,186.70321918246933,156.06373508517726,0.07000375787357913,0.2658504682717684,0.19584671039818927,-5856496,-6296416,57.90867979392237,43.11706885411318,NaN,NaN,17.916956900657052,10.343767977241532
2004-06-28T09:30:00-04:00,26.5,26.55,26.19,26.23,953300,569550,61.62413090659668,58.35796173977848,NaN,NaN,151.86839435264937,164.66006132696566,0.059840290496083776,0.270647073518294,0.2108067830222102,-6809796,-6271716,58.09887260702881,45.197554551016005,NaN,NaN,18.7308491732997,11.54192243382127
2004-06-29T09:30:00-04:00,26.25,26.60001,26.21001,26.59,732900,602020,66.76167329130047,58.79177109984578,NaN,NaN,160.02547960737516,177.98978808420333,0.07138557290677475,0.30003874915567863,0.22865317624890388,-6076896,-6171556,58.9096899300682,47.129984637937646,NaN,NaN,20.974616927076006,12.889450218571946
2004-06-30T09:30:00-04:00,26.53999,26.82001,26.5,26.78,857500,613920,69.11197249137982,59.78257668350413,NaN,NaN,178.19776286199254,174.85376333867353,0.08492055132520948,0.33480386540541573,0.24988331408020625,-5219396,-6048116,59.938582204381404,49.08937844975647,NaN,NaN,23.605841991916535,14.420363329049744
2004-07-01T09:30:00-04:00,26.78,26.78,26.13,26.24001,2647700,690440,56.81580047776783,59.77606421336475,NaN,NaN,95.14125245502807,154.38722169190288,0.052213299195908,0.3151499380750913,0.2629366388791833,-7867096,-6365936,56.04727947856325,50.616431596279696,NaN,NaN,22.092625648290245,15.516400803226958
2004-07-02T09:30:00-04:00,26.12,26.17999,25.95,26.14,1199400,719870,54.868720165589544,60.06690638318082,NaN,NaN,28.240030184571705,122.69458389232334,0.020196372078913005,0.2881821039778245,0.2679857318989115,-9066496,-7007936,49.11129060608159,51.582816267708495,NaN,NaN,20.25475281065507,16.193308232859547
2004-07-06T09:30:00-04:00,26.09,26.14999,25.89999,25.94,1044300,752640,51.09746965652843,59.81750033337214,NaN,NaN,1.5391647332060474,92.62873796843468,-0.01613665229164729,0.2478149165343524,0.2639515688259997,-10110796,-7668136,43.191848022054145,51.99950435255804,NaN,NaN,17.517142676113036,16.382427439038615
2004-07-07T09:30:00-04:00,25.92999,26.33,25.92999,26.24001,242300,745385,55.984617229169764,59.90377055421394,NaN,NaN,36.558856682335055,67.93541338342666,-0.021324036848913486,0.2372965227648578,0.2586205596137713,-9868496,-8426456,37.587730397944135,51.8705885774584,NaN,NaN,16.68723667979722,16.425971616289843
2004-07-08T09:30:00-04:00,26.17999,26.25999,26,26.02,1419600,791105,51.88924966644415,59.59368634379642,NaN,NaN,16.72614313132159,35.641089437292464,-0.03985586623735199,0.20880072681708128,0.24865659305443327,-11288096,-9640196,30.717786232460426,51.05656055667256,NaN,NaN,14.678785655044873,16.176373621826276
2004-07-09T09:30:00-04:00,26.12,26.17999,25.98,26.12,124900,783550,53.55239336885219,59.16524626797231,NaN,NaN,12.750486030396592,19.16293615236616,-0.04526713582271974,0.1920726732760336,0.23733980909875335,-11163196,-10299416,27.751068625259933,49.69854106226268,NaN,NaN,13.549579584433937,15.801117330770227
2004-07-12T09:30:00-04:00,26.17999,26.23,25.95,26.14,593400,800070,53.89566984320913,58.907228611346625,NaN,NaN,12.5568747287161,16.02630506119504,-0.04717326516391193,0.17837322764386343,0.22554649280777536,-10569796,-10600076,26.494263043742663,47.99591847403235,NaN,NaN,12.738069375458618,15.363539051439997
2004-07-13T09:30:00-04:00,26.12,26.23,26.09,26.23,132800,788805,55.4898484288279,58.66543201088974,NaN,NaN,26.748878399973503,21.068247794548526,-0.042207764175397844,0.17278678758852806,0.2149945517639259,-10436996,-10665316,26.216808909447337,46.08441755142831,NaN,NaN,12.506558145385313,14.955398922003614
2004-07-14T09:30:00-04:00,26.16,26.47,26.07001,26.23,770100,784905,55.4898484288279,58.101451767140325,NaN,NaN,42.718676979969956,22.30021185407555,-0.03884294790002504,0.1664408668888946,0.20528381478891963,-10436996,-10779016,25.711453200893914,43.94390783749566,NaN,NaN,12.316277880588352,14.578381630372862
2004-07-15T09:30:00-04:00,26.25,26.42,26.23,26.28,871100,796800,56.45987097296243,57.63993747372058,NaN,NaN,54.120135213167046,29.779010270444637,-0.03337838489541631,0.16356083366964924,0.19693921856506555,-9565896,-10434576,30.106770711714972,41.98515169739736,NaN,NaN,12.408814403967503,14.268443455172097
2004-07-16T09:30:00-04:00,26.39999,26.50999,26.31799,26.34,590000,820985,57.652529608360226,57.19241389541544,NaN,NaN,76.35902289556971,42.50071764347926,-0.02616995001313177,0.16422678104865085,0.19039673106178262,-8975896,-9997116,35.33937329576797,40.373058376100616,NaN,NaN,12.796079320695682,14.058105721675465
2004-07-19T09:30:00-04:00,26.37,26.37,26.11,26.22,311800,763290,54.44061390800814,56.679305538373406,NaN,NaN,6.801017032421505,41.349546104220344,-0.02967390096770059,0.15330435485215688,0.18297825581985747,-9287696,-9740696,38.25724940611325,38.955799576035226,NaN,NaN,12.30013749524113,13.806967403613417
2004-07-20T09:30:00-04:00,26.2,26.24001,25.94,26.17999,1140200,779545,53.37293938252395,55.722967402032225,NaN,NaN,-51.74194992652605,25.651380438920434,-0.034536077180870955,0.13980815934376878,0.17434423652463973,-10427896,-9738876,38.27853899680595,37.482145937945056,NaN,NaN,11.602370320390646,13.492024963153021
2004-07-21T09:30:00-04:00,26.24001,26.33,25.67999,25.67999,958500,809690,42.22749635633785,53.80264767810066,NaN,NaN,-162.20603800394494,-15.333562557862546,-0.06927145183513822,0.08775492173071697,0.1570263735658552,-11386396,-9928756,36.85088875342747,35.83302497716263,NaN,NaN,7.519535344847117,12.638812160537892
2004-07-22T09:30:00-04:00,25.55,25.69,25.25999,25.57001,1723700,858820,40.237136185947946,52.6184573715421,NaN,NaN,-268.12706692859035,-79.78300298621403,-0.09586183390232991,0.037199081187942795,0.1330609150902727,-13110096,-10637596,32.045897641232514,34.118640560210444,NaN,NaN,3.4956782928544565,11.33265017944026
2004-07-23T09:30:00-04:00,25.5,25.52,25.24001,25.44,1617500,917625,37.95940008260199,51.41064879418585,NaN,NaN,-241.98293741019432,-143.45139504736682,-0.11701295994012947,-0.013205284834889142,0.10380767510524033,-14727596,-11787936,26.098545937385637,32.47487308387502,NaN,NaN,-0.6056406213845615,9.627180065036713
2004-07-26T09:30:00-04:00,25.45,25.55,25.07001,25.22,1046600,948880,34.409728345779016,50.21866727198947,NaN,NaN,-223.82778161685613,-189.57715477722235,-0.13912234405908597,-0.07009525496861713,0.06902708909046884,-15774196,-13085236,21.298015755095776,30.91102792194942,NaN,NaN,-5.300989500009741,7.494584412887219
2004-07-27T09:30:00-04:00,25.10001,25.69,25.08,25.64999,1353300,968880,45.19662494882354,49.44809639482187,NaN,NaN,-139.51502379344657,-207.13176955060644,-0.11887540406071961,-0.07956716598543068,0.03930823807528894,-14420896,-13883836,18.983202575617227,29.582133077497502,NaN,NaN,-6.11035334196706,5.551021876479465
2004-07-28T09:30:00-04:00,25.53,25.92,25.46001,25.88,454600,954965,49.93933671429095,49.308816898239506,NaN,NaN,-62.87470826567169,-187.2655036029518,-0.0856330340535461,-0.06773305449164368,0.01789997956190241,-13966296,-14399816,17.648533289162003,28.64861501011904,NaN,NaN,-5.20634632013407,4.0142549912489605
2004-07-29T09:30:00-04:00,25.92,26.28999,25.89999,26.22,265600,925370,56.000844283576015,49.483706249291195,NaN,NaN,36.012996865468175,-126.4374908441401,-0.03877352039666761,-0.030566920933932096,0.008206599462735508,-13700696,-14517936,17.347839244502794,27.905527197207814,NaN,NaN,-2.323478247499396,3.108864528570624
2004-07-30T09:30:00-04:00,26.22,26.24001,26.09,26.17,413300,813650,54.94717292386923,49.55881361219549,NaN,NaN,47.44845735482169,-68.5512118911369,-0.010636014238457845,-0.005088418335336797,0.005547595903121047,-14113996,-14395216,18.893969038695005,27.36264905399013,NaN,NaN,-0.4053486553640419,2.6068340737228146
2004-08-02T09:30:00-04:00,26.03,26.35001,25.97,26.33,860600,796710,57.690533016251564,49.716005368440044,NaN,NaN,57.85618837515183,-12.214417892735295,0.017717836786908584,0.02769489188675678,0.009977055099848194,-13253396,-13891056,25.093369902978424,27.282403410670923,NaN,NaN,2.062470239459334,2.5290678116851746
2004-08-03T09:30:00-04:00,26.3,26.3,25.96001,26.07001,617100,775350,52.13516463743862,49.476385097626526,NaN,NaN,28.939610055792382,21.4765088771125,0.017877769699678362,0.032324267224446146,0.014446497524767784,-13870496,-13780976,26.415899123939454,27.33272097660275,NaN,NaN,2.39774011431631,2.510306712061051
2004-08-04T09:30:00-04:00,26,26.22,25.81,26.11,795600,803015,52.886669100731616,49.221156392467186,NaN,NaN,14.756661361152798,37.0027828024774,0.01946119273744227,0.03877298844657062,0.019311795709128353,-13074896,-13602696,28.614144034121637,27.226104785346084,NaN,NaN,2.895247575038401,2.565298263914958
2004-08-05T09:30:00-04:00,26.10001,26.2,25.53999,25.55,2039800,834025,42.761746052988975,48.15752899565495,NaN,NaN,-50.959877250707144,19.608207979242316,-0.016480489952956673,-0.0012888167320674881,0.015191673220889185,-15114696,-13885496,27.224774282457787,26.64649057010964,NaN,NaN,-0.10363407723516577,2.184022215179226
2004-08-06T09:30:00-04:00,25.33,25.53999,25,25.09,1615200,908540,36.56863639081193,46.88095917299808,NaN,NaN,-152.41553390418215,-20.364590272558463,-0.06763873078218888,-0.0693567402568469,-0.0017180094746580346,-16729896,-14408676,24.82342569917384,25.686931733899684,NaN,NaN,-4.967635678166127,1.1623568018441757
2004-08-09T09:30:00-04:00,25,25.3,25,25.25,1236700,940705,39.83271485627439,45.91380027826597,NaN,NaN,-133.63692788310368,-58.66321352420956,-0.0859315020235526,-0.10913238700409877,-0.023200884980546184,-15493196,-14856636,22.956331645516116,24.592488351664695,NaN,NaN,-7.676642985338771,-0.10035745346767366
2004-08-10T09:30:00-04:00,25.35001,25.66,25.32001,25.66,1542100,1011170,47.31436383688108,46.277147955447624,NaN,NaN,-57.23069936506805,-75.89727540838165,-0.06651562511166888,-0.10634541637013228,-0.03982979125846341,-13951096,-14872756,22.889612051100656,23.595254301498496,NaN,NaN,-7.32717015437019,-1.1327592678823188
2004-08-11T09:30:00-04:00,25.57001,25.63,25.24001,25.57001,1346400,1039985,45.963398748820616,46.686166709938526,NaN,NaN,-62.808728839611675,-91.41035344853455,-0.056239101594018515,-0.11012866825098655,-0.053889566656968035,-15297496,-15317276,21.070973242258844,22.811331130143234,NaN,NaN,-7.506025614854672,-2.043225888878369
2004-08-12T09:30:00-04:00,25.52,25.52,25.17,25.22,1700600,1081460,41.0535034597709,46.907174094022025,NaN,NaN,-87.85641844068381,-98.78966168652987,-0.06869534872645197,-0.139758752565033,-0.07106340383858104,-16998096,-15693956,19.646485140757207,22.350469644669776,NaN,NaN,-9.327424948008886,-3.083825754468443
2004-08-13T09:30:00-04:00,25.22,25.3,24.99001,25.13,415100,1072715,39.874006803317634,47.29747969813193,NaN,NaN,-107.57837041432573,-89.82222898855859,-0.07799727767313544,-0.16856000093000034,-0.0905627232568649,-17413196,-15830616,19.140904739454143,22.19639028640966,NaN,NaN,-11.146686101571802,-4.23566294691178
2004-08-16T09:30:00-04:00,25.2,25.84,25.2,25.83,1949100,1154580,51.53671807147808,47.75034349260726,NaN,NaN,-9.272438426545765,-64.94933109724701,-0.03424079261519457,-0.13336371402585812,-0.09912292141066355,-15464096,-15824796,19.23622565926844,22.214463363813316,NaN,NaN,-8.643255591966849,-4.865319039062504
2004-08-17T09:30:00-04:00,25.78,26.11,25.78,25.97,1103000,1152720,53.480239828475455,48.00326514362043,NaN,NaN,63.030671731157824,-40.897056878001834,0.004818041132332113,-0.0931003699952484,-0.09791841112758051,-14361096,-15906796,18.898195664174864,22.303724962028518,NaN,NaN,-6.020963908850392,-5.0304111633179165
2004-08-18T09:30:00-04:00,25.95,26.2,25.75999,26.2,248500,1117220,56.562212382468324,48.04336286496988,NaN,NaN,80.56696657835246,-12.221917794409006,0.0446175578936651,-0.04214646376049913,-0.08676402165416423,-14112596,-15669816,23.10374829917727,22.714861323076693,NaN,NaN,-2.8491092623366185,-4.718796606034874
2004-08-19T09:30:00-04:00,26.19,26.3,26.10001,26.24001,284000,1045235,57.09472195507336,48.19675922434161,NaN,NaN,100.52606653185983,25.454579200099722,0.07056855359607178,0.0014466703409254933,-0.06912188325514629,-13828596,-15035916,33.09750176374993,23.72939937486633,NaN,NaN,-0.1925602837094353,-4.07219141713124
2004-08-20T09:30:00-04:00,26.23,26.55,26.23,26.45,1063800,1017550,59.875007677779806,48.35279312873649,NaN,NaN,123.74970919088277,71.72019512114142,0.09716605699999828,0.052335687994851554,-0.04483036900514672,-12764796,-14106236,44.49159195612253,25.114986664376623,NaN,NaN,2.9030189769859547,-3.075732789400212
2004-08-23T09:30:00-04:00,26.52,26.52,26.2,26.23,632100,996825,55.795684882202,48.614258860505295,NaN,NaN,95.45999900808762,92.6666826080681,0.0951120754640436,0.07405972532490779,-0.021052350139135815,-13396896,-13692796,48.67767043412127,26.705113186532465,NaN,NaN,4.263109558819803,-2.027326739654496
2004-08-24T09:30:00-04:00,26.25,26.42999,26.16,26.3,594800,958900,56.80411296050267,48.89407627906037,NaN,NaN,83.14421540610945,96.68939134305842,0.09349791419337757,0.09582004260258614,0.0023221284092085764,-12802096,-13380996,51.6396774630022,28.349794145738223,NaN,NaN,5.667471553703321,-0.9280698406033792
2004-08-25T09:30:00-04:00,26.3,26.61,26.08,26.59,584200,965380,60.79447398323048,50.18212827407763,NaN,NaN,96.222568909346,99.82051180925713,0.10607082612609947,0.13491066106683292,0.028839834940733444,-12217896,-13002056,55.036107316370504,30.336317933874845,NaN,NaN,8.107365840558103,0.3627066852768326
2004-08-26T09:30:00-04:00,26.47,26.77,26.47,26.73,769800,990590,62.591106977845,52.04087617315141,NaN,NaN,125.24304968260931,104.76390843940703,0.11706242143284809,0.17516786173179355,0.05810544029894547,-11448096,-12525956,58.93808740646988,32.773079484395986,NaN,NaN,10.67834054925799,1.8363686658455693
2004-08-27T09:30:00-04:00,26.67999,26.83,26.64,26.75999,123000,976075,62.98244578826132,53.694428382579055,NaN,NaN,127.52924171663113,105.5198149445567,0.11919929039057965,0.20710455328717003,0.08790526289659038,-11325096,-12238016,61.13478714938806,35.500112020386844,NaN,NaN,12.886860669565275,3.41501038066267
2004-08-30T09:30:00-04:00,26.78999,26.91,26.53,26.53,391100,952600,57.97372905687787,54.45581161257882,NaN,NaN,105.90012771186461,107.60784068531208,0.09881117468187633,0.2114192312489358,0.11260805656705947,-11716196,-11901876,63.58400060626718,38.406854060041596,NaN,NaN,13.38793645159144,4.8397141050810655
2004-08-31T09:30:00-04:00,26.53,26.7,26.42999,26.61,277800,935635,59.18948048867885,55.40053173685441,NaN,NaN,86.59004163274463,108.29700593063913,0.08493124063322655,0.21877210735859265,0.1338408667253661,-11438396,-11629136,65.48460512113161,41.579256337103935,NaN,NaN,14.14586951770827,6.169164878313524
2004-09-01T09:30:00-04:00,26.55,26.85001,26.55,26.72,361300,913920,60.86584062393928,56.815698677152156,NaN,NaN,94.06312375380803,107.86511689953154,0.07757907228030536,0.2308147070757478,0.15323563479544244,-11077096,-11400976,67.03461010810254,44.96412240620003,NaN,NaN,15.253215890917046,7.466886451542598
2004-09-02T09:30:00-04:00,26.71001,27.13,26.71001,27.09,408400,832350,65.93460753274138,58.67717015782528,NaN,NaN,116.39366293177946,106.09523954936556,0.09111956800980536,0.26713509480769915,0.17601552679789378,-10668696,-11245096,68.08898825287126,48.46041408572983,NaN,NaN,17.777995084720573,8.939901970568023
2004-09-03T09:30:00-04:00,27,27.10001,27,27.03,1422000,822690,64.47619653359365,59.60141861940497,NaN,NaN,116.10057053778496,103.80950531359633,0.08939609029856968,0.2877606396711059,0.1983645493725362,-12090696,-11398216,65.86060393179164,51.790726819481485,NaN,NaN,19.444523693391286,10.440562216685631
2004-09-07T09:30:00-04:00,27.06,27.31,27.06,27.27,826000,802155,67.56652513269387,60.60758185542057,NaN,NaN,130.81759223996318,108.79299821921606,0.0971373446690609,0.3197862302088623,0.22264888553980142,-11264696,-11307916,66.55574861520466,55.194837744555045,NaN,NaN,21.818118467845053,12.06592739542269
2004-09-08T09:30:00-04:00,27.2,27.2,26.91,26.96001,449000,747500,60.273125051380724,60.872647046057175,NaN,NaN,97.06707399132942,110.88840469093302,0.07508462781968855,0.3165046703144121,0.24142004249472354,-11713696,-11362976,65.67759647800841,58.235826900185835,NaN,NaN,21.710231510948073,13.443685126212031
2004-09-09T09:30:00-04:00,27.02,27.11,26.96001,27.05,417900,701075,61.57000574174458,61.192310173676546,NaN,NaN,92.86077839671557,110.64793561951453,0.060868322991405266,0.31750544623398014,0.25663712324257487,-11295796,-11406716,64.9445122024932,60.510613360096066,NaN,NaN,22.001197205708507,14.666186851854384
2004-09-10T09:30:00-04:00,27,27,26.63,26.78999,525600,642325,55.89259426398647,60.907852072691306,NaN,NaN,51.94596152648471,97.75839533845559,0.029834058035164868,0.29392969578653094,0.2640956377513661,-11821396,-11637256,61.0750326644167,61.695144839259946,NaN,NaN,20.530614713713785,15.503962260691441
2004-09-13T09:30:00-04:00,26.82001,26.92,26.71001,26.75999,211100,632125,55.25944863723031,60.869549483764764,NaN,NaN,44.125416197982474,83.3633644704951,0.004496191941076366,0.26971587767771155,0.2652196857366352,-12032496,-11625616,61.20072969784258,62.58964907238289,NaN,NaN,19.153009911259584,16.025254782201177
2004-09-14T09:30:00-04:00,26.7,26.75,26.48,26.73,1766600,623000,54.59366746718015,60.71166051995601,NaN,NaN,6.002307958202156,58.40030761414289,-0.01595263844858691,0.24527888767590156,0.26123152612448847,-13799096,-12132496,53.15158314808566,62.697642335603135,NaN,NaN,17.830914408107233,16.283206157330614
2004-09-15T09:30:00-04:00,26.64999,26.74001,26.52,26.62,330700,584385,52.11352671772624,60.091592858134284,NaN,NaN,-9.84682797203243,37.017527221470516,-0.03733484648810337,0.21456296801435926,0.2518978145024626,-14129796,-12615716,46.82851260778782,62.11138557070437,NaN,NaN,16.010407665258775,16.244234944177496
2004-09-16T09:30:00-04:00,26.62,26.81,26.62,26.73,395700,591745,54.347035797645724,59.50273063097718,NaN,NaN,7.7688066633010395,19.999132874787612,-0.04405620717106676,0.19682755553862918,0.24088376270969594,-13734096,-13103376,41.467174646122714,60.86346323067958,NaN,NaN,15.042302525209191,16.07253031289631
2004-09-17T09:30:00-04:00,26.60001,26.75,26.46001,26.49001,1545700,654830,48.979506565092365,58.50252068646512,NaN,NaN,-50.1206655977589,-0.4141925500611009,-0.06347121907698139,0.1615447388634692,0.2250159579404506,-15279796,-13795056,35.29487216044228,59.01775501718345,NaN,NaN,12.632136563998245,15.581045491625156
2004-09-20T09:30:00-04:00,26.39999,26.72,26.39999,26.52,1206700,661975,49.648738894022806,57.90787853197548,NaN,NaN,-61.25043803556993,-21.489363396771587,-0.07245044202197812,0.13445290541297794,0.20690334743495606,-14073096,-14203176,32.24505874046686,56.77925916962628,NaN,NaN,10.813983112885255,14.900036580376598
2004-09-21T09:30:00-04:00,26.73,26.73,26.5,26.64,843900,672565,52.342464189328155,57.418805939164706,NaN,NaN,-42.31315326549511,-31.152455641511047,-0.06850865178404894,0.12126753270489488,0.18977618448894382,-13229196,-14089196,33.9613280900482,54.52759652454889,NaN,NaN,9.967788724103203,14.195429743766113
2004-09-22T09:30:00-04:00,26.64999,26.64999,26.41,26.41,484700,667060,47.13725148411953,56.43819242917758,NaN,NaN,-100.75563281575192,-49.33421661025495,-0.0788548932233471,0.09120756795975993,0.17006246118310703,-13713896,-14006016,35.250339948963145,52.25729151318179,NaN,NaN,7.710453800602495,13.269004609028453
2004-09-23T09:30:00-04:00,26.45,26.45,26.17,26.17999,3864300,831065,42.57724520597786,54.76980940583733,NaN,NaN,-179.24866863946394,-86.73771167080795,-0.09743514096443531,0.048268534977562894,0.1457036759419982,-17578196,-14774836,29.515744736568394,49.50205983344587,NaN,NaN,4.34219490704254,11.993746080173324
2004-09-24T09:30:00-04:00,26.14999,26.50999,26.14999,26.41,1642000,874675,47.995131325837086,53.592590462426145,NaN,NaN,-130.27899769652058,-102.76937809056028,-0.09062282094252201,0.032425149763845695,0.12304797070636771,-15936196,-14906116,28.658410559054587,46.8447603068218,NaN,NaN,3.0248027202109924,10.712468457321563
2004-09-27T09:30:00-04:00,26.39,26.53,26.25999,26.38,185800,877815,47.36738457377168,52.14979470821742,NaN,NaN,-105.29296829178847,-111.57788414180399,-0.08463872748410874,0.01724956135123179,0.10188828883534053,-16121996,-15315896,26.109087049149906,43.9557130521036,NaN,NaN,1.7724701840156665,9.435325846849292
2004-09-28T09:30:00-04:00,26.60001,27.05,26.53,27.03,1726000,944560,59.67422996076524,52.10701648745917,NaN,NaN,50.30096836118213,-93.05505981646854,-0.035898526281016724,0.05701513098406963,0.09291365726508635,-14395996,-15549256,24.758396956952467,41.03291308631388,NaN,NaN,4.743117586196002,8.765010381041678
2004-09-29T09:30:00-04:00,27.10001,27.17999,26.97,27.16,830300,972185,61.6077557620569,52.109712917481474,NaN,NaN,109.58079667081529,-50.987773919155096,0.003981967864291239,0.0978911170954504,0.09390914923115916,-13565696,-15519616,25.287080995651493,38.20023942868233,NaN,NaN,7.770818755969397,8.622983006031353
2004-09-30T09:30:00-04:00,27.23,27.58,27.14999,27.55,1091800,1008710,66.75730757262426,52.885763868098465,NaN,NaN,171.18892088997933,19.099743986733557,0.05280228474669843,0.1599120051645322,0.10710972041783376,-12473896,-14498756,40.73328275117336,36.74725729202209,NaN,NaN,12.227737519035411,9.137947936460504
2004-10-01T09:30:00-04:00,27.49001,27.73,27.49001,27.7,1237000,1050140,68.50696026267795,53.83201469848758,NaN,NaN,192.18024767868357,83.59159306177439,0.08923008124086598,0.21864732196891623,0.12941724072805025,-11236896,-13558896,50.81511220186553,36.005427470880875,NaN,NaN,16.393042170336066,10.1743899698713
2004-10-04T09:30:00-04:00,27.75999,27.89999,27.64999,27.75999,1044100,1031245,69.20504401709782,54.87568445205313,NaN,NaN,185.73825996047916,141.79783871222793,0.11003327942763319,0.26695884001259174,0.15692556058495855,-10192796,-12373056,60.04933068603425,36.49812372359149,NaN,NaN,19.913937675575895,11.565753927829098
2004-10-05T09:30:00-04:00,27.67999,27.75,27.56,27.72,1309900,1055440,68.121038639253,56.01907816073362,NaN,NaN,149.7496196883989,161.68756897767128,0.11332146593974005,0.2985773930096336,0.18525592706989355,-11502696,-11794396,63.63698354279721,37.69872879037788,NaN,NaN,22.417405933979246,13.115989928707691
2004-10-06T09:30:00-04:00,27.7,28.17,27.7,28.17,1066100,1086295,73.20687961006439,57.36620986162067,NaN,NaN,172.20827179321057,174.21306400215036,0.13647094483645994,0.3558446081154685,0.21937366327900854,-10436596,-11168576,67.08012733300461,39.52822541086944,NaN,NaN,26.411485461016376,15.015346433323217
2004-10-07T09:30:00-04:00,28.14999,28.17999,27.8,27.81,1866300,1158715,64.36073063733176,58.46486872392347,NaN,NaN,133.81329886769322,166.73793959769313,0.11885221050538855,0.3679389264107442,0.24908671590535567,-12302896,-11134376,67.26255946395236,41.81163164683444,NaN,NaN,26.884091852973235,16.71088149327322
2004-10-08T09:30:00-04:00,27.8,27.95,27.55,27.64999,677300,1166300,60.841623758826415,59.264360499980874,NaN,NaN,90.6469256156045,146.4312751850773,0.0890963594597145,0.3604571652299988,0.2713608057702843,-12980196,-11483036,63.4048763717817,44.03733290621408,NaN,NaN,26.104426910481237,18.052816552874365
2004-10-11T09:30:00-04:00,27.7,27.81,27.59,27.64999,773300,1194410,60.84162375882642,59.871443326373615,NaN,NaN,76.64295271863871,124.61221373670921,0.06330144543529281,0.3504876125644003,0.2871861671291075,-12980196,-12040516,57.70603889522605,45.7333836780125,NaN,NaN,25.494866668426518,19.115966569381815
2004-10-12T09:30:00-04:00,27.42999,27.5,27.19,27.35001,398100,1125985,54.37702629710887,60.38857009872999,NaN,NaN,31.76713629331777,101.015717057693,0.02205308242618831,0.31475252016184285,0.29269943773565454,-13378296,-12415636,54.177398737159116,47.08531644859793,NaN,NaN,22.906263061640413,19.65743749684733
2004-10-13T09:30:00-04:00,27.23,27.35001,26.49001,26.73,2632100,1241055,43.9765559068098,60.488520863075124,NaN,NaN,-30.507508484000574,60.47256100225076,-0.04719272606212843,0.23370853015799398,0.2809012562201224,-16010396,-13530396,45.31034538779111,48.21350220939955,NaN,NaN,16.771577562498248,19.24517179194032
2004-10-14T09:30:00-04:00,26.69,26.85001,26.64999,26.67999,502800,1246410,43.25785962360589,60.15014431291575,NaN,NaN,-46.90144703863048,24.329611820986024,-0.09387318112705706,0.1635597798113011,0.25743296093835816,-16513196,-14372456,39.986548959393375,49.022654952280895,NaN,NaN,11.796339214404089,18.181052852292286
2004-10-15T09:30:00-04:00,26.85001,27.08,26.78,26.92999,219000,1180075,47.846417059234504,60.18436091902024,NaN,NaN,-24.406491933850006,1.318928311095115,-0.10460314994913511,0.12667902350193927,0.23128217345107438,-16294196,-15035256,36.36471602407368,49.75519987906115,NaN,NaN,9.130844908114266,16.888166003124
2004-10-18T09:30:00-04:00,26.8,27.00999,26.72,26.86,498300,1144655,46.70763912680214,59.258175859451455,NaN,NaN,-36.10831480567694,-21.231325193768004,-0.11242017028200468,0.09075696059856853,0.2031771308805732,-16792496,-15797716,32.69589164258264,50.3221637851776,NaN,NaN,6.649376137732656,15.425481736639522
2004-10-19T09:30:00-04:00,26.94,26.96001,26.22,26.22,1767200,1190820,37.838984250334676,57.560406465757005,NaN,NaN,-86.75566218597565,-44.935884889626685,-0.15412210805653573,0.010524495809903556,0.16464660386643928,-18559696,-16833996,28.488938069711054,50.55086786189613,NaN,NaN,1.2120940109943805,13.394997775833074
2004-10-20T09:30:00-04:00,26.25,26.49001,26.22,26.39999,1079000,1220535,41.219303015165984,55.73626328308141,NaN,NaN,-97.6428029165331,-58.36294377613319,-0.16219524952243092,-0.03809745803659936,0.12409779148583155,-17480696,-17128056,27.41112149420863,49.599284914970085,NaN,NaN,-2.0093950992015404,11.194370222256701
2004-10-21T09:30:00-04:00,26.32001,26.69,26.25999,26.59,1200700,1087355,44.64173472131681,54.03160431584133,NaN,NaN,-82.37732104129383,-65.45811857666585,-0.1477581767704046,-0.060599929477174186,0.0871582472932304,-16279996,-17081416,27.877188668832744,47.960861805467744,NaN,NaN,-3.511350898019664,9.093552919360079
2004-10-22T09:30:00-04:00,26.60001,26.89999,26.41,26.42,1308500,1070680,42.2703963639492,52.107700912045004,NaN,NaN,-76.93468590905132,-75.96375737170612,-0.1426071794294291,-0.09110072699355598,0.05150645243587313,-17588496,-17340276,26.846889170917194,45.58925884010223,NaN,NaN,-5.493677633218378,7.009662840420299
2004-10-25T09:30:00-04:00,26.39999,26.75,26.39999,26.67999,1226800,1122730,46.91468564805369,50.592961412673624,NaN,NaN,-75.42406601241777,-83.82690761305429,-0.11578055017380934,-0.09321923528138853,0.022561314892420796,-16361696,-17254116,27.80332782663666,43.02971200323363,NaN,NaN,-5.683595163923185,5.19634026837123
2004-10-26T09:30:00-04:00,26.72,26.95,26.56,26.94,855400,1079200,51.14746726751012,49.01728910249118,NaN,NaN,-46.19621866793474,-75.71501890944612,-0.07650918734823028,-0.07307516929286706,0.0034340180553632214,-15506296,-16643436,34.35454057622809,40.69217009203531,NaN,NaN,-4.484038777546904,3.813428976097211
2004-10-27T09:30:00-04:00,27.02,27.25999,26.78999,27.25,4149398,1245154.9,55.68441979305012,48.397552613613925,NaN,NaN,-7.119738447111916,-57.61040601556188,-0.028131751419290182,-0.03173067121874951,-0.003598919799459325,-11356898,-15418676.4,45.11187681231143,39.10997847406095,NaN,NaN,-1.9799139057672086,2.9858085644022943
2004-10-28T09:30:00-04:00,26.89999,27.03999,26.60001,26.89999,2916300,1336379.9,50.03440795422898,47.625608627571246,NaN,NaN,-38.37083598753119,-48.80910900480934,-0.01863900875877865,-0.02689768074793264,-0.008258671989153988,-14273198,-15017316.8,48.112622943833394,38.01767465777893,NaN,NaN,-1.6882345582896439,2.318088118303446
2004-10-29T09:30:00-04:00,27,27.3,27,27.28999,685900,1308824.9,55.457634804387204,47.241037987968454,NaN,NaN,14.15448286987807,-30.59127524902347,0.013252127699453995,0.008306487635163506,-0.004945640064290489,-13587298,-14217077.2,53.56366886002842,37.721791083836244,NaN,NaN,0.3983809567454062,2.043844238080869
2004-11-01T09:30:00-05:00,27.39999,27.39999,27.16,27.32001,360800,1274659.9,55.85482701285117,47.34659518195004,NaN,NaN,33.854440307727224,-8.735573984994508,0.03450707048961434,0.03818819804772744,0.0036811275581130967,-13226498,-13590037.6,57.345023767590455,37.94805001458134,NaN,NaN,2.1508619419484285,2.0591324814905203
2004-11-02T09:30:00-05:00,27.47,27.53,27.17999,27.19,1255200,1271924.9,53.62463355530235,48.0357435854138,NaN,NaN,39.76932716765715,8.457535182123866,0.037689844588306196,0.05079343329349584,0.013103588705189646,-14481698,-13385118,58.533419220205374,38.89255528832522,NaN,NaN,2.9105216327809407,2.1807595031034377
2004-11-03T09:30:00-05:00,27.27,27.71001,27.27,27.59,970800,1267159.9,59.04310476316956,49.163261095382644,NaN,NaN,86.19265004074683,27.12001287969561,0.06311658441004434,0.09199931921774507,0.028882734807700733,-13510898,-13815918,55.060397510977545,39.96925875629552,NaN,NaN,5.313029852771116,2.628226695913106
2004-11-04T09:30:00-05:00,27.75,28.25,27.59,28.25,1071800,1227434.9,66.08446704154684,50.465978951262066,NaN,NaN,171.94072365522553,69.18232480824695,0.11760123642216451,0.17588428033540637,0.058283043913241864,-12439098,-13449098,57.37931868976032,41.470301803844556,NaN,NaN,9.987918206324615,3.6796111974004644
2004-11-05T09:30:00-05:00,28.38,28.53,28.21001,28.37,2369400,1312039.9,67.18898140747294,51.92893197130998,NaN,NaN,205.97848499543937,107.5471252333592,0.15271307389218153,0.24917438627846877,0.09646131238628725,-10069698,-12745578,61.48422736823673,43.52661149853414,NaN,NaN,14.029847696816375,5.158216411602737
2004-11-08T09:30:00-05:00,28.35001,28.42999,28.34,28.38,548200,1300784.9,67.28459693720194,54.03219002037192,NaN,NaN,185.30807665075096,137.83785250196397,0.16647377897523508,0.3045535361053311,0.13807975713009601,-9521498,-12004578,65.27755105659529,46.15436956902587,NaN,NaN,17.22180600680952,6.881586353775134
2004-11-09T09:30:00-05:00,28.36,28.72,28.36,28.67,531200,1307439.9,70.0136674491909,56.088930337087994,NaN,NaN,176.804819945085,165.24495105744955,0.18362016747184437,0.3676049664699015,0.18398479899805711,-8990298,-10906298,69.99450499207296,49.19603981887332,NaN,NaN,20.81204901198377,8.871652447804939
2004-11-10T09:30:00-05:00,28.7,28.75,28.57001,28.66,416200,1196644.9,69.79745100067856,57.88576721418526,NaN,NaN,153.7450704240323,178.75543513410662,0.18242598807292482,0.4120172840892131,0.2295912960162883,-9406498,-10085418,72.95208414698729,52.41567521017007,NaN,NaN,23.617342348222493,10.978179576436018
2004-11-11T09:30:00-05:00,28.72,28.91,28.63,28.88,1069200,1224964.9,71.85660908566476,59.99906812287923,NaN,NaN,141.16324136039162,172.59993867513987,0.18406117384056964,0.4596677633170003,0.2756065894764307,-8337298,-9265058,75.54621109333533,55.8941982046285,NaN,NaN,26.637519539772036,13.215228142626877
2004-11-12T09:30:00-05:00,29,29.19,28.88,29.17999,761700,1252099.9,74.41785794808644,61.96358043002442,NaN,NaN,140.02618241208472,159.40947815846891,0.19206929402259715,0.5156932070046771,0.32362391298208,-7575598,-8766238,76.99123424718867,59.40762009181079,NaN,NaN,30.058529604107783,15.621414065695578
2004-11-15T09:30:00-05:00,29.25,29.25,28.92999,29,490500,1251709.9,70.28487588928182,63.33053818872241,NaN,NaN,118.33560053620168,146.01498293555906,0.17258308008666368,0.5393527630904096,0.3667696830037459,-8066098,-8475158,77.81506865712126,62.511943526160316,NaN,NaN,31.71914714271285,17.92109021955519
2004-11-16T09:30:00-05:00,28.88,29.03,28.83,28.83,293400,1178019.9,66.52677812393233,64.10499235521398,NaN,NaN,93.07334661566595,129.26868826967524,0.1371296364253764,0.5381817285354664,0.40105209211009,-8359498,-8348998,78.17973908097787,64.87393368820791,NaN,NaN,32.01711092792941,19.93480746360865
2004-11-17T09:30:00-05:00,29.19,29.44,28.98,29.05,1120800,1180109.9,68.84816869845848,65.44883240837324,NaN,NaN,101.72589282304685,118.86485274947816,0.11810311331864382,0.5486809837583948,0.430577870439751,-7238698,-7915438,79.43105421442017,67.11096449324982,NaN,NaN,32.95209037021775,21.79441930740995
2004-11-18T09:30:00-05:00,29.05,29.31,29.05,29.14,552700,1147709.9,69.77173573272447,66.47126818896875,NaN,NaN,93.69070344633721,109.37034516666726,0.10180459037291378,0.5578336084058932,0.45602901803297946,-6685998,-7585178,80.35521084093574,69.02464606331463,NaN,NaN,33.990757098124185,23.536753277511984
2004-11-19T09:30:00-05:00,29,29.19,28.84,28.94,283800,1096474.9,65.14934092455123,67.13516203980448,NaN,NaN,73.5332419009241,96.07175706443515,0.06933116482126644,0.5426929740595625,0.47336180923829607,-6969798,-7464018,80.6978424114178,70.69270453787372,NaN,NaN,33.55571058927665,24.968032893478366
2004-11-22T09:30:00-05:00,28.89,29.28,28.86,29.28,664300,1068349.9,68.91910855323974,68.22762453965714,NaN,NaN,80.11090102400877,88.42681716199657,0.06272545301603605,0.5517686255083412,0.4890431724923051,-6305498,-7111898,81.6969659797987,72.3472435921304,NaN,NaN,34.286896218449904,26.299299082760015
2004-11-23T09:30:00-05:00,29.36,29.36,29.02,29.14,316000,1041379.9,65.7646148268422,68.70773240134805,NaN,NaN,78.7010817109017,85.55236418104371,0.04190396274646019,0.5414231259253803,0.49951916317892014,-6621498,-6764298,82.65162005262145,74.31804520224782,NaN,NaN,33.9658916192364,27.394526587970926
2004-11-24T09:30:00-05:00,29.14999,29.42,29.14999,29.42,690300,868425,68.83679583882892,68.90432731543963,NaN,NaN,88.2350092056649,82.85418745756733,0.03997170606265876,0.5494837957572436,0.5095120896945848,-5931198,-6502798,83.3549896947204,76.17345027403069,NaN,NaN,34.60348395674787,28.424377640653347
2004-11-26T09:30:00-05:00,29.39,29.8,29.39,29.71001,547500,749985,71.67225390426582,69.22456106521054,NaN,NaN,115.46579164281277,87.20920509686243,0.05052785834467688,0.5726719126254309,0.522144054280754,-5383698,-6242338,84.04869488442925,77.78519795375871,NaN,NaN,36.0267113187961,29.510425308959455
2004-11-29T09:30:00-05:00,29.78,29.78,29.39999,29.63,825400,756960,69.78572400422142,69.40321299856907,NaN,NaN,107.79561625403561,94.06167996748474,0.04462915730422945,0.5779305009110409,0.5333013436068115,-6209098,-6090198,84.45620189166003,79.15510158483478,NaN,NaN,36.63030997879288,30.52755169036423
2004-11-30T09:30:00-05:00,29.83,29.83,29.48,29.50999,406400,759240,66.93960141968842,69.18363685360461,NaN,NaN,105.4676460466913,99.13302897202125,0.026071667210675775,0.5658909276201562,0.5398192604094805,-6615498,-6152198,83.51980216850406,80.12119424029413,NaN,NaN,36.309346193363396,31.353522333649824
2004-12-01T09:30:00-05:00,29.56,29.87,29.5,29.78,486300,720795,69.91274994352894,69.19187249237964,NaN,NaN,119.20253589499843,107.23331980884059,0.02538345031447009,0.571548573302568,0.5461651229880979,-6129198,-6053738,83.82648327200356,80.89793703493815,NaN,NaN,36.90275001739241,32.14626914561305
2004-12-02T09:30:00-05:00,29.8,29.8,29.25999,29.41,2147400,779625,61.721477146801384,68.46793449674654,NaN,NaN,81.8646104209398,105.95924005189556,-0.004970371897822012,0.5399521581158204,0.5449225300136424,-8276598,-6522818,76.5205692487335,80.96753404603803,NaN,NaN,34.871413405488845,32.53557546845245
2004-12-03T09:30:00-05:00,29.17999,29.42,29.14999,29.39,1118400,781955,61.30336548865042,67.53118503535825,NaN,NaN,44.858747625470954,91.83783124842721,-0.02997931246713037,0.5074483894297295,0.5374277018968598,-9394998,-7325078,65.93609187905392,80.17788101974268,NaN,NaN,33.12056847851993,32.61914589846209
2004-12-06T09:30:00-05:00,29.39999,29.39999,29.13,29.31,392800,683125,59.565191747404846,66.76549331093847,NaN,NaN,30.186393604483214,76.31598671851673,-0.05408790569198063,0.4698178197818841,0.5239057254738647,-9787798,-8040818,58.20129823305972,78.77689741802399,NaN,NaN,31.16716970991219,32.411720728669245
2004-12-07T09:30:00-05:00,29.35001,29.35001,28.67999,28.69,2673600,789395,48.16681127652887,65.4540671075525,NaN,NaN,-71.82246157877739,40.857965193423,-0.11070662753315447,0.3855224410574216,0.4962290685905761,-12461398,-9209998,48.245176442173005,76.63871437239507,NaN,NaN,25.547833559469137,31.431165418783515
2004-12-08T09:30:00-05:00,28.58,28.82001,28.306,28.81,1232800,824475,50.154950866536694,64.11883726241523,NaN,NaN,-142.65707715148415,-11.513957415873515,-0.13725662718539672,0.32465828460883017,0.4619149117942269,-11228598,-10229878,41.565665736961385,73.9340437668623,NaN,NaN,21.60022799919707,30.026745787414022
2004-12-09T09:30:00-05:00,28.55,29.06,28.44,29,2020600,904695,53.21482950200383,62.93620110307804,NaN,NaN,-97.79651776882346,-47.44618305382617,-0.13878826735925354,0.28842957759515997,0.4272178449544135,-9207998,-10416158,40.463724480153545,71.08465188394929,NaN,NaN,19.228759940944038,28.48417638077545
2004-12-10T09:30:00-05:00,28.92,29.16,28.92,28.99001,1081100,905290,53.03049593287414,62.07056931795825,NaN,NaN,-50.73227992842544,-66.56438856460545,-0.13700516144099933,0.25596139315316435,0.3929665545941637,-10289098,-10594978,39.38432633220888,68.13368644972009,NaN,NaN,17.274019418657787,26.882725386187214
2004-12-13T09:30:00-05:00,29.19,29.44,29.05,29.41,1257200,930065,59.39810263548222,61.39049746668986,NaN,NaN,24.431924436567964,-67.7152823981885,-0.10548532868365029,0.2611098937396008,0.3665952224232511,-9031898,-10443798,40.82160806957421,65.2140180275612,NaN,NaN,17.461642540028084,25.536856408164482
2004-12-14T09:30:00-05:00,29.10001,29.45,29.10001,29.38,707300,940905,58.785055067229436,60.891957483860374,NaN,NaN,24.01718246011704,-48.547353590409614,-0.08545630149663841,0.2597748455524531,0.3452311470490915,-9739198,-9899358,45.80533118057918,62.58214025098675,NaN,NaN,17.432383762241006,24.379074601603985
2004-12-15T09:30:00-05:00,29.45,29.7,29.39999,29.69,860900,969280,63.031088309018465,60.477264088873916,NaN,NaN,96.65321147936751,-0.6852958642392821,-0.05178666543360777,0.28049781525708184,0.3322844806906896,-8878298,-9429298,49.740781474932234,60.18112537814473,NaN,NaN,18.708122463800834,23.56893858191782
2004-12-16T09:30:00-05:00,29.67,29.67,29.33,29.46001,1213200,973900,58.23747348749796,59.51763691624764,NaN,NaN,59.51018059771109,30.77604380906763,-0.04567524594746797,0.2751904232563547,0.32086566920382265,-10091498,-9605998,48.32030047927928,57.629097206348305,NaN,NaN,18.33317475694967,22.820972321208085
2004-12-17T09:30:00-05:00,29.10001,29.37,29.10001,29.25,620900,977310,54.18514820366801,58.40331007335097,NaN,NaN,-11.963501556794307,38.52979948339385,-0.055777973380711,0.25114320247793387,0.30692117585864487,-10712398,-9690658,47.618641284071,54.9978428772348,NaN,NaN,16.773198572884546,21.95700464287615
2004-12-20T09:30:00-05:00,29.36,29.55,29.25,29.37,338000,980020,56.066306922349135,57.62664618068387,NaN,NaN,27.26831813309899,39.09707822270006,-0.05432621579625507,0.239013406113326,0.29333962190958107,-10374398,-9959158,45.3685398025954,52.27275270824132,NaN,NaN,16.041540977916704,21.1119384050248
2004-12-21T09:30:00-05:00,29.5,29.77,29.39999,29.74001,303000,961955,61.33768223807976,57.01414134458036,NaN,NaN,92.88709269388508,52.87106026945368,-0.02962955981585358,0.2563026721397641,0.2859322319556177,-10071398,-10025598,44.804362736607224,49.48545838428443,NaN,NaN,17.043342131288682,20.530710365919642
2004-12-22T09:30:00-05:00,29.75999,29.94,29.61,29.75,1682600,1030285,61.47209432954406,56.99632828620484,NaN,NaN,115.63276598070358,56.66697116972089,-0.014566194932545407,0.2677244882899359,0.2822906832224813,-8388798,-9927698,45.87247414526587,47.29630873403675,NaN,NaN,17.881803896287813,20.152295155972237
2004-12-23T09:30:00-05:00,29.8,29.87,29.71001,29.82001,272700,1009405,62.457141576049715,57.07874086387623,NaN,NaN,109.7936563585998,66.72366632189863,-0.002466901272217381,0.27920705663220957,0.28167395790442695,-8116098,-9532618,50.071489375087026,46.16312284089624,NaN,NaN,18.858542028518652,19.967473280621725
2004-12-27T09:30:00-05:00,29.89999,29.98,29.72,29.75,122500,988155,60.78353903923206,57.165765670435306,NaN,NaN,108.25334773313561,90.76703617988463,-0.0017898217184093568,0.27943668075641526,0.2812265024748246,-8238598,-9037858,54.80037021341326,45.920199410921505,NaN,NaN,19.215588536288823,19.860061174288454
2004-12-28T09:30:00-05:00,29.75,29.92,29.75,29.92,116100,952690,63.351563740635726,58.25039084644293,NaN,NaN,111.34150256097156,107.58167306545913,0.007013498548077757,0.2899933756599218,0.282979877111844,-8122498,-8587478,58.64056744415201,46.662727339634294,NaN,NaN,20.24809357829559,19.915494374860902
2004-12-29T09:30:00-05:00,29.99001,29.99001,29.81,29.92999,389700,951855,63.50281237028668,59.203809525282225,NaN,NaN,112.75132127018188,111.5545187807185,0.010221254897321064,0.29575644573349535,0.2855351908361743,-7732798,-8119758,62.22948201749187,48.138714216815046,NaN,NaN,21.143106539701076,20.09086754126664
2004-12-30T09:30:00-05:00,29.96001,29.96001,29.77,29.78999,533600,954220,59.77945128754563,59.67271108139236,NaN,NaN,93.37206372686732,107.10237832995124,0.00015835659546359349,0.2857331365805038,0.2855747799850402,-8266398,-8095278,62.413318915883366,49.70654239079575,NaN,NaN,20.927614298628225,20.210402792318295
2004-12-31T09:30:00-05:00,29.85001,29.89,29.72,29.73,676900,880695,58.20461601371535,60.042291087166724,NaN,NaN,73.13970692844303,99.7715884439199,-0.012589126833929931,0.2698383714426278,0.2824274982765577,-8943298,-8260718,60.2780492816415,51.19895117289808,NaN,NaN,20.328014417546324,20.227204453065156
2005-01-03T09:30:00-05:00,29.78999,29.89999,29.25,29.42999,908300,870190,50.97256836566553,59.44046721075124,NaN,NaN,17.003535848070296,81.52162606690683,-0.041639834569562384,0.23037770506460475,0.27201753963416714,-9851598,-8583318,56.237764129530525,52.300105177180676,NaN,NaN,17.710099901986762,19.867618088625385
2005-01-04T09:30:00-05:00,29.39999,29.39999,28.64,28.89999,1688200,934960,41.22694131833964,58.18631622868768,NaN,NaN,-92.42357892010953,40.7686097706906,-0.09396872024645445,0.1545566393260991,0.24852535957255353,-11539798,-9266778,48.778221319501526,52.51245447281798,NaN,NaN,11.986334983814269,18.741720502223796
2005-01-05T09:30:00-05:00,28.63,29.06,28.45,28.5,1742500,888405,35.68218285489476,56.23282298196456,NaN,NaN,-147.43052046066205,-11.26775857547818,-0.14963364203281887,0.06148330703152993,0.2111169490643488,-13282298,-10376678,39.593542777208704,51.78765170869487,NaN,NaN,5.014825203372193,16.78073545953071
2005-01-06T09:30:00-05:00,28.53,28.75999,28.48,28.69,333000,843415,39.82242151061725,54.91746212647308,NaN,NaN,-152.59848187409776,-60.461867695671195,-0.1664786506271279,0.0030186357804389274,0.16949728640756684,-12949298,-11313258,33.80846541719578,50.7510920614032,NaN,NaN,0.6979148075817654,14.483189652109433
2005-01-07T09:30:00-05:00,28.85001,28.92,28.60001,28.74001,1195700,802170,40.90078147178265,53.968578788481274,NaN,NaN,-128.55188120839847,-100.8001853230395,-0.16666344275166484,-0.03883201703201422,0.12783142571965062,-11753598,-11875318,30.89140790094214,49.55628967689399,NaN,NaN,-2.3782868616302206,12.074407293003768
2005-01-10T09:30:00-05:00,28.85001,29,28.72,28.87,792400,787735,43.7236629304042,53.0869613604852,NaN,NaN,-103.04871190172773,-124.81063487299912,-0.15091225039573888,-0.06080888727502298,0.0901033631207159,-10961198,-12097238,29.79818725014168,48.444121637433014,NaN,NaN,-4.057772218094901,9.769810219989672
2005-01-11T09:30:00-05:00,28.83,28.83,28.50301,28.57001,1603000,805025,39.08395230150379,51.497409222158346,NaN,NaN,-126.39132384834485,-131.6041838586462,-0.15309475477295192,-0.10126508034547399,0.05182967442747792,-12564198,-12302118,28.78537302675764,47.299908086729474,NaN,NaN,-6.9939604597248,7.37498583717332
2005-01-12T09:30:00-05:00,28.62,28.77,28.32001,28.75999,1005100,819915,43.194948755850774,50.1918988240374,NaN,NaN,-111.61397281021728,-124.44087432855721,-0.13478566768842834,-0.1166524101830575,0.018133257505370835,-11559098,-11957478,32.915943734177844,46.37444162879462,NaN,NaN,-8.162510742774984,5.155343468609276
2005-01-13T09:30:00-05:00,28.8,28.84,28.55,28.64999,566100,805175,41.45066794681525,48.69143642194921,NaN,NaN,-89.64119365990358,-111.84941668571837,-0.12342945965411213,-0.13615356706226933,-0.012724107408157201,-12125198,-11792658,34.8617772240172,45.288033618003915,NaN,NaN,-9.650699410203979,3.0401944859216683
2005-01-14T09:30:00-05:00,28.60001,28.96001,28.60001,28.92,532400,771135,47.097812643646755,47.71388453655027,NaN,NaN,-61.58573062482315,-98.45618656900332,-0.09249382156610314,-0.12834138436578613,-0.035847562799682986,-11592798,-11760498,35.25639265731546,43.892035221139786,NaN,NaN,-9.175632789452555,1.2950763037253508
2005-01-18T09:30:00-05:00,28.83,29.05,28.62,29.03,357800,757980,49.245537879925536,46.70631126078525,NaN,NaN,-47.1040259755915,-87.26724938377608,-0.060908525562861235,-0.11198321975325953,-0.0510746941903983,-11234998,-11815258,34.86903674052728,42.19406874230945,NaN,NaN,-8.127627123616694,-0.051024185894941176
2005-01-19T09:30:00-05:00,29.02,29.08,28.8,28.83,481600,765160,45.61914985069448,45.42890679510009,NaN,NaN,-42.67931262811335,-70.52484713972977,-0.05021644290622408,-0.1138452478231784,-0.06362880491695432,-11716598,-11645738,37.17036742121148,40.40413198543228,NaN,NaN,-8.324630175581751,-1.2329678987073427
2005-01-20T09:30:00-05:00,28.85001,28.85001,28.62,28.67,664900,783255,42.8976073125859,44.223060796888674,NaN,NaN,-62.621908942479195,-60.72643436618216,-0.050513158263295305,-0.12677025274607345,-0.07625709448277815,-12381498,-11810218,35.84688027290683,38.506529225219666,NaN,NaN,-9.306889467690201,-2.3863852657048934
2005-01-21T09:30:00-05:00,28.64,28.75,28.50999,28.55,981800,748215,40.92559818004268,42.98884523734063,NaN,NaN,-72.39338906970298,-57.276873448142034,-0.05501404875949653,-0.14502465543214882,-0.09001060667265229,-13363298,-12057838,33.89047921243491,36.62170279170492,NaN,NaN,-10.709415534615724,-3.5753895898350123
2005-01-24T09:30:00-05:00,28.5,28.7,28.14999,28.14999,893400,779250,35.12851044491647,41.85712681442998,NaN,NaN,-105.60377918899026,-66.08048316097545,-0.07965828656757645,-0.18958346488212285,-0.1099251783145464,-14256698,-12590618,30.08582395003917,34.753707064598395,NaN,NaN,-13.832916364940445,-5.0407505577072165
2005-01-25T09:30:00-05:00,28.3,28.61,28.24001,28.3,1882100,867230,38.638798360589014,41.672259460304936,NaN,NaN,-96.23126568152901,-75.90593110216295,-0.08035354375939319,-0.21036710801378788,-0.1300135642543947,-12374598,-12818538,28.606311346591568,33.312856352247685,NaN,NaN,-15.324129217091736,-6.509804651905005
2005-01-26T09:30:00-05:00,28.39999,28.49001,28.23,28.35001,608200,891835,39.80815728565236,41.96697191964477,NaN,NaN,-100.72663814262228,-87.51539620506475,-0.07220022174062671,-0.22026384143017808,-0.14806361968955137,-11766398,-12828498,28.540260820290797,32.52333621246783,NaN,NaN,-16.182713736586525,-7.891648806859507
2005-01-27T09:30:00-05:00,28.58,28.58,28.31,28.5,536200,899160,43.29827734036306,42.215247336055185,NaN,NaN,-79.21400886252135,-90.83381618907319,-0.05238314337264313,-0.2135425489053553,-0.16115940553271216,-11230198,-12598238,32.42485159785228,32.42450665394329,NaN,NaN,-15.877999741471804,-9.032556083232691
2005-01-28T09:30:00-05:00,28.46001,28.60001,28.34,28.47,185400,881750,42.76417259825173,42.34834670223154,NaN,NaN,-76.17582382929139,-91.59030314099087,-0.03766144201447241,-0.20823620805080267,-0.17057476603633026,-11415598,-12208698,38.51427777349956,32.968997359125964,NaN,NaN,-15.777413341270963,-9.996107120095301
2005-01-31T09:30:00-05:00,28.57001,28.89,28.57001,28.82001,519000,873855,50.44468107382914,42.8284194267619,NaN,NaN,19.735261950020238,-66.52249491318877,-0.002567971692020443,-0.1737847306513558,-0.17121675895933536,-10896598,-11536678,47.33190602476407,34.22140584302756,NaN,NaN,-13.34222576290597,-10.474124069068253
2005-02-01T09:30:00-05:00,28.75,29.10001,28.75,29.06,1084300,882655,54.91231257559944,43.95901658919729,NaN,NaN,123.34819980624054,-22.606601815634864,0.03643910460069413,-0.1256678782084677,-0.16210698280916183,-9812298,-11024218,52.88115945248549,35.94253344486526,NaN,NaN,-9.831172248323831,-10.382273808961907
2005-02-02T09:30:00-05:00,29.09,29.38,29.09,29.36,584600,827475,59.79220369901654,45.14453479942342,NaN,NaN,223.44519516720138,42.22776484632987,0.07960098381645803,-0.06260575303858928,-0.1422067368550473,-9227698,-10516478,57.643033424979585,37.70875413706539,NaN,NaN,-5.173335543967359,-9.638139771105543
2005-02-03T09:30:00-05:00,29.2,29.3,29.06,29.19,1183000,799500,56.08768303500135,46.19003587715099,NaN,NaN,156.61697081263878,89.3939607813619,0.09292866724432494,-0.02604590279964114,-0.11897457004396608,-10410698,-10352578,59.08062190771843,39.43867161447262,NaN,NaN,-2.454076572418039,-8.6118450284359
2005-02-04T09:30:00-05:00,29.14,29.53999,29.11,29.52,786800,822190,61.123031760943434,47.191837242672186,NaN,NaN,185.38920161033562,141.7069658692873,0.11855522422716167,0.029219460239986006,-0.08933576398717566,-9623898,-9994238,62.108591456822936,41.356685814437434,NaN,NaN,1.5846085284191878,-7.15520880602803
2005-02-07T09:30:00-05:00,29.58,29.72,29.49001,29.50999,955900,810200,60.8949297283353,48.02393666041574,NaN,NaN,189.97229781779598,175.75437304284247,0.12857823521064782,0.07138703002613411,-0.057191205184513705,-10579798,-9930878,62.63508259788312,43.33997480424858,NaN,NaN,4.691720917029074,-5.46279027416273
2005-02-08T09:30:00-05:00,29.41,29.50999,29.38,29.50999,325100,786835,60.8949297283353,49.11506379453294,NaN,NaN,139.60901075755277,179.0065352331049,0.12864158206273074,0.10361077239389971,-0.02503080966883102,-10579798,-10084378,60.4438896722755,45.00236925075315,NaN,NaN,7.184632807489169,-3.6560155482124586
2005-02-09T09:30:00-05:00,29.48,29.50999,29.06,29.10001,823000,747835,51.725776201140405,49.74564728657255,NaN,NaN,76.93394309478832,149.70428481862228,0.09600191764234602,0.0949715873841015,-0.0010303302582445155,-11402798,-10519398,54.61288232903196,46.3427979690478,NaN,NaN,6.652471977775369,-2.18337447307134
2005-02-10T09:30:00-05:00,29.11,29.53999,29.11,29.49001,2506800,822920,58.17710043210522,50.97789744743415,NaN,NaN,97.28764237651924,137.83841913139838,0.09540971137374941,0.11823180895894225,0.02282209758519284,-8895998,-10216458,57.67498918787147,48.04169153872184,NaN,NaN,8.30077726394305,-0.685638510640713
2005-02-11T09:30:00-05:00,29.58,29.88,29.42,29.78,1183300,853780,62.22004767010739,52.91300724923351,NaN,NaN,136.3894789808158,128.0384746054944,0.10833541285340267,0.1582413636519462,0.049905950798543514,-7712698,-9834218,61.22930129658237,50.2662256349035,NaN,NaN,11.049800705515143,0.9908528059529804
2005-02-14T09:30:00-05:00,29.67999,29.89,29.67,29.81,661700,860245,62.622594125897834,54.626135518184135,NaN,NaN,131.3592038674605,116.31585581542731,0.11221741765814904,0.1901777228712298,0.07796030521308077,-7050998,-9128458,66.77689113587039,52.992695619851986,NaN,NaN,13.331961302161833,2.7538683054113875
2005-02-15T09:30:00-05:00,29.85001,30.12,29.78999,29.97,2535200,969115,64.77810739891916,56.40970338341752,NaN,NaN,135.90688808289826,115.57543128049642,0.11826803758821272,0.22579535219834668,0.10752731461013396,-4515798,-7915658,73.73251438817904,56.220713731844,NaN,NaN,15.901526811879894,4.632105234906888
2005-02-16T09:30:00-05:00,29.94,30.41,29.86,30.35001,1137000,1001885,69.30562425765142,58.26737102036669,NaN,NaN,148.1664747217003,129.82193760587884,0.13913168740655568,0.28144192386832856,0.14231023646177288,-3378798,-6310858,79.76841521509573,59.60239684736139,NaN,NaN,19.669845253734433,6.780353809025108
2005-02-17T09:30:00-05:00,30.45,30.47,30.24001,30.24001,718800,1004580,66.63547683094848,59.972464179845026,NaN,NaN,144.81680618971996,139.32777036851897,0.13659774767743196,0.3130574210585628,0.17645967338113086,-4097598,-5351178,82.3764176702529,62.73540683998663,NaN,NaN,21.88952799437595,8.938807264075228
2005-02-18T09:30:00-05:00,30.35001,30.64,30.31,30.58,927900,1001885,70.42782475180344,61.399831585414624,NaN,NaN,150.26604343443657,142.1030832592431,0.14793746205779776,0.36138150095337807,0.2134440388955803,-3169698,-4442578,84.42368179036504,65.38481939467242,NaN,NaN,25.063120050974742,11.242280519346588
2005-02-22T09:30:00-05:00,30.60001,30.69,30.12,30.12,2129700,1063700,60.421173209348446,61.79332163068241,NaN,NaN,114.83220216773739,138.7976829192985,0.11598779521264413,0.35842878291138547,0.24244098769874134,-5299398,-4092258,85.14042400444782,67.68905257695545,NaN,NaN,24.44137403570982,13.127865307398478
2005-02-23T09:30:00-05:00,30.28,30.58,30.2,30.58,647600,1001975,65.67357310973269,62.213419445733564,NaN,NaN,118.68321534902724,135.35294837252428,0.11702792826539887,0.38872589803048996,0.2716979697650911,-4651798,-4119458,84.81409561030941,69.62984273305042,NaN,NaN,25.764820708833312,14.933144650460598
2005-02-24T09:30:00-05:00,30.39999,30.92999,30.39999,30.91,1179400,1030535,68.86566412432487,63.12613238068525,NaN,NaN,137.56598873511618,133.2328511752075,0.130127876665044,0.4343578155963961,0.3042299389313521,-3472398,-4138178,84.57383823980196,71.45078675677068,NaN,NaN,27.978052461624834,16.796702909198345
2005-02-25T09:30:00-05:00,30.95,31.39999,30.86,31.39,984100,1052930,72.82425091724834,63.96193374899274,NaN,NaN,168.98657767822291,138.06680547290807,0.15937602456448696,0.5034499696369608,0.3440739450724738,-2488298,-3816318,85.34263313035395,73.1103611620229,NaN,NaN,31.291358637147205,18.86736801319104
2005-02-28T09:30:00-05:00,31.38,31.38,30.89,31.09,2165300,1151925,67.08335052765635,64.40396380608709,NaN,NaN,139.3749682160729,135.88859042923534,0.14707128684841536,0.527913053632993,0.38084176678457765,-4653598,-4113098,81.318306347895,74.44487714416661,NaN,NaN,31.900570158308888,20.72925403392216
2005-03-01T09:30:00-05:00,31.3,31.38,31.033,31.13,1709000,1211425,67.45178023830717,64.87231027108508,NaN,NaN,129.767816985997,138.87571339288723,0.13072984061121506,0.5442540675485965,0.41352422693738144,-2944598,-3642138,82.71152108878988,76.0354222453462,NaN,NaN,32.48744394551995,22.4089954498647
2005-03-02T09:30:00-05:00,31.05,31.16,30.78999,31.03999,812200,1197820,65.67052975285577,65.86836409620761,NaN,NaN,98.66554904772423,134.87218013262662,0.1041200150681093,0.5436742457725181,0.4395542307044088,-3756798,-3463138,83.22361989536238,78.07904635722694,NaN,NaN,32.39442738436094,23.835485726221307
2005-03-03T09:30:00-05:00,31.02,31.22,30.87,31.00999,469700,1192075,65.05390616395024,66.35956450562512,NaN,NaN,93.5399009748586,126.06696258057514,0.07606148676329444,0.5346310891585269,0.4585696023952324,-4226498,-3613958,81.04533055614144,79.7483564549605,NaN,NaN,32.13683388797606,25.021392606471988
2005-03-04T09:30:00-05:00,31.25,31.99001,31.19,31.98,1280200,1196935,73.66446592406096,67.17702295233609,NaN,NaN,152.35845324228453,122.74133769338744,0.11221075653204243,0.5988330480602855,0.48662229152824305,-2946298,-3705558,79.68123053080201,81.0663514002619,NaN,NaN,34.898983609465915,26.43247703547112
2005-03-07T09:30:00-05:00,32,32,31.63,31.63,1176000,1216395,67.22783796511564,67.50596894085164,NaN,NaN,137.4637301239347,122.3590900749598,0.10221352033843722,0.6143891919512896,0.5121756716128524,-4122298,-3599298,80.09967460130403,82.01797879065002,NaN,NaN,34.898654069965815,27.64193089754179
2005-03-08T09:30:00-05:00,31.63,31.71001,31.5,31.55,873100,1212255,65.81232381618207,67.57984154208472,NaN,NaN,107.13384963222111,117.83229660420461,0.08081442379717818,0.6131937013593252,0.532379277562147,-4995398,-4009458,73.78332159277656,82.0216078766927,NaN,NaN,34.431962208557515,28.611935370544035
2005-03-09T09:30:00-05:00,31.7,31.92,31.58,31.62,2328000,1312400,66.47743619760828,67.3778281092245,NaN,NaN,107.07406142730804,119.51399908012138,0.06277909523551506,0.6108531466065408,0.5480740513710257,-2667398,-3791578,74.91493882460784,81.67493099165786,NaN,NaN,34.26637983378029,29.41971315100636
2005-03-10T09:30:00-05:00,31.73,31.75,31,31.22,3670400,1454770,59.369617575775244,66.85883816242641,NaN,NaN,62.27336118945079,113.2606911230398,0.017660164750369245,0.5701492573089872,0.552489092558618,-6337798,-4213838,68.72372456283279,80.69973862684215,NaN,NaN,31.840141365530183,29.765488610224047
2005-03-11T09:30:00-05:00,31.14999,31.66,31.14999,31.41,3094800,1484170,61.47661869996329,66.21946630158068,NaN,NaN,65.18543473962266,95.82608742250747,-0.0044568632676557085,0.5469180134740483,0.551374876741704,-3242998,-4273178,67.87480164081794,79.51767575901735,NaN,NaN,30.49475490894149,29.869669510040826
2005-03-14T09:30:00-05:00,31.3,31.49001,31.13901,31.39999,1257400,1487875,61.29626997981571,66.28197321375691,NaN,NaN,52.64540238851607,78.86242187542375,-0.023751346132084405,0.5216856940765986,0.545437040208683,-4500398,-4348798,66.74333106630064,78.20359769200684,NaN,NaN,29.36972177560266,29.798248405121086
2005-03-15T09:30:00-05:00,31.60001,31.60001,31.24001,31.25,1180300,1513805,58.52573961850966,65.77141367866956,NaN,NaN,50.79964823880479,67.59558159674047,-0.049144326160607044,0.4840066325079242,0.5331509586685312,-5680698,-4485858,64.6400603198023,76.76259517125632,NaN,NaN,27.620664845359137,29.487165039440807
2005-03-16T09:30:00-05:00,31,31.13,30.53,30.58,4914301,1632760.05,48.07305653486913,64.28622742227985,NaN,NaN,-49.07491939116657,36.36578543304556,-0.11010239759268292,0.39552296167767764,0.5056253592703606,-10594999,-6071378.2,46.41733764220706,74.03713084285668,NaN,NaN,22.558506078270035,28.49735661641641
2005-03-17T09:30:00-05:00,30.64999,31.03,30.57001,30.94,2575800,1704700.05,52.93684107425631,62.86569814778043,NaN,NaN,-41.68321600516248,15.574469994122902,-0.12417331710555235,0.3504087128884201,0.4745820299939725,-8019199,-6407658.4,43.60928843295654,71.05617765018545,NaN,NaN,19.822489224567907,27.258089846152338
2005-03-18T09:30:00-05:00,30.94,30.96001,30.64,30.83,2400700,1788795.05,51.3540233314016,61.74217477661937,NaN,NaN,-56.49146928947253,-8.760910811696139,-0.13782994318552327,0.3022946010120684,0.44012454419759167,-10419899,-7843038.6,34.120851327969206,67.68493086304788,NaN,NaN,17.131433506936915,25.81142465483585
2005-03-21T09:30:00-05:00,31,31,30.53999,30.64999,1279400,1806370.05,48.783427333588165,60.408720997710866,NaN,NaN,-76.32365548005535,-34.55472238541043,-0.15466472758555827,0.24679363471564386,0.40145836230120213,-11699299,-9282818.8,27.627472179913624,63.750355940985294,NaN,NaN,14.112579025485402,24.14016099350007
2005-03-22T09:30:00-05:00,30.75999,31.09,30.52,30.55,1386200,1769195.05,47.365144522118534,59.10119348122964,NaN,NaN,-87.57772303297243,-62.23019663976587,-0.16714981117472394,0.19252109833279718,0.3596709095075211,-13085499,-10763779,22.817424333262466,59.43562768654959,NaN,NaN,11.216120342960508,22.29386947199442
2005-03-23T09:30:00-05:00,30.53,30.61,30.22,30.25,2119500,1842790.05,43.29784477632679,57.5471890963994,NaN,NaN,-159.31179411752493,-84.27757158503753,-0.18863730056054911,0.12387428380683474,0.31251158436738385,-15204999,-11685779,20.432365422919162,55.10613017703371,NaN,NaN,7.465978409778602,20.175599320249304
2005-03-24T09:30:00-05:00,30.5,30.53999,30.24001,30.25,1675600,1867600.05,43.29784477632679,55.3781447287041,NaN,NaN,-149.11415786168038,-105.76375995634112,-0.19506567208346604,0.06867949426305131,0.26374516634651735,-15204999,-13122939,17.382362965848927,50.65621106525135,NaN,NaN,4.44319530680576,17.92811303261451
2005-03-28T09:30:00-05:00,30.39999,30.39999,30.08,30.08,1163500,1876570.05,40.98488506646011,53.50364809308585,NaN,NaN,-151.29360252867897,-124.7241866041824,-0.20212270314048641,0.011091787420909327,0.21321449056139574,-16368499,-14312659,15.340836941022886,46.030579803802695,NaN,NaN,1.1951179524576891,15.53768516402068
2005-03-29T09:30:00-05:00,30.00999,30.34,29.39999,29.41,2257800,1881195.05,33.40981827225727,51.18918341137693,NaN,NaN,-189.89509636696178,-147.43847478156368,-0.24065197796828458,-0.08760048189895997,0.1530514960693246,-18626299,-15698059,13.37141576515674,41.71544367325843,NaN,NaN,-4.3739486874080855,12.693166042387999
2005-03-30T09:30:00-05:00,29.50999,29.91,29.50999,29.91,2084000,1899945.05,42.02187352389704,49.44235750611184,NaN,NaN,-152.96517216511916,-160.51596460799306,-0.22167251601649185,-0.1240391489512902,0.09763336706520165,-16542299,-16389419,12.508425410736194,37.25783557226759,NaN,NaN,-6.427473578521917,9.961646096543724
2005-03-31T09:30:00-05:00,30.05,30.28,30,30.16,1523600,1935515.05,45.79653773270322,48.47285180303527,NaN,NaN,-92.23646902576253,-147.10089958964056,-0.1830918061888882,-0.1312313906709086,0.0518604155179796,-15018699,-16352159,12.834933765333176,33.26577908673191,NaN,NaN,-6.871384776552632,7.556927400387102
2005-04-01T09:30:00-05:00,30.00999,30.52,29.96001,30.07001,1958400,2009950.05,44.66918176110195,47.2723205931166,NaN,NaN,-79.36333967727072,-133.15073595275862,-0.15552794275216186,-0.14254951292222273,0.012978429829939131,-16977099,-16706579,12.362339145123684,29.30060319418231,NaN,NaN,-7.574284642348325,5.395325679996327
2005-04-04T09:30:00-04:00,29.91,29.91,29.67,29.89,838200,1987850.05,42.41969703141965,45.923993953945455,NaN,NaN,-112.58017045127802,-125.40804953727843,-0.14170455492519807,-0.16415226382655845,-0.022447708901360386,-17815299,-16995939,11.974667910224426,25.388555825891153,NaN,NaN,-8.839122680700081,3.3618330570396977
2005-04-05T09:30:00-04:00,29.8,30.03,29.77,29.95,456200,1951860.05,43.4420665356042,44.846588733737924,NaN,NaN,-90.5409458304938,-105.53721942998484,-0.12157822500770407,-0.17442049016099048,-0.05284226515328641,-17359099,-16742499,14.503571339267324,21.807378041567226,NaN,NaN,-9.569761643702245,1.5144623855051345
2005-04-06T09:30:00-04:00,30.06,30.24001,30.06,30.10001,1024000,1959405.05,46.022543582583324,44.70012352286036,NaN,NaN,-57.10209833740994,-86.36460466444298,-0.09253505927984065,-0.16851108925308722,-0.07597602997324657,-16335099,-16701059,14.93390995129748,19.55856177793083,NaN,NaN,-9.444393411594525,-0.051088442651959554
2005-04-07T09:30:00-04:00,30.23,30.44,30.17,30.42999,1370500,1911530.05,51.287545913008,44.582316725628345,NaN,NaN,-23.384625533151645,-72.5942359659208,-0.04772931327757794,-0.135637671570219,-0.08790835829264106,-14964599,-16690239,15.054135503058134,17.518907997223796,NaN,NaN,-7.759767730905195,-1.1523283409738503
2005-04-08T09:30:00-04:00,30.44,30.48,29.97,29.99001,942000,1775110.05,44.986681796306556,44.127506615978696,NaN,NaN,-46.86615134122318,-66.09479829871131,-0.044420942248114714,-0.14343453610278445,-0.09901359385466973,-15906599,-16476139,17.53766890213366,16.334394966806975,NaN,NaN,-8.19652319489582,-2.158641891534131
2005-04-11T09:30:00-04:00,30.09,30.09,29.75,29.89,276700,1634205.05,43.67327537765491,43.762495761983466,NaN,NaN,-79.55911001708063,-59.490586211871836,-0.04549841670913532,-0.1558866147410889,-0.11038819803195357,-16183299,-16149739,21.31460850814078,15.88347613310892,NaN,NaN,-8.945262245347983,-3.12815908493611
2005-04-12T09:30:00-04:00,29.82001,29.96001,29.38,29.86,1485000,1645585.05,43.26522233167116,43.46964417695151,NaN,NaN,-104.56625883777546,-62.29564881332817,-0.04469679642501656,-0.16625919356322427,-0.12156239713820771,-17668299,-16211579,21.117263526659613,15.762036075494427,NaN,NaN,-9.669273626339134,-4.062604019422256
2005-04-13T09:30:00-04:00,29.85001,29.85001,28.94,29.03,2851000,1729120.05,33.843714664065715,42.79434916893286,NaN,NaN,-182.19342665233384,-87.31391447631295,-0.09371167623251173,-0.23870199242884738,-0.14499031619633565,-20519299,-17048419,18.606677078828383,15.631629765202229,NaN,NaN,-13.522598738740065,-5.414031836467657
2005-04-14T09:30:00-04:00,29,29.03,28.06,28.22,7866898,1876749.9,27.540703154051073,41.668839053056026,NaN,NaN,-271.39844555636006,-136.91667848095463,-0.16989119105627928,-0.35735430501668475,-0.18746311396040546,-28386197,-19732738.6,13.189771305967227,15.332158932353533,NaN,NaN,-19.3764968764892,-7.408669699327877
2005-04-15T09:30:00-04:00,27.97,28.24001,27.47,27.52,3167400,1906329.9,23.47230443291393,40.417940436374145,NaN,NaN,-292.4254713140815,-186.0285424755263,-0.25169635738425833,-0.5020835606907283,-0.25038720330647,-31553597,-22862138.2,9.659258845906734,14.926331925559522,NaN,NaN,-25.92325876586524,-10.0536109945475
2005-04-18T09:30:00-04:00,27.64999,28.05,27.52,27.96001,4350301,2003809.95,30.429333806868556,40.20504868884638,NaN,NaN,-218.30754120482925,-213.77822871307603,-0.25941276925235873,-0.5746531648719184,-0.3152403956195597,-27203296,-25066137.6,8.029185621098037,14.544744058126762,NaN,NaN,-28.527930809762875,-12.692799539578267
2005-04-19T09:30:00-04:00,28.46001,28.91,28.05,28.3,1724200,2026049.95,35.32204688707331,39.72648964335898,NaN,NaN,-125.55800527037148,-217.97657799959524,-0.2260790666619228,-0.5978392289469632,-0.3717601622850404,-25479096,-26628297,7.112941680910666,14.15935236313922,NaN,NaN,-28.80413438329005,-14.994418802965665
2005-04-20T09:30:00-04:00,28.7,28.7,27.75999,27.83,2399900,2076734.95,31.974380839444336,38.739192722411914,NaN,NaN,-129.7619367340563,-207.4902800159397,-0.219939744964522,-0.6466848434906929,-0.4267450985261709,-27878996,-28100236.4,6.374776055664583,13.697912526734324,NaN,NaN,-30.22243196149917,-17.169849254184737
2005-04-21T09:30:00-04:00,28.13,28.37,27.82001,28.35001,2179300,2079724.95,38.876793426566074,38.32545069851649,NaN,NaN,-104.04325832252007,-174.0192425691717,-0.16748575523215964,-0.6361022925663704,-0.46861653733421077,-25699696,-27562936.2,10.044586470409783,13.532358764254756,NaN,NaN,-28.896697765932664,-18.845113327291582
2005-04-22T09:30:00-04:00,28.45,28.45,27.78999,28.08,1492100,2070549.95,36.789401626744365,37.92328674103969,NaN,NaN,-95.77846820734139,-134.68984194782368,-0.13878785051175768,-0.6421013504739079,-0.5033134999621502,-27191796,-26690576,15.814279617020318,13.806616743311606,NaN,NaN,-28.563202316398872,-20.23341175430691
2005-04-25T09:30:00-04:00,28.10001,28.42999,28.10001,28.36,956200,2060184.95,40.36522444202993,37.70351230578438,NaN,NaN,-71.17670512564443,-105.26367473198673,-0.0910675123699235,-0.6171478904245546,-0.5260803780546311,-26235596,-26497036,17.084908067460304,13.990997938182531,NaN,NaN,-27.095483041295378,-21.21370765244812
2005-04-26T09:30:00-04:00,28.19,28.38,27.81,27.82001,1983100,2046449.95,36.12135082586162,36.99628425173283,NaN,NaN,-83.09412423189498,-96.77089852429143,-0.08604814533691918,-0.6336405597257802,-0.547592414388861,-28218696,-27044956,16.33331034283509,14.090955109006645,NaN,NaN,-27.277737590982724,-22.07999764366735
2005-04-27T09:30:00-04:00,27.39,27.67,27.19,27.55,5989301,2241715,34.18590522329943,35.774738488182216,NaN,NaN,-108.01056546333011,-92.42062427014619,-0.09063042924716302,-0.6608804509478148,-0.5702500217006518,-34207997,-28310756.2,14.722023010555404,14.067232788113595,NaN,NaN,-28.057442490070738,-22.93391833601069
2005-04-28T09:30:00-04:00,27.7,27.8,27.24001,27.33,5820102,2456540.1,32.65079939563181,34.89360403099117,NaN,NaN,-98.74293349761055,-91.36055930516429,-0.09759254461087596,-0.6922407024642467,-0.5946481578533708,-40028099,-31176436.8,11.867649527568318,13.662231404216069,NaN,NaN,-29.174378021840457,-23.825412576843515
2005-04-29T09:30:00-04:00,27.53,28.16,27.46001,28.00999,3796100,2548425.1,41.408505036580884,34.73183472091445,NaN,NaN,-64.07197775207757,-85.01926121411152,-0.04802363422354561,-0.6546777006328028,-0.6066540664092572,-36231999,-32984477.4,10.486223894363377,12.888775360374824,NaN,NaN,-27.239284929363265,-24.31310862720348
2005-05-02T09:30:00-04:00,28.02,28.28999,28.00999,28.24001,2863400,2649685.1,44.05846920354501,34.78849521176258,NaN,NaN,-38.15350854794353,-78.41462189857134,0.005772765113878919,-0.5994381100169086,-0.6052108751307875,-33368599,-34411078,9.542383477332649,12.061998213994327,NaN,NaN,-24.82267100527294,-24.385903252641974
2005-05-03T09:30:00-04:00,28.19,28.56,28.13,28.42,1730300,2713390.1,46.11229029454817,35.664822042511325,NaN,NaN,-19.41850971124162,-65.67949899444066,0.05619282145734461,-0.5349698483091068,-0.5911626697664514,-31638299,-35094998.6,9.118645170279805,11.384281649098,NaN,NaN,-22.223529193889885,-24.076992672820246
2005-05-04T09:30:00-04:00,28.55,28.86,28.42,28.86,1268700,2725625.1,50.861677443258486,37.33060592031186,NaN,NaN,17.58926291450482,-40.55953331887368,0.11831870471660333,-0.44326428887069724,-0.5615829935873006,-30369599,-34327319,13.74849132706342,11.424190222033442,NaN,NaN,-18.492471152397147,-23.279203884188377
2005-05-05T09:30:00-04:00,28.75,28.99001,28.49001,28.69,3103400,2812270.1,49.062482210461035,39.15847576156522,NaN,NaN,31.500546234881632,-14.510837372375244,0.14532638485828753,-0.3799250125144411,-0.5252513973727286,-33472999,-33016299,21.13734649262004,12.244053625370109,NaN,NaN,-15.982393373462603,-22.236802382656123
2005-05-06T09:30:00-04:00,28.71001,28.96001,28.67999,28.75999,1065400,2818440.1,49.84905423377669,40.545598649201516,NaN,NaN,56.26480581110996,9.556519340262263,0.16389124132943012,-0.32038734571094096,-0.4842785870403711,-32407599,-32251419,25.16527973887098,13.468060348068175,NaN,NaN,-13.712756956901002,-21.019081607548248
2005-05-09T09:30:00-04:00,28.66,28.81,28.5,28.72,924400,2850825.1,49.37986214059149,41.549728310167104,NaN,NaN,55.7289973551855,28.333020520888066,0.1687988910779178,-0.2732799731929738,-0.4420788642708916,-33331999,-32244099,25.204651779665056,14.76032535512206,NaN,NaN,-11.9759814723324,-19.72721015966027
2005-05-10T09:30:00-04:00,28.5,28.57001,28.22,28.28999,1149900,2834070.1,44.52668685175944,42.44632159676104,NaN,NaN,20.368488145186053,36.2904200921736,0.13961430906794725,-0.26756097793595757,-0.4071752870039048,-34481899,-32812819,24.14190821263864,16.02940622347735,NaN,NaN,-11.799551250260876,-18.594687458317498
2005-05-11T09:30:00-04:00,28.3,28.41,28,28.32001,2752000,2829120.1,44.93357942948372,42.878949168398016,NaN,NaN,9.534799745097043,34.67952745829204,0.11963111131685988,-0.25763639785783,-0.3772675091746899,-31729899,-33084879,23.628648078676704,16.999696338353555,NaN,NaN,-11.543420343794844,-17.587363584814263
2005-05-12T09:30:00-04:00,28.3,28.37,27.46001,27.55,3160600,2593805.2,37.3633095598168,42.919942592188896,NaN,NaN,-80.01092658253336,12.377232894809044,0.055134006119965384,-0.30835000152473313,-0.3634840076446985,-34890499,-33368379,23.078045777775273,17.518536778407483,NaN,NaN,-13.613522340044447,-17.019671978418575
2005-05-13T09:30:00-04:00,27.60001,28.81,26.7,27.00999,4615801,2666225.25,33.145775052327565,42.404267635781586,NaN,NaN,-133.1972575281091,-25.51517977303477,-0.019330107929779905,-0.3876466425569234,-0.3683165346271435,-39506300,-34788119.2,20.50156628917425,17.762583794244193,NaN,NaN,-16.79216369319703,-16.987170794815498
2005-05-16T09:30:00-04:00,26.74001,27.16,26.74001,27.13,1973400,2547380.2,34.904368567838745,42.31734033163709,NaN,NaN,-198.54586753275152,-76.37015275062217,-0.05397282643186052,-0.4357825676669691,-0.3818097412351086,-37532900,-35628299.4,19.139768613965515,17.963045099324937,NaN,NaN,-18.829770125348993,-17.250399270605996
2005-05-17T09:30:00-04:00,27.06,27.59,27.00999,27.50999,2358600,2579100.2,40.26260988721566,42.75139066477397,NaN,NaN,-115.08715170612429,-103.46128072088425,-0.04512590589670029,-0.43821712360598397,-0.3930912177092837,-35174300,-35766779.6,18.916734325996288,18.26266733614214,NaN,NaN,-18.94221669074983,-17.492087473483686
2005-05-18T09:30:00-04:00,27.60001,28.32001,27.60001,28.21001,4650199,2691615.15,48.64845611061812,43.89408043013014,NaN,NaN,-2.608961697059512,-105.89003300931556,0.011042125678525916,-0.37928856061112626,-0.3903306862896522,-30524101,-35525620,20.650852822088055,18.89003900003641,NaN,NaN,-16.292712377674153,-17.320748174082325
2005-05-19T09:30:00-04:00,28.22,28.28,27.89999,28.07001,2236100,2694455.15,47.22075962805035,44.309241472377956,NaN,NaN,4.913211883821309,-88.90520531604463,0.04029241066482775,-0.3399651729586175,-0.38025758362344525,-32760201,-35099560.4,23.753400759068,19.837694490372453,NaN,NaN,-14.612780999987985,-16.933895720640276
2005-05-20T09:30:00-04:00,28.00999,28.00999,27.74001,27.89,3835700,2811635.15,45.376789536493334,44.4034072104457,NaN,NaN,-27.01181899270766,-67.66811760896432,0.0484926460162472,-0.31964177610313627,-0.36813442211938346,-36595901,-34517480.6,27.90105010331223,21.149027820799567,NaN,NaN,-13.789562403163153,-16.484705246714974
2005-05-23T09:30:00-04:00,27.83,28.22,27.8,28.11,1937400,2860695.15,48.04698112992618,44.541599412972694,NaN,NaN,2.2477816867477927,-27.509387765064464,0.06848642733076321,-0.28252638795592944,-0.35101281528669265,-34658501,-33942600.8,31.84437416354386,22.772294177461283,NaN,NaN,-12.305650048017673,-15.887697361186788
2005-05-24T09:30:00-04:00,28.03999,28.12,27.91,28.02,2012500,2862165.15,47.034045040008166,44.26819709845482,NaN,NaN,-2.423316061318155,-4.976620636103239,0.07488449751658838,-0.2574071933909572,-0.33229169090754557,-36671001,-34241941,30.896786241507897,23.99717238563589,NaN,NaN,-11.373823698523642,-15.242858266520624
2005-05-25T09:30:00-04:00,27.85001,28,27.55,27.73,3253000,2725350.1,43.827737590732525,43.89428676847421,NaN,NaN,-50.834527585622496,-14.621733813815842,0.05949143226724768,-0.25792740057348595,-0.31741883284073363,-39924001,-36121921,25.720293726892947,24.32452575951252,NaN,NaN,-11.488515036071709,-14.706523519313636
2005-05-26T09:30:00-04:00,27.75,27.99001,27.75,27.94,1224500,2495570,46.663211627618345,43.66672658232004,NaN,NaN,-32.68571379862025,-22.141518950304153,0.06302027430860763,-0.2386434899549741,-0.3016637642635817,-38699501,-37309781,23.088157998445382,24.176159920910695,NaN,NaN,-10.77861211722599,-14.145393319015401
2005-05-27T09:30:00-04:00,28.03,28.06,27.88,28.03,1272800,2369405,47.87754114635181,43.55941793987434,NaN,NaN,-15.802749694470378,-19.8997050906567,0.07042225791961837,-0.21363594186405876,-0.28405819978367713,-37426701,-37475941,22.737629406042572,23.99994403708052,NaN,NaN,-9.850641438550525,-13.531857336091848
2005-05-31T09:30:00-04:00,27.86,27.97,27.60001,27.83,1934300,2322950,45.40369299287389,43.622061235668234,NaN,NaN,-47.81147026237136,-29.91155548048053,0.06119619834129647,-0.20756295185705653,-0.268759150198353,-39361001,-38416441,20.811625493621165,23.762066700007843,NaN,NaN,-9.730310544872138,-12.988779223060462
2005-06-01T09:30:00-04:00,27.83,28.35001,27.8,28.25,4453102,2459090.1,51.1160044006901,44.06366301932583,NaN,NaN,17.90887767432209,-25.845116733352477,0.08145912177128056,-0.1669352479842523,-0.24839436975553286,-34907899,-38063820.6,23.430420828927396,23.747907610740036,NaN,NaN,-7.972930034895011,-12.272229339036826
2005-06-02T09:30:00-04:00,28.25,28.25,28.00999,28.16,1834900,2487400.1,49.91090748055307,44.95992001366414,NaN,NaN,27.093497976173843,-10.259511620993212,0.08641028216222732,-0.1403815170527487,-0.22679179921497603,-36742799,-37427580.2,28.053669673404414,24.103309317570687,NaN,NaN,-6.846173743538738,-11.497078539679956
2005-06-03T09:30:00-04:00,28.19,28.37,28.00999,28.10001,2283800,2446420.1,49.08030473168376,46.098100705046726,NaN,NaN,40.639829090466996,4.405596956824238,0.08322299968847105,-0.12276304960438722,-0.20598604929285827,-39026599,-37492999.8,27.867350301417602,24.629436747016644,NaN,NaN,-6.1282095401082,-10.730097254026848
2005-06-06T09:30:00-04:00,28.06,28.10001,27.94,28.02,2768800,2531590.1,47.93453715595225,47.02882703276912,NaN,NaN,19.258093860203584,11.417765667759031,0.0736344698287619,-0.1139429620069059,-0.1875774318356678,-41795399,-38366739.4,25.437387338112686,25.079266655884293,NaN,NaN,-5.820494537071261,-10.028725437318908
2005-06-07T09:30:00-04:00,28.12,28.49001,28.12,28.19,3913300,2681035.1,50.57468390494192,47.76540374832099,NaN,NaN,95.03938442369395,39.98793660497209,0.07632363497944328,-0.0921728881113637,-0.16849652309080698,-37882099,-38070959,27.734626877738123,25.709116123865858,NaN,NaN,-4.8542653813864955,-9.289516857899992
2005-06-08T09:30:00-04:00,28.35001,28.35001,27.98,28,2490300,2748055.1,47.66549574769855,47.69519229382674,NaN,NaN,57.25267700811355,47.85669647173039,0.06341893504616225,-0.08922285428310417,-0.15264178932926642,-40372399,-39163859,24.705766740191308,25.9987528323018,NaN,NaN,-4.781158840522908,-8.645465712560409
2005-06-09T09:30:00-04:00,27.89999,27.92999,27.61,27.88,2422700,2731590.1,45.870814145719116,47.59876761651737,NaN,NaN,-25.611181067729625,37.3157606629497,0.04573948016206977,-0.09546743912667921,-0.14120691928874898,-42795099,-40374319,21.858477998729526,25.86340120656334,NaN,NaN,-5.1945241568832925,-8.152474061749391
2005-06-10T09:30:00-04:00,27.95,28.3,27.95,28.13,2117100,2679415.1,50.087185034506184,47.935224437804,NaN,NaN,65.15639332164338,42.21907350918497,0.04950237370121641,-0.07932895216222846,-0.12883132586344487,-40677999,-40704599,21.142489869435423,25.380646904143568,NaN,NaN,-4.422140153924417,-7.619569217774395
2005-06-13T09:30:00-04:00,28.17,28.5,27.98,28.31,2960500,2596650.05,52.93012405653042,48.28402036113288,NaN,NaN,100.75301613433834,58.51805796401193,0.06192759633732145,-0.05142183044179305,-0.1133494267791145,-37717499,-39889019,27.461157334178324,25.067559987760315,NaN,NaN,-2.9701124784007273,-6.9553611121495855
2005-06-14T09:30:00-04:00,28.25999,28.42,28.25999,28.36,2023700,2599165.05,53.71869944416735,48.76149567571567,NaN,NaN,140.15707852079785,67.54159678343271,0.07069340651689363,-0.024982668632997473,-0.0956760751498911,-35693799,-39451359,30.671484634253375,25.051467015813564,NaN,NaN,-1.5371362457335072,-6.18132898837586
2005-06-15T09:30:00-04:00,28.42999,28.63,28.2,28.63,3246900,2643580.05,57.82743873753351,49.76147432905861,NaN,NaN,194.7229866805777,95.03565871792553,0.09058481107551179,0.017554938694498645,-0.07302987238101315,-32446899,-37866259,40.877094285137304,26.134095627116732,NaN,NaN,0.8933165928486682,-5.170665333915213
2005-06-16T09:30:00-04:00,28.64999,29.10001,28.64999,28.92999,3618900,2592015.1,61.87708280528695,50.84817941317779,NaN,NaN,286.9365092842514,157.5451967883217,0.11811421298640952,0.07461289385199876,-0.04350131913441076,-28827999,-35072839,53.78775285349981,28.326923831049193,NaN,NaN,4.248353728039802,-3.8250911822073537
2005-06-17T09:30:00-04:00,29.06,29.06,28.78999,28.8,2315300,2595975.1,59.223288580889246,51.65858994421618,NaN,NaN,217.66455369054955,188.04682886210296,0.12127830165500791,0.10809655793434914,-0.013181743720658778,-31143299,-33165899,60.18032718811015,31.00140224405402,NaN,NaN,6.34894058713043,-2.371658072301956
2005-06-20T09:30:00-04:00,28.8,28.8,28.42,28.5,1949900,2501685.1,53.518526272243164,52.238220892742554,NaN,NaN,107.07575145424288,189.31137592608385,0.09787875845428365,0.10916670434719578,0.011287945892912134,-33093199,-32241039,62.863469327961674,34.005105375078344,NaN,NaN,6.549416318970751,-1.097218873548712
2005-06-21T09:30:00-04:00,28.48,28.48,28.25,28.35001,1484300,2479030.1,50.87967394167528,52.22134014567007,NaN,NaN,42.93157811056503,169.8662758440373,0.06840649040136217,0.09679605889461484,0.02838956849325268,-34577499,-32017779,63.5027994315216,36.8674181324065,NaN,NaN,5.9490023199156745,-0.09061584591094252
2005-06-22T09:30:00-04:00,27.95,28.50999,27.95,28.32001,1339800,2445395.1,50.34497331875854,52.252344848399034,NaN,NaN,12.815135318429656,133.4847055716077,0.044174510303907163,0.08360770637313664,0.03943319606922947,-35917299,-32711859,60.04210670398443,39.15230649173365,NaN,NaN,5.304589207929897,0.6801277332091774
2005-06-23T09:30:00-04:00,28.28,28.37,27.64999,27.64999,2692200,2417355.1,40.187073097348616,51.617114017375094,NaN,NaN,-93.59331055201852,57.37874160435372,-0.01644794222729927,0.018873268285105382,0.03532121051240465,-38609499,-34668159,51.51983727899864,40.841769847275145,NaN,NaN,1.3792257825937135,0.779998883121254
2005-06-24T09:30:00-04:00,27.64,27.71001,27.2,27.34,2179100,2465085.1,36.51613368383898,50.801513769367,NaN,NaN,-202.53652318897167,-26.661473771550533,-0.07368754705215189,-0.05678822330278521,0.016899323749366677,-40788599,-36597219,44.771511249141376,42.22277869806292,NaN,NaN,-3.184089749633781,0.21370050701339194
2005-06-27T09:30:00-04:00,27.31,27.41,27.19,27.27,3183600,2560625.1,35.72259361238517,49.740650177041516,NaN,NaN,-201.60442881894375,-88.39750982618787,-0.11032270383763836,-0.12100405604768127,-0.010681352210042915,-43972199,-38773019,38.625985205432585,43.0007328643268,NaN,NaN,-7.089096661045162,-0.829556231280687
2005-06-28T09:30:00-04:00,27.37,27.7,27.36,27.7,1967000,2562260.1,43.80168412783724,49.46466363276571,NaN,NaN,-125.89289019320431,-122.16240348694176,-0.0999626366442523,-0.1356346480153583,-0.035672011371106,-42005199,-40258559,35.084964901803545,43.74210416158481,NaN,NaN,-7.966236783707356,-1.8490820244844968
2005-06-29T09:30:00-04:00,27.55,27.7,27.52,27.58,1099800,2394595,42.20731339992991,49.202985008066484,NaN,NaN,-106.76448527396182,-146.07832760542004,-0.09556184538161484,-0.15512431809812455,-0.059562472716509704,-43104999,-41696099,32.02537420816762,44.468311033687534,NaN,NaN,-9.175979634492965,-2.895781683057135
2005-06-30T09:30:00-04:00,27.55,27.59,27,27.14,2036500,2404675,36.90313760097199,48.26126733424261,NaN,NaN,-147.41317891130885,-156.8423012772781,-0.11533075721780889,-0.20372591923877081,-0.08839516202096193,-45141499,-43002499,29.50706413481248,45.065780624071614,NaN,NaN,-11.9930413183608,-4.19539020238623
2005-07-01T09:30:00-04:00,27.2,27.28,27,27.12,1840300,2382500,36.67751009212713,47.10036633678523,NaN,NaN,-139.85841359069528,-144.30667935762284,-0.12214617075823093,-0.2410778754687506,-0.11893170471051966,-46981799,-44241139,27.313987965363935,45.05526852629915,NaN,NaN,-14.282042029038145,-5.636340463336504
2005-07-05T09:30:00-04:00,27.02,27.24001,26.97,27.19,927100,2290415,38.10392090500307,45.98502501255921,NaN,NaN,-119.28343170749316,-127.8424799353327,-0.11446332170372348,-0.262010856840174,-0.14754753513645052,-46054699,-44657639,26.598119492688113,44.7643138733302,NaN,NaN,-15.73249020180677,-7.078647568832256
2005-07-06T09:30:00-04:00,27.16,27.28,27.06,27.10001,1853900,2187445,36.95152964658932,44.49388864892035,NaN,NaN,-103.5240427104327,-123.36871043877838,-0.1080452931459544,-0.2826041515688935,-0.1745588584229391,-47908599,-45838319,24.62763628662924,43.60363830200821,NaN,NaN,-17.26984794068739,-8.534533336240132
2005-07-07T09:30:00-04:00,26.75999,27.17,26.7,27.16,2428700,2184365,38.29134715032707,42.80919324499463,NaN,NaN,-107.30964557528397,-123.47774249904282,-0.0929388429364153,-0.29073241209345824,-0.19779356915704294,-45479899,-46313299,23.86177118249148,41.46606818265047,NaN,NaN,-18.182914826339356,-9.912873549111449
2005-07-08T09:30:00-04:00,27.2,27.73,27.2,27.69,3949300,2260695,48.66966331167831,42.055362868622424,NaN,NaN,-38.745636181927495,-101.74423395316656,-0.042971796846867416,-0.2515083152156272,-0.2085365183687598,-41530599,-45591119,27.55084780408025,39.135391083791184,NaN,NaN,-15.855293423901964,-10.761790674081523
2005-07-11T09:30:00-04:00,27.64999,28.07001,27.64999,28.07001,2867300,2298205,54.569406177575516,42.13042571900331,NaN,NaN,9.971588328038303,-71.77823356941984,0.016751770276957123,-0.18759680552256341,-0.20434857579952054,-38663299,-43927419,35.325200511095375,37.16837188258645,NaN,NaN,-11.887821280380566,-10.922652189267101
2005-07-12T09:30:00-04:00,28.09,28.11,27.75999,28,4228398,2361599.9,53.35275643517188,42.30707446853878,NaN,NaN,15.606078003354995,-44.8003316272502,0.050702321948477236,-0.140970673363924,-0.19167299531240123,-42891697,-43294818.6,38.047457943832285,35.350133204894355,NaN,NaN,-9.065675552409362,-10.657369812573139
2005-07-13T09:30:00-04:00,27.98,28.07001,27.77,27.91,3095500,2415189.9,51.75526694804396,42.407809727773454,NaN,NaN,13.82023297993313,-21.331476489177046,0.06532782687406727,-0.11001321171981715,-0.17534103859388442,-45987197,-42910538.2,39.707655344908225,33.89767239353177,NaN,NaN,-7.211794158852107,-10.16514471918442
2005-07-14T09:30:00-04:00,28.12,28.25,27.91,27.95,2127000,2359194.9,52.436904369627285,43.28279767579336,NaN,NaN,34.25929558905485,6.98231174369072,0.0752214747163687,-0.08131419519842353,-0.15653566991479223,-43860197,-42586597.8,41.139597226209005,33.15622667547537,NaN,NaN,-5.496047181541125,-9.498130785235379
2005-07-15T09:30:00-04:00,27.92999,27.99001,27.84,27.89999,872100,2221854.9,51.45800508878605,44.350074204718155,NaN,NaN,26.17664914504112,19.966768809084442,0.07571497196495067,-0.06189195495860389,-0.13760692692355456,-44732297,-43226937.4,39.15974401551819,32.755386158788,NaN,NaN,-4.3282247550842605,-8.759572780928076
2005-07-18T09:30:00-04:00,27.86,28,27.82001,27.84,1889200,2200549.9,50.246259650622754,45.38747892173512,NaN,NaN,34.23788355603787,24.820027854684394,0.06948129696976213,-0.050755305711351895,-0.12023660268111402,-46621497,-44818577,34.69078708581091,32.474300578815026,NaN,NaN,-3.6599668980963944,-8.031057654809265
2005-07-19T09:30:00-04:00,27.97,28.39999,27.97,28.28999,3756600,2290884.9,58.19803080354256,46.41578939857122,NaN,NaN,100.30471003922476,41.75975426185835,0.09174531054638342,-0.005554964498134751,-0.09730027504451817,-42864897,-44813217,34.7178058701423,32.44807493369636,NaN,NaN,-0.6600849103242357,-6.978061548454261
2005-07-20T09:30:00-04:00,28.28999,28.81,28.28999,28.73,3035700,2368454.9,64.21981380153684,47.98811085582885,NaN,NaN,163.9318478600549,71.7820772378827,0.12985800044081422,0.06502222550649961,-0.06483577493431461,-39829197,-43581617,40.780246824102385,33.0734229776917,NaN,NaN,4.033112029433774,-5.405036751613114
2005-07-21T09:30:00-04:00,28.73,28.89999,28.59,28.59,3255400,2464234.9,61.199007281102986,49.72353011869535,NaN,NaN,165.33887800369652,97.99799372081104,0.1385955475874071,0.10840865954994428,-0.030186888037462833,-43084597,-43426497,41.516904854359595,33.93126874337364,NaN,NaN,6.95950698334484,-3.6386733609048347
2005-07-22T09:30:00-04:00,28.64999,28.85001,28.45,28.77,2058800,2432564.9,63.571599611163,51.644536512912204,NaN,NaN,143.61972361100854,121.48660861400451,0.14856905282490523,0.15552442799366872,0.006955375168763482,-41025797,-42685197,45.03567669186564,35.197103652409474,NaN,NaN,10.149399116956708,-1.6689487212103287
2005-07-25T09:30:00-04:00,28.88,28.97,28.53,28.53,1874500,2417334.9,58.44042199266418,53.09714373345942,NaN,NaN,125.22752311610327,139.6845365260176,0.13165236729707436,0.17152083429010645,0.03986846699303208,-42900297,-41940957,48.39285409299432,36.75387040957421,NaN,NaN,11.29236302360946,0.18266724233535525
2005-07-26T09:30:00-04:00,28.36,28.36,28.00999,28.13,3991000,2457704.9,51.045333320384216,54.10384399587333,NaN,NaN,46.88238799517905,129.00007211720845,0.08825734316953554,0.1501901459549515,0.061932802785415964,-46891297,-42746237,45.17746280340801,38.221715160772696,NaN,NaN,9.886401777180582,1.5689150330275303
2005-07-27T09:30:00-04:00,28.3,28.47,26.42,28.42999,2405300,2479619.9,55.584689066216335,55.339082704151146,NaN,NaN,-13.910778776631288,93.43154678987122,0.07501161840801954,0.15569732579544038,0.08068570738742084,-44485997,-43677597,41.724447219382654,39.497620591979214,NaN,NaN,10.178585924577794,2.798868017534711
2005-07-28T09:30:00-04:00,28.60001,28.8,28.52,28.75,1544500,2501854.9,59.860455881944574,56.138425030598725,NaN,NaN,114.64322410047178,83.29241600922629,0.08246391615764684,0.18376560258447938,0.10130168642683254,-42941497,-43648977,41.87147612572618,40.52052261495392,NaN,NaN,11.847302575442646,4.091501525807273
2005-07-29T09:30:00-04:00,28.85001,28.96001,28.62,28.64,1991300,2499594.9,57.800642889187245,56.36922765285671,NaN,NaN,108.5841939234331,76.2853100717112,0.07486848610366262,0.1948872940564108,0.12001880795274819,-44932797,-44430377,38.97983258556949,40.78156776313064,NaN,NaN,12.525144734366675,5.296307698458617
2005-08-01T09:30:00-04:00,28.60001,28.74001,28.41,28.5,2656400,2540399.9,55.197332809996475,56.50098310820133,NaN,NaN,72.63597252814618,65.76699995411977,0.05615442644089372,0.19021184100386535,0.13405741456297163,-47589197,-45368157,35.78573170762479,40.62001588911583,NaN,NaN,12.272024779248419,6.292838710000017
2005-08-02T09:30:00-04:00,28.53,29.06,28.53,28.92999,4027800,2695434.9,61.006343734449146,57.16177430723026,NaN,NaN,105.02949137747189,77.39642063057833,0.06769988997672216,0.21868227703387433,0.15098238705715217,-43561397,-44702177,39.57265965779895,40.61037334003659,NaN,NaN,13.933712152508287,7.38439205892977
2005-08-03T09:30:00-04:00,28.91,29.06,28.82001,29.05,2160200,2710749.9,62.46896741581934,57.878350239101124,NaN,NaN,114.0912529589868,102.99682697770194,0.07766970297879494,0.24806951578064584,0.1703998128018509,-41401197,-44085217,42.93035420476504,40.738284552790596,NaN,NaN,15.7360317557633,8.577483444191703
2005-08-04T09:30:00-04:00,29.55,29.55,28.72,28.74001,2508700,2714749.9,56.56675495101365,58.24326094354596,NaN,NaN,108.68889285973897,101.80596072955538,0.058510674274182495,0.24353815564457904,0.18502748137039654,-43909897,-44278897,42.1387612464971,40.95107149786052,NaN,NaN,15.397249239581054,9.551735700675897
2005-08-05T09:30:00-04:00,28.77,29,28.53999,28.59,3651800,2699874.9,53.91218219431576,58.505112553809745,NaN,NaN,54.69316274166214,91.02775449320119,0.03217479204613566,0.22524597142806613,0.19307117938193047,-47561697,-44804677,39.98339495532786,41.329114917111724,NaN,NaN,14.289341502846026,10.228536529557344
2005-08-08T09:30:00-04:00,28.67999,28.99001,28.59,28.59,1283700,2620694.9,53.912182194315754,58.198980510293545,NaN,NaN,52.148691944405776,86.93029837645311,0.012221122422653913,0.20834758241024787,0.19612645998759395,-47561697,-44799177,40.017957354681656,41.70769716600739,NaN,NaN,13.406195214132538,10.682487770210942
2005-08-09T09:30:00-04:00,28.63,28.82001,28.63,28.77,1790600,2498805,56.73749593419038,57.66452923405451,NaN,NaN,50.93406494995537,76.1112130909498,0.008773029426346807,0.20709274677052747,0.19831971734418066,-45771097,-45241117,38.11839993276083,41.51756524519728,NaN,NaN,13.467030721374948,11.08027962037723
2005-08-10T09:30:00-04:00,29,29.17999,28.74001,28.86,4337199,2560889.95,58.11992443996734,57.444594745401965,NaN,NaN,83.65671148301215,70.02430479575487,0.010087481574114654,0.21092906931182398,0.20084158773770933,-41433898,-45247657.2,38.089585096725735,41.27275669108058,NaN,NaN,13.908201118783797,11.484268405863881
2005-08-11T09:30:00-04:00,28.99001,29.23,28.89999,29.10001,1996200,2554349.95,61.64021642167073,57.30663880329538,NaN,NaN,111.28519268140225,70.54356476008752,0.023868395337035775,0.23067708190900404,0.20680868657196827,-39437698,-44353217.4,44.291781702834434,41.219621334721204,NaN,NaN,15.316562800774044,12.03173903370819
2005-08-12T09:30:00-04:00,29,29.11,28.7,28.89,2960500,2658769.95,57.11618374339624,57.2120503569191,NaN,NaN,70.08874306512632,73.62268082478036,0.015967001481223153,0.22676743842349723,0.21080043694227407,-42398198,-43320517.6,50.462346358612244,41.36744221083677,NaN,NaN,15.210317976937384,12.48582173988379
2005-08-15T09:30:00-04:00,28.8,28.95,28.63,28.87,1182800,2623449.95,56.68946800220179,57.61520283419178,NaN,NaN,45.45064762378573,72.28307196065636,0.006979363664277954,0.21952464152262152,0.21254527785834357,-43580998,-42524377.8,54.634244638526035,42.04292662763091,NaN,NaN,15.003891357270335,12.84554597093901
2005-08-16T09:30:00-04:00,28.86,28.86,28.31,28.31,4075600,2639399.95,46.266550162600645,56.94962148393352,NaN,NaN,-70.09072966765157,48.07811303713497,-0.03669540984084324,0.1666760155572895,0.20337142539813274,-47656598,-42901478,52.38390405971058,42.804316401940056,NaN,NaN,11.49502117281089,12.652613856920707
2005-08-17T09:30:00-04:00,28.14999,28.41,28.14999,28.28,2108000,2593014.95,45.7809380274532,55.94394163718414,NaN,NaN,-124.6705010428487,6.412670531962803,-0.0659149061124348,0.12097779275758924,0.18689269887002405,-49764598,-44567618,43.79980208492795,42.94205397045447,NaN,NaN,8.541131688639187,12.065259261451919
2005-08-18T09:30:00-04:00,28.2,28.23,28.03,28.03999,2573500,2558919.95,41.984276734142966,54.81420119753812,NaN,NaN,-145.055435766269,-44.85545515757145,-0.09779449455592915,0.06464958067511262,0.16244407523104176,-52338098,-47147698,34.39926726471174,42.614870733250335,NaN,NaN,4.818974417207442,11.030075712274137
2005-08-19T09:30:00-04:00,28.25,28.33,28.05,28.10001,3100600,2611009.95,43.251699104161325,53.960941647121324,NaN,NaN,-108.97138897233157,-80.66748156506303,-0.11030008942338876,0.024568963451805814,0.13486905287519457,-49237498,-48515558,30.644168093209743,42.24761618936355,NaN,NaN,2.1367666156397624,9.759602984183513
2005-08-22T09:30:00-04:00,28.28,28.44,28.02,28.11,1534400,2594004.95,43.473052085051734,52.70856367216437,NaN,NaN,-88.65150444144838,-107.48791197810985,-0.11294827801213962,-0.006316294639979958,0.10663198337215966,-47703098,-49339978,28.61657228662112,41.465038519993705,NaN,NaN,0.004584243623854603,8.366028878389276
2005-08-23T09:30:00-04:00,28.08,28.10001,27.64999,27.64999,3558300,2572369.95,36.427047084752125,50.848426505659575,NaN,NaN,-158.9047175099257,-125.25070954656466,-0.13901608291496842,-0.06713812027155086,0.07187796264341756,-51261398,-50060938,26.937977504558106,40.32272589855035,NaN,NaN,-4.200188221513488,6.570855006974595
2005-08-24T09:30:00-04:00,27.64999,27.72,27.37,27.39,2324400,2568324.95,33.156190540443816,49.176243333476016,NaN,NaN,-208.18671992186927,-141.9539533223688,-0.16531467731225108,-0.1347653839968963,0.030549293315354782,-53585798,-50825178,25.247352171326057,39.11619667889528,NaN,NaN,-8.866075571939035,4.365579209986933
2005-08-25T09:30:00-04:00,27.39999,27.5,27.32001,27.41,982900,2540244.95,33.64974847531367,47.72892663926158,NaN,NaN,-179.0532625380294,-148.75351867672086,-0.17213421703722384,-0.18461847798117503,-0.012484260943951185,-52602898,-50878138,25.129653440198098,38.05521514210029,NaN,NaN,-12.462536168415326,1.961562727358039
2005-08-26T09:30:00-04:00,27.42999,27.44,27.14999,27.27,1058300,2493594.95,31.875491353071908,46.15487729345845,NaN,NaN,-162.31347686339257,-159.42193625493306,-0.17620566863547987,-0.23274134673830105,-0.05653567810282116,-53661198,-51762878,23.185110728604016,36.85286895452332,NaN,NaN,-16.03321641009551,-0.6091200065638964
2005-08-29T09:30:00-04:00,27.03999,27.49001,27.02,27.44,2971200,2509334.95,36.26975293565907,44.692895650706205,NaN,NaN,-133.45194062057612,-168.38202349075863,-0.1581561554696528,-0.2542308724398872,-0.09607471697023437,-50689998,-52360258,21.950055686197175,35.69798722262591,NaN,NaN,-17.821687247414335,-3.068058183828245
2005-08-30T09:30:00-04:00,27.39999,27.39999,27.05,27.17999,3986300,2507259.95,32.78636672161207,42.883355813680836,NaN,NaN,-128.37786662653733,-162.27665331408093,-0.1542695991977792,-0.28891171596745835,-0.13464211676967916,-54676298,-53043238,20.599023303325325,34.448661380240175,NaN,NaN,-20.445628659275815,-5.5505682517493256
2005-08-31T09:30:00-04:00,27.13,27.49001,27.10001,27.44,1340800,2466289.95,39.08657272894981,41.272381264200774,NaN,NaN,-100.42956755783298,-140.72522284127368,-0.1259257764663975,-0.292049337352676,-0.16612356088627853,-53335498,-52993178,20.98292376184169,32.78374295588355,NaN,NaN,-20.78798135295804,-7.727341551921999
2005-09-01T09:30:00-04:00,27.5,27.74001,27.5,27.52,1757100,2428709.95,40.92146968555999,40.11561597435532,NaN,NaN,-64.38532605645898,-117.7916355449596,-0.09493925030479747,-0.28479762376727535,-0.1898583734624779,-51578398,-52788278,22.631811212524156,30.795847588305826,NaN,NaN,-20.519436527057312,-9.554783691227044
2005-09-02T09:30:00-04:00,27.52,27.64999,27.42999,27.5,1379000,2315069.95,40.5922645383151,38.965815726934856,NaN,NaN,-64.01932124220953,-98.13280442072302,-0.07008607436109177,-0.2774659664138426,-0.2073798920527508,-52957398,-52647518,23.808065021824433,28.593977615684285,NaN,NaN,-20.392695307845553,-11.103056779315402
2005-09-06T09:30:00-04:00,27.46001,27.69,27.46001,27.69,1833300,2342549.95,45.10996267414114,38.88320233490203,NaN,NaN,-48.0821067387585,-81.0588376443595,-0.036818558319986344,-0.25340308995273375,-0.2165845316327474,-51124098,-52734338,23.57003917227054,26.53584440943857,NaN,NaN,-18.972886097852275,-12.227318110534956
2005-09-07T09:30:00-04:00,27.74001,27.92,27.67,27.86,3054300,2405734.95,48.85742122009398,39.102951134376376,NaN,NaN,-19.17853268087462,-59.21897085522695,-0.001213471415840911,-0.21810137090254855,-0.21688789948670764,-48069798,-51413038,34.330482960546135,25.859464471982726,NaN,NaN,-16.645692502035985,-12.85851445217796
2005-09-08T09:30:00-04:00,27.94,27.95,27.7,27.71001,1875900,2282670,45.88112960894867,39.38129776829107,NaN,NaN,-17.414930348959953,-42.616043413452346,0.013572033630660868,-0.19992285744838156,-0.21349489107904243,-49945698,-50735078,39.0705159681527,26.19312509365708,NaN,NaN,-15.498868252457623,-13.235707852217912
2005-09-09T09:30:00-04:00,27.75,28.00999,27.75,28,1664200,2266070,51.972815080576474,40.0042346237493,NaN,NaN,11.138106012904254,-27.511356999579714,0.04258070982119905,-0.1602690038025436,-0.20284971362374266,-48281498,-50075698,43.35313833034764,27.100908682024073,NaN,NaN,-12.601949195129365,-13.145170901205262
2005-09-12T09:30:00-04:00,27.96001,28.11,27.94,28.07001,1688500,2202470,53.33837373320223,40.708900455760045,NaN,NaN,43.51792154112513,-6.003908442912737,0.06484785165824919,-0.12178989905093118,-0.18663775070918037,-46592998,-48802818,50.57523458879489,28.669384560750768,NaN,NaN,-9.81292496759248,-12.669135767832007
2005-09-13T09:30:00-04:00,28.06,28.06,27.75999,27.77,1908900,2238775,47.151401466851496,41.47492576876714,NaN,NaN,22.04180316769042,8.020873538377048,0.0579606366608339,-0.11418695488313801,-0.1721475915439719,-48501898,-48278378,53.22146158631685,30.546776280876394,NaN,NaN,-9.197356355232067,-12.17316728031773
2005-09-14T09:30:00-04:00,27.75999,27.98,27.74001,27.87,2047400,2137365,49.263937434142775,42.62547911831707,NaN,NaN,31.822823889812483,18.221144852514467,0.05855667449260413,-0.09895174842821675,-0.15750842292082087,-46454498,-47955318,54.82597492285024,32.65953504884241,NaN,NaN,-8.053437996805632,-11.584634525530287
2005-09-15T09:30:00-04:00,27.37,27.95,27.08,27.78999,1840600,2123995,47.623641563704055,43.623614338916376,NaN,NaN,-23.316925734019225,17.040745775502614,0.05219054476517104,-0.09227024196435707,-0.1444607867295281,-48295098,-47625198,56.46908919571983,34.89806617423682,NaN,NaN,-7.579248202295655,-11.01243647935391
2005-09-16T09:30:00-04:00,27.64999,27.95,27.64999,27.83,2879200,2139280,48.54625343612802,44.81438305913468,NaN,NaN,35.09402882636031,21.831930338193825,0.04933482953389037,-0.08279224981216515,-0.13212707934605553,-45415898,-47052078,59.24089039769337,37.4734790077432,NaN,NaN,-6.928573784235914,-10.429027522908482
2005-09-19T09:30:00-04:00,27.97,27.97,27.57001,27.63,2299500,2099225,44.341502538673446,45.39093660220713,NaN,NaN,19.0055304172987,16.92945211342854,0.033399753863241635,-0.09037738701700349,-0.12377714088024512,-47715398,-47276558,57.69138858102591,40.02643135737382,NaN,NaN,-7.558760902421387,-10.01898943426747
2005-09-20T09:30:00-04:00,27.78999,27.85001,27.21001,27.21001,3232400,2184125,37.07872163058481,45.69753338141947,NaN,NaN,-65.39091772723694,-0.5570920655569352,-0.004013241201742568,-0.12879369238242333,-0.12478045118068076,-50947798,-47765738,54.354934070278226,42.437567840727596,NaN,NaN,-10.468191408052553,-10.083161144808196
2005-09-21T09:30:00-04:00,27.07001,27.17,26.82001,26.89999,4017200,2207070,32.80707346853265,45.248997719961096,NaN,NaN,-182.91472545472644,-43.50460193446472,-0.045899753544781374,-0.18215514311165748,-0.1362553895668761,-54964998,-49467838,44.673764469452024,44.12977074841405,NaN,NaN,-14.429625536384291,-10.704084629319066
2005-09-22T09:30:00-04:00,27,27.08,26.77,27.06,3520700,2266885,36.850790323708125,44.95823490840025,NaN,NaN,-153.52282339365686,-69.54578146639224,-0.058293588312958444,-0.20912237495807418,-0.15082878664511573,-51444298,-50097678,41.71308739652237,45.492719047271066,NaN,NaN,-16.387337799249384,-11.515977939309112
2005-09-23T09:30:00-04:00,26.89,27.17,26.75,27.08,2244300,2329955,37.358235023896945,44.727232800227526,NaN,NaN,-128.79480345442025,-102.32354792254834,-0.06035452707870531,-0.22627194549349738,-0.16591741841479207,-49199998,-50854498,38.41832597003846,46.53630911500064,NaN,NaN,-17.78613121676299,-12.411714121802524
2005-09-26T09:30:00-04:00,27.25,27.33,26.94,27.05,1908100,2372445,36.87951461768825,44.13934365333803,NaN,NaN,-97.30674608312268,-125.58600322263263,-0.05888429201114956,-0.239522783428729,-0.18063849141757946,-51108098,-51533038,35.69600814423606,47.40244975585533,NaN,NaN,-19.0613095773391,-13.36165632973632
2005-09-27T09:30:00-04:00,27.02,27.21001,26.91,27.05,2289600,2338365,36.87951461768825,43.28377889602334,NaN,NaN,-100.44873499369558,-132.59756667592436,-0.053229118619685184,-0.24717488969218593,-0.19394577107250074,-51108098,-51565098,35.56776630775738,47.49082713779898,NaN,NaN,-20.103210750590552,-14.324735532715495
2005-09-28T09:30:00-04:00,27.10001,27.24001,27.00999,27.13,6117000,2444900,39.28567653829566,42.812675105262414,NaN,NaN,-82.70022925717204,-112.55466743641348,-0.040020627462546476,-0.24397155540068383,-0.20395092793813735,-44991098,-49570318,48.0690013711121,48.133576095153224,NaN,NaN,-20.345671145664827,-15.184869191708257
2005-09-29T09:30:00-04:00,27.08,27.31,26.92999,27.28999,2476600,2501690,43.892121654257416,42.2354827176682,NaN,NaN,-67.81837581391996,-95.41377792046609,-0.01757428396031488,-0.22591878288853096,-0.20834449892821608,-42514498,-47784358,56.252902658549246,49.05498783288191,NaN,NaN,-19.283167213006312,-15.77034033760798
2005-09-30T09:30:00-04:00,27.28999,27.58,27.25,27.5,1608400,2494255,49.32692484486159,41.94895065421529,NaN,NaN,-10.232659100110679,-71.70134904960418,0.012717706899885883,-0.1924473653033587,-0.2051650722032446,-40906098,-46125578,62.209735175259425,49.88602358905795,NaN,NaN,-16.752616163305024,-15.9106654555647
2005-10-03T09:30:00-04:00,27.53,27.53999,27.27,27.39,1119800,2481295,46.77141321854988,41.921808636479454,NaN,NaN,-17.87844572224553,-55.81568897742875,0.025887964487740556,-0.1728051165935689,-0.19869308108130945,-42025898,-44309138,67.43837957427623,50.901517731055044,NaN,NaN,-15.313779314227787,-15.825396006802285
2005-10-04T09:30:00-04:00,27.89,27.89,27.09,27.09,1203400,2449800,40.59446581262213,41.302560663513695,NaN,NaN,-24.349332798622427,-40.59580853841412,0.01545188466498662,-0.17937822525007618,-0.1948301099150628,-43229298,-42733378,71.16551420393377,52.06862767970387,NaN,NaN,-15.870525773258937,-15.831843116296092
2005-10-05T09:30:00-04:00,27.00999,27.08,26.47,26.47,4792102,2536690.1,31.37292421642003,40.1417951387077,NaN,NaN,-148.80500717207366,-53.81676412139444,-0.029689983959264477,-0.2319425898641434,-0.20225260590487892,-48021400,-43339438.4,67.94420784267066,52.88827901162893,NaN,NaN,-19.714992947579333,-16.386578806479413
2005-10-06T09:30:00-04:00,26.53,26.66,26.12,26.33,4827500,2684270.1,29.730591021208866,38.79781925192776,NaN,NaN,-177.59944946599484,-75.77297885180943,-0.06351820918316581,-0.2816503673838362,-0.2181321582006704,-52848900,-45406318.8,58.25898773378974,52.81814310706438,NaN,NaN,-23.3304686303292,-17.378563067029383
2005-10-07T09:30:00-04:00,26.42999,26.73,26.42999,26.59,1821700,2692145.1,36.390360552386525,38.22988053862155,NaN,NaN,-123.41218999758475,-98.40888503130424,-0.062810094066487,-0.2966447757837791,-0.23383468171729213,-51027200,-47430539.2,50.6448690533204,52.31482028365684,NaN,NaN,-24.059704344243034,-18.333011820917047
2005-10-10T09:30:00-04:00,26.59,26.7,26.42999,26.45,2222600,2718850.1,34.49460040711389,38.04530045123077,NaN,NaN,-122.69024827546055,-119.37124554194725,-0.06587629908646458,-0.3161800555753729,-0.2503037564889083,-53249800,-49675319.6,43.8072698112399,51.56141569372554,NaN,NaN,-25.273959218907336,-19.32457573491566
2005-10-11T09:30:00-04:00,26.64,26.74001,26.46001,26.48,2018400,2724325.1,35.27274821906211,38.22142007626859,NaN,NaN,-107.73853840195828,-136.0490866626144,-0.0601482910535277,-0.3254891203058179,-0.2653408292522902,-51231400,-51275740,39.69270603594523,51.205625805617906,NaN,NaN,-25.98657738921669,-20.276290256958664
2005-10-12T09:30:00-04:00,26.52,26.61,26.13,26.27,1666500,2705280.1,32.37367167801045,37.90162588729019,NaN,NaN,-135.3272292777804,-133.35353108375574,-0.06438766149159808,-0.3458254061167878,-0.2814377446251897,-52897900,-52251040,37.38808430345602,50.89669701325602,NaN,NaN,-27.50271700576653,-21.308636935359786
2005-10-13T09:30:00-04:00,26.24001,26.34,25.98,26.23,1542000,2690350.1,31.836915869189767,37.507245947668245,NaN,NaN,-143.7465358897331,-126.58294836850341,-0.06365640149766472,-0.3610082464972706,-0.2973518449996059,-54439900,-52569240,36.640606613491514,50.76971705921695,NaN,NaN,-28.88368556824174,-22.39078674005721
2005-10-14T09:30:00-04:00,26.27,26.38,26.06,26.32001,1647900,2628785.1,34.46985825680761,37.33512763617677,NaN,NaN,-115.29428803952368,-124.95936797689119,-0.051405960214982394,-0.36160929526833385,-0.31020333505335146,-52792000,-52922200,35.785957854321495,50.77614203850878,NaN,NaN,-29.268847574589934,-23.37336685927617
2005-10-17T09:30:00-04:00,26.3,26.53,26.3,26.52,1777000,2602660.1,40.014115737444115,37.55902771615934,NaN,NaN,-71.8023397500404,-114.78178627180716,-0.025441876390718432,-0.3420056805417495,-0.3165638041510311,-51015000,-52475240,37.7655853241089,50.93312911110531,NaN,NaN,-27.95387183839369,-24.027724713435816
2005-10-18T09:30:00-04:00,26.5,26.55,26.21001,26.24001,1067400,2494410.1,35.48728753701741,37.28771421606804,NaN,NaN,-83.70372223068013,-109.97482303755153,-0.022816642373023943,-0.34508460711731104,-0.3222679647442871,-52082400,-52645440,37.29409893268983,50.16349322264658,NaN,NaN,-28.17419276396643,-24.620077292083046
2005-10-19T09:30:00-04:00,26.08,26.49001,25.92999,26.46001,2393200,2413210.1,41.12350309465932,37.08995574752532,NaN,NaN,-81.94290690760157,-99.29795856351578,-0.0029971688951356823,-0.3260144258632067,-0.32301725696807104,-49689200,-52003700,40.31954426813586,49.025396194759914,NaN,NaN,-26.58528934092762,-24.900821870489413
2005-10-20T09:30:00-04:00,26.49001,26.81,26.17999,26.28,5773699,2525860.05,38.183947044515676,36.29402876178632,NaN,NaN,-54.19367267998808,-81.38738592156676,0.0010394786692580205,-0.3217179086314985,-0.32275738730075654,-55462899,-52208299.8,39.66250427146656,47.41487970163185,NaN,NaN,-26.160557130028185,-25.080784050423524
2005-10-21T09:30:00-04:00,26.25,26.66,26.2,26.52,2150800,2521185.05,43.93782779625178,36.09162980305075,NaN,NaN,-43.943716961270646,-67.11727170591615,0.021773836777565614,-0.29554009132879955,-0.31731392810636516,-53312099,-52312319.6,39.31175712864418,45.40583524122957,NaN,NaN,-23.954635426577997,-24.91990567558845
2005-10-24T09:30:00-04:00,26.67,27.13,26.56,27.13,2823400,2566950.05,55.32106268112646,37.14352957937249,NaN,NaN,44.70652640046468,-43.81549847581515,0.07544997568656953,-0.22300145849815323,-0.29845143418472275,-50488699,-52207059.4,39.891033918466675,43.17194379226763,NaN,NaN,-17.741746920958505,-23.89445442492703
2005-10-25T09:30:00-04:00,27.13,27.38,26.96001,27.11,2686600,2586800.05,54.92726910492158,38.82598278569402,NaN,NaN,81.17487234489147,-10.839779560700828,0.10658249875420356,-0.16522331074196828,-0.27180580949617184,-53175299,-52425639.2,39.05732475689086,41.108595000426206,NaN,NaN,-13.144860079117842,-22.358798089811433
2005-10-26T09:30:00-04:00,27.05,27.67999,27.05,27.33,5978199,2579860,58.43244608356252,40.87611529014786,NaN,NaN,111.49796849063505,27.848395518946496,0.13702641809377658,-0.10052278687895111,-0.2375492049727277,-47197100,-51927219.2,42.032378934411575,39.949551514756344,NaN,NaN,-8.157382864753314,-20.3300244862317
2005-10-27T09:30:00-04:00,27.32001,27.5,26.7,27.05,2795700,2595815,52.804065297263776,42.0485227719248,NaN,NaN,66.32446399208978,51.95202285336207,0.13322167056583786,-0.07102211676543035,-0.20424378733126822,-49992800,-50833199.4,48.02952287454835,39.762741073415484,NaN,NaN,-5.800241014386602,-18.254341133110973
2005-10-28T09:30:00-04:00,27.14999,27.55,27.09,27.48,1833100,2607050,59.289395117668334,43.819579536964405,NaN,NaN,119.72716050965356,84.6861983475469,0.15315687548008697,-0.012797692981159514,-0.16595456846124648,-48159700,-49802719.6,52.96551411624326,40.41690138091572,NaN,NaN,-1.466809260789386,-15.85612229420789
2005-10-31T09:30:00-05:00,27.7,29.42,27.53999,27.56,2604600,2681290,60.38019730283607,45.61296875723398,NaN,NaN,225.65977369927285,120.87684780730856,0.16424152844697437,0.03934734209747148,-0.12489418634950289,-45555100,-48815999.8,57.16112125013413,41.664645324786356,NaN,NaN,2.2779313897361324,-13.2655431965016
2005-11-01T09:30:00-05:00,27.7,27.77,27.5,27.64999,2162600,2729250,61.62576440676639,47.70240395214512,NaN,NaN,133.4137146590823,131.32461627014672,0.16946094988745602,0.08693200100981713,-0.08252894887763888,-43392500,-46859440,64.01562932199491,43.56661282611056,NaN,NaN,5.670836086545852,-10.56034615606625
2005-11-02T09:30:00-05:00,27.66,28.06,27.59,27.9799,1625400,2570914.9,65.86285655987825,50.13282828719429,NaN,NaN,139.88027509426044,137.0010775908718,0.18565544525892597,0.1495403576960186,-0.036115087562907384,-41767100,-45773440,67.15688918414645,45.74634729544305,NaN,NaN,10.005839893410418,-7.622319577569584
2005-11-03T09:30:00-05:00,28.08,28.19,27.8,27.89,5225801,2590829.95,63.79572256972438,52.22753288097406,NaN,NaN,129.45104234598222,149.6263932616503,0.18066552237903766,0.1897168154108897,0.00905129303185203,-46992901,-45173460.2,68.77845943747923,48.10295455138289,NaN,NaN,12.855376531939614,-4.6969344190682705
2005-11-04T09:30:00-05:00,27.91,27.98,27.62,27.85001,1864200,2592954.95,62.85075916708499,53.85872169737697,NaN,NaN,98.6697785846682,145.4149168766532,0.16543256288316321,0.21584199663580605,0.050409433752642833,-48857101,-45312940.4,67.93867242224515,50.25817505839262,NaN,NaN,14.874258475452566,-1.9010497198510086
2005-11-07T09:30:00-05:00,27.88,28.05,27.10001,28,2274500,2595549.95,64.94792486980754,55.96305293543342,NaN,NaN,78.123753668156,115.90771287042985,0.15632502888273478,0.24581571985606132,0.08949069097332654,-46582601,-45518440.6,66.64749794657733,52.35484641652744,NaN,NaN,17.199503946742023,0.8276008039479961
2005-11-08T09:30:00-05:00,27.95,28,27.78,27.86,1657100,2577484.95,61.460314231153255,57.415682302325834,NaN,NaN,87.02278102038291,106.62952614268995,0.13267144420281737,0.25532999622684827,0.12265855202403089,-48239701,-46487880.8,60.779148751925305,53.816246736798114,NaN,NaN,18.16097150211232,3.303796617971471
2005-11-09T09:30:00-05:00,27.8,28.09,27.8,27.83,2059100,2597114.95,60.70802179045215,59.024544784178445,NaN,NaN,81.73035347864692,94.99954181956724,0.10785819471737204,0.25748129542074594,0.1496231007033739,-50298801,-48194221,52.08590950919244,54.703632825207094,NaN,NaN,18.742258118307912,5.509291118019534
2005-11-10T09:30:00-05:00,27.85001,28.28,27.73,28.22,2678400,2653934.95,66.45622252179083,60.63300155028838,NaN,NaN,91.95452327390464,87.50023800515172,0.11017642949843404,0.28734363757641646,0.17716720807798242,-47620401,-48319721,51.50244073813444,55.57439594017069,NaN,NaN,21.01017698945326,7.723703385367209
2005-11-11T09:30:00-05:00,28.28,28.62,28.2,28.61,1224700,2632774.95,71.02169467734612,61.75447526430407,NaN,NaN,126.51776391041047,93.06983507030017,0.12912751292638788,0.3385765992359673,0.2094490863095794,-46395701,-47827441,53.69368472831682,56.5602995694457,NaN,NaN,24.52678116957025,10.124143068824786
2005-11-14T09:30:00-05:00,28.91,29.24001,28.78999,28.89,6159199,2851884.9,73.78081721610702,63.101157272245885,NaN,NaN,162.91952106260473,110.0289885491899,0.15019604580420765,0.39719414356483895,0.2469980977606313,-40236502,-46558221.2,58.85538928763073,57.97444703592712,NaN,NaN,28.42762566490765,12.738926296836624
2005-11-15T09:30:00-05:00,28.89999,29.06,28.77,28.814,1503200,2873674.9,71.78298163833291,64.05476695472949,NaN,NaN,142.08996686152585,121.0424257174185,0.14842589217881813,0.432530462984154,0.28410457080533585,-41739702,-45258221.4,63.360390254325566,59.49787641592098,NaN,NaN,30.929461490375854,15.337574181627943
2005-11-16T09:30:00-05:00,28.81,28.96001,28.72,28.86,2005200,2854274.9,72.27237478081861,65.44536048926912,NaN,NaN,130.1926209013305,130.7348792019552,0.13988114904419197,0.4589560071105758,0.31907485806638386,-39734502,-43145361.6,69.25287563138833,61.01383018426669,NaN,NaN,33.09453987680665,17.87428356665347
2005-11-17T09:30:00-05:00,28.92999,29.25999,28.92,29.22,1956400,2663409.95,75.80858008542769,66.6253022726805,NaN,NaN,152.45363480272843,142.83470150771998,0.14725808301044974,0.503147461829446,0.3558893788189963,-37778102,-41176901.8,73.52483321662527,62.48235297715111,NaN,NaN,36.15165011451238,20.485335930633315
2005-11-18T09:30:00-05:00,29.27,29.46001,29.14999,29.3,2182500,2664994.95,76.52505589600318,67.77850645790673,NaN,NaN,150.7371069569023,147.67857011701835,0.1460231278337124,0.5384182886111368,0.3923951607774244,-35595602,-39016882,77.25866131221014,63.91789155301369,NaN,NaN,38.85446495275058,23.10949721950721
2005-11-21T09:30:00-05:00,29.39,29.55,28.46001,29.49001,2475500,2647599.95,78.17816881015501,68.96082105814877,NaN,NaN,117.27922684753851,138.55051127400512,0.1461429107239961,0.5750737991824195,0.4289308884584234,-33120102,-37593602,79.32749689972316,65.01159637999429,NaN,NaN,41.65754422131876,25.759218219766005
2005-11-22T09:30:00-05:00,29.32001,29.64,29.32001,29.58,2062800,2616409.95,78.93476935149731,69.89452911469299,NaN,NaN,134.28941423149396,136.99040074799876,0.14038940598175398,0.6044176459356159,0.4640282399538619,-31057302,-35457122,81.97788182905686,66.0702387117736,NaN,NaN,44.19768490231203,28.39328488870115
2005-11-23T09:30:00-05:00,29.5,29.67,29.47,29.53,985200,2366760,77.33046589767983,70.86129649526124,NaN,NaN,121.16368487625486,135.18461354298364,0.12200243594981836,0.6165312848911348,0.4945288489413165,-32042502,-33918722,83.60760356932335,67.1294632926196,NaN,NaN,45.841996868756425,30.885958028709044
2005-11-25T09:30:00-05:00,29.48,29.71001,29.48,29.7,194000,2236675,78.90065092542707,72.00771733514281,NaN,NaN,115.53135269823655,127.80015712208524,0.11042274778709615,0.6325572836751867,0.5221345358880906,-31848502,-32732802,84.75228146867137,68.33043536736433,NaN,NaN,47.715086137295124,33.29011918707848
2005-11-28T09:30:00-05:00,29.78,29.78,29.59,29.62,1967400,2243390,76.22498829868357,72.81322186577681,NaN,NaN,106.8888700670747,119.03050974411971,0.087510666676208,0.6315228692333505,0.5440122025571426,-33815902,-32376862,85.08883830398514,69.64767396432204,NaN,NaN,48.544631353884576,35.46933521090792
2005-11-29T09:30:00-05:00,29.67999,30.03,29.63,29.89,2306700,2228495,78.83385020974161,74.05418872139026,NaN,NaN,111.90095266751895,117.95485490811582,0.08083347818782904,0.6450540502919289,0.5642205721040998,-31509202,-32054682,85.40290822964658,71.4065139270164,NaN,NaN,50.04610564957807,37.5517309878608
2005-11-30T09:30:00-05:00,29.7,29.99001,29.62,29.67,1566400,2198685,71.90977345572995,74.85431384033869,NaN,NaN,95.79375100678364,110.25572226317374,0.05322714400881945,0.6307545021151242,0.5775273581063047,-33075602,-32458342,83.04286996713515,73.61772538829803,NaN,NaN,49.27344123533698,39.22626102321454
2005-12-01T09:30:00-05:00,29.75999,30.25,29.75999,30.25,2832100,2259020,77.51643464818956,75.64432899222432,NaN,NaN,118.36692207870408,109.69636970366359,0.06488281205701063,0.6586308731775681,0.5937480611205574,-30243502,-32098542,83.48105625669379,75.90191221105228,NaN,NaN,50.3986237145979,40.822312836269305
2005-12-02T09:30:00-05:00,30.21001,30.23,30.07001,30.12,881800,2041819.95,73.95350008431822,75.85374366415088,NaN,NaN,113.32104351757704,109.25430786753168,0.05507771072700207,0.66259519952931,0.6075174888023079,-31125302,-31953902,83.663811192845,78.04263552994713,NaN,NaN,50.126796072444144,42.151524727151426
2005-12-05T09:30:00-05:00,30.19,30.2,30.02,30.2,4327398,2164979.85,74.72345119758148,75.92107466282764,NaN,NaN,105.93390884794388,109.0633156237055,0.04561159068670162,0.664531977160685,0.6189203864739834,-26797904,-30550302.4,85.35682884546489,79.93559549836387,NaN,NaN,50.14569755630799,43.29354941703093
2005-12-06T09:30:00-05:00,30.33,30.61,30.23,30.42,2026400,2152574.85,76.758157414674,76.2764443611377,NaN,NaN,125.84794207882258,111.85271350596625,0.045684682099182305,0.6760262390979612,0.6303415569987789,-24771504,-29202762.8,86.77399982548184,81.6079961820179,NaN,NaN,50.792194504094034,44.364784429468514
2005-12-07T09:30:00-05:00,30.49001,30.57001,30.22,30.34,2422900,2190864.85,74.41240974129208,76.42930400117154,NaN,NaN,113.00445959404924,115.29485522341938,0.03248351109555203,0.670945945868219,0.638462434772667,-27194404,-28026523.2,87.87690823407785,82.93828422506714,NaN,NaN,50.606263933716654,45.25642435864682
2005-12-08T09:30:00-05:00,30.25,30.52,30.17,30.28999,1613900,2168604.85,72.91234714137934,76.2224302194538,NaN,NaN,102.47869348897683,112.11720950547392,0.013494172017973538,0.6553301497951338,0.6418359777771603,-28808304,-27739483.6,88.13688841527582,83.98200245354217,NaN,NaN,50.017388917175644,45.93656215272237
2005-12-09T09:30:00-05:00,30.39999,30.39999,30.14,30.21001,1161900,2092779.85,70.46581066274001,75.78962698850641,NaN,NaN,87.36550195671217,106.92610119330095,-0.010070997472295451,0.6292472309367909,0.6393182284090864,-29970204,-27508464,88.35336895495077,84.7744815708808,NaN,NaN,48.82844825621842,46.34968873893609
2005-12-12T09:30:00-05:00,30.23,30.39999,30.08,30.21001,2054900,2134289.85,70.46581066274001,75.23874426369106,NaN,NaN,77.43862170202844,101.22704376411787,-0.030141793099867975,0.6016409870342514,0.6317827801341194,-29970204,-28142924,83.82903339908727,85.09601989226394,NaN,NaN,47.85135258236339,46.56421214513999
2005-12-13T09:30:00-05:00,30.16,30.58051,30.11,30.48,1416900,1897174.9,73.89512908506583,74.87876995894597,NaN,NaN,92.4262094447997,94.54269723731329,-0.02967140831769588,0.5946935197369996,0.6243649280546955,-28553304,-28899284,78.65793028291297,84.8588804961108,NaN,NaN,47.914861516908324,46.75716205539261
2005-12-14T09:30:00-05:00,30.41,30.5,30.28,30.31,1373600,1890694.9,68.50164174348771,74.24813966221794,NaN,NaN,81.28213963383766,88.19823324527097,-0.04436237471271287,0.5689119596638044,0.6132743343765172,-29926904,-29445784,75.05532607369906,84.24800353213764,NaN,NaN,46.40393486820748,46.70670102865188
2005-12-15T09:30:00-05:00,30.39999,30.46001,30.13,30.14999,1266900,1853779.9,63.78275035854011,73.16828962172602,NaN,NaN,56.47653116848098,78.99780078117179,-0.06704740828022082,0.5294650740262412,0.596512482306462,-31193804,-29922884,71.95683654244115,83.33404318026405,NaN,NaN,43.71293897791966,46.27902073569013
2005-12-16T09:30:00-05:00,29.89999,30.10001,29.77,29.8,2014000,1856659.9,54.877846135537126,71.64349375292984,NaN,NaN,-14.945348168962546,58.53563075603686,-0.10552504650209182,0.4646061741788472,0.570131220680939,-33207804,-30570404,67.86211510291807,82.1035629516164,NaN,NaN,38.42233331577337,45.156636818559164
2005-12-19T09:30:00-05:00,29.8,29.98,29.64,29.66,1066300,1800849.9,51.76458310616839,69.70997467410318,NaN,NaN,-49.001651748910454,33.24757606584908,-0.13824253783927865,0.39732804838184066,0.5355705862211193,-34274104,-31431184,62.750118955922666,80.48550657492183,NaN,NaN,33.037820265723056,43.42537731101115
2005-12-20T09:30:00-05:00,29.63,29.87,29.53,29.55,1298700,1742009.9,49.39354628924726,68.10167273364013,NaN,NaN,-85.13063431391902,-2.263792685894674,-0.16340496312088798,0.3313143823200093,0.4947193454408973,-35572804,-32835084,55.4178037499027,78.51228755940522,NaN,NaN,27.842451438510768,41.19924504351109
2005-12-21T09:30:00-05:00,29.7,30.13,29.7,30.12,1492800,1713509.9,59.6956204296405,66.8287574323152,NaN,NaN,-13.537020985533275,-21.227624809768866,-0.1387445190922294,0.32128869657561054,0.46003321566783995,-34080004,-33665704,51.5777289674464,76.23347846731613,NaN,NaN,26.331166175195804,39.075233776608904
2005-12-22T09:30:00-05:00,30.2,30.44,30.17999,30.42999,1538300,1741164.9,63.98910753314379,66.11701510723131,NaN,NaN,75.78493059451816,-17.365944924561433,-0.10042581097979575,0.33450095194309526,0.434926762922891,-32541704,-33935284,50.35809466668692,73.8544987154477,NaN,NaN,26.558830970425674,37.28717623286844
2005-12-23T09:30:00-05:00,30.42,30.55,30.38,30.52,1667900,1814859.9,65.14999087589614,65.43319651282522,NaN,NaN,105.85759639133661,6.794643987498398,-0.06936481649144566,0.3482207423085839,0.41758555880002957,-30873804,-33468484,52.454636109384644,71.50434209144197,NaN,NaN,27.12339929312972,35.83520809862005
2005-12-27T09:30:00-05:00,30.66,30.75999,30.28999,30.33,2803200,1856649.9,60.701605584824385,64.28629995355024,NaN,NaN,93.23227240547594,35.241428818375674,-0.06219257255207422,0.3398448431099368,0.402037415662011,-33677004,-33349064,53.00148837665929,69.0920198450975,NaN,NaN,26.145486509719323,34.45096215734852
2005-12-28T09:30:00-05:00,30.38,30.61,30.38,30.59,816600,1782144.9,64.29437320897462,63.563583058384715,NaN,NaN,105.17506371357761,73.302568423875,-0.04150961736260933,0.35015039395874936,0.3916600113213587,-32860404,-32806584,55.505080708301975,66.77974645039923,NaN,NaN,26.499603737202392,33.31505381161336
2005-12-29T09:30:00-05:00,30.52,30.72,30.45,30.53999,923000,1749974.9,63.09942815835627,62.862660273883066,NaN,NaN,113.8948179460178,98.78893621018521,-0.0331321499411692,0.3502448238948972,0.3833769738360664,-33783404,-32747264,55.78246136138573,64.46871594654992,NaN,NaN,26.41075999382342,32.328726123357654
2005-12-30T09:30:00-05:00,30.42,30.42,30.25,30.28,718200,1644279.9,57.15247542955594,61.911707757227056,NaN,NaN,25.44539551708324,88.72102919469823,-0.04623160271792576,0.3255874704386592,0.37181907315658497,-34501604,-33139244,53.41294497465843,61.97297137652905,NaN,NaN,24.455125708335096,31.203926064068717
2006-01-03T09:30:00-05:00,30.11,31.00999,30.11,30.92,5604602,1880420,65.71783054893504,61.57256632052671,NaN,NaN,135.39879379367787,94.62926867516649,-0.014565047603899317,0.3536127636517108,0.3681778112556101,-28897002,-32743883.6,55.467659569753415,59.947158960148066,NaN,NaN,25.654491359258873,30.41114967766731
2006-01-04T09:30:00-05:00,30.81,31.11,30.81,31.11,3107500,1819425.1,67.7772310078235,61.135573600723674,NaN,NaN,211.89483627149795,118.3617814483709,0.014815208820541659,0.3866968222812872,0.37188161346074555,-25789502,-31166383.2,62.562657248737246,58.79749660056409,NaN,NaN,27.32480150787886,29.97024279626896
2006-01-05T09:30:00-05:00,31.12,31.12,30.88,31.06,1685500,1802380.1,66.64267480499987,61.002790247974545,NaN,NaN,184.33183452350843,134.19313561035705,0.025872289755027034,0.40422197565452933,0.3783496858995023,-27475002,-30089302.8,66.48850836017718,58.18558104959827,NaN,NaN,28.261597026272128,29.72615054341227
2006-01-06T09:30:00-05:00,31.28,31.50999,31.2,31.39,835300,1723000.1,70.1895020938562,61.4604153719257,NaN,NaN,218.6057146212368,155.13531494540086,0.04905687288669636,0.4396707770078727,0.39061390412117636,-26639702,-28660562.4,70.85456387420741,58.106847287581566,NaN,NaN,30.245741436138836,29.80037781380178
2006-01-09T09:30:00-05:00,31.41,31.49001,31.3101,31.38,883800,1686495.1,69.94679226246718,62.53676866670641,NaN,NaN,180.93452564404112,186.23314097079242,0.056817549053830796,0.46163584043846484,0.40481829138463404,-27523502,-27264942,74.36760581295428,58.57152519544129,NaN,NaN,31.723684645203456,30.07513593257345
2006-01-10T09:30:00-05:00,31.17,31.25,30.67,31.17999,2888400,1772820.1,65.09814891753089,63.489166224660885,NaN,NaN,98.30426508921794,178.81423522990045,0.04224849868844438,0.4576289147451895,0.41538041605674514,-30411902,-27567922,72.32935007129888,59.25575598939674,NaN,NaN,31.491000386952887,30.277402283199084
2006-01-11T09:30:00-05:00,31,31.16,30.92,30.94,2789900,1809570.1,59.74646142984657,64.22866016327511,NaN,NaN,82.72474741457421,152.9802174585157,0.011799618951593704,0.43012993974623726,0.41833032079464355,-33201802,-29050382,63.201730147158344,59.81175073205787,NaN,NaN,29.631854724772484,30.185181203423856
2006-01-12T09:30:00-05:00,30.92999,30.92999,30.50999,30.50999,2036800,1840565.1,51.566360231069595,63.64799872052005,NaN,NaN,19.202587875072584,119.95436812882852,-0.039159775798718655,0.36938060104624526,0.4085403768449639,-35238602,-30603102,55.32637659371676,60.07951127679146,NaN,NaN,25.262154211361125,29.48189163312918
2006-01-13T09:30:00-05:00,30.21001,30.71001,30.21001,30.58,1273900,1835580.1,52.70178265274605,62.84176122906307,NaN,NaN,-7.809933043256912,74.67123859592976,-0.06830402701318078,0.32316034307848795,0.39146437009166873,-33964702,-32068102,49.10869285133485,59.9902682899806,NaN,NaN,22.133874019202025,28.432174831139587
2006-01-17T09:30:00-05:00,30.39999,30.71001,30.3513,30.61,1233300,1833900.1,53.20798939587981,61.988761123347615,NaN,NaN,-0.5881021397811782,38.36671303916531,-0.08464484511697512,0.2856583136954498,0.3703031588124249,-32731402,-33109682,45.21783095208086,59.47335363588747,NaN,NaN,19.771756928895794,27.19497227367619
2006-01-18T09:30:00-05:00,30.5,30.56,30.21001,30.31,1807600,1823580.1,47.70916725167969,61.06072981383728,NaN,NaN,-42.77086867680553,10.151686285960636,-0.11297101303971901,0.22908939251277616,0.3420604055524952,-34539002,-33935102,42.353990522117755,58.712818074848784,NaN,NaN,15.996474698469548,25.595186905789525
2006-01-19T09:30:00-05:00,30.45,30.78,30.41,30.63,2888000,1914665.1,53.25813577397986,60.272427139909084,NaN,NaN,-4.131048916251301,-7.219472980204477,-0.10750002614752568,0.20768537286808808,0.31518539901561377,-31651002,-33624942,43.79449116874503,57.876347393451866,NaN,NaN,14.43044927561528,24.000224387193203
2006-01-20T09:30:00-05:00,30.60001,30.75,30.09,30.11,3347900,2017125.1,44.91683310467578,58.97367035036048,NaN,NaN,-78.99799130832538,-26.859588816884063,-0.13449425885252053,0.14706757544996307,0.2815618343024836,-34998902,-33577002,44.02730957734324,57.03669369459169,NaN,NaN,10.168258669218893,22.024229284625445
2006-01-23T09:30:00-05:00,30.10001,30.61,30.10001,30.52,1729000,2028935.1,51.382400299404175,58.56152212677821,NaN,NaN,-65.7833299027184,-38.45426818877637,-0.12076501298921627,0.13060556806596324,0.2513705810551795,-33269902,-33438042,44.74182471037501,56.41732796142859,NaN,NaN,8.789345365698873,20.13353158192165
2006-01-24T09:30:00-05:00,30.50999,30.89999,30.50999,30.86,3577500,2130895.1,55.9952281362206,57.86705052587003,NaN,NaN,13.807133848311041,-35.57522099115792,-0.08642277803322918,0.14334210851364304,0.22976488654687222,-29692402,-32830242,47.87603591852733,55.87506912919815,NaN,NaN,9.265120630978323,18.580901446072602
2006-01-25T09:30:00-05:00,31.14999,31.25999,30.91,31.00999,1871600,2141080.1,57.89321786173312,57.16104958686357,NaN,NaN,78.38243630257725,-11.344559995281362,-0.05289001686747774,0.16365236546252504,0.21654238233000278,-27820802,-31486602,54.07712160959134,55.26895944068773,NaN,NaN,10.279170739745675,17.394939916597327
2006-01-26T09:30:00-05:00,31.60001,31.60001,31.06,31.38,2344600,2118150.1,62.22202822779346,56.845289117063125,NaN,NaN,125.43131713031158,14.567913214031217,-0.007460751501749019,0.2072164429528165,0.2146771944545655,-25476202,-30251642,58.915132452916346,54.72800401874053,NaN,NaN,12.616022848064953,16.712237478235558
2006-01-27T09:30:00-05:00,31.49001,31.66,31.33,31.60001,2080100,2181325.1,64.55538129993278,56.44285191749715,NaN,NaN,140.56233561485925,58.47997859866814,0.03348789005334596,0.25653705702124796,0.223049166967902,-23396102,-27931082,66.13478322147253,54.39087682925946,NaN,NaN,15.295671443450143,16.50987090183764
2006-01-30T09:30:00-05:00,31.57001,31.75011,31.5302,31.69,4935898,2381970,65.49417622995017,56.124807915174515,NaN,NaN,142.6758817760152,100.17182093441485,0.061107669628391814,0.2994337540033918,0.23832608437499997,-18460204,-24969142.4,72.72338002988619,54.27343213046888,NaN,NaN,17.728280995931183,16.683929486708145
2006-01-31T09:30:00-05:00,31.73,31.92999,31.55,31.74001,2249300,2458525,66.0326070708665,56.19155492612706,NaN,NaN,141.83292344700914,125.77697885415448,0.07623459531314453,0.3336193285164306,0.2573847332032861,-16210904,-22272842.8,77.09249517863333,54.61365678099277,NaN,NaN,19.845311193287625,17.135555444790928
2006-02-01T09:30:00-05:00,31.85001,31.89,31.60001,31.83,1606000,2258594.9,67.02958160916765,56.71177779607856,NaN,NaN,132.05328507332428,136.5111486083039,0.08511593990184463,0.3637796580805919,0.27866371817874724,-14604904,-19629663.2,80.40588021354942,55.84252464287785,NaN,NaN,21.886116048256962,17.81420695957179
2006-02-02T09:30:00-05:00,31.8,32,31.33,31.36,3592500,2282844.9,57.53187650541106,57.137886101388666,NaN,NaN,85.50572061559885,128.52602930536133,0.05368585049200847,0.34577103129375786,0.2920851808017494,-18197404,-18173903.6,81.95405969892703,57.74450200753573,NaN,NaN,20.832168341591224,18.24534429986028
2006-02-03T09:30:00-05:00,31.32001,31.38,31.03,31.08,2796100,2338374.9,52.73765754725571,57.14044859385364,NaN,NaN,19.66004118972957,104.34557042033539,0.0106399476493233,0.3053851153634035,0.2947451677140802,-20993504,-17693384,82.44706481528002,60.12581429067466,NaN,NaN,18.425468168112012,18.2710762810391
2006-02-06T09:30:00-05:00,31.31,31.67,31.27,31.64,2903700,2441794.9,59.929620758559075,57.620565119759306,NaN,NaN,74.66366228086045,90.74312652130445,0.016152602353531276,0.3149359206559943,0.298783318302463,-18089804,-17619304,82.52632057330777,62.79070640647659,NaN,NaN,18.655328101890486,18.325969398303585
2006-02-07T09:30:00-05:00,31.46001,31.57001,30.5,30.81,6102898,2702749.8,48.21801833123966,57.65691162544216,NaN,NaN,-10.618243379414372,60.25289315601975,-0.03693153003093613,0.25261890576379287,0.289550435794729,-24192702,-19215663.6,74.69904600752555,65.10106751257715,NaN,NaN,14.494316011930936,17.778590343107492
2006-02-08T09:30:00-05:00,30.8,30.92,30.57001,30.86,2417400,2679199.8,48.866292430340614,57.34320852946792,NaN,NaN,-36.16848415301229,26.60853931075244,-0.06771651683024127,0.20490478975692739,0.27262130658716865,-21775302,-20649743.2,68.42086465114659,66.86009418989156,NaN,NaN,11.586047566865258,16.893941375072888
2006-02-09T09:30:00-05:00,30.98,31.38,30.89,30.96001,2118900,2645649.8,50.20902264345353,57.721222067952056,NaN,NaN,9.341894382749283,11.375774064182526,-0.07956517029818688,0.17316484371443508,0.25273001401262196,-19656402,-20941542.8,67.18355640053576,68.5141118201196,NaN,NaN,9.736021622593293,15.871381410432946
2006-02-10T09:30:00-05:00,30.92,31.06,30.46001,30.89999,2910800,2689349.8,49.37112352136133,57.57755944094898,NaN,NaN,-34.69162233312072,0.5054413596124704,-0.08895516652126939,0.14153605586103524,0.23049122238230463,-22567202,-21256282.4,65.80134178771743,70.01836303992977,NaN,NaN,8.007451976746218,14.747962919906271
2006-02-13T09:30:00-05:00,30.75,30.99001,30.53,30.59,4411898,2846249.7,45.177684674563814,56.80487776511636,NaN,NaN,-54.062478724149535,-25.239786841389524,-0.11206163950334891,0.09041417300311849,0.2024758125064674,-26979100,-23034141.6,58.48209979755113,70.77593903128862,NaN,NaN,5.220709765339955,13.386926754968226
2006-02-14T09:30:00-05:00,30.63,31.45,30.63,31.41,3357400,2952454.7,55.85831854212976,56.65952781371612,NaN,NaN,16.829701867472778,-19.750197792012095,-0.07018532180881057,0.1147441602454542,0.18492948205426477,-23621700,-22919941.2,58.7991242410953,71.11322493353889,NaN,NaN,6.294148294883209,12.373672689241795
2006-02-15T09:30:00-05:00,31.45,31.94,31,31.27,2673800,2995764.7,53.92660982479063,56.06699792778734,NaN,NaN,51.62272703821604,-2.191955553766431,-0.05087926633443046,0.12133039913622667,0.17220966547065714,-26295500,-23823980.8,55.205410155055894,70.84824476940601,NaN,NaN,6.502962251060898,11.534999769501667
2006-02-16T09:30:00-05:00,31.2,31.67999,31.2,31.67999,2644700,2983599.7,58.457432141909834,55.63143013078571,NaN,NaN,66.22451484754808,9.184568539193329,-0.011516828227849135,0.1578136301858457,0.16933045841369485,-23650800,-24622860.4,52.17095970532233,69.8508288039667,NaN,NaN,8.201570012296177,11.05879551847231
2006-02-17T09:30:00-05:00,31.74001,31.77991,31.56,31.64999,1801500,2906279.7,58.007914452254255,55.09669714666457,NaN,NaN,84.3973494098478,33.00236288778704,0.010300233185022128,0.1822057498949725,0.17190551670995038,-25452300,-25199880,50.031822459348476,68.23000326321402,NaN,NaN,9.388511524441775,10.820183519325091
2006-02-21T09:30:00-05:00,31.85001,31.89999,31.53,31.66,2180900,2928874.7,58.12362518325648,54.53176986897814,NaN,NaN,84.30981187669418,60.67682100795578,0.022506374400846407,0.20003848471100838,0.17753211031016197,-23271400,-24458340,52.715073127146894,66.48875883096498,NaN,NaN,10.368295214154022,10.755628047157796
2006-02-22T09:30:00-05:00,31.77,31.98,31.67999,31.78999,1952900,2847644.7,59.67749367714751,54.0066207309767,NaN,NaN,101.9868531602346,77.70825126650814,0.03565425766441749,0.22209993239068382,0.18644567472626633,-21318500,-23997700,54.35481124225368,64.62796819015814,NaN,NaN,11.634471275210474,10.88117707973675
2006-02-23T09:30:00-05:00,31.8,31.94,31.57001,31.63,2486400,2878384.7,56.87998013948574,53.96005670483918,NaN,NaN,73.04181912075306,81.99206968301556,0.03011606341323908,0.2240907539928152,0.19397469057957611,-23804900,-23499580,56.126592687922724,62.78314911794356,NaN,NaN,11.923809012581565,11.03012449871458
2006-02-24T09:30:00-05:00,31.75999,31.82001,31.53,31.72,1948500,2858579.7,58.070710638421886,54.340989068493904,NaN,NaN,62.3829295460209,81.22375262271011,0.02904125625677839,0.2302762609005491,0.2012350046437707,-21856400,-23140700,57.40930662248985,60.994737818458546,NaN,NaN,12.494615739942844,11.23933753317576
2006-02-27T09:30:00-05:00,31.60001,31.78999,31.46001,31.46001,1971300,2853139.7,53.476642075280076,53.88006201968826,NaN,NaN,36.2011862428491,71.58451998931037,0.008418621771292267,0.21175828185788603,0.20333966008659377,-23827700,-22815780,58.58975796170991,59.28498334620155,NaN,NaN,11.709838310958537,11.306551930001872
2006-02-28T09:30:00-05:00,31.42999,31.45,31.06,31.06,5528699,2882779.75,47.279239581741464,53.8130063947241,NaN,NaN,-39.242587320392545,46.87404014989303,-0.03233007663234472,0.16292706429616288,0.1952571409285076,-29356399,-24032779.8,52.69822743992707,57.7134963056588,NaN,NaN,9.151631784383127,10.99870619491348
2006-03-01T09:30:00-05:00,31.03,31.59,31.03,31.53999,1064700,2823549.75,54.14623281390927,54.19014499355044,NaN,NaN,6.214671313958627,27.71960378063784,-0.02732405694498241,0.16110206974727959,0.188426126692262,-28291699,-25427419.6,46.88048184270935,56.174897533627565,NaN,NaN,8.99397721569111,10.712316340738855
2006-03-02T09:30:00-05:00,31.45,31.77,31.27,31.73,2889500,2887724.75,56.558464790676645,54.64367657549495,NaN,NaN,54.42565238387086,23.996370433261404,-0.012345859299419892,0.17299380256798713,0.18533966186740702,-25402199,-25746879.4,45.63762641984546,54.63590253500683,NaN,NaN,9.610084359831808,10.554854629180706
2006-03-03T09:30:00-05:00,31.58,31.89,31.55,31.74001,1550500,2785624.75,56.68773464241234,55.16629165557003,NaN,NaN,81.67572426093359,27.854929376243945,-0.0033615163502538903,0.18113776642958967,0.18449928277984357,-23851699,-26145939.2,44.066037378504014,53.083380791491585,NaN,NaN,10.1409102794006,10.495719722069262
2006-03-06T09:30:00-05:00,31.78,31.78,31.2,31.31,2601000,2775869.75,49.828175114500695,55.49846954413694,NaN,NaN,13.543567492147158,23.323405626103554,-0.026678366365167128,0.15115132482338467,0.1778296911885518,-26452699,-26670939,42.01611382920112,51.90723893660943,NaN,NaN,8.517819086847894,10.21316248846621
2006-03-07T09:30:00-05:00,31.35001,31.35001,30.89,31.00999,6244000,2942884.75,45.675461949857805,54.771122644688944,NaN,NaN,-58.520976346519554,19.46772782087815,-0.06066156885509816,0.10200273011967909,0.16266429897477724,-32696699,-27338999,39.49813938068521,50.52859716086586,NaN,NaN,5.8310815336589155,9.58715092349374
2006-03-08T09:30:00-05:00,31.06,31.06,30.5,30.82001,6385801,2957029.9,43.21911527490323,54.00630160541128,NaN,NaN,-116.78043070640712,-5.13129258319501,-0.09238866126982431,0.04717847238749684,0.13956713365732115,-39082500,-29497159.2,32.683837444247374,48.91991339580811,NaN,NaN,2.8377593658489246,8.62295212954448
2006-03-09T09:30:00-05:00,30.95,31.25999,30.74001,30.75999,2868400,2979579.9,42.44254472195998,52.86238107541486,NaN,NaN,-93.65734335750888,-34.74789173147096,-0.11253416494953536,-0.001100572529598054,0.1114335924199373,-41950900,-32806899.4,25.436259547827177,47.01029195598703,NaN,NaN,0.17442264234921645,7.416019345659443
2006-03-10T09:30:00-05:00,30.84,31.39999,30.78,31.31,4213898,3084329.8,51.11157246283826,52.369785219028,NaN,NaN,-41.97390305010984,-59.47781719367964,-0.08517731500711131,0.0049619486610481545,0.09013926366815947,-37737002,-35583960,21.190322493004444,44.95018481553388,NaN,NaN,0.4403629055840139,6.419496997077239
2006-03-13T09:30:00-05:00,31.36,31.50999,31.28,31.38,1485600,3013069.8,52.10038277858338,51.93955361869421,NaN,NaN,2.349501540244569,-61.71663038406016,-0.059919981845498765,0.01523928636128602,0.07515926820678479,-36251402,-37543700.6,18.804783313577957,42.52802125742182,NaN,NaN,0.9538372799594855,5.638688466060417
2006-03-14T09:30:00-05:00,31.39,31.96001,31.35001,31.96001,5210801,3053014.95,59.42360916030749,51.921419010348494,NaN,NaN,89.44572191928583,-32.12329073089908,-0.004618399784958732,0.06938626847558638,0.07400466826054511,-31040601,-37212481,20.435102416204884,40.10518491270405,NaN,NaN,3.830158697141401,5.380327070500558
2006-03-15T09:30:00-05:00,32.14999,32.36,31.77,32.34,10341801,3402235,63.37433838574285,52.385301742224,NaN,NaN,173.60396666375325,25.95358874313299,0.053861052268968715,0.141330983596756,0.08746993132778728,-20698800,-33535741,35.83654749271338,38.65589597018909,NaN,NaN,7.59985481788969,5.697402462984719
2006-03-16T09:30:00-05:00,32.41,32.60001,32.3,32.39,2996500,3418370,63.872787494390536,52.79973580336462,NaN,NaN,203.63104639969623,85.41126669457402,0.09008479104351577,0.200075920132182,0.10999112908866623,-17702300,-28686021,49.67436641536172,38.10340024110851,NaN,NaN,10.729603823857945,6.416288371680894
2006-03-17T09:30:00-05:00,32.39999,32.39999,32.19,32.19,1843200,3378295,60.33563404612738,53.28966380128228,NaN,NaN,142.78795291517062,122.3636378876301,0.09430043424042911,0.22786667188920262,0.1335662376487735,-19545500,-25047720.6,57.14193251584315,37.999984137832314,NaN,NaN,12.263583454613721,7.251616240671297
2006-03-20T09:30:00-05:00,32.25999,32.36,31.98,32.12,2560600,3416250,59.10198166447969,54.13414537862072,NaN,NaN,107.99002100883236,143.49174178134768,0.0863143987783773,0.24145923612174514,0.15514483734336784,-22106100,-22218660.2,61.87873694981043,38.655734817109696,NaN,NaN,13.152785554392562,8.094640428345764
2006-03-21T09:30:00-05:00,32.10001,32.27,31.64999,31.64999,5221602,3568285.1,51.48942247016363,53.944373211210326,NaN,NaN,47.86108623867985,135.1748146452265,0.04537479701577929,0.21186333361309195,0.16648853659731266,-27327702,-21476080.4,63.033639033967056,39.80953175934239,NaN,NaN,11.592390162408284,8.594318961783268
2006-03-22T09:30:00-05:00,31.66,32.03,31.66,31.98,3988500,3670065.1,55.794758853026416,53.889822787092456,NaN,NaN,52.92718927566314,111.03945916760844,0.03687864895317777,0.2125868477887849,0.17570819883560712,-23339202,-22004160.8,61.60431525405562,40.95000953321455,NaN,NaN,11.60493042205247,9.024406313250296
2006-03-23T09:30:00-05:00,31.97,32.14999,31.78999,32.07001,3207300,3706110.1,56.917853412043314,53.9062598420661,NaN,NaN,68.6461410510566,84.04247809788052,0.033762518039262585,0.21791134638468534,0.18414882834542276,-20131902,-22490081.2,60.25047177503205,42.106040561537974,NaN,NaN,11.953709121760394,9.442878143037452
2006-03-24T09:30:00-05:00,32.06,32.19,31.89999,32.05,1546600,3686015.1,56.573742473051745,54.388086081962605,NaN,NaN,69.87204533673389,69.45929658219316,0.02708365939627283,0.21800340259076378,0.19091974319449095,-21678502,-22916681.6,59.024085173842,43.320895657583755,NaN,NaN,12.137533734593184,9.827828941831129
2006-03-27T09:30:00-05:00,32.03999,32.3,32.03999,32.27,2502600,3712580.1,59.47466951599491,55.373743765258105,NaN,NaN,86.54328911060644,65.16995020254798,0.03377701719521506,0.23314101468850978,0.19936399749329473,-19175902,-22330642,60.22193128450634,44.80116650785669,NaN,NaN,13.130473274850935,10.299635275119673
2006-03-28T09:30:00-05:00,32.2,32.52,31.99001,32,3068100,3589550.15,54.649665512852216,56.19021163939732,NaN,NaN,74.78009654175374,70.55375226316275,0.017153304395775393,0.22080562798801395,0.20365232359223856,-22244002,-21313902,62.28203124993653,46.915323208263054,NaN,NaN,12.587279805465709,10.626441636597677
2006-03-29T09:30:00-05:00,32.07001,32.59,32.07001,32.53999,2978200,3685225.15,61.39516320167778,57.543970102234304,NaN,NaN,102.57067307286141,80.4824490226024,0.038438919631515966,0.25170097313163353,0.21326205350011757,-19265802,-20499222,63.89552562720007,49.66241364250398,NaN,NaN,14.222639006768018,11.140184118050584
2006-03-30T09:30:00-05:00,32.7,33.02,32.50999,32.66,2951000,3688300.15,62.722250789712696,58.37330426843962,NaN,NaN,137.83168352543925,94.31955751747896,0.0554797876071397,0.2826117880090422,0.22713200040190248,-16314802,-19735802,65.38964855849747,52.81950836146776,NaN,NaN,15.961457152656292,11.828937408708542
2006-03-31T09:30:00-05:00,32.48,32.52,32.25999,32.35001,2745700,3748060.15,57.24790304321856,58.74098428734214,NaN,NaN,76.58072074930955,95.66129259999408,0.04139877467659628,0.2788804687476478,0.23748169407105155,-19060502,-19212202,66.41618901394759,56.220323054351304,NaN,NaN,15.76373827685344,12.391051818443527
2006-04-03T09:30:00-04:00,32.71001,33.11,32.57001,32.75,2427400,3739380.15,61.872132689520704,58.91587882514308,NaN,NaN,128.03043843762663,103.95872246539811,0.05376422846635376,0.3046869796539937,0.25092275118763996,-16633102,-18703642,67.42674067640866,59.57686864436586,NaN,NaN,17.071277571649514,13.059655497472955
2006-04-04T09:30:00-04:00,32.8,32.88,32.62199,32.8,3689100,3611635.15,62.41934004770522,58.84766465814039,NaN,NaN,115.80348094077497,112.16339934520235,0.05959951401098157,0.3254221437013669,0.26582262969038534,-12944002,-16843642,70.87819593951738,62.079843533423286,NaN,NaN,18.28088123327807,13.805544888302256
2006-04-05T09:30:00-04:00,33,33.25,32.69,33.25,3648500,3474770.1,67.0085507850919,59.07164775033335,NaN,NaN,156.2964960649011,122.9085639436103,0.08642714747823976,0.373856564038185,0.28742941655994525,-9295502,-14849582,74.05248690144876,63.821137853858076,NaN,NaN,20.82427916585474,14.808221213666897
2006-04-06T09:30:00-04:00,33.32001,33.41,33.05,33.32001,2603300,3461515.1,67.67002245532673,59.59553263670473,NaN,NaN,173.70058306116314,130.08234385075508,0.10055897003153397,0.4131281290993627,0.31256915906782873,-6692202,-12925062,76.69297486356778,65.21764087869555,NaN,NaN,23.069689584587874,15.988430980941322
2006-04-07T09:30:00-04:00,33.3,33.42999,32.81,32.81,3173500,3409495.2,58.47261055414342,59.550577557394995,NaN,NaN,118.58729195100653,138.48365809109447,0.0687477751714925,0.39850387803219434,0.32975610286070184,-9865702,-11086102,78.90229294671707,66.43360916418888,NaN,NaN,22.137934256338777,16.866931448855244
2006-04-10T09:30:00-04:00,33,33.08,32.74001,32.8,2653200,3467875.2,58.305276948057106,60.037424305815954,NaN,NaN,84.15329671867941,129.70822974730504,0.0415607624606118,0.3817070559364666,0.3401462934758548,-12518902,-10263262,79.8238809862439,67.63291216078008,NaN,NaN,21.351872337972065,17.507637290157646
2006-04-11T09:30:00-04:00,33.25999,33.39,32.56,32.56,2247800,3319725.15,54.28973356729121,59.92992249969201,NaN,NaN,68.11405097934617,120.17034375501927,0.0039244976036565404,0.34505191548042546,0.3411274178767689,-14766702,-10627802,78.19424414176473,68.81790708133073,NaN,NaN,19.464766554393485,17.78722718504848
2006-04-12T09:30:00-04:00,32.75,32.85001,32.60001,32.78,1329400,2869105.1,57.1996461439583,59.950050551971664,NaN,NaN,45.44574067304567,98.0001926766482,-0.008941020235783248,0.32995114258203984,0.3388921628178231,-13437302,-11456162,74.47359328351868,69.83384433193693,NaN,NaN,18.730270508123546,17.92194765977349
2006-04-13T09:30:00-04:00,33.28,33.28,32.56,32.95,4045200,2921540.1,59.35295389129425,60.1485656532747,NaN,NaN,71.34815193360691,77.52970645113695,-0.008776786826537653,0.32792117928465103,0.3366979661111887,-9392102,-11996142,72.06635046294534,70.76543470973003,NaN,NaN,18.747376229787175,18.039866026918304
2006-04-17T09:30:00-04:00,33.10001,33.32001,33.07001,33.24001,2214900,2940125.1,62.79204209006651,60.38552083713695,NaN,NaN,107.07401686994203,75.22705143492402,0.007224394757753105,0.34572845955838005,0.33850406480062695,-7177202,-11458442,73.00217288946955,71.67830911008454,NaN,NaN,19.7966101464793,18.290829472569875
2006-04-18T09:30:00-04:00,33.3,34.17999,33.3,34.14999,4110602,3017625.2,71.06471192086849,61.558024151995255,NaN,NaN,190.61709079506429,96.51981025020099,0.07186163144618585,0.4283311041083593,0.35646947266217344,-3066600,-9567981.6,76.04125270909859,72.66111064288184,NaN,NaN,23.735140595547698,19.06858820442385
2006-04-19T09:30:00-04:00,34.14999,34.41,33.86,34.38,1625700,2837830.1,72.71598065998384,62.36665397044569,NaN,NaN,219.9427496524132,126.8855499848144,0.12003673042147767,0.5065153856890205,0.3864786552675429,-1440900,-6902821.2,79.53825841564905,73.77844869919963,NaN,NaN,27.45374920089413,20.266468346776747
2006-04-20T09:30:00-04:00,34.39999,34.41,33.83,34.06,4531500,2864980.1,66.98832366115721,62.67137346126315,NaN,NaN,175.8109134582999,152.95858454186524,0.11999432084299066,0.5364715563212812,0.4164772354782905,-5972400,-5409840.8,81.19418063107878,74.90734384724114,NaN,NaN,28.607034813887655,21.457977842078307
2006-04-21T09:30:00-04:00,34.06,34.50999,34.06,34.39999,2327900,2821010.1,69.71754677382634,63.562062299163706,NaN,NaN,173.79353081367282,173.44766031787842,0.13157786282501938,0.5809495640095648,0.4493717011845454,-3644500,-4260320.4,82.37676013911211,76.04738464189575,NaN,NaN,30.47682673163602,22.746384826300837
2006-04-24T09:30:00-04:00,34.25,34.32001,34.00999,34.28,1689700,2828165.1,67.59361420806334,63.970739550488176,NaN,NaN,134.25626683484725,178.88411031085948,0.12018635603378192,0.5996046462267728,0.47941829019299087,-5334200,-3891720,82.75131706379408,77.14199724099471,NaN,NaN,31.29028628585272,23.96694217766539
2006-04-25T09:30:00-04:00,34.5,34.52,33.89999,34.03999,3398600,2872965.1,63.43097310554842,64.04299905461983,NaN,NaN,110.77500304052046,162.9156927599507,0.08705837035368913,0.5882412531351022,0.5011828827814131,-8732800,-5024960,77.31100076672536,77.601483300081,NaN,NaN,30.659115463964216,24.922966932850937
2006-04-26T09:30:00-04:00,33.95,34.31,33.92,34.03,2213600,2830240.1,63.256355390899515,63.77498509789181,NaN,NaN,89.50370887495625,136.82788460445934,0.056523919957596425,0.5718377827284087,0.5153138627708123,-10946400,-6926060,69.10339699829315,77.24797687842702,NaN,NaN,30.105004765813597,25.663258051845602
2006-04-27T09:30:00-04:00,33.39999,33.94,33.25,33.35001,8383000,3100480.1,52.63493215765242,62.70105007662936,NaN,NaN,18.780902934851998,105.42188249976975,-0.013670950627092004,0.49822517448694725,0.5118961251140393,-19329400,-9597460,59.538285164511876,76.02264189992304,NaN,NaN,26.118564379849023,25.72830181298895
2006-04-28T09:30:00-04:00,33.60001,33.64,33.38,33.5,6580199,3281940.05,54.45168290188809,62.41384095861112,NaN,NaN,13.88559561689624,73.44029546041445,-0.05204592965119231,0.44683871305004885,0.49888464270124117,-12749201,-11418400.2,54.04665914519781,74.2472394855288,NaN,NaN,23.45104524601343,25.40297944627816
2006-05-01T09:30:00-04:00,33.64999,34.03,33.58,33.72,2119100,3250610.05,57.05368785248101,62.32444173749854,NaN,NaN,40.77050615163931,54.743143323772856,-0.06387863944140065,0.41903634339949036,0.482914982840891,-10630101,-12477580.4,51.09451366685828,72.19514181985839,NaN,NaN,22.021513738800213,24.919912916638452
2006-05-02T09:30:00-04:00,33.75,34.07001,33.75,34.05,3352200,3296850.05,60.6819885348093,62.78103137803555,NaN,NaN,58.0478680173567,44.1977163191401,-0.051289343524634434,0.418803303435098,0.4700926469597324,-7277901,-12186600.6,51.872267170475055,70.31500060762342,NaN,NaN,21.919712430555553,24.49131284719804
2006-05-03T09:30:00-04:00,34.09,34.12,33.82001,34.06,2889300,3256860.05,60.79009307874367,63.037491873377355,NaN,NaN,57.17605370862435,37.73218528587372,-0.04435751289138157,0.41464575584550545,0.459003268736887,-4388601,-10875040.8,55.32128181373593,68.9469783597818,NaN,NaN,21.870073168920584,24.116850036015546
2006-05-04T09:30:00-04:00,34.32001,34.56,34.06,34.39999,2025700,3175720.05,64.37635185032676,63.396306013308255,NaN,NaN,93.91026710382621,52.75805811966857,-0.020174759282958366,0.43378481963318904,0.4539595789161474,-2362901,-7481741,62.75757357710255,68.28206572507874,NaN,NaN,22.90292505705717,23.943432181878634
2006-05-05T09:30:00-04:00,34.59,34.67,34.41,34.64,2784300,3184770.05,66.69234737374688,63.67489924785684,NaN,NaN,113.40042234371154,72.66102346503163,0.007218331064985373,0.4629824927473791,0.45576416168239375,421399,-4847621,67.30655726498853,67.8752360376158,NaN,NaN,24.477996571095012,24.01979852319526
2006-05-08T09:30:00-04:00,34.7,34.88,34.69,34.77,2169100,3134550.05,67.9093095570402,63.44951336472626,NaN,NaN,130.40634853805608,90.58819194231498,0.0281505739925324,0.49095237917305923,0.4628018051805268,2590499,-2203501,71.1198965251838,67.5237105959076,NaN,NaN,26.143876377323945,24.323238216642213
2006-05-09T09:30:00-04:00,34.91,35.05,34.71001,35,2640300,3133905.05,69.99790265800269,63.255364936013315,NaN,NaN,140.6012595035694,107.0988702395575,0.0502535856905969,0.525618787293773,0.4753652016031761,5230799,298239,74.18763467264847,67.14152318569327,NaN,NaN,28.188566334452908,24.875427947758027
2006-05-10T09:30:00-04:00,35.00999,35.03,34.71001,35.00999,4704699,3256750,70.08896285502794,63.47683916414694,NaN,NaN,133.568543173336,122.37736813249985,0.05777667387218266,0.5475860439434044,0.4898093700712217,9935498,3163058.8,77.1773231854888,66.85460479672257,NaN,NaN,29.880920735425555,25.590498345996245
2006-05-11T09:30:00-04:00,35.34,35.35001,34.45,34.53,4856199,3433089.95,60.575751129221416,62.823853760960866,NaN,NaN,108.11183917389675,125.21768254651394,0.024365912095753894,0.5202667601909141,0.4959008480951602,5079299,4651498.8,78.56635706173094,66.5824331483382,NaN,NaN,28.614694731716213,26.022526401099096
2006-05-12T09:30:00-04:00,34.37,34.45,33.73,33.78999,9833500,3722504.95,49.43525797224878,61.526828315545536,NaN,NaN,-31.658519230935873,96.20589423158445,-0.049599350261171904,0.43390166026869537,0.48350101052986727,-4754201,3616378.8,75.14129094168183,66.0388598539016,NaN,NaN,23.66278557187383,25.68542056835263
2006-05-15T09:30:00-04:00,33.24001,33.61,32.94,33.35001,7872199,4005369.9,44.22720779048087,60.15513079304072,NaN,NaN,-162.0552196528427,37.7135805934047,-0.12584574600878973,0.3261938280188801,0.4520395740276698,-12626400,572999,66.02734745641214,65.23288461745065,NaN,NaN,17.66267485083927,24.539314037279294
2006-05-16T09:30:00-04:00,33.69,33.69,32.87,33.36,5350199,4067349.75,44.37051256166749,58.806142019524145,NaN,NaN,-144.406173813202,-19.28790606994958,-0.17052208781734413,0.23888696425598965,0.4094090520733338,-7276201,-1928401,59.625951690948284,64.5559242383546,NaN,NaN,13.064259610536254,22.900020547744575
2006-05-17T09:30:00-04:00,33.14,33.34,32.3,32.46001,6302699,4301199.7,35.51674202222527,57.58341415270792,NaN,NaN,-201.63197851610173,-86.32801040783713,-0.2507530671583066,0.09596771812545057,0.34672078528375716,-13578900,-6631280.6,49.84204920527179,63.86333595555174,NaN,NaN,5.533376970719376,20.419071465312403
2006-05-18T09:30:00-04:00,32.67,32.74001,32.08,32.12,3457900,4247519.7,32.84984735943897,56.04042589967584,NaN,NaN,-204.70270288283191,-148.89091881918284,-0.3127550316375275,-0.04422300426315218,0.2685320273743753,-17036800,-11054500.4,42.738780248689274,63.05563032008684,NaN,NaN,-1.4943854790731728,17.288577616114463
2006-05-19T09:30:00-04:00,31.89999,32.38,31.73,32.25,8487500,4555499.7,34.86372016645858,54.45542820781709,NaN,NaN,-182.66067386065748,-179.09134974512716,-0.3293733851728448,-0.14318470409168071,0.1861886810811641,-8549300,-11813520.2,41.64206496862178,62.38045541306995,NaN,NaN,-6.3466394358879334,13.912118037256977
2006-05-22T09:30:00-04:00,31.5,31.91,31.03999,31.55,9012199,4921624.65,29.698803107643457,52.2423435344481,NaN,NaN,-196.54887025716013,-185.99007986599065,-0.36889296144079375,-0.27492752071982807,0.09396544072096566,-17561499,-12800540,40.19752832221042,61.546545495336765,NaN,NaN,-12.465718818346314,10.14385562931365
2006-05-23T09:30:00-04:00,32,32.3,31.62,31.62,6295301,5066459.7,30.80278743607873,50.10039313140061,NaN,NaN,-140.14267290418067,-185.13737968418639,-0.3707145161380718,-0.3694277044516241,0.001286811686447703,-11266198,-13598539.4,39.01901632914508,60.38209796072313,NaN,NaN,-16.842102839075807,6.288718705258014
2006-05-24T09:30:00-04:00,31.39999,31.87,30.95,31.48,4620000,5186779.7,29.7950239755628,47.630298283203174,NaN,NaN,-146.48098409969563,-174.10718080090516,-0.3613689683712831,-0.45042439877765617,-0.08905543040637308,-15886198,-14059999,38.31938540813627,58.63651309151125,NaN,NaN,-20.67833343318515,2.43628268548042
2006-05-25T09:30:00-04:00,31.78,32.14,31.67999,32.02,4313801,4983319.75,38.19439657585854,45.5947303690683,NaN,NaN,-95.61108822798538,-152.28885786993584,-0.3012943618071082,-0.4656733826652584,-0.16437902085815015,-11572397,-12967118.4,41.01678231017868,56.758672023310545,NaN,NaN,-21.32006017106465,-0.9574805797403045
2006-05-26T09:30:00-04:00,32.42,32.61,32.12,32.56,4473000,4877959.8,45.24875661779299,43.97611944483636,NaN,NaN,-57.81285102846495,-127.31929330349735,-0.21188626332244595,-0.4292368500112076,-0.21735058668876164,-7099397,-12677137.8,41.74475006469276,54.660447276132615,NaN,NaN,-19.491274297494424,-3.605165396562321
2006-05-30T09:30:00-04:00,32.53999,32.53999,31.78999,31.78999,2988800,4921444.8,38.50060788508411,41.72631267534217,NaN,NaN,-73.87269346596707,-102.78405794525875,-0.19189826677212352,-0.45722342015391604,-0.2653251533817925,-10088197,-11182477.4,45.4798239636902,52.609889368349876,NaN,NaN,-20.244066017600122,-5.9821511995677215
2006-05-31T09:30:00-04:00,31.99001,32.39999,31.92999,32.14999,3880400,4947854.8,42.79593005989077,39.776810332832376,NaN,NaN,-60.06393805599062,-86.76831097562075,-0.14391727577355118,-0.4452217480987315,-0.3013044723251803,-6207797,-10170797.2,47.91409937515347,50.51965909618307,NaN,NaN,-19.353927751427097,-7.892404992690489
2006-06-01T09:30:00-04:00,31.95,32.56,31.81,32.5,4100801,5008429.85,46.6941172993157,38.78526505926768,NaN,NaN,-47.50146161851494,-66.97240647938462,-0.08121558288079134,-0.4028239509261695,-0.3216083680453782,-2106996,-7414956.8,53.94625957984025,48.76108070461945,NaN,NaN,-17.302386814359778,-9.236688110071816
2006-06-02T09:30:00-04:00,32.85001,32.87,32.56,32.81,3707900,5092539.85,49.94744592605542,38.821849913111016,NaN,NaN,-16.327805254014127,-51.11574988459037,-0.014942403566945761,-0.34028637250406035,-0.3253439689371146,1600904,-4780296.6,58.85252572604804,47.59759747493133,NaN,NaN,-14.551107934573729,-9.995890942143518
2006-06-05T09:30:00-04:00,32.58,32.77,31.82001,31.83,3639800,5135314.85,41.35478576332996,38.616676911171666,NaN,NaN,-50.480197766056044,-49.64921923210858,-0.03219556489094455,-0.36558842505079525,-0.3333928601598507,-2038896,-3768196.4,60.589455320350034,47.20917660806974,NaN,NaN,-15.108591746176861,-10.726276771291138
2006-06-06T09:30:00-04:00,31.75,31.75,31.28,31.56,5348801,5294299.9,39.34642379922619,38.257813428140146,NaN,NaN,-89.02004081648928,-52.678688702213,-0.055513057611099814,-0.40278418217372547,-0.34727112456262565,-7387697,-3228096.4,61.522875091551334,47.34467113668425,NaN,NaN,-16.232838709587348,-11.512928476762026
2006-06-07T09:30:00-04:00,31.64999,31.64999,30.84,30.84,5564199,5440494.85,34.53056920769444,38.187372512816516,NaN,NaN,-117.90924263790686,-64.24774961859626,-0.11000063749653927,-0.4847719214332997,-0.37477128393676046,-12951896,-4576916.2,57.838642114383546,47.915856344477945,NaN,NaN,-18.886054470101353,-12.566232190096216
2006-06-08T09:30:00-04:00,30.92,30.95,29.67999,30.74001,13610801,5885799.95,33.909839417629826,38.263086231258725,NaN,NaN,-173.51228505356735,-89.44991430560674,-0.1413503917309092,-0.5514592736003969,-0.41010888186948774,-26562697,-9468056.4,46.876273429585304,48.21139157168481,NaN,NaN,-21.139453556970594,-13.790978099649697
2006-06-09T09:30:00-04:00,30.8,31.19,30.50999,30.58,4087300,5847355,32.890896619545856,38.122170263622095,NaN,NaN,-141.74383299261126,-114.53311985332616,-0.1600625692287132,-0.6101870934053792,-0.45012452417666604,-30649997,-15918236.6,36.93448019773056,47.87513551662114,NaN,NaN,-23.26147958568332,-15.143906883368786
2006-06-12T09:30:00-04:00,30.78999,30.89999,30.08,30.10001,4422699,5576814.95,29.980619034524636,38.142299972685045,NaN,NaN,-162.98557256414426,-137.0341948129438,-0.18992839628951919,-0.687535019538565,-0.4976066232490458,-35072696,-22524996.6,29.932041014534065,47.14188642321569,NaN,NaN,-25.998289216273367,-16.694532930926584
2006-06-13T09:30:00-04:00,29.89999,30.23,29.39,29.59,9180301,5642220.05,27.224201305467815,37.88668667764141,NaN,NaN,-189.12717023082666,-157.05562069581129,-0.22670241984295003,-0.7809846480527334,-0.5542822282097833,-44252997,-29898056.6,24.377476435621332,46.09606214510685,NaN,NaN,-29.222755877631045,-18.484279066170078
2006-06-14T09:30:00-04:00,29.73,30.07001,29.42,29.98,5136199,5631520.05,32.346504465228335,38.06893528404608,NaN,NaN,-156.71568864438578,-164.81690989710705,-0.20792537575854264,-0.8141889479079616,-0.606263572149419,-39116798,-35131037,21.349286709273244,44.883912238045205,NaN,NaN,-30.28343969486934,-20.169873441698545
2006-06-15T09:30:00-04:00,30.32001,31.08,30.31,30.98,7140898,5673430,43.355678842545316,38.437598303095136,NaN,NaN,-62.339179396510644,-142.58228876569575,-0.11591164344114924,-0.7511531264508555,-0.6352414830097063,-31975900,-36213677.6,20.774322140351828,43.43802222591472,NaN,NaN,-27.438818291687213,-21.20829413455407
2006-06-16T09:30:00-04:00,30.83,30.83,30.41,30.59,4813602,5741215.1,40.58205336478687,38.10426235645184,NaN,NaN,-69.60272820596997,-128.15406780836747,-0.07126045228794553,-0.7243170483696382,-0.6530565960816926,-36789502,-37441578.6,20.112726863536963,41.89287771154644,NaN,NaN,-26.0598689748302,-21.901376254593515
2006-06-19T09:30:00-04:00,30.45,30.67,29.83,29.98,12047398,5919210,36.63438514292359,37.97096073201181,NaN,NaN,-96.44960926729296,-114.84687514899721,-0.07251334264901255,-0.7436982743929583,-0.6711849317439458,-48836900,-40194419.4,18.67668299072004,39.978367642048575,NaN,NaN,-26.22882259741498,-22.51958287499658
2006-06-20T09:30:00-04:00,30.2,30.39999,29.94,30.11,3511700,5644185.05,38.01817202424517,37.62969230089426,NaN,NaN,-86.39123756823273,-94.29968861647842,-0.055081999609446486,-0.7400374312557538,-0.6849554316463073,-45325200,-40408860,18.565480746293602,37.882037739987155,NaN,NaN,-25.918707329398398,-23.00517208276827
2006-06-21T09:30:00-04:00,30.17,31.03999,30.14,30.84,13065102,5982675.1,45.248761349720624,37.526452590208905,NaN,NaN,-40.110606074350514,-70.97867210247136,0.011562620455469186,-0.6705021560769708,-0.68206477653244,-32260098,-39037520,21.77317043646852,35.58395994403204,NaN,NaN,-23.249658245964174,-23.040098677510542
2006-06-22T09:30:00-04:00,30.84,30.89999,30.50999,30.67999,3054900,5904420.1,44.0361337574715,37.10421600673862,NaN,NaN,-35.103288611783334,-65.53149394552591,0.048734835506196394,-0.6211462321496946,-0.669881067655891,-35314998,-39705339.6,21.33248970992483,32.90395737145181,NaN,NaN,-21.50192190769656,-22.82035913896569
2006-06-23T09:30:00-04:00,30.59,31.14999,30.57001,30.94,2577600,5817610.05,46.54312009457816,37.474811316113495,NaN,NaN,-16.2548236830114,-54.86191304093419,0.0921793077407963,-0.5546569329798956,-0.6468362407206919,-32737398,-38894918.8,23.359685811173094,30.244688120796315,NaN,NaN,-19.294207264615856,-22.316623156915714
2006-06-26T09:30:00-04:00,30.95,31.05,30.8,31.03,3083700,5748145.05,47.42111654084929,38.05157508337228,NaN,NaN,-4.197101191020481,-36.4114114256797,0.1262179419273708,-0.4890638133114784,-0.6152817552388492,-29653698,-35058278.4,32.25937348439528,28.15443800599946,NaN,NaN,-17.24622684786722,-21.592280827051642
2006-06-27T09:30:00-04:00,31.00999,31.12,30.59,30.64,4295398,5813474.95,44.045179661086415,38.73119011575743,NaN,NaN,-16.574205620663715,-22.44800503616589,0.12165666274317632,-0.46321092680987874,-0.5848675895530551,-33949096,-32783057.6,36.93623511205657,26.661408934404676,NaN,NaN,-16.46194640733734,-20.8593759099496
2006-06-28T09:30:00-04:00,30.72,30.78,30.47,30.72,1844200,5711664.95,44.911529542452996,39.51702512467337,NaN,NaN,-24.914577719282967,-19.40879936515238,0.12285783730605915,-0.4312952929204812,-0.5541531302265403,-32104896,-32752017.2,37.0001398914619,25.955970824538717,NaN,NaN,-15.574023504895852,-20.10432556637049
2006-06-29T09:30:00-04:00,30.94,31.95,30.94,31.95,6226500,5817949.9,56.152431041345494,41.17856329765906,NaN,NaN,100.89658912524075,7.79117618225244,0.20071813421240436,-0.30325546246103485,-0.5039735966734392,-25878396,-30864696.8,40.92022322813814,26.24066675528212,NaN,NaN,-11.046972108691353,-18.810417929559186
2006-06-30T09:30:00-04:00,32.10001,32.21001,31.92999,32.10001,2099700,5737539.9,57.29688869883521,43.129725416538385,NaN,NaN,180.64344868629001,47.17083065611272,0.2531654024723561,-0.18751684358299414,-0.4406822460553502,-23778696,-29072956.4,44.45387399023374,27.277940539260666,NaN,NaN,-7.058692483835179,-17.131600008741472
2006-07-03T09:30:00-04:00,32.24001,32.52,32.2,32.48,2236200,5667359.9,60.13532454190138,45.48051993342649,NaN,NaN,216.20196824460933,91.25064454323868,0.3010346754041941,-0.06438890180010759,-0.3654235772043017,-21542496,-27450716,47.514757472021294,28.930603470432093,NaN,NaN,-2.815066127812982,-15.086380882894545
2006-07-05T09:30:00-04:00,32.3,32.3,31.89999,32.09,5716000,5685719.85,56.01968484118286,47.17146138885182,NaN,NaN,159.08546724865087,126.38257911710161,0.29370008128630454,0.0017015244035789578,-0.2919985568827256,-27258496,-26112596,49.964044878018456,30.97451476819961,NaN,NaN,-0.47441123165335414,-12.998956647002947
2006-07-06T09:30:00-04:00,32.09,32.33,31.97,32.06,3841000,5599559.9,55.70386865983871,48.053474947229915,NaN,NaN,138.29824833275455,159.0251443275091,0.2744542214014653,0.051069219869106064,-0.22338500153235924,-31099496,-25911516,50.33908330724628,33.086283422977786,NaN,NaN,1.3169616565959261,-10.953825460774537
2006-07-07T09:30:00-04:00,31.89999,32.14,31.66,31.81,2569000,5047469.85,53.021319522955295,48.941993958527654,NaN,NaN,94.47564893248939,157.74095628895884,0.2340860879440631,0.06922260839771965,-0.16486347954634345,-33668496,-27469536,47.37601964831947,35.03366147903368,NaN,NaN,2.0714007716892273,-9.093078856136856
2006-07-10T09:30:00-04:00,31.89999,32.07001,31.69,31.89,1786700,4932439.85,53.788238549087446,50.16726920182508,NaN,NaN,83.1635312033155,138.24497279236394,0.20312138639349295,0.08903825344552274,-0.1140831329479702,-31881796,-29090156,44.44542601365658,36.874285980672006,NaN,NaN,2.907089753554969,-7.3787690547523095
2006-07-11T09:30:00-04:00,31.66,31.89999,31.48,31.85001,2136200,4818114.9,53.31966024976781,51.260232646505266,NaN,NaN,61.54325114254356,107.31322937195077,0.17155335840109157,0.10035856505339424,-0.07119479334769732,-34017996,-31585256,40.3110274181086,38.42753931437307,NaN,NaN,3.4801139366770197,-5.827500055976691
2006-07-12T09:30:00-04:00,31.97,32.03999,31.52,31.62,2775500,4497874.85,50.589815538905896,51.641736517161355,NaN,NaN,52.54301508700276,86.00473893962115,0.12874438799027835,0.0897356916401506,-0.039008696350127735,-36793496,-33492256,37.44410374223851,39.54689169335664,NaN,NaN,3.255565362601224,-4.5299192818941325
2006-07-13T09:30:00-04:00,31.48,31.48,30.67999,30.73,6215398,4551834.8,41.69456831394261,51.474481842623575,NaN,NaN,-29.402954606293765,52.464498351811486,0.038721475166688196,0.00939314760823251,-0.029328327558455686,-43008894,-35874135.6,34.174822197913684,40.46420115678442,NaN,NaN,0.35116923161664676,-3.8326209228211643
2006-07-14T09:30:00-04:00,30.67,30.86,30.32001,30.78,3293600,4359469.9,42.308292167828604,51.17199413357004,NaN,NaN,-60.668624882800984,21.435643588753415,-0.01627472231498983,-0.049671730452192975,-0.033397008137203144,-39715294,-37083495.2,32.617632050498074,41.12548303102192,NaN,NaN,-1.8397301935307728,-3.547922247208251
2006-07-17T09:30:00-04:00,30.57001,30.73,30.3,30.37,3492900,4293434.8,38.71008132558335,50.549777332479614,NaN,NaN,-78.5574534856697,-10.908553349043626,-0.07575289362363594,-0.12808812516674806,-0.05233523154311213,-43208194,-39348774.8,29.87195142737353,40.95495288409179,NaN,NaN,-4.832712701731344,-3.73146374071155
2006-07-18T09:30:00-04:00,30.50999,30.67,30.13,30.5,3680100,3875069.9,40.43974568047005,50.29224633386416,NaN,NaN,-85.0156967196211,-40.22034292147656,-0.10028814064440247,-0.17769540734861522,-0.07740726670421275,-39528094,-40450794.4,28.61020871850164,40.360236713123584,NaN,NaN,-6.839548351205449,-4.175475827924965
2006-07-19T09:30:00-04:00,30.69,31.5,30.64999,31.32001,5532398,3976104.8,50.020971573256055,50.65720647892152,NaN,NaN,-15.43715619880642,-53.81637717863839,-0.05737225831750317,-0.1491225896010917,-0.09175033128358853,-33995696,-39891234.4,30.221851100330554,39.87607322804278,NaN,NaN,-5.7599247585358535,-4.4018256751550915
2006-07-20T09:30:00-04:00,31.64,31.67999,30.45,30.45,4686898,3557194.6,42.254446746023845,49.66449331496998,NaN,NaN,-50.767498609970524,-58.08928597937374,-0.08215140155092782,-0.1944395832222483,-0.11228818167132049,-38682594,-39025974.4,32.750038466582296,39.292488602217354,NaN,NaN,-7.393455786518664,-4.829201405349887
2006-07-21T09:30:00-04:00,30.58,30.58,29.97,30.05,4597500,3634324.6,39.23795973631828,48.37456981764734,NaN,NaN,-119.05940806676324,-69.7674426161662,-0.1178793318685,-0.2596373465069455,-0.14175801463844548,-43280094,-39738934.4,31.729894053240173,38.383632892432104,NaN,NaN,-9.744877158400985,-5.531440798642901
2006-07-24T09:30:00-04:00,30.25,30.59,29.92,30.5,6811398,3846014.5,44.07492348462798,47.227398313556385,NaN,NaN,-96.94617974629492,-73.44518786829124,-0.1040831475854325,-0.2718619491202361,-0.1677788015348036,-36468696,-38391034.8,35.80137697329123,37.54696285680853,NaN,NaN,-10.106643345971372,-6.185041162546968
2006-07-25T09:30:00-04:00,30.75,31.08,30.39,30.97,4112500,3897454.5,48.67086464952414,46.70248258558076,NaN,NaN,-45.10722628109842,-65.4634937805867,-0.05845584666589157,-0.24084860986716805,-0.18239276320127648,-32356196,-36956655.2,39.908399196741556,36.82870245100303,NaN,NaN,-8.889942643415301,-6.571455659813872
2006-07-26T09:30:00-04:00,30.99001,31,30.67999,30.89999,5218602,3943614.7,48.037584409489604,46.15489085341297,NaN,NaN,-40.83131549333993,-70.5423256394934,-0.02959822095878481,-0.2193905393997575,-0.1897923184409727,-37574798,-37672475.6,38.58189228146056,35.98890309201834,NaN,NaN,-8.125820166794945,-6.79350773223974
2006-07-27T09:30:00-04:00,30.97,31.03999,30.17999,30.22,3117400,4007274.7,42.28293193907106,45.38786316884982,NaN,NaN,-79.02998436575618,-76.19482279065053,-0.05162430545959412,-0.25432270026546533,-0.2026983948058712,-40692198,-38074396.4,37.82172763462985,35.30645366246908,NaN,NaN,-9.312436316412668,-7.153354672835873
2006-07-28T09:30:00-04:00,30.39,30.8,30.22,30.77,5327398,3962319.6,47.73650614433484,44.95559656851035,NaN,NaN,-61.26316805399557,-64.635574788097,-0.025775919437774186,-0.23491829410308895,-0.20914237466531477,-35364800,-36491337.6,42.61736034236597,35.17587754309118,NaN,NaN,-8.534711759085962,-7.350691399443028
2006-07-31T09:30:00-04:00,30.63,31.06,30.63,30.89999,3163200,4015494.6,48.96390672794645,44.64447131695168,NaN,NaN,-29.26569831964037,-51.09947850276609,0.0019789336715796413,-0.20666870757584022,-0.20864764124741986,-32201600,-35637918.4,45.07667517278608,35.516280954139575,NaN,NaN,-7.531492319763908,-7.376520102346011
2006-08-01T09:30:00-04:00,30.89999,30.89999,30.50999,30.64999,2858000,4046584.6,46.69272515407297,44.36610771803504,NaN,NaN,-44.39801897065913,-50.95763704067823,0.0052191836900783994,-0.20212366163482187,-0.20734284532490027,-35059600,-36178599.2,43.796022104137954,35.96998940856097,NaN,NaN,-7.389856378783871,-7.378425284694277
2006-08-02T09:30:00-04:00,30.78,31.36,30.78,31.14,3762100,3948889.6,51.446573231975606,45.062679497894536,NaN,NaN,14.732356141803407,-39.844902713649574,0.040138109984128645,-0.15717020784473945,-0.1973083178288681,-31297500,-34923139.6,47.524108130895144,36.92350983234536,NaN,NaN,-5.795886765177753,-7.152348353334774
2006-08-03T09:30:00-04:00,31,31.46001,30.89999,31.33,4304500,3972064.6,53.18971784238811,45.83992418893451,NaN,NaN,46.206108290615845,-14.797684182375164,0.07384468883893294,-0.10500245678020192,-0.17884714561913487,-26993000,-32183300,54.60141839506708,38.49378028552885,NaN,NaN,-3.961671679557465,-6.696537399938015
2006-08-04T09:30:00-04:00,31.64999,31.81,31.03,31.17999,2211100,3954169.6,51.61416233650595,46.76164426114327,NaN,NaN,74.15199338623216,12.285348105670389,0.08315748638708637,-0.0749002876352769,-0.15805777402236326,-29204100,-30951160,57.38491903937072,40.458992257814366,NaN,NaN,-2.90011180874082,-6.154190886909845
2006-08-07T09:30:00-04:00,31.24001,31.42999,31.11,31.33,2105900,3970129.6,53.10995485088921,47.6666592018875,NaN,NaN,77.90069826760842,33.71862742312015,0.09564958492823289,-0.038495792862072165,-0.13414537779030505,-27098200,-29930480,59.59495272215952,42.67218825807564,NaN,NaN,-1.590272703440488,-5.502202574985651
2006-08-08T09:30:00-04:00,31.25,31.48,30.91,31.002,6915199,4209079.55,49.50623279961954,47.629892146627746,NaN,NaN,59.09042886399823,54.41631699005162,0.07875606505729782,-0.03570029646868278,-0.1144563615259806,-34013399,-29721239.8,60.052322344951484,44.802936204119995,NaN,NaN,-1.4734528584093547,-4.926666901189037
2006-08-09T09:30:00-04:00,31.22,31.36,30.92999,31.03,3813600,4260984.55,49.819259434408835,48.17023591008382,NaN,NaN,66.68321190453563,64.80648814259806,0.06686938240266276,-0.03086963352265215,-0.0977390159253149,-30199799,-29501699.6,60.55681779701858,46.78913472772258,NaN,NaN,-1.2923319226102008,-4.407476189963489
2006-08-10T09:30:00-04:00,31.19,31.31,30.84,31.11,3798000,4140114.65,50.758530964577304,48.99313385495946,NaN,NaN,59.2413312519272,67.41353273486034,0.06191011753295314,-0.020351369009123488,-0.08226148654207663,-26401799,-29383459.4,60.843634130708175,48.86868759039887,NaN,NaN,-0.8921204139992056,-3.9052825076828777
2006-08-11T09:30:00-04:00,30.97,31.22,30.72,30.75999,5106898,4230779.55,46.644829673223384,49.17669858271627,NaN,NaN,12.919368093801124,55.167007676374126,0.03396945748449684,-0.03979966468645557,-0.07376912217095241,-31508697,-29844378.8,59.041311862639596,50.52868293963804,NaN,NaN,-1.6532285529990383,-3.583560514156615
2006-08-14T09:30:00-04:00,30.78,31.05,30.66,30.67999,3346000,4223434.55,45.73251839421705,48.9668167073372,NaN,NaN,-17.23607175845637,36.139653671161156,0.010243183873593492,-0.06096514232896055,-0.07120832620255405,-34854697,-31395678.2,53.31682096722981,51.48642735181578,NaN,NaN,-2.538744091688758,-3.434301025232635
2006-08-15T09:30:00-04:00,30.86,31.33,30.84,31.33,3275900,4203224.55,53.6627289772166,49.368612747889124,NaN,NaN,71.08718777584977,38.539005453531466,0.03696636297950617,-0.02500037247817133,-0.0619667354576775,-31578797,-30908757.8,54.79825758545889,52.644739159244224,NaN,NaN,-1.0873022067252747,-3.099015479731584
2006-08-16T09:30:00-04:00,31.47,31.88,31.47,31.88,5822602,4217734.75,59.10790305978034,50.570396399368356,NaN,NaN,192.0947296612009,63.62130900486452,0.08744275009615068,0.047336702162510846,-0.04010604793363983,-25756195,-30020037,57.45220186482515,54.04691588997246,NaN,NaN,1.8947271653072326,-2.3856236732974674
2006-08-17T09:30:00-04:00,31.8,31.89999,31.57001,31.67999,4029500,4184864.85,56.50738296670003,51.196887600965866,NaN,NaN,155.88042314643596,82.94912738376627,0.10209794644167892,0.08751638511845883,-0.014581561323220096,-29785695,-30696816.2,54.81291924297787,54.918027240016166,NaN,NaN,3.6002994767547145,-1.5304917947185843
2006-08-18T09:30:00-04:00,31.64999,31.78999,31.44,31.67999,1210000,4015489.85,56.50738296670003,51.73570733230541,NaN,NaN,129.1867793879603,106.2026096425981,0.10606433384260293,0.11799885598003357,0.011934522137430636,-29785695,-30352215.8,55.923224743880205,55.692780780808604,NaN,NaN,4.978729803835132,-0.6006029949251962
2006-08-21T09:30:00-04:00,31.7,31.78999,31.55,31.67999,995400,3724689.95,56.50738296670003,52.43675431892162,NaN,NaN,127.94299119007528,135.23842223230443,0.1028815162205487,0.1405364174131165,0.03765490119256781,-29785695,-29338415.4,59.10670170391088,56.786400752220956,NaN,NaN,6.113060337108757,0.3584917667939399
2006-08-22T09:30:00-04:00,31.66,31.88,31.66,31.77,1920700,3615099.95,57.55695982833634,52.87321050437597,NaN,NaN,129.8024467948982,146.9814740361141,0.10089430408628437,0.16377278130042328,0.0628784772141389,-27864995,-28595655,61.3114322389968,57.771209617085354,NaN,NaN,7.354741312162899,1.357955987560934
2006-08-23T09:30:00-04:00,31.85001,31.96001,31.60001,31.72,2622000,3485269.85,56.73786232475952,53.12664939597392,NaN,NaN,111.44980206618057,130.85248851711006,0.09059557761389027,0.17612294923150174,0.08552737161761147,-30486995,-29541815,57.089057492691715,57.948898124058545,NaN,NaN,8.201822172917696,2.3356511568976144
2006-08-24T09:30:00-04:00,31.73,31.8299,31.42999,31.47,1901500,3424474.85,52.69955478431122,53.20417742796001,NaN,NaN,66.69788608772699,113.01598110536824,0.0626572128241497,0.1638488876477986,0.1011916748236489,-32388495,-30062375,54.85090335756739,57.76789700392974,NaN,NaN,7.903300325538357,3.1310296095605774
2006-08-25T09:30:00-04:00,31.46001,31.67,31.45,31.57001,1624300,3239319.95,54.10677825303392,53.27537909954178,NaN,NaN,56.668026323881996,98.51223049255259,0.04732125177245948,0.16034323953922325,0.11302198776676377,-30764195,-30258075,53.99389221357451,57.367821253316514,NaN,NaN,8.00732820293623,3.8276436943285277
2006-08-28T09:30:00-04:00,31.45,31.63,31.38,31.53999,2057700,3184044.95,53.59137790404091,53.567175178429025,NaN,NaN,40.73165357656478,81.06996296985048,0.03228210412334567,0.15337461792094587,0.1210925137976002,-32821895,-30865315,51.31473027666649,56.74370753415331,NaN,NaN,7.966041428351138,4.418843370617472
2006-08-29T09:30:00-04:00,31.62,31.74001,31.3,31.67,3755700,3228929.95,55.56545680545048,53.97761784778914,NaN,NaN,46.203884328351506,64.35025047654115,0.028356533630962688,0.15653818083630355,0.12818164720534087,-29066195,-31105555,50.252349193082075,56.00767406244356,NaN,NaN,8.423870463627182,4.990990098190287
2006-08-30T09:30:00-04:00,31.8,31.82001,31.64,31.67999,1743300,3127989.95,55.721316544769635,54.33210253208859,NaN,NaN,74.31631478630509,56.923553020566054,0.023878496599079313,0.15802976795419,0.13415127135511068,-27322895,-30472735,53.0119439876202,55.44826762365157,NaN,NaN,8.85266640126104,5.5426581414861085
2006-08-31T09:30:00-04:00,31.8,31.96001,31.73,31.83,974300,2961479.95,58.09808307675475,55.15019206091227,NaN,NaN,96.08509988471641,62.80099577996394,0.028170255707986286,0.16936409099009353,0.14119383528210724,-26348595,-29264755,57.82172978415451,55.36115461804549,NaN,NaN,9.825637664913579,6.154512359118604
2006-09-01T09:30:00-04:00,31.86,32.34,31.81,32.19,2947400,2998294.95,63.20281967967608,56.39807072415933,NaN,NaN,144.41398316446185,80.35018714807993,0.051070637548524644,0.20503213221776306,0.15396149466923842,-23401195,-27792155,62.8183531544279,56.03983548855964,NaN,NaN,12.121729896022163,7.0069720072476835
2006-09-05T09:30:00-04:00,32.2,32.49001,32.2,32.38,3501700,3068084.95,65.5857612697452,57.249715887911385,NaN,NaN,178.95406604526485,107.99466964181993,0.07346866458865214,0.2457973254050536,0.17232866081640147,-19899495,-25207675,69.62044281666535,57.098563005074354,NaN,NaN,14.803295744371333,8.120732541122491
2006-09-06T09:30:00-04:00,32.16,32.24001,31.95,31.98,3840900,2914370,57.18915802296806,57.112662670996215,NaN,NaN,106.4587025128186,120.04563327871335,0.05655781218347858,0.24302592604574969,0.1864681138622711,-23740395,-24142515,71.90192292605526,58.13068593801936,NaN,NaN,14.835745022314992,9.080020038435705
2006-09-07T09:30:00-04:00,31.75,31.85001,31.52,31.63,2999100,2873645,51.03264397784879,56.72160988607828,NaN,NaN,13.640857290266899,107.91054177950573,0.018957387004921,0.21016484761842236,0.19120746061350136,-26739495,-24025835,72.14866742647546,59.36895366541204,NaN,NaN,12.966153364930127,9.635181942220623
2006-09-08T09:30:00-04:00,31.5,31.86,31.5,31.75,2810700,2824280,52.90460789843707,56.46426880977378,NaN,NaN,16.971320432565545,92.08778588907555,0.0003113091298900805,0.19159659702586396,0.19128528789597388,-23928795,-23541875,73.19991448350643,60.603002932528206,NaN,NaN,11.967909315030742,9.968428709764925
2006-09-11T09:30:00-04:00,31.55,31.55,30.75999,30.89999,7744102,2956140.2,40.9598649651753,55.353731809664865,NaN,NaN,-167.72496755080027,29.65999574602312,-0.06738157446487883,0.10705831981487535,0.17443989427975418,-31672897,-25196215.4,64.26964064542133,60.971784285493236,NaN,NaN,6.771118583440291,9.511670120289978
2006-09-12T09:30:00-04:00,30.89999,31.28,30.89,31.25999,5234801,3050580.25,46.47208774685729,54.561955232416366,NaN,NaN,-166.46645251951642,-39.42410796693313,-0.08489388524091937,0.06832253772860497,0.15321642296952434,-26438096,-26503935.6,58.22288316863876,60.75117363761052,NaN,NaN,4.36908153338631,8.777014607875168
2006-09-13T09:30:00-04:00,31.25,31.61,31.17999,31.48,1971200,2985345.25,49.57083261778928,54.05002453906134,NaN,NaN,-87.23048149142836,-78.16194476778253,-0.07877630528593296,0.054746041362108144,0.1335223466480411,-24466896,-26649235.8,57.57471966423826,60.78586379272099,NaN,NaN,3.482432508497039,8.020645736535435
2006-09-14T09:30:00-04:00,31.42,31.47,31.25999,31.38,2671900,2827810.15,48.204870366699495,53.72897565208908,NaN,NaN,-93.22988895304448,-99.53609401644479,-0.078411404721588,0.0355080907460561,0.1139194954676441,-27138796,-26729096,57.19782564094771,60.953501098676725,NaN,NaN,2.339623460825726,7.209071125719762
2006-09-15T09:30:00-04:00,31.27,31.38,31.17,31.17,4258801,2839275.2,45.37704446721587,53.10542323881636,NaN,NaN,-116.84764944927358,-126.29988799281261,-0.0885125284095176,0.003278834955747101,0.0917913633652647,-31397597,-28222856.4,50.53423450573288,60.70638269097376,NaN,NaN,0.49738415131160485,6.250258700804311
2006-09-18T09:30:00-04:00,31.3,31.78,31.22,31.55,3340200,2945785.2,50.9807742046849,52.91895154600521,NaN,NaN,-33.0226156089845,-99.35941760444948,-0.06678987613424352,0.008304018197460294,0.07509389433170381,-28057397,-27499756.4,53.36646911040844,60.85293546481246,NaN,NaN,0.7108538827770221,5.458915155371841
2006-09-19T09:30:00-04:00,31.50999,31.53999,31.06,31.14999,5340602,3163045.3,45.6694840572295,52.21209634970371,NaN,NaN,-97.00376793686266,-85.4668806879187,-0.07588562325797679,-0.019763134740767185,0.05612248851720961,-33397999,-28891737,47.70408222074309,60.670916395359676,NaN,NaN,-0.861754955206803,4.555962282432034
2006-09-20T09:30:00-04:00,31.10001,31.56,31.10001,31.42,7781000,3456060.3,49.494440309518346,51.76731947575719,NaN,NaN,-61.81064882476622,-80.38291415458629,-0.060888862182564576,-0.01998858921099611,0.040900272971568466,-25616999,-29121757.6,46.82002386404472,60.228636386532855,NaN,NaN,-0.9142035758934204,3.7745100169569694
2006-09-21T09:30:00-04:00,31.2,31.53999,31.10001,31.14,2955300,3472725.3,45.8867225961233,50.895079441426375,NaN,NaN,-81.23332944225977,-77.98360225242934,-0.0665391139568064,-0.04227361947443953,0.024265494482366867,-28572299,-29408458.2,45.68362063640503,59.361628590265035,NaN,NaN,-2.1272255331587164,2.931404938369014
2006-09-22T09:30:00-04:00,31,31.28999,30.98,31.11,2492900,3502295.3,45.50400916823404,49.63087869060909,NaN,NaN,-102.93801013029483,-75.2016743886336,-0.06872824579689554,-0.061644812763752554,0.0070834330331429815,-31065199,-29341978.6,46.010849647526555,58.161092625486376,NaN,NaN,-3.2042136177813716,2.054888001776102
2006-09-25T09:30:00-04:00,31.10001,31.32001,30.67,31.28,3230700,3582615.3,48.14339621334236,48.38499547229459,NaN,NaN,-99.88989526749569,-88.57513032033584,-0.055713078468867853,-0.06255791505294184,-0.006844836584073984,-27834499,-29297399,46.24471967733991,56.49139811553456,NaN,NaN,-3.3158079293622307,1.2876457258991976
2006-09-26T09:30:00-04:00,31.25,31.94,31.25,31.89999,3348800,3647170.3,56.43112162959062,48.330850015624776,NaN,NaN,37.89069330587781,-61.59623807178775,-0.005006135639631365,-0.01310250613361319,-0.008096370493981824,-24485699,-27514939,54.695187037349655,55.262345552055585,NaN,NaN,-0.7057581613325935,1.0028737420089417
2006-09-27T09:30:00-04:00,32.05,32.07001,31.62,31.83,4785398,3698655.2,55.355576461678716,48.63963090732691,NaN,NaN,63.91270938791416,-36.45156642925167,0.02264563844521597,0.020210677562538137,-0.0024349608826778318,-29271097,-28245758.6,51.14510224763525,53.76209089642414,NaN,NaN,1.0430619633070675,1.0086149164801026
2006-09-28T09:30:00-04:00,31.89,31.99001,31.75999,31.92,1853100,3704145.2,56.50360950741153,48.89670245082509,NaN,NaN,70.5325168613629,-6.0983971685271285,0.044555901767435846,0.053259916326616974,0.00870401455918113,-27417997,-28014898.2,52.2005493223597,52.26213624205652,NaN,NaN,2.812725032451099,1.2663449330473877
2006-09-29T09:30:00-04:00,31.8,31.89,31.64,31.64,2764300,3793645.2,52.02161608698427,49.686827530954304,NaN,NaN,37.85983913219328,22.06117268397049,0.03800483764144724,0.05621006161099018,0.01820522396954294,-30182297,-27838317.8,53.03628422276162,51.45975364043797,NaN,NaN,3.0032706528514024,1.5144771787336755
2006-10-02T09:30:00-04:00,31.5,31.86,31.45,31.7,1882200,3740385.2,52.88407935332747,50.14482693141646,NaN,NaN,33.87746527902493,48.81464479327461,0.03556956745050179,0.06266718328267018,0.027097615832168388,-28300097,-27931437.4,52.51483630442427,51.05203600727979,NaN,NaN,3.4073052886864748,1.7848811944412182
2006-10-03T09:30:00-04:00,31.48,31.48,31.23,31.28,4682500,3799425.2,46.5728939323688,49.930688453886425,NaN,NaN,-37.36963422623033,33.76257928685298,0.005128109177681778,0.03350775230427061,0.028379643126588833,-32982597,-29630817,44.01070173056017,50.08317758344564,NaN,NaN,1.8556909365734995,1.7949968718886868
2006-10-04T09:30:00-04:00,31.14999,31.4012,30.97,31.33,5462199,3880490.15,47.37801029712417,49.87162702034533,NaN,NaN,-57.817983827650096,9.416440643740131,-0.011288679673874414,0.014268793534245816,0.02555747320812023,-27520398,-29280677.2,45.95273899903235,49.27995710902311,NaN,NaN,0.8257873375088691,1.6565383669772844
2006-10-05T09:30:00-04:00,31.35001,31.88,31.35001,31.83,1997200,3830395.15,54.72544706586822,50.53937006310621,NaN,NaN,74.79537342672799,10.26901195681315,0.010689195666273986,0.03891896779096271,0.028229772124688725,-25523198,-28901717.4,48.05288884586409,49.1027181333182,NaN,NaN,2.164380375801141,1.7290872253806924
2006-10-06T09:30:00-04:00,30.92999,32,30.92999,31.98,2340100,3806865.15,56.67963633374881,50.94643164375363,NaN,NaN,62.224430026835314,15.141930135741557,0.03321944097617153,0.06975407334490313,0.036534632368731605,-23183098,-27501877.6,55.00769062490281,49.21994824149636,NaN,NaN,3.865216911495061,2.0342486091113163
2006-10-09T09:30:00-04:00,32.05,32.44,32.02,32.24001,2531900,3546255.05,59.90986624397335,51.963601799949615,NaN,NaN,197.7687855135055,47.92019418263767,0.06185969576430606,0.11385925207411418,0.05199955630980812,-20651198,-25972097.8,61.13192321044412,50.17907974076072,NaN,NaN,6.311053557366751,2.6452207445763785
2006-10-10T09:30:00-04:00,32.17,32.39999,32,32.39,1862400,3377635,61.68475010338279,52.834338213797075,NaN,NaN,174.11449086162983,90.2170192002097,0.08566600650828296,0.15908206444516182,0.07341605793687886,-18788798,-23133338,69.44377059458779,51.795061650085245,NaN,NaN,8.879740576660716,3.5358664348741407
2006-10-11T09:30:00-04:00,32.14,32.25999,31.83,32.10001,4651898,3511669.9,56.478544326808446,53.59089690884601,NaN,NaN,110.08912102528151,123.79844017079601,0.07692078274339409,0.16956703636612147,0.09264625362272738,-23440696,-22317397.6,71.34083680138207,53.62771994758361,NaN,NaN,9.535873097357376,4.393010243800317
2006-10-12T09:30:00-04:00,32.22,32.48,32.14999,32.42999,2523600,3504254.9,60.557910700558466,54.66617558972633,NaN,NaN,152.03600810904072,139.24656710725858,0.08762104587061197,0.20217256096099234,0.11455151509038038,-20917096,-21396177.2,73.3523868125699,55.58068688794385,NaN,NaN,11.372116494324898,5.390025422446685
2006-10-13T09:30:00-04:00,32.48,32.89,32.45,32.75,2762600,3429444.85,64.0747292662534,55.8041279506485,NaN,NaN,190.82748098319226,164.96717729852998,0.10911246978992842,0.2509421023277909,0.1418296325378625,-18154496,-20390456.8,75.3837501777448,57.66204620940134,NaN,NaN,14.062518450813505,6.62895299792766
2006-10-16T09:30:00-04:00,32.85001,33.05,32.84,32.99001,1602800,3342574.85,66.488180511465,56.52248929935382,NaN,NaN,191.2487379175501,163.6631677793389,0.1308868657842119,0.3054382147681274,0.17455134898391547,-16551696,-19570556.4,76.92788504415888,59.250096067030576,NaN,NaN,17.079610195919802,8.12190402621225
2006-10-17T09:30:00-04:00,33.03,33.03,32.5,32.75999,2855600,3218324.75,62.17706514691582,57.009738491156476,NaN,NaN,137.05631588905928,156.25153278482478,0.12140263920747374,0.32630464799325765,0.2049020087857839,-19407296,-19694256,76.15175386747688,61.03628546844783,NaN,NaN,18.279209120067357,9.572947611048694
2006-10-18T09:30:00-04:00,33.05,33.06,32.58,32.64,2079800,2933264.75,59.991814140330675,57.258895964936414,NaN,NaN,117.95037856051694,157.82378429187185,0.09956844879033283,0.32936256977369993,0.2297941209833671,-21487096,-19303536,76.94304327341791,62.80360646495199,NaN,NaN,18.60799471826926,10.863668626365918
2006-10-19T09:30:00-04:00,32.66,32.92999,32.59,32.86,2808400,2925919.75,62.58804788731825,58.013641093531696,NaN,NaN,107.6446153071072,148.94550573148518,0.09260855552349506,0.3455548153877359,0.25294625986424085,-18678696,-18855856,77.84990532075588,64.57600797195157,NaN,NaN,19.661472548838475,12.120497758147712
2006-10-20T09:30:00-04:00,32.81,32.88,32.67,32.67999,2558300,2929189.75,59.202760644403554,58.464975471465706,NaN,NaN,90.97102128177512,128.97421379120175,0.06959765531865192,0.33994332901255575,0.27034567369390383,-21236996,-19472356,73.55922219574275,66.07917839276004,NaN,NaN,19.547163255241774,13.181449972018292
2006-10-23T09:30:00-04:00,32.58,32.89999,32.58,32.89,3224000,2928854.75,61.798788124326805,59.55253934231985,NaN,NaN,88.132365511948,108.3509393100813,0.06246410244472089,0.348425801749805,0.2859616993050841,-18012996,-19764616,71.54607671809197,68.04599089186945,NaN,NaN,20.212390374923885,14.185870029576234
2006-10-24T09:30:00-04:00,32.89999,33.31,32.84,33.27,4015000,2962164.75,66.01302830628228,60.88361205725971,NaN,NaN,121.94690342840359,105.32905681795016,0.07636211225946521,0.3814143396294156,0.3050522273699504,-13997996,-18682756,74.34503151149025,70.07401178561645,NaN,NaN,22.10052665769344,15.316535262164406
2006-10-25T09:30:00-04:00,33.25999,33.44,33.03999,33.24001,2792100,2862499.85,65.399836478554,61.64606844388012,NaN,NaN,119.4441052478579,105.62780215541834,0.07637509278962817,0.4005210933569856,0.32414600056735743,-16790096,-17743356,76.50612045361568,72.10638547188442,NaN,NaN,23.4427657938142,16.477425338114376
2006-10-26T09:30:00-04:00,33.39,33.42999,33.07001,33.31,2828200,2911254.85,66.18918100870694,62.325321634948565,NaN,NaN,109.76151245860349,106.05118158571761,0.0738909412440159,0.4165096771223773,0.3426187358783614,-13961896,-16799996,78.46768856737214,73.78209961063223,NaN,NaN,24.77773273942313,17.66318353830134
2006-10-27T09:30:00-04:00,33.25,33.69,33.16,33.39,3352200,2940649.85,67.1127196885763,62.83981116670592,NaN,NaN,114.48756587744138,110.75449050485088,0.07044226143280474,0.43067156266936735,0.3602293012365626,-10609696,-14674536,82.09498818028173,75.27946139419205,NaN,NaN,26.15392058805604,18.87614597398058
2006-10-30T09:30:00-05:00,33.45,33.58,33.24001,33.48,3828500,3037964.85,68.16619686417175,63.30277164961941,NaN,NaN,107.84705094311816,114.6974275910849,0.06704744396047502,0.4440386061871564,0.3769911622266814,-6781196,-12428176,84.97569061379883,76.38888425270713,NaN,NaN,27.608943050125312,20.12368841342983
2006-10-31T09:30:00-05:00,33.50999,33.57001,33.33,33.53999,849600,2846319.85,68.88173628248461,64.18871393216772,NaN,NaN,109.58546633868511,112.2251401731412,0.06179636552198453,0.454236619129162,0.3924402536071775,-5931596,-10814896,86.63833524577576,77.48156271302096,NaN,NaN,29.032674782083074,21.396400751808862
2006-11-01T09:30:00-05:00,33.53999,33.83,33.21001,33.28,2856700,2716044.9,62.34161841472732,64.31612162603692,NaN,NaN,103.63210768034835,109.0627406596393,0.03509586639487389,0.43631008660076986,0.401214220205896,-8788296,-9214536,88.05097088006096,78.53146157498462,NaN,NaN,28.52807917644918,22.415211955328907
2006-11-02T09:30:00-05:00,33.2,33.49001,33.12,33.39,2268000,2729584.9,63.903221501041536,64.30387107137892,NaN,NaN,79.25435467878187,102.96130910367496,0.019882877066417615,0.426067816538918,0.4061849394725004,-6520296,-7726216,89.19504905069076,79.51798292305219,NaN,NaN,28.515415116694403,23.28666954980969
2006-11-03T09:30:00-05:00,33.50999,33.67,33.25,33.28,4326801,2828919.95,61.171461468173746,63.924105425429545,NaN,NaN,82.17834925919341,96.49946578002539,-0.0014176767700327941,0.40441284350995943,0.4058305202799922,-10847097,-7773696.2,88.90260789885447,80.37332026981616,NaN,NaN,27.762654461568488,23.926095965775232
2006-11-06T09:30:00-05:00,33.48,33.77,33.41,33.69,2715600,2838104.95,66.858294787656,64.25847897119671,NaN,NaN,109.90006337116564,96.91006826563489,0.007771228482538917,0.41554455588316586,0.40777332740062694,-8131497,-8043756.4,87.15232028381473,81.1590750138403,NaN,NaN,28.715822273999663,24.610342581235866
2006-11-07T09:30:00-05:00,33.88,33.92999,33.58,33.58,2189200,2854444.95,64.14392808777532,64.55505853887132,NaN,NaN,112.86024785656687,97.56502456921123,0.0023857410289901404,0.41075550368686464,0.4083697626578745,-10320697,-8921576.6,81.53331200388376,81.48695135173071,NaN,NaN,28.72674197792809,25.198399637906185
2006-11-08T09:30:00-05:00,33.64999,33.73,33.36,33.66,1680400,2705870.05,65.24893088724986,64.745121610295,NaN,NaN,88.1235393963739,94.46331091241635,0.0002675412705362423,0.4087041892460448,0.40843664797550855,-8640297,-8891976.8,81.5764462303211,81.75313284527108,NaN,NaN,29.04571856862919,25.74801662800947
2006-11-09T09:30:00-05:00,33.67999,34.21001,33.67999,34.03,1521000,2655740.05,69.87326454875456,65.5073004606058,NaN,NaN,157.19258733257027,110.05095744317403,0.018814766399422422,0.4319551059747866,0.41314033957536417,-7119297,-9011777,80.75429430464897,82.26706656733582,NaN,NaN,30.735952382727504,26.460578878683474
2006-11-10T09:30:00-05:00,33.95,33.95,33.50999,33.7,2358500,2635535.05,61.95460803425929,65.5184304541724,NaN,NaN,96.94954748592772,113.00519708852089,0.004627155971973773,0.41892428454033137,0.4142971285683576,-9477797,-8737917,81.22023767009918,82.95807806390776,NaN,NaN,29.72756085363501,26.927290589390836
2006-11-13T09:30:00-05:00,33.58,34.03,33.5,34.03,1270500,2618920.05,66.09285476444775,65.52413234404136,NaN,NaN,114.89874994607162,114.0049344035021,0.012774834674706581,0.4302656719117408,0.41749083723703423,-8207297,-8753077,81.1031819970587,83.44080309859122,NaN,NaN,30.188733752539896,27.39321104126927
2006-11-14T09:30:00-05:00,34.10001,34.11,33.72,34.02,2023700,2577325.05,65.85907834104934,65.5569353342196,NaN,NaN,126.90780401009434,116.8144456342076,0.012767602986461735,0.43345034097011137,0.42068273798364964,-10230997,-8735137,81.13782598496603,83.77163920797338,NaN,NaN,30.480580691348795,27.83426384842349
2006-11-15T09:30:00-05:00,33.92999,34.24001,33.82001,34.16,4898602,2718265.15,67.58758217386347,65.65682113173078,NaN,NaN,142.60096838508275,127.70993143194937,0.01719296017189781,0.4421739381985219,0.4249809780266241,-5332395,-8073556.6,82.417954227764,84.05380104085852,NaN,NaN,31.241027524117893,28.32094437352269
2006-11-16T09:30:00-05:00,34.53999,34.53999,33.96001,33.98,1567300,2656210.15,63.16000238411558,65.37448418141216,NaN,NaN,143.58692071788377,124.98879810901205,0.0037037549979577755,0.4296106717740713,0.42590691677611353,-6899695,-8029636.2,82.50285220290414,84.08293418533154,NaN,NaN,30.561303764096927,28.640995715033295
2006-11-17T09:30:00-05:00,33.8,34.02,33.69,33.83,6759699,2866280.1,59.65300647074151,64.76639915330999,NaN,NaN,66.34576776467114,118.86804216476074,-0.018400736067320234,0.40290599669196325,0.4213067327592835,-13659394,-8865955.6,75.06954195328339,83.37535213815188,NaN,NaN,28.94113712230293,28.683873058928956
2006-11-20T09:30:00-05:00,34.52,34.69991,34.34,34.48,4663000,2938230.1,67.95618109537976,64.70028806851678,NaN,NaN,197.50405083051248,135.3891023416489,0.006349702577830685,0.42924386098157186,0.42289415840374117,-8996394,-9023775,73.71974018440042,82.45259534805362,NaN,NaN,30.163239055238417,28.895211058401735
2006-11-21T09:30:00-05:00,34.34,34.60001,34.31,34.57001,2907200,2882840.1,68.91031942243407,65.1694809976387,NaN,NaN,167.467548162717,143.50105117217345,0.023418718724867893,0.452167556809826,0.4287488380849581,-6089194,-8195414.4,76.14434671495763,81.60212219340339,NaN,NaN,31.439950974340995,29.258745332107342
2006-11-22T09:30:00-05:00,34.74001,35.05,34.67999,35.05,2261400,2856305.1,73.45028935156198,65.85141441553301,NaN,NaN,212.68797435815725,157.51845236678835,0.05961261857084876,0.5032646112985191,0.4436519927276703,-3827794,-7894494.2,76.97538417353742,80.72928898789245,NaN,NaN,34.14202394887726,29.956356563074472
2006-11-24T09:30:00-05:00,34.95,35.08,34.88,35.08,655900,2747690.1,73.70870714133164,66.74693196361572,NaN,NaN,189.60426926049442,166.7219220753105,0.07704310121381719,0.5399558692449418,0.4629127680311246,-3171894,-7148934,78.93349733280306,80.01720966174591,NaN,NaN,36.32286057625305,30.865857136385696
2006-11-27T09:30:00-05:00,34.94,35,34.44,34.5,3437000,2751930.1,61.288400339124586,66.34908236014918,NaN,NaN,111.16538506632271,175.6858455356408,0.0426949310184338,0.5162814318041669,0.47358650078573306,-6608894,-5738834,82.04385527238304,79.6523193037865,NaN,NaN,33.98707726310268,31.311745725916694
2006-11-28T09:30:00-05:00,34.41,34.67,34.38,34.64,3642700,2742640.1,62.912905396314024,66.26115216790195,NaN,NaN,85.74070413729538,153.33317619699739,0.023544899747101666,0.5030176254696102,0.4794727257225085,-2966194,-4532794,84.19342783049889,79.84232757711617,NaN,NaN,32.67209783203774,31.506081741076844
2006-11-29T09:30:00-05:00,34.61,34.94,34.60001,34.92999,1419300,2771125.1,66.08744086376652,66.32104573765317,NaN,NaN,110.35158980436417,141.9099845253268,0.02444299160649216,0.5100264652306237,0.4855834736241315,-1546894,-3624334,85.59254787421892,80.12919198025172,NaN,NaN,32.62280977763515,31.665614317728032
2006-11-30T09:30:00-05:00,34.92999,35.08,34.75999,35,1658000,2711190.1,66.82572003491902,66.1033639866649,NaN,NaN,112.77673732647199,121.92773711898974,0.023765458979460585,0.5152902973484572,0.49152483836899663,111106,-2836554,86.69255566794783,80.55335350620165,NaN,NaN,32.81549350123188,31.829882772514296
2006-12-01T09:30:00-05:00,34.91,35,34.45,34.72,4243699,2809975.05,61.096939985505806,66.04210198318252,NaN,NaN,71.93112409476903,98.39310808584467,-0.00025511397196931185,0.491205945904035,0.4914610598760043,-4132593,-3028693.8,84.9881844341824,80.82249256077901,NaN,NaN,31.157021198381496,31.733759690495326
2006-12-04T09:30:00-05:00,34.84,35.28,34.83,35.23,3507600,2769015,66.69706629308993,66.0852599495141,NaN,NaN,115.20001322318714,99.20003371721756,0.01276908162965179,0.507422411913069,0.49465333028341724,-624993,-1831913.6,86.73722021020464,81.224923861718,NaN,NaN,31.553689253233983,31.708035342315135
2006-12-05T09:30:00-05:00,35.22,35.49001,35.17999,35.38,3290800,2797775,68.14930733757943,66.24884773498054,NaN,NaN,134.24597888853236,108.90108866746498,0.025326008334675132,0.5263108407017612,0.500984832367086,2665807,-705513.4,88.13804769211318,81.7249396979428,NaN,NaN,32.343671943894186,31.79884057111214
2006-12-06T09:30:00-05:00,35.33,35.48,35.2,35.24001,879100,2732270,65.28790211359652,66.08458487353289,NaN,NaN,118.21912423806083,110.4745955542043,0.01836759767419538,0.5239443294598303,0.5055767317856349,1786707,-38793.2,88.88629398970586,82.18696396665293,NaN,NaN,32.087651174460404,31.840099228733322
2006-12-07T09:30:00-05:00,35.45,35.62,35.33,35.46001,1985800,2747540,67.59090842542324,66.40107816219772,NaN,NaN,130.28356994623098,113.97596207815609,0.02247398034022252,0.533669207210913,0.5111952268706905,3772507,693487,89.65793289435929,82.69804115889973,NaN,NaN,32.587832412218134,31.946918254945437
2006-12-08T09:30:00-05:00,35.42999,35.57001,35.37,35.55,587000,2700840,68.51120244037985,67.03380644574332,NaN,NaN,120.76979739155462,123.74369673751323,0.02495214051765482,0.542385402517759,0.5174332620001042,4359507,2391907,91.186414812251,83.84924636311169,NaN,NaN,33.2706524116473,32.13602313447427
2006-12-11T09:30:00-05:00,35.63,35.64,35.42,35.42,7031898,2934509.9,65.6126503822509,66.86641139480555,NaN,NaN,110.4127161820888,122.78623732929354,0.012183734292898096,0.5326629298662269,0.5204791955733288,-2672391,1982427.4,87.81663440378158,84.85616737878179,NaN,NaN,32.99382057143081,32.258565625468066
2006-12-12T09:30:00-05:00,35.2,35.25,34.83,35.02,3347100,3038339.9,57.54530364863352,66.05462455381979,NaN,NaN,37.466841015046754,103.43040975459644,-0.02673012185032264,0.48706654326042553,0.5137966651107482,-6019491,245367.8,75.13236012582753,84.78388262241535,NaN,NaN,30.244608006886104,31.97085739424207
2006-12-13T09:30:00-05:00,35.12,35.23,35.02,35.23,2757500,3075029.9,60.304772072429806,65.11565903388177,NaN,NaN,52.01349048247088,90.18928300347844,-0.04100181255635271,0.46254439941530734,0.50354621197166,-3261991,-764371.8,68.90217279177571,84.20722466657523,NaN,NaN,28.767980949489093,31.513303616420217
2006-12-14T09:30:00-05:00,35.16,35.52,35.08,35.49001,2761300,2968164.8,63.47066951629893,64.38437063209372,NaN,NaN,81.50306979692334,80.43318297361691,-0.03579515296261793,0.45880227076838764,0.49459742373100557,-500691,-1619011.4,64.06021734891766,83.14484752486912,NaN,NaN,28.480318548849976,31.080020035338755
2006-12-15T09:30:00-05:00,35.14999,35.49001,35.14999,35.37,5539301,3166764.85,61.05042469503675,64.36737237180174,NaN,NaN,70.85956246479171,70.45113598826433,-0.04282318666861684,0.4410684403952345,0.48389162706385136,-6039992,-3698911.2,54.096892815396195,81.14863592079864,NaN,NaN,27.516878273278145,30.57099978361581
2006-12-18T09:30:00-05:00,35.36,35.3699,35,35.00999,3451300,3001344.9,54.35459641293207,63.75606458727445,NaN,NaN,19.727052073346673,52.314003166515896,-0.07236990458092973,0.39342924633768916,0.4657991509186189,-9491292,-5062691.4,48.74360975108435,78.61650605798332,NaN,NaN,24.570701250683683,29.713814278911222
2006-12-19T09:30:00-05:00,34.8,35.3,34.8,35.27,3546700,2945529.9,57.94233617326275,63.17427139509561,NaN,NaN,12.707631040765996,47.36216117165974,-0.07474883614605571,0.37236310573604925,0.44711194188210496,-5944592,-5047711.6,48.803538353680835,75.98871966365917,NaN,NaN,23.183567204639115,28.780921839729494
2006-12-20T09:30:00-05:00,35.14999,35.34,35.10001,35.10001,953900,2847864.9,54.90393337682224,62.32271520523155,NaN,NaN,21.245711469227825,41.20860536901113,-0.08724604575648887,0.33805438468649385,0.4253004304429827,-6898492,-5775011.8,45.99189755188987,73.08152979822646,NaN,NaN,21.09760610247751,27.683305305836353
2006-12-21T09:30:00-05:00,35.14999,35.34,34.5,34.6763,6316699,3050629.85,48.129257379203715,61.396452161924266,NaN,NaN,-78.84758881283179,9.138473647060104,-0.121423037921143,0.27352163304155397,0.394944670962697,-13215191,-8317911.8,37.79354771653371,69.7104843183944,NaN,NaN,17.052071616431387,26.16455763592136
2006-12-22T09:30:00-05:00,34.75999,34.77,34.39,34.49001,2116400,3123654.85,45.47257213550991,59.88041686495426,NaN,NaN,-140.10357716300805,-33.05415427849985,-0.1519685459711605,0.20498398849874633,0.3569525344699068,-15331591,-10176231.6,33.143857426781935,65.88238697672136,NaN,NaN,12.875785922938867,24.26616167692386
2006-12-26T09:30:00-05:00,34.64,34.81,34.59,34.78999,379600,2970784.85,50.236140871896254,58.60090497454832,NaN,NaN,-95.71181749448064,-56.141928192065315,-0.1472576816846602,0.17288043236408157,0.32013811404874176,-14951991,-11268371.4,30.749510719699842,61.78320576440613,NaN,NaN,10.822770740209817,22.345677257393284
2006-12-27T09:30:00-05:00,35.03,35.19,34.88,35.13,1130000,2845149.85,55.031387861873455,57.86829681371096,NaN,NaN,-13.737669933756958,-61.43098838696991,-0.11780550641094839,0.17288123103505626,0.29068673744600465,-13821991,-12843851.2,27.646755944358304,57.4089530468813,NaN,NaN,10.618990265279232,20.67043625851985
2006-12-28T09:30:00-05:00,35.25,35.25,35,35.08,1383300,2843349.85,54.20422117470245,56.912104867230894,NaN,NaN,-5.2495980069663775,-66.73005028220875,-0.09901091291137826,0.16692309630678182,0.2659340092181601,-15205291,-14505211,24.804429078600904,52.77655991718427,NaN,NaN,10.204903705456493,19.175360179510797
2006-12-29T09:30:00-05:00,35.05,35.05,34.78,34.81,524700,2786684.85,49.847088263893795,55.57895385462475,NaN,NaN,-78.58881616020429,-66.67829575168327,-0.10169574898551156,0.1388143229862706,0.24051007197178217,-15729991,-15008171,23.999986101448457,47.9775292949841,NaN,NaN,8.51007906597898,17.651748591863395
2007-01-03T09:30:00-05:00,34.85001,35.06,34.44,34.61,3817800,2765389.9,46.84332092580341,54.2382874648785,NaN,NaN,-134.77363976093645,-65.61230827126894,-0.11300371019715266,0.09925543422534133,0.212259144422494,-19547791,-15851411,22.672390577713628,43.32436902169353,NaN,NaN,6.170407663064906,16.01155703060647
2007-01-04T09:30:00-05:00,34.58,34.58,34.23,34.45,4474398,2813729.8,44.53142763514709,53.308724892486616,NaN,NaN,-179.76267486050907,-82.42247974447463,-0.1263134323085048,0.05436735403686299,0.1806807863453678,-24022189,-17665450.6,20.096878224337914,39.39326317158712,NaN,NaN,3.523722760070966,14.227580706244254
2007-01-05T09:30:00-05:00,34.37,34.46001,33.98,34.22,6999602,2999169.9,41.37057531614085,51.95628226703741,NaN,NaN,-188.19122970195622,-117.3131916981145,-0.14435944434932654,0.00023148090870961369,0.14459092525803616,-31021791,-21105410.6,16.312615817278584,35.636866244837336,NaN,NaN,0.3070965620131434,12.238940114211239
2007-01-08T09:30:00-05:00,34.24001,34.28999,34.03999,34.22,3339500,3122189.9,41.37057531614085,50.377704109883254,NaN,NaN,-161.31501948120365,-148.52627599296196,-0.14942098233729534,-0.042185302663583,0.10723567967371232,-31021791,-24268710.6,13.748788623132981,32.04319276442414,NaN,NaN,-2.284671567997506,10.164138445324276
2007-01-09T09:30:00-05:00,34.3,34.41,33.97,34.23,3853900,3215594.9,41.579670063421275,48.98693592191073,NaN,NaN,-135.95985298247976,-160.00048335741704,-0.1451000320732065,-0.07413936041779579,0.0709606716554107,-27167891,-26556290.6,12.24944201731958,29.05408913599009,NaN,NaN,-4.3619775252694515,8.088979020953744
2007-01-10T09:30:00-05:00,34.10001,34.49001,33.98,34.47,4336898,3403089.8,46.51020820626495,48.426622478577364,NaN,NaN,-102.44659998857362,-153.53507540294447,-0.12011605629271922,-0.07918439871048832,0.0409316575822309,-22830993,-27212931,11.849966008545323,26.418828868665877,NaN,NaN,-4.84554772151094,6.241189486315932
2007-01-11T09:30:00-05:00,34.50999,34.95,34.45,34.84,3684100,3235699.9,53.08413961521681,48.07960843871694,NaN,NaN,-13.85924870916344,-120.35439017267535,-0.07492053263679563,-0.05271900821376363,0.02220152442303199,-19146893,-26237871.8,16.219215906751785,24.0913772653138,NaN,NaN,-3.3258126132906676,4.874474900657846
2007-01-12T09:30:00-05:00,34.78999,35.36,34.78999,35.23,3189600,3227824.9,58.82799902979303,48.35989884250056,NaN,NaN,62.096954127879215,-70.29675340670826,-0.017978914042299694,-0.0002721181298426245,0.01770679591245707,-15957293,-23224972.2,28.081384158776856,22.81205488009144,NaN,NaN,-0.13888577416563533,4.158280518540206
2007-01-16T09:30:00-05:00,35.33,35.42,35.2,35.32001,2064900,3193194.9,60.04384522821716,49.2109408317158,NaN,NaN,96.2278264075748,-18.788184228952584,0.024236272174922555,0.04800213613111026,0.023765863956187707,-13892393,-19799092.6,38.708012320304405,22.877373780360774,NaN,NaN,2.8308204331093103,3.9686433634786495
2007-01-17T09:30:00-05:00,35.33,35.48,35.17999,35.44,3217000,3215979.9,61.66889612726067,50.36782111684086,NaN,NaN,106.69392034164731,29.742570435872842,0.05686624025216658,0.09484866427139593,0.037982424019229355,-10675393,-16500593,46.850910693783646,23.856449013718038,NaN,NaN,5.790883136834759,4.2289633311009505
2007-01-18T09:30:00-05:00,35.49001,35.59,35.17999,35.23,1822300,3030129.85,57.278217028481066,50.87082655659692,NaN,NaN,100.18212423603347,70.26831528079427,0.06058906190313893,0.11371875139815302,0.053129689495014086,-12497693,-14433933,51.22335711660936,25.318866613497285,NaN,NaN,7.05651475061573,4.632899248174491
2007-01-19T09:30:00-05:00,35.36,35.81,35.2491,35.77,10905398,3402834.75,64.31413677929207,51.533880050698244,NaN,NaN,140.49598508835595,101.13936204029815,0.09372344087126556,0.17028399058409605,0.07656054971283048,-1592295,-10923013.4,57.60432753486137,27.45869315567608,NaN,NaN,10.54540556475136,5.477543007685472
2007-01-22T09:30:00-05:00,35.85001,35.85001,35.30949,35.39999,3344400,3392719.75,57.3451078553665,51.75822909931711,NaN,NaN,113.91252626802279,111.50247646832686,0.08526712834099617,0.1831444601390757,0.09787733179807953,-4936695,-8718893.8,61.04932399674969,30.047614221258137,NaN,NaN,11.23748088925448,6.300391276481044
2007-01-23T09:30:00-05:00,35.5,35.87,35.36,35.85001,2421300,3466089.75,62.646609358441886,52.67248060607054,NaN,NaN,130.47841967145774,118.35259512110345,0.10332392782849642,0.22703224158370006,0.12370831375520364,-2515395,-6443494.2,64.27653957482156,32.924510897927625,NaN,NaN,13.672681033529097,7.353575527487909
2007-01-24T09:30:00-05:00,35.83,36.28,35.81,36.22,4037900,3352149.8,66.34968074186534,54.06579202150353,NaN,NaN,164.09592358482365,129.83299576973872,0.13170924125068817,0.28834486531856385,0.15663562406787568,1522505,-4003914.6,67.39564851316956,36.11902932188876,NaN,NaN,17.000314319950444,8.731681069268271
2007-01-25T09:30:00-05:00,36.48,36.48,35.94,36.10001,3971000,3444879.8,64.12929578858282,55.46563974674895,NaN,NaN,151.9979605245556,140.19616302744313,0.13351069115624803,0.3235239880131857,0.19001329685693769,-2448495,-1994075,69.73977110344498,39.664950241824975,NaN,NaN,18.89012493254584,10.182887335450781
2007-01-26T09:30:00-05:00,36.16,36.16,35.75,36.08,3435400,3597669.8,63.746179761955894,57.06389720716431,NaN,NaN,114.41240792647635,134.97944759506723,0.12463164760071238,0.34580285635782815,0.22117120875711577,-5883895,-2852395,67.5075877741329,43.32173395302886,NaN,NaN,20.255318067914597,11.621806011517041
2007-01-29T09:30:00-05:00,36.11,36.17,35.86,35.94,2830000,3682669.8,61.000360900846516,58.466024748928994,NaN,NaN,100.02679285017291,132.20230091149725,0.1015821895776503,0.34814894572917865,0.24656675615152834,-8713895,-3607835,65.51985633434808,47.0196673609728,NaN,NaN,20.562088636318926,12.898989243631595
2007-01-30T09:30:00-05:00,35.97,36.06,35.83,36.03999,3034300,3765219.8,62.25101222575225,59.942549189095494,NaN,NaN,87.79056488211313,123.66472995362832,0.08594335575147782,0.35399595084087565,0.2680525950893978,-5679595,-4240675,63.824461311986205,50.70359731059184,NaN,NaN,21.178559080523375,14.081784934616135
2007-01-31T09:30:00-05:00,35.99001,36.64999,35.92999,36.25,3951300,3936549.8,64.80393600189132,61.24924403164023,NaN,NaN,109.100341918464,112.66561362035638,0.08259450819628811,0.37129573033475793,0.2887012221384698,-1728295,-4890835,62.04807551761696,54.28917656123981,NaN,NaN,22.454299883374695,15.2778584987245
2007-02-01T09:30:00-05:00,36.63,36.78,36.59,36.69,1730300,3832174.8,69.46353629764336,62.41920093752784,NaN,NaN,137.83759839620097,109.83354119468547,0.101613512971796,0.41571811335321485,0.31410460038141885,2005,-4400735,62.88662693968532,57.62256306359222,NaN,NaN,25.071259669377593,16.6769158088178
2007-02-02T09:30:00-05:00,36.62,36.69,36.37,36.63,6801000,3948504.9,68.13879142000657,63.084257536828815,NaN,NaN,113.52517680885899,109.65609497116199,0.10151481693393472,0.4409981215488372,0.3394833046149025,-6798995,-4583755,62.33275324615003,60.069089426976014,NaN,NaN,26.794936275648197,18.122347304079284
2007-02-05T09:30:00-05:00,36.7,36.75999,36.45,36.48,3033600,3750204.8,64.81105337307375,63.42477240431857,NaN,NaN,105.38728463376343,110.7281933278801,0.08346372766133581,0.44381296419157223,0.3603492365302364,-9832595,-4807495,61.61827056098398,61.70553644416741,NaN,NaN,27.273356085970015,19.42963427292082
2007-02-06T09:30:00-05:00,36.61,36.78,36.53999,36.73,4313301,3798894.85,67.64702787905172,63.85178181516079,NaN,NaN,109.87743593267918,115.14556753799332,0.08044352884128625,0.4609036475818442,0.38046011874055796,-5519294,-4775434.8,61.68604090753692,62.76518860229264,NaN,NaN,28.52897197712879,20.72953965923624
2007-02-07T09:30:00-05:00,36.73,36.91,36.66,36.73,12246801,4218539.9,67.64702787905172,64.59241116163011,NaN,NaN,111.52691033126351,115.63088122055323,0.07086496174424617,0.4690413209208657,0.39817635917661953,-5519294,-5533634.6,59.03143165097504,63.32290821189019,NaN,NaN,29.54461629344567,21.98883632126616
2007-02-08T09:30:00-05:00,36.64999,36.84,36.57001,36.77,12896102,4646500.1,68.1237362919072,64.86452541253121,NaN,NaN,102.58777581614363,108.58091670454175,0.06006905175334287,0.4732626738682981,0.41319362211495525,7376808,-4058674,62.41953961029254,63.66685193156384,NaN,NaN,30.51961776585689,23.207519384779122
2007-02-09T09:30:00-05:00,36.85001,36.97,36.58,36.60001,4001600,4662375.1,63.82001999502798,65.32701913679273,NaN,NaN,93.90390439723365,104.65666222221668,0.035538093516792546,0.45761623901094595,0.4220781454941534,3375208,-2023833.4,66.53173979031325,64.05845305967553,NaN,NaN,30.19720552671999,24.206045976484962
2007-02-12T09:30:00-05:00,36.67,36.88,36.60001,36.75,2758116,4640800.9,65.86891135443284,65.55718356507779,NaN,NaN,89.39043098387305,101.45729149223861,0.024023604062859638,0.45210765057272795,0.4280840465098683,6133324,1169350.4,71.75490129358458,64.59262175387288,NaN,NaN,30.47422694183265,25.10150040010606
2007-02-13T09:30:00-05:00,37.05,37.53,36.99001,37.49001,15392941,5307202.95,73.76331790641484,66.08672907683133,NaN,NaN,157.03331334630766,110.8884669749643,0.058870136987495214,0.5016717177442374,0.44280158075674214,21526265,6578462.2,78.0142408054501,65.35109263189291,NaN,NaN,33.33118887306839,26.277170181957825
2007-02-14T09:30:00-05:00,37.57001,37.75,37.47,37.72,5228770,5407791.45,75.6484911670271,66.90952874672021,NaN,NaN,176.40604896978294,123.86429470266819,0.08826568588900258,0.5531336881179953,0.46486800222899277,26755035,13033328,82.88772101582596,66.2902319113487,NaN,NaN,36.32215802928298,27.71216844586142
2007-02-15T09:30:00-05:00,37.75,37.92,37.67,37.89999,3643100,5498831.45,77.0389502237297,67.85901235113262,NaN,NaN,180.63929617067907,139.47459877357528,0.10931164181731978,0.6015075545006425,0.49219591268332274,30398135,17637593.4,85.37758028482232,67.56665994782652,NaN,NaN,39.23023843793106,29.357607016157083
2007-02-16T09:30:00-05:00,37.84,38,37.71001,37.71001,2432300,5075176.55,72.34351223705421,68.66923744657603,NaN,NaN,160.82723243683327,152.8592643814952,0.10016120641619086,0.6173974207035613,0.5172362142873704,27965835,22555718.8,87.47410359839716,69.13482046668717,NaN,NaN,40.1805561314297,30.90374260405317
2007-02-20T09:30:00-05:00,37.78999,38.06,37.66,38.02,3335900,5074751.55,75.01898379314619,69.5812354156756,NaN,NaN,157.35178877542347,166.4515359398053,0.10424256860415693,0.6475394250425666,0.5432968564384096,31301735,27589401,89.18348401942393,70.94617923150415,NaN,NaN,41.850627193387105,32.4675832596723
2007-02-21T09:30:00-05:00,37.89999,38.53999,37.81,38.25999,3827000,5145036.55,76.88345778553783,70.44405840022178,NaN,NaN,159.30129865442768,166.9051330014293,0.11169858706123259,0.6829200902649504,0.5712215032037178,35128735,30309895,89.97940521974036,72.94127421022725,NaN,NaN,43.84632570182205,34.09311789426513
2007-02-22T09:30:00-05:00,38.55,38.7,38.14,38.25,2926800,5089481.55,76.627076976469,70.95573987728075,NaN,NaN,145.9799300376055,160.8199092149938,0.10467119460646934,0.7020604964618045,0.5973893018553351,32201935,31399275,90.28760018333905,74.89848658477395,NaN,NaN,45.35176999608531,35.70149676595373
2007-02-23T09:30:00-05:00,38.28,38.50999,38.03999,38.39999,4731898,5127526.45,77.82282672051056,71.64745668445961,NaN,NaN,120.57396435789697,148.80684285243737,0.09890525133939287,0.7210208660295763,0.6221156146901834,36933833,32706414.6,90.65884456790059,76.92177882204184,NaN,NaN,46.97055992043873,37.31136293088016
2007-02-26T09:30:00-05:00,38.95,39.16,38.59,38.75,4041369,5157824.9,80.34926605517971,72.75732901889576,NaN,NaN,145.9137608853026,145.82414854213124,0.1067716043011876,0.7555801200666679,0.6488085157654803,40975202,35308288,91.36627001211806,79.04663592569429,NaN,NaN,49.19322857353589,39.008772308402406
2007-02-27T09:30:00-05:00,37.98,38.03999,36.42,37.17999,9243102,5478480,51.82778886644787,71.62738337513834,NaN,NaN,-4.332674031507867,113.487255980745,-0.000004495750084321237,0.6488028960778749,0.6488073918279592,31732100,35394361,91.38950132981523,81.16831167014274,NaN,NaN,39.8233242493573,39.12513687139596
2007-02-28T09:30:00-05:00,37.25,37.45,36.72,37.45,8475500,5750540,54.799428488604306,70.70969770439208,NaN,NaN,-11.840834814644582,79.25882928693053,-0.05561309672822934,0.5792910209176725,0.6349041176459018,40207600,36410134,91.67421922279193,83.49993935384394,NaN,NaN,33.9539193834927,38.38639151598121
2007-03-01T09:30:00-05:00,36.5,37.39999,34.48,37.06,7733051,5939627.55,50.00151750902375,69.4152535056147,NaN,NaN,-105.7787679809861,28.9070896832122,-0.11822934861386847,0.48711743187856626,0.6053467804924347,32474549,36464656.8,91.69010279851318,85.59069386728827,NaN,NaN,27.500714324186376,36.83129477429623
2007-03-02T09:30:00-05:00,37.05,37.05,36.32001,36.45,5944602,6150342.65,43.57515773044838,67.96919191528758,NaN,NaN,-74.16642233427504,-10.040987655222201,-0.195725830374325,0.36068949252452853,0.5564153228988535,26529947,34383879.6,85.02364493489739,86.91154423475857,NaN,NaN,19.682428020884526,34.38145666666599
2007-03-05T09:30:00-05:00,36.10001,36.45,35.83,35.97,6020898,6111337.55,39.29539586447518,66.0710836660049,NaN,NaN,-122.1263538917281,-63.64901061062834,-0.26974406325662964,0.21923524382806647,0.4889793070846961,20509049,30290649,73.67558577168205,87.0487359831941,NaN,NaN,11.812211802376185,31.157278828910304
2007-03-06T09:30:00-05:00,36.2,36.83,36.2,36.7,6362301,6277772.6,47.70719479115331,64.20993201491478,NaN,NaN,-72.48060717837241,-77.27859724000125,-0.2598678645468213,0.16414447640116947,0.4240123409479908,26871350,29318499,71.24350008671206,86.56511164614139,NaN,NaN,8.536076891620636,27.925678552154636
2007-03-07T09:30:00-05:00,36.53999,36.87,36.50999,36.52,10999500,6612082.55,46.014057742021876,62.093186770271544,NaN,NaN,-66.27949619156165,-88.16632951538466,-0.2554077707212185,0.10475262754646764,0.36016039826768614,15871850,24451349,60.47916530076074,84.96450052363673,NaN,NaN,5.45743278793106,24.715929157265556
2007-03-08T09:30:00-05:00,36.75999,37.25999,36.36,36.88,10040301,6501757.55,49.84771789829139,60.15095588988309,NaN,NaN,-46.69612177943406,-76.34980027507424,-0.21953252756324998,0.08574473881362366,0.30527726637687363,25912151,23138869.4,57.937018615660946,83.00446040441092,NaN,NaN,4.352015449470318,21.806798627580523
2007-03-09T09:30:00-05:00,37.10001,37.41,37.07001,37.31,2021200,5958012.45,54.04542664253694,58.843949775989,NaN,NaN,-6.156890569187321,-62.7478939220567,-0.1608799214392867,0.10417736457776527,0.265057286017052,27933351,23419550.2,58.34030699685401,80.92347493287214,NaN,NaN,4.916362315281037,19.39387915439488
2007-03-12T09:30:00-04:00,37.10001,37.59,37.10001,37.42999,2380900,5876977.45,55.17294365758996,57.42637548059213,NaN,NaN,2.0242007640140955,-37.91778299090826,-0.1104430080874334,0.1270035259077602,0.2374465339951936,30314251,25380590.6,61.14340882556183,78.92061241902483,NaN,NaN,5.727434755438988,17.441529954544038
2007-03-13T09:30:00-04:00,37.25,37.47,36.44,36.52,7498398,6113991.55,45.96261115456952,55.21774357838011,NaN,NaN,-60.27283440673103,-35.476228436579994,-0.13327871356483773,0.07084814203914647,0.2041268556039842,22815853,24569491.2,59.364228926253666,76.73381411234722,NaN,NaN,3.2184164868139473,15.409656602011168
2007-03-14T09:30:00-04:00,36.55,36.92999,35.92999,36.75,7030602,5695874.6,48.3112750522018,53.195186298075306,NaN,NaN,-81.11317329337628,-38.442963856942924,-0.12778792385933824,0.044391950779811395,0.17217987463914963,29846455,27364412.2,63.3245122264227,74.80787925828176,NaN,NaN,2.0360473017152905,13.499140987683186
2007-03-15T09:30:00-04:00,37.07001,37.67,37,37.45,6131398,5741006,54.75649375194933,51.54759108603521,NaN,NaN,7.315655499049788,-27.64060840124615,-0.07454491549643852,0.07899873026860149,0.15354364576504,35977853,29377552.6,65.90221659803727,73.0395486890058,NaN,NaN,3.2705069012480776,12.037907546763885
2007-03-16T09:30:00-04:00,37.39999,37.42,36.85001,37.10001,6839898,5900845.9,51.311422763284256,49.473459422328396,NaN,NaN,-16.122245995952632,-29.633679486599213,-0.061000833962185225,0.07729260331230847,0.1382934372744937,29137955,29618473.4,66.20830865143348,71.2425514489569,NaN,NaN,3.1035658668327963,10.761573021059444
2007-03-19T09:30:00-04:00,37.5,37.64999,37.14999,37.64999,4770000,6017730.9,55.99658730964206,49.77123073969941,NaN,NaN,26.26437492177792,-24.78564465504645,-0.015476257656879044,0.11894811520339488,0.13442437286027392,33907955,30337214.2,67.15557107032247,69.51155643042172,NaN,NaN,4.5645702063593765,9.87628690467372
2007-03-20T09:30:00-04:00,37.55,37.92999,37.5125,37.81,2734587,5987665.25,57.284447458460356,49.948732094689134,NaN,NaN,58.59086603096551,-1.0129045675071453,0.022854898852807143,0.16299299642628284,0.1401380975734757,36642542,33102552,70.57347556673668,68.0043604549892,NaN,NaN,6.135121244830448,9.341834667553252
2007-03-21T09:30:00-04:00,37.8,38.3,37.66,38.24001,5003563,6046493.4,60.62004520612786,50.707198358768,NaN,NaN,97.22640835520328,34.655011762208765,0.07184665492404829,0.22994641622853607,0.15809976130448777,41646105,35462482,73.14212842621225,66.67950514268199,NaN,NaN,8.531921612656424,9.22613280256799
2007-03-22T09:30:00-04:00,38.21001,38.25999,37.978,38.06,1261900,5963248.4,58.55855738915866,51.777441191533015,NaN,NaN,105.2983306200713,54.251546786413066,0.0858582351203297,0.2654225552048999,0.17956432008457018,40384205,36343752.4,74.05298215584241,65.8958863727495,NaN,NaN,9.83685163186429,9.31337834961032
2007-03-23T09:30:00-04:00,38,38.22,37.89999,38.22,3590162,5906161.6,59.86501596881535,53.24669977041446,NaN,NaN,110.43890486195592,79.56377695799479,0.09871336415935966,0.30295602528376975,0.20424266112441009,43974367,39311034.8,76.89436257267265,66.12579900139168,NaN,NaN,11.294832597441044,9.596443242157566
2007-03-26T09:30:00-04:00,38.3,38.59,37.82001,38.49001,3698400,5889013.15,62.03988376813179,54.27046326877006,NaN,NaN,143.24149426902892,102.95920082744499,0.11696535838287975,0.3504493591030098,0.23348400072013004,47672767,42063997.2,79.17309224960624,66.69219844159842,NaN,NaN,13.168396722746373,10.10672231081311
2007-03-27T09:30:00-04:00,38.39999,38.50999,38,38.07001,3086100,5581163.05,56.87691033546284,55.046381311158704,NaN,NaN,112.90573240261341,113.82217410177456,0.09334178952995731,0.35016123763257667,0.25681944810261936,44586667,43652822.2,80.3759752974992,68.11339915565115,NaN,NaN,13.25965817480726,10.557141719955132
2007-03-28T09:30:00-04:00,38.14999,38.14999,37.60001,37.69,7326102,5523693.15,52.61078041678446,55.24374291962249,NaN,NaN,61.7630002006019,106.72949247085428,0.04704913907718744,0.31563087194910366,0.2685817328719162,37260565,42775714.2,77.70773729624555,69.52559334712149,NaN,NaN,12.053988919117941,10.770977034121247
2007-03-29T09:30:00-04:00,38.95,38.95,37.60159,37.98,4877898,5380935.5,55.36238914405059,55.33781166973061,NaN,NaN,94.22432403832504,104.51469115450504,0.03162592311188561,0.30811413676177324,0.2764882136498876,42138463,43126565.8,78.02203475119661,70.93143104386024,NaN,NaN,11.85378303006491,10.92566360497034
2007-03-30T09:30:00-04:00,38.10001,38.34,37.66,38.05,5779398,5372675.3,56.02611190922896,55.398752259133396,NaN,NaN,68.45085642101836,96.11708146631753,0.02224761319364177,0.30429773014193984,0.28205011694829807,47917861,43915264.6,78.74742331738696,72.18886065041919,NaN,NaN,11.879089373212654,11.061867286147814
2007-04-02T09:30:00-04:00,38.02,38.12,37.77,38.03999,2124100,5177835.4,55.898113772920894,56.108431017587066,NaN,NaN,57.26124675630512,78.92103196377278,0.01199300168648848,0.29704136905640866,0.2850483673699202,45793761,43539463.4,77.4359557578472,73.47969828124728,NaN,NaN,11.865228129095902,11.176633120854683
2007-04-03T09:30:00-04:00,38.13,38.59,38.13,38.45,3265000,5022970.35,59.93564903666477,56.93874344504871,NaN,NaN,100.78618853265196,76.49712318978047,0.028504065680247104,0.32067844947022905,0.29217438378998195,49058761,44433882.2,78.35970035264378,74.55364029026308,NaN,NaN,12.986599026240803,11.435199678766987
2007-04-04T09:30:00-04:00,38.45,38.61,38.44,38.50999,2351200,4590555.35,60.50537531459238,57.349377842380356,NaN,NaN,110.35719608701241,86.21596236706257,0.0385233740619656,0.3403286013674389,0.3018052273054733,51409961,47263761.4,81.00880396894912,75.6326822453282,NaN,NaN,14.074303845188021,11.812214559684277
2007-04-05T09:30:00-04:00,38.47,38.50999,38.34,38.46001,1577400,4167410.3,59.74312407080952,57.9516422214893,NaN,NaN,93.33470632939265,86.0380388252761,0.03684271603877293,0.3478586223539395,0.31101590631516657,49832561,48802581,82.27915732985647,76.78060000807271,NaN,NaN,14.790070132627381,12.23762249867615
2007-04-09T09:30:00-04:00,38.7,39.05,38.7,39.05,4340801,4283390.35,65.30039748899793,58.6162000914433,NaN,NaN,149.23047308001617,102.19396215707567,0.06867426692075729,0.3968587399661132,0.3281844730453559,54173362,50053681.2,83.25961048995387,77.93088853804637,NaN,NaN,17.055987084780988,12.925960296691127
2007-04-10T09:30:00-04:00,38.89,38.92999,38.62,38.62,1846895,4256690.1,58.916749085414565,58.73279306479717,NaN,NaN,110.79274895140989,112.90026259609662,0.05459205714568477,0.3964245444774619,0.3418324873317771,52326467,51360222.4,84.24024599664253,78.9070864258968,NaN,NaN,17.19543028943239,13.53588458136845
2007-04-11T09:30:00-04:00,38.89999,38.89999,38.31,38.45,4944082,4128974.3,56.56252878165522,58.44297046304912,NaN,NaN,84.0598503479457,109.55499495915538,0.02893837064580229,0.37800545063903,0.3490670799932277,47382385,51024947.2,82.89825242647287,79.60395242591541,NaN,NaN,16.63115545725673,13.978066135066776
2007-04-12T09:30:00-04:00,38.48,38.8,38.38,38.78999,4214898,3988189.1,60.00460309292224,58.54625944188938,NaN,NaN,98.41550748994129,107.16665723974116,0.029857129318638542,0.3863884916415259,0.35653136232288735,51597283,51062411.6,82.93097455673566,80.23809474026493,NaN,NaN,17.14663960594052,14.430719488048739
2007-04-13T09:30:00-04:00,38.78999,38.89999,38.52,38.88,1797026,3771470.5,60.88823705921192,58.61934666263199,NaN,NaN,108.9808350789383,110.29588298965027,0.03136162894578781,0.3957333985051221,0.3643717695593343,53394309,51774761.2,83.57451859402902,80.71524874179038,NaN,NaN,17.823114999357053,14.91534741823564
2007-04-16T09:30:00-04:00,38.97,39.39999,38.94,39.39999,2016019,3530276.55,65.61458389114476,58.874682385704354,NaN,NaN,181.94529115510667,116.83884660466838,0.06052323089102701,0.4400258081731181,0.3795025772820911,55410328,52022154.4,83.80291313177153,81.04595023337363,NaN,NaN,19.86048113916113,15.621795092653567
2007-04-17T09:30:00-04:00,39.2,39.25999,38.97,39.03,2863483,3434950.7,60.053772461290805,59.101601108977775,NaN,NaN,136.23749268019824,121.92779535042605,0.04855668027067134,0.44019842762043027,0.39164174734975893,52546845,52066230,83.84600968945887,81.29380983279931,NaN,NaN,19.931813370381988,16.237511989471912
2007-04-18T09:30:00-04:00,38.92,39.03,38.72,38.82001,2726100,3434526.35,57.09618115130808,59.42198687572945,NaN,NaN,82.24043754178628,121.56391278919416,0.021539262478711352,0.41856582544814813,0.3970265629694368,49820745,52553902,84.34242419729013,81.7677160400168,NaN,NaN,19.103509667837727,16.646940229238457
2007-04-19T09:30:00-04:00,38.45,38.78,38.27,38.67999,3678000,3368248.2,55.145943303193654,59.406526458525384,NaN,NaN,21.829563315037152,106.24672395421335,-0.009079219986648512,0.38567753798612614,0.39475675797277465,46142745,51462994.4,78.52890614857301,81.80392113982938,NaN,NaN,17.84611249412881,16.818250552794222
2007-04-20T09:30:00-04:00,39,39.14,38.89999,39.08,3154467,3462876.55,59.41126234960176,59.64832291855202,NaN,NaN,106.8170727353839,105.81397148550245,-0.0058655622092624315,0.3874248052111966,0.39329036742045903,49297212,50643575,74.38164229551992,81.49207963826746,NaN,NaN,18.00862173688379,16.988303579092733
2007-04-23T09:30:00-04:00,39.2,39.32001,38.99001,39.07001,2511307,3408933.8,59.25970096192517,59.888436289195184,NaN,NaN,111.9430109330869,91.8135154410985,-0.007766912978692753,0.3835817261970931,0.39134863917578583,46785905,48918690.4,66.4287240922004,80.70584880500698,NaN,NaN,18.097044908834327,17.146695197627245
2007-04-24T09:30:00-04:00,39.10001,39.14999,38.64,38.91,5698746,3508951.1,56.761981482959726,59.66174574964482,NaN,NaN,59.94919297839879,76.55585550073862,-0.022330803622080675,0.363435134648185,0.3857659382702657,41087159,46626753.2,57.61386955677115,79.22400374815892,NaN,NaN,17.47354693727429,17.19338830329111
2007-04-25T09:30:00-04:00,39.09,39.60001,39.09,39.53,2086300,3458961.1,63.22918728768104,59.856303747722585,NaN,NaN,142.8089326606885,88.66955452451904,0.0057614466418403065,0.39296774657256606,0.38720629993072575,43173459,45297296,53.20368013846819,77.23792347455314,NaN,NaN,18.857869380336727,17.431171314297625
2007-04-26T09:30:00-04:00,39.39,39.52,39.10001,39.37,2284942,3206903.1,60.70574337326253,59.925062269326375,NaN,NaN,118.8046552227927,108.06457290607015,0.009326188180511064,0.3988640351563646,0.38953784697585353,40888517,44246450.4,49.94901466792418,74.92862757012941,NaN,NaN,19.25624789183901,17.69189653966068
2007-04-27T09:30:00-04:00,39.19,39.37,38.97,39.34,2936189,3109817.65,60.22044817335766,59.56220874678064,NaN,NaN,89.37600798501019,104.57635995599541,0.005605732812030473,0.3965450129908916,0.39093928017886115,37952328,41977473.6,43.72876617267268,72.10499583318075,NaN,NaN,19.443502745085944,17.942125997578575
2007-04-30T09:30:00-04:00,39.3,39.42,38.62,38.62,3150165,2978356,49.908383212086406,58.91875404154291,NaN,NaN,12.619435676086546,84.71164490459535,-0.04653287505514514,0.3327731863599297,0.37930606141507484,34802163,39580725.2,38.30267606901803,68.82374083835043,NaN,NaN,16.365944396900137,17.716957197481655
2007-05-01T09:30:00-04:00,38.59,38.69,38.13,38.46001,4076099,3075955.95,47.94376216420593,58.30312785458225,NaN,NaN,-108.01681627577456,51.11844305376068,-0.09044126316423684,0.2662544824597788,0.3566957456240156,30726064,37508506.2,34.335667317676155,65.35498475915067,NaN,NaN,13.23673399418598,17.07692531129656
2007-05-02T09:30:00-04:00,38.47,39.03,38.45,38.92,2376064,3031509.15,53.59925527619606,57.84560301053038,NaN,NaN,-20.547706261989344,18.4471152692251,-0.08711754956815942,0.24779880866381632,0.33491635823197574,33102128,35494240,30.977193222482086,61.64400037813256,NaN,NaN,12.261685166370645,16.389033862021428
2007-05-03T09:30:00-04:00,39.14999,39.23,38.88,39.05,1638260,2995862.15,55.08441911323935,57.43104458581804,NaN,NaN,43.302400532038085,3.3466643310741815,-0.07522453658568534,0.24088568749986905,0.3161102240855544,34740388,34264614.2,29.10559032964821,57.7533626449625,NaN,NaN,11.919914350629659,15.75058821753689
2007-05-04T09:30:00-04:00,39.33,39.53999,39.17999,39.39999,1987700,3016377.15,58.898613753087666,56.95133243309969,NaN,NaN,120.33819478780343,9.539101691632823,-0.044373204357059604,0.26064371863922986,0.30501692299628946,36728088,34019766.2,28.7333138173542,53.819819836789826,NaN,NaN,12.804436813305003,15.329709445503763
2007-05-07T09:30:00-04:00,39.27,40.00999,39.27,39.92,3098001,2954237.15,63.81529058085836,57.22001229878309,NaN,NaN,181.33431852242654,43.282078260900825,0.007694971987329713,0.3146356379804516,0.30694066599312186,39826089,35024551.4,32.546226220867666,50.155549589033306,NaN,NaN,15.182688933532267,15.30870651522212
2007-05-08T09:30:00-04:00,39.95,39.95,39.55,39.95,5473461,3135565.45,64.08223371567499,57.71901605338075,NaN,NaN,173.7226572457532,99.62997296520638,0.03904312349735839,0.3557445703648199,0.3167014468674615,45299550,37939248.6,42.2058276931786,47.14579269588249,NaN,NaN,17.148444886004064,15.571526282476684
2007-05-09T09:30:00-04:00,39.75,40.1282,39.75,40.12,5973301,3187026.4,65.62959138639576,58.467848059323764,NaN,NaN,182.99855589246607,140.33922539609745,0.06460652871068706,0.39745960775582034,0.3328530790451333,51272851,41573393.2,51.526563718110154,45.21705395084941,NaN,NaN,19.24809618463196,16.096750554213152
2007-05-10T09:30:00-04:00,39.91,39.98,39.28999,39.35001,7005176,3326540.3,54.23319753576264,58.097986286906675,NaN,NaN,78.36103629299916,147.35095254828965,0.02506887391214424,0.3641891714353136,0.33912029752316936,44267675,43478850.6,55.57233538151833,43.87353202842073,NaN,NaN,17.49658227695147,16.29672651460434
2007-05-11T09:30:00-04:00,39.50999,39.89,39.42999,39.81,3993350,3436356.5,58.83229292108359,58.06745714113227,NaN,NaN,101.20483866264028,143.52428132325704,0.025237078220582077,0.3706666452988969,0.34542956707831485,48261025,45785438,59.931977360329626,43.40947869042996,NaN,NaN,17.534044500062837,16.473486226812696
2007-05-14T09:30:00-04:00,39.85001,39.99001,39.45,39.75999,2571100,3464110.55,58.14814368208036,58.16646872678375,NaN,NaN,93.97848269130431,126.05311415703261,0.017678799285963998,0.36752806618576983,0.34984926689980583,45689925,46958205.2,61.97508912671084,43.72099437399708,NaN,NaN,17.349236653226868,16.59859343058615
2007-05-15T09:30:00-04:00,39.74001,40.2,39.67,40.00999,3584300,3500151.4,60.613877214523725,57.97966086441537,NaN,NaN,118.50389467837485,115.00936164355691,0.024779571574973347,0.38082373136852254,0.3560441597935492,49274225,47753140.2,63.339657264393054,44.44499274013458,NaN,NaN,17.955081509436678,16.792377441850512
2007-05-16T09:30:00-04:00,40.00999,40.14999,39.71001,40.14999,2857900,3506741.4,61.96527861701473,58.06962766754053,NaN,NaN,113.1474385665628,101.03913817837628,0.03361969828512673,0.3980687826499576,0.36444908436483087,52132125,47924995,63.64341325835389,45.423164068022416,NaN,NaN,18.85691131626322,17.087310852480897
2007-05-17T09:30:00-04:00,39.85001,40.3,39.84,40.13,3271732,3486428,61.64006131791876,58.17102860643775,NaN,NaN,116.14354115358849,108.59563915049416,0.032799790472646806,0.4054488224556394,0.3726490319829926,48860393,48843538.6,65.29842221809973,46.96385378555293,NaN,NaN,19.496846285201972,17.431530200012478
2007-05-18T09:30:00-04:00,40.14999,40.42,40.14999,40.28,3194200,3488414.65,63.20078815219861,59.12048610216005,NaN,NaN,130.04337254622965,114.36334592721202,0.03674174840487765,0.4185762174890897,0.38183446908421204,52054593,49602252.2,66.64890819266552,48.988584651527745,NaN,NaN,20.47566936628893,17.866407223766256
2007-05-21T09:30:00-04:00,40.27,40.5199,40.25999,40.34,4074383,3566568.45,63.83463813490254,60.255548671495525,NaN,NaN,127.7903473047748,121.12571884990614,0.03763437596433539,0.42887743903963127,0.3912430630752959,56128976,51690062.4,70.09753127804913,51.5430035058401,NaN,NaN,21.466160507294866,18.380657692841773
2007-05-22T09:30:00-04:00,40.34,40.42,40.10001,40.10001,2082381,3385750.2,59.425559696137775,60.67171327291993,NaN,NaN,93.65416776262568,116.1557734667563,0.017338511985694194,0.4129162030574136,0.3955776910717194,54046595,52644536.4,71.54608776021823,54.44078168710696,NaN,NaN,21.135087861638507,18.774147716955593
2007-05-23T09:30:00-04:00,40.25,40.61,40.17999,40.28,7222652,3642567.8,61.569475149274204,61.13493156120814,NaN,NaN,104.84306874921705,114.49489950328714,0.011588679201454122,0.41006354007353707,0.39847486087208295,61269247,54471960.8,74.13003818382168,57.65681367669079,NaN,NaN,21.43335579594553,19.15403458538273
2007-05-24T09:30:00-04:00,40.25,40.58,39.69,39.85001,5966297,3826635.55,54.20130685520184,60.79940963993058,NaN,NaN,53.74416481833662,102.01502423623677,-0.023696478817428868,0.36885426235029684,0.3925507411677257,55302950,55760472.2,75.79886565791706,61.018638808159565,NaN,NaN,19.555249782190415,19.21135104206954
2007-05-25T09:30:00-04:00,39.85001,40.32001,39.85001,40.32001,2935925,3826622.35,59.85634093737012,60.51662752253856,NaN,NaN,67.54170816754684,89.5146913605002,-0.01815483188196465,0.3698572013152699,0.38801203319723454,58238875,56997328.6,77.3118369467923,64.21618243143989,NaN,NaN,19.590533486496543,19.26551996270197
2007-05-29T09:30:00-04:00,40.33,40.39999,40.00999,40.19,3058898,3822059,57.73276364730555,60.063093946226466,NaN,NaN,68.23485050500688,77.60359200054661,-0.025564094770288315,0.3560569147343742,0.3816210095046625,55179977,56807528.8,76.52127065961504,66.66728550047107,NaN,NaN,18.983584630343405,19.225243486650747
2007-05-30T09:30:00-04:00,39.98,40.72,39.8269,40.7,5442766,3890392.35,63.24196114298934,59.8925489288403,NaN,NaN,103.14526900246597,79.50181224851467,0.0001998775315033008,0.3818708564190416,0.3816709788875383,60622743,58122758.4,78.18590911627757,68.57152445748304,NaN,NaN,20.181703513288234,19.361880633313245
2007-05-31T09:30:00-04:00,40.83,41.09,40.77,40.89999,3526700,3947924.15,65.15969872208056,60.673013299291576,NaN,NaN,200.17625400389755,98.56844929945078,0.02562103145564515,0.41369726820709474,0.3880762367514496,64149443,58698797.6,78.89179073484217,70.23719983986331,NaN,NaN,21.770696581658605,19.70599719736258
2007-06-01T09:30:00-04:00,41,41.47,41,41.47,2217500,3976886.15,69.96884282658513,61.468481149684536,NaN,NaN,248.191303970994,137.45787712998225,0.07305011101953113,0.4793888755258635,0.4063387645063324,66366943,60911596.2,81.38385400173514,71.76947674282084,NaN,NaN,24.794826232026367,20.43297277374312
2007-06-04T09:30:00-04:00,41.25999,41.25999,41.03,41.22,1995635,3977282.9,65.68628897552719,62.00692009921646,NaN,NaN,188.38872199730682,161.62727989593424,0.07928940279980268,0.5054505180060858,0.4261611152062831,64371308,62138082.8,82.60939532214223,73.24335575678023,NaN,NaN,25.89694886787782,21.213540787190936
2007-06-05T09:30:00-04:00,41.16,41.21001,40.86,41.08,4230121,4033888.9,63.34797103822334,62.20221251519501,NaN,NaN,139.36966464436944,175.85424272380675,0.0662238860233978,0.5089409727355303,0.4427170867121325,60141187,63130324.8,83.55274168098353,74.6871475008224,NaN,NaN,26.061501405219694,21.906106589766473
2007-06-06T09:30:00-04:00,40.94,40.95,40.41,40.55,5365602,4028495.95,55.319390983976334,61.72750625569227,NaN,NaN,58.081792834395216,166.84154749019262,0.01670357869827238,0.46359656008497296,0.4468929813867006,54775585,61960893.2,78.17075401636694,75.72481469782335,NaN,NaN,23.575230739195867,22.144552896827815
2007-06-07T09:30:00-04:00,40.35001,40.58,39.46001,39.64,8333430,4146502.4,44.816787654690195,60.525843851175935,NaN,NaN,-71.63476552264223,112.47934358488465,-0.07735873184307474,0.3501945665828572,0.4275532984259319,46442155,58419435.6,64.59993706594202,75.67492290124063,NaN,NaN,17.435911096352164,21.47188978247415
2007-06-08T09:30:00-04:00,39.78999,40.39999,39.3,40.39999,6421863,4117336.75,52.865234693497506,59.78759003269728,NaN,NaN,-54.27595147429007,51.98589249582784,-0.08765702873238113,0.31798201251045555,0.4056390412428367,52864018,55718850.6,56.539247377958226,74.95280427161869,NaN,NaN,15.209123249379575,20.577208849174927
2007-06-11T09:30:00-04:00,40.17999,40.25999,39.67,40.05,3859302,4110634.35,49.299262317745765,58.749348902900365,NaN,NaN,-66.34561003964264,1.0390260884379559,-0.11555035328779095,0.261201099633098,0.37675145292088896,49004716,52645532.2,49.03989100192317,73.44868710903826,NaN,NaN,12.163430666219519,19.375240537324153
2007-06-12T09:30:00-04:00,39.72,40.13499,39.55,39.56,5236699,4243914.3,44.74824065602346,57.70096897146363,NaN,NaN,-113.33114630489081,-49.50113610141409,-0.16168143462979012,0.1746496596336513,0.33633109426344143,43768017,49370898.2,42.56197081766709,71.37839304171318,NaN,NaN,8.042132464914879,17.756225098408542
2007-06-13T09:30:00-04:00,39.82001,40.60001,39.75999,40.49001,4476352,4288516.9,53.51871070024312,57.125914367961414,NaN,NaN,-14.916528691326928,-64.10080040655852,-0.1258350955975846,0.17903722476646067,0.30487232036404527,48244369,48064655,40.276459667191695,68.96028029052532,NaN,NaN,7.799641766638116,16.333856051012766
2007-06-14T09:30:00-04:00,40.49001,40.99001,40.49001,40.8,2733200,4282281.9,56.024433092146225,57.256137670600296,NaN,NaN,69.43348698189725,-35.88714990565063,-0.07976744625024507,0.20516301255123892,0.284930458801484,50977569,48971737.8,42.58222725302187,66.58766326160423,NaN,NaN,8.520023037283808,15.21759419190863
2007-06-15T09:30:00-04:00,40.97,41.25,40.83,41.10001,3515700,4294480.3,58.36380133627104,57.14952769909322,NaN,NaN,108.03799865133949,-3.4243598805247215,-0.030163314058638202,0.24722631622818625,0.27738963028682445,54493269,49297588,43.42718217413832,64.16733077784325,NaN,NaN,9.900271921364828,14.457976724688086
2007-06-18T09:30:00-04:00,41.92,41.92,40.97,41.10001,1943500,4231945.3,58.36380133627104,57.19460181973361,NaN,NaN,130.26990374471436,35.898742876346674,-0.000020102537511612617,0.2773645021149349,0.2773846046524465,54493269,50395298.6,46.29440396038396,62.008268870755316,NaN,NaN,10.958417002581218,13.958039621529961
2007-06-19T09:30:00-04:00,40.85001,41.32001,40.81,41.3,2359915,4146221.9,60.00853788085207,56.96364301529523,NaN,NaN,88.80073358531136,76.32511885438711,0.029108164375452605,0.3137698101217623,0.2846616457463097,56853184,53012332,52.47816589571643,60.17200149785809,NaN,NaN,12.32973559229513,13.7254247602107
2007-06-20T09:30:00-04:00,41.34,41.38,40.64999,40.78,3225000,4203352.85,54.03192090243039,56.168801742463074,NaN,NaN,52.83866134554366,89.87615686176123,0.010058908620341256,0.2972352815217363,0.287176372901395,53628184,54089095,54.78497439894577,58.450086045294064,NaN,NaN,11.64142935943034,13.427711131527792
2007-06-21T09:30:00-04:00,40.66,41.14999,40.25,41.00999,6647547,4174597.6,56.11382354728586,55.17915750822741,NaN,NaN,30.357043491712556,82.06086816372428,0.009651191873834841,0.2992403627436886,0.28958917086985375,60275731,55948727.4,58.5291242341905,56.8176053476123,NaN,NaN,11.71426615401607,13.182933277597545
2007-06-22T09:30:00-04:00,40.89999,41.10001,40.67999,40.89,4414352,4097000.35,54.72136659074412,54.39594876645719,NaN,NaN,38.58841319807681,68.17095107307175,-0.0014078991845515865,0.28782929688916425,0.28923719607371584,55861379,56222349.4,59.06623117405171,55.135950765605834,NaN,NaN,11.364357733333717,12.923136771274141
2007-06-25T09:30:00-04:00,40.75999,40.94,40.25,40.25,3911400,4145774.1,47.89455848961156,53.29213358441349,NaN,NaN,-27.508969972120816,36.615176329704724,-0.051745943957441254,0.22455476612691427,0.2763007100843555,51949979,55713691.4,57.57343923821387,53.280286305408005,NaN,NaN,8.923743413775474,12.351794863060046
2007-06-26T09:30:00-04:00,40.35001,40.64,39.7,39.75,9543426,4470000.5,43.34495042835891,52.43681640186939,NaN,NaN,-95.56905402488931,-0.2587811923354181,-0.11501206006424719,0.13253563500404653,0.24754769506829372,42406553,52824365.2,49.86431174120001,51.25839757146751,NaN,NaN,5.3688306334043485,11.354228544537804
2007-06-27T09:30:00-04:00,39.71001,40.14999,39.25,40.10001,8664797,4631102.05,47.130981632644264,52.60211597172325,NaN,NaN,-112.65138861441108,-33.35679118432636,-0.12855693830508286,0.08685152218694014,0.215408460492023,51071350,52312998.4,48.62337737354778,50.11721473629649,NaN,NaN,3.581123738882626,10.243785000872778
2007-06-28T09:30:00-04:00,40.24001,40.44,40.11,40.25,5007363,4705135.2,48.71267449033414,52.30550452864015,NaN,NaN,-44.99640669348997,-48.427481221366875,-0.12269926486276414,0.06203437941356782,0.18473364427633196,56078713,51473594.8,46.574435827215844,49.40544248267203,NaN,NaN,2.6044423312565366,9.152450333784744
2007-06-29T09:30:00-04:00,40.41,40.82001,40.19,40.5,7680379,4978279.15,51.32649587581519,52.450306925645116,NaN,NaN,-5.95348331977429,-57.3358605249371,-0.09832545583398414,0.061826824483851794,0.16015228031783593,63759092,53053137.4,50.77774336569085,49.52957479436973,NaN,NaN,2.5619743381969906,8.210953762986493
2007-07-02T09:30:00-04:00,40.83,41.22,40.59,41.14999,4669684,5111981.6,57.40474415092705,53.3543428895668,NaN,NaN,70.88561073510543,-37.65694438349185,-0.0378732761284008,0.11281068515733494,0.15068396128573575,68428776,56348896.8,58.17233956032655,50.64460113313111,NaN,NaN,4.437213015981381,7.671847941985764
2007-07-03T09:30:00-04:00,41.21001,41.25999,41.07001,41.16,2008694,5000910.25,57.49278021311226,53.63820499762888,NaN,NaN,96.33049572868403,0.7229655672228233,0.0012674165777984414,0.15226823200798378,0.15100081543018534,70437470,61955080.2,67.19915331293187,52.56765067925539,NaN,NaN,5.954890705581886,7.42656833678521
2007-07-05T09:30:00-04:00,41.16,41.25999,41.02,41.25,2273610,4846310.65,58.32674914676672,53.802656144387484,NaN,NaN,88.68274771085218,40.98979283227548,0.030100548546336425,0.18862650111310586,0.15852595256676943,72711080,66283026.2,72.18899538997961,54.68241983189523,NaN,NaN,7.4427724400518604,7.428883208680446
2007-07-06T09:30:00-04:00,41.33,41.60001,41.11,41.60001,3036478,4581463.05,61.49100763519959,54.026028022882386,NaN,NaN,114.67348369218313,72.9237709094101,0.06748624624323729,0.24288376037081605,0.17539751412757876,75747558,70216795.2,75.79349902104983,56.99429960667462,NaN,NaN,9.660472142487624,7.747681627795758
2007-07-09T09:30:00-04:00,41.44,41.75,41.38,41.7,2504807,4385610.25,62.37004843327104,54.31218852981095,NaN,NaN,127.74130376090487,99.66272832554594,0.0921631992837911,0.29060151323231764,0.19843831394852654,78252365,73115449.8,78.05094287413782,59.262623814799895,NaN,NaN,11.753071209959483,8.319880139533433
2007-07-10T09:30:00-04:00,41.45,41.45,40.78,41.10001,4722344,4428762.35,54.35254928125256,53.908189344125276,NaN,NaN,51.35084464188647,95.75577510690214,0.06269980383497298,0.27681306874224276,0.21411326490726978,73530021,74135698.8,78.80033367596951,61.14277865624655,NaN,NaN,11.309119668350094,8.746914357935813
2007-07-11T09:30:00-04:00,41.14,41.50999,41,41.39999,2840360,4308945.4,57.30748191614353,54.14215798796193,NaN,NaN,76.92189921376026,91.87405580391739,0.05813788407141862,0.28678561999654306,0.22864773592512444,76370381,75322281,79.6697188096722,62.92026039986986,NaN,NaN,11.807283150405288,9.184109899717166
2007-07-12T09:30:00-04:00,42.05,42.64,41.75,42.45,7018859,4436070.75,65.68167478916699,54.82557593381058,NaN,NaN,215.77947457019735,117.2934011757864,0.11715552461313727,0.37509214169154603,0.25793661707840876,83389240,77457913,81.16672088023108,64.53723158887276,NaN,NaN,15.11558609437927,10.031463641811753
2007-07-13T09:30:00-04:00,42.56,43.03999,42.5,42.89999,3709249,4484873.2,68.53055616865508,55.81194661794708,NaN,NaN,244.30172236698772,143.21904891074732,0.17437090379161618,0.475900246817929,0.3015293430263128,87098489,79728099.2,82.6308436140559,66.2204181917302,NaN,NaN,18.82746835616494,11.288035743862208
2007-07-16T09:30:00-04:00,42.89999,43.03,42.48,42.67,5841465,4601161.45,65.5360888699901,57.07205593083126,NaN,NaN,189.70984453788805,155.61275706614396,0.1836651741386709,0.5311108106996514,0.3474456365609805,81257024,80329031,83.00742523556849,68.03713147725554,NaN,NaN,20.848918272548964,12.653876105103173
2007-07-17T09:30:00-04:00,42.82001,43.1299,42.8085,43.05,4135816,4710777.25,68.0223205169908,58.8347252228764,NaN,NaN,179.0962405802735,181.16183625382138,0.20094572751532092,0.5986277959551316,0.3976820684398107,85392840,82701594.8,84.44166243445925,70.50694224105978,NaN,NaN,23.336533071593408,14.17996995745892
2007-07-18T09:30:00-04:00,42.63,43.12,42.55,43.12,6527898,4919176.4,68.47350263436942,60.359191008713914,NaN,NaN,141.84310177515718,194.14607676610075,0.20208458146852532,0.6502877952754673,0.448203213806942,91920738,85811666.2,86.09809326969447,73.18370766221311,NaN,NaN,25.457711600975525,15.791075906532722
2007-07-19T09:30:00-04:00,43.13,43.25999,42.95,43.22,5034297,5009641.25,69.14329640628577,61.8185211455676,NaN,NaN,134.15954421512677,177.82209069508664,0.19450036860955555,0.6913286745688865,0.4968283059593309,96955035,88524825.2,87.36216671435993,76.09711701129483,NaN,NaN,27.3869505190314,17.447629422603963
2007-07-20T09:30:00-04:00,43.09,43.09,42.41,42.8,11448793,5249703.55,63.0814997222753,62.65816427745761,NaN,NaN,91.28558822275933,147.21886386624095,0.1482177925683591,0.6821005466697798,0.5338827541014207,85506242,88206375.8,86.36948925256874,78.63938457464324,NaN,NaN,27.278306004208254,18.852011791404575
2007-07-23T09:30:00-04:00,42.60001,42.94,42.56,42.75,5119082,5284940.05,62.3803600208896,63.01356541102636,NaN,NaN,79.76471518902525,125.2298379964684,0.10338075859273121,0.6631087023423348,0.5597279437496036,80387160,88032403,85.79593162324069,80.61249829342283,NaN,NaN,26.990334178896735,20.014629275332027
2007-07-24T09:30:00-04:00,42.37,42.48,41.60001,41.89999,6783844,5428562.25,51.83292253079134,62.60928986228915,NaN,NaN,21.956238745526374,93.80183762951899,0.010509798898303169,0.5728651923724826,0.5623553934741794,73603316,85674498.2,78.21478076828748,81.39932882594823,NaN,NaN,23.37839679913148,20.495167493017664
2007-07-25T09:30:00-04:00,42.05,42.5,40.63,41.2,14607395,5681760.7,45.073997306025504,61.66266473080764,NaN,NaN,-24.83458543160356,60.46630018816684,-0.09804947372739559,0.4397935513149349,0.5378430250423305,58995921,79089534.8,61.79302220048729,80.65675931241307,NaN,NaN,17.90599134731846,20.125285186489208
2007-07-26T09:30:00-04:00,40.64,40.74001,39.10001,39.83,19391840,6218112.85,35.356496526194235,59.79591393730726,NaN,NaN,-146.6856749761795,4.297256349905586,-0.25328601885903124,0.22123550146854143,0.47452152032757267,39604081,67619344,44.332563884774366,78.40954965982196,NaN,NaN,9.026360399980895,18.539724502702306
2007-07-27T09:30:00-04:00,39.60001,40.03999,38.84,38.92,14800910,6707790.2,30.632435059368703,57.528941553457095,NaN,NaN,-181.94188687490532,-50.34823866962735,-0.39970780246872717,-0.025113232758336324,0.37459456971039085,24803171,55478729.8,33.532302283156,75.22964676046612,NaN,NaN,-0.2062898644728497,15.861722450248713
2007-07-30T09:30:00-04:00,39.14,40.00999,39.00999,39.89999,7402066,6693874.55,39.93926713313343,56.49942140002001,NaN,NaN,-144.71607600015756,-95.24439690746391,-0.4114032311062785,-0.1396594691724573,0.2717437619338212,32205237,45842345.2,27.75295482883297,71.58340541424208,NaN,NaN,-4.188113664845073,12.997460148092458
2007-07-31T09:30:00-04:00,40.37,40.62849,39.39999,39.42,11363914,7028586.05,37.299624597295704,55.07028873438802,NaN,NaN,-121.17509431034057,-123.8706635186373,-0.43027653847406777,-0.26610191115876347,0.16417462731530427,20841323,35289946.6,23.06493523590045,67.54020658754409,NaN,NaN,-8.244188513232153,9.962938910760371
2007-08-01T09:30:00-04:00,39.38,39.64999,38.64,39.64999,15560176,7706160.15,39.36744282212347,53.19070073674205,NaN,NaN,-136.1478027505576,-146.1333069824281,-0.40636947898802844,-0.3437872214197313,0.06258225756829715,36401499,30771062.2,21.39800223303054,63.271012398458346,NaN,NaN,-10.619940673937213,7.022527541517859
2007-08-02T09:30:00-04:00,39.67,39.78,39.14,39.75,7545488,7969754.05,40.28961339222938,51.17349053842593,NaN,NaN,-108.00339856947049,-138.3968517010863,-0.3642705836145544,-0.39275597194989587,-0.028485388335341463,43946987,31639643.4,22.556551392845805,58.97999152551477,NaN,NaN,-12.154685293010523,4.282925708013805
2007-08-03T09:30:00-04:00,39.48,39.53,38.42,38.42,9367480,8286304.15,33.083382455274105,48.85544008023193,NaN,NaN,-128.32028987982457,-127.67253230207015,-0.40340594269333613,-0.5327428167020116,-0.1293368740086755,34579507,33594910.6,25.22831733646936,54.852912389864834,NaN,NaN,-16.125940148140526,1.3673734428489008
2007-08-06T09:30:00-04:00,38.67,38.87,37.83,38.87,11319391,8727033.35,37.177637531561615,46.65224843841556,NaN,NaN,-121.15908650524061,-122.96113440308677,-0.37689093316327277,-0.6004505404627665,-0.2235596072994937,45898898,36333642.8,28.926995447894583,50.88757903368163,NaN,NaN,-17.874489793323438,-1.3814641623185762
2007-08-07T09:30:00-04:00,38.45,39.41,38.45,39.14999,10386695,9010250.9,39.65175464466551,44.593552153436704,NaN,NaN,-87.20271303820654,-116.16665814865996,-0.320608135413487,-0.6243197765663524,-0.3037116411528654,56285593,43422496.8,37.53943939137045,47.419103756658494,NaN,NaN,-18.44294153939127,-3.818818073328961
2007-08-08T09:30:00-04:00,39.34,40.3,39.27,40.16,9106590,9323562.4,47.659523002407944,43.05899691030258,NaN,NaN,-44.29933600926863,-97.79696480040216,-0.20129900023328584,-0.5553353914444727,-0.3540363912111869,65392183,49220633.6,43.563369431322144,44.29061823644151,NaN,NaN,-16.17059750640853,-5.583357992340328
2007-08-09T09:30:00-04:00,39.48,39.75,38.78999,39.14999,8229039,9384071.4,41.70052715408378,41.53178458400318,NaN,NaN,-65.89998577231694,-89.37628224097146,-0.1771947159147273,-0.575529786104596,-0.39833507018986875,57163144,51863865,46.11475061968673,41.41527976266423,NaN,NaN,-16.324181710789485,-7.117761380690207
2007-08-10T09:30:00-04:00,38.75,39.28,38.16,38.67999,12427434,9819980.65,39.24169961789836,39.87902312664666,NaN,NaN,-80.76707329053686,-79.86563892311392,-0.17916053486766026,-0.622285738774444,-0.4431252039067838,44735710,53895105.6,48.058065858258566,38.719717922308355,NaN,NaN,-17.284392302732794,-8.570137226696291
2007-08-13T09:30:00-04:00,39.28999,39.31,38.66,38.85001,5835898,9819702.3,40.606018223138015,39.077101390385714,NaN,NaN,-66.1992494764303,-68.87367151735187,-0.15611061371546764,-0.6382634710511184,-0.4821528573356507,50571608,54829647.6,48.969912516729295,36.630798761482765,NaN,NaN,-17.59608500401031,-9.85955833774115
2007-08-14T09:30:00-04:00,38.86,39.07001,37.71001,37.85001,7003570,9963090,35.54973671588425,38.39679706251848,NaN,NaN,-95.15639503594889,-70.46440791690033,-0.1929017616091342,-0.7232800593470685,-0.5303782977379343,43568038,52286136.6,46.57349753232768,35.54368985661423,NaN,NaN,-19.557539522988453,-11.244984221347908
2007-08-15T09:30:00-04:00,37.81,37.96001,36.53999,36.89999,15960848,10434737.5,31.532588178032725,38.12366075193552,NaN,NaN,-146.46751082323462,-90.89804287969352,-0.2616422105271896,-0.8574310608969213,-0.5957888503697317,27607190,44729138,40.26832884823101,35.25338735400398,NaN,NaN,-22.608670860019288,-12.86836802687239
2007-08-16T09:30:00-04:00,36.22,36.55,34.63,36.39999,16849120,11025478.65,29.63456300219505,38.05238417642311,NaN,NaN,-205.45180669515213,-118.80840706426056,-0.3174888138522285,-0.9926498676850173,-0.6751610538327888,10758070,35448123.2,34.15302740222931,35.29772486250922,NaN,NaN,-25.706578995830576,-14.702398165294989
2007-08-17T09:30:00-04:00,37.69,38.35001,36.35001,36.89999,13889453,11147511.65,33.91816513891938,37.62230546255068,NaN,NaN,-124.8735236890831,-127.62969714396982,-0.29778494828061586,-1.0473922391835586,-0.7496072909029428,24647523,31430485.8,31.89496300933081,35.593582589687635,NaN,NaN,-26.840613280091176,-16.436428895980157
2007-08-20T09:30:00-04:00,37.31,37.8,36.92,37.59,11216746,11452394.85,39.400769540203065,37.77238724418692,NaN,NaN,-102.3498552986645,-134.85981830841666,-0.21895571521791413,-1.0233019349253354,-0.8043462197074213,35864269,28489018,30.314668666315043,36.111420691860104,NaN,NaN,-26.00075964102175,-17.802761859557528
2007-08-21T09:30:00-04:00,37.45,38.06,37.37,37.82001,7779703,11502187.8,41.153446454405476,37.89995893220707,NaN,NaN,-72.90299401999316,-130.4091381052255,-0.136057286907747,-0.974417828342105,-0.838360541434358,43643972,28504204.8,30.333860854083966,36.749696307649636,NaN,NaN,-24.780023478031964,-18.79951351933959
2007-08-22T09:30:00-04:00,38.17999,39.25,38.17999,39.25,16704602,11607048.15,50.70011103641838,38.64356590679199,NaN,NaN,18.899020439091142,-97.33583185276036,0.02193598386127993,-0.8109405616077581,-0.832876545469038,60348574,35052481.6,38.23308543049438,37.86944873891025,NaN,NaN,-20.415117549042687,-19.030314095011462
2007-08-23T09:30:00-04:00,39.36,39.39,38.33,38.5,6581898,10966551.05,46.444356886402495,39.597921223301164,NaN,NaN,11.915121948172887,-53.86244612409536,0.07954311323917151,-0.7334476539200736,-0.8129907671592451,53766676,43654202.8,46.77103789731578,39.40821449325642,NaN,NaN,-18.212091684803276,-18.913425179267435
2007-08-24T09:30:00-04:00,38.63,39.39999,38.62,39.39999,5533699,10503190.5,51.68528439036468,40.63418171321566,NaN,NaN,45.78187738528164,-19.73136590922241,0.17632750536009456,-0.5925813854591269,-0.7689088908192214,59300375,50584773.2,52.47161920759524,41.08997333323504,NaN,NaN,-14.57201089043863,-18.293223138006176
2007-08-27T09:30:00-04:00,39.39999,39.50999,38.98,39.05,5113398,10388757.1,49.65045149097545,41.348374345094946,NaN,NaN,52.06888891463959,11.152382933438412,0.2124211595441372,-0.50338244138905,-0.7158036009331872,54186977,54249314.8,55.203433867421765,42.351687224381564,NaN,NaN,-12.325899811389677,-17.440748377060963
2007-08-28T09:30:00-04:00,38.7,38.81,37.84,38.14999,9541199,10297621.35,44.76933810150352,41.14193256645891,NaN,NaN,-19.601594784904652,21.812662780456122,0.17299780372608375,-0.49955634627558254,-0.6725541500016663,44645778,54449676,55.35453031711853,43.19391300193844,NaN,NaN,-12.01240764942771,-16.66527113025621
2007-08-29T09:30:00-04:00,38.22,38.98,38.13,38.89999,7988898,9919057.45,49.24704478712902,41.68096954024786,NaN,NaN,19.339725167388462,21.90080372611558,0.19321397298954268,-0.4310366837647379,-0.6242506567542806,52634676,52906896.4,53.848417761341196,43.746317797770914,NaN,NaN,-10.280191725785587,-15.753116929617551
2007-08-30T09:30:00-04:00,38.47,39.08,38.3,38.8,5809602,9832263.15,48.6804017769867,42.35516255161131,NaN,NaN,29.417245607071866,25.40122845789538,0.19506652637007516,-0.3804174987916866,-0.5754840251617618,46825074,51518576,52.46502765296718,44.06110078310724,NaN,NaN,-9.08885350792238,-14.801079297946812
2007-08-31T09:30:00-04:00,39.28,39.64999,39.07001,39.14999,6349898,9681384.05,50.813726810990424,43.08428459360077,NaN,NaN,78.36531232780901,31.917915446400855,0.21358408346131186,-0.3085039208351219,-0.5220880042964338,53174972,50293495.4,51.21469393921179,44.22144231328456,NaN,NaN,-7.4649012839916455,-13.753053867381787
2007-09-04T09:30:00-04:00,39.27,39.87,38.99001,39.7,5009500,9365889.5,54.046616658692585,44.40549030380136,NaN,NaN,90.61229881217236,39.626597425907406,0.2538542288691007,-0.20477021821005792,-0.4586244470791586,58184472,51092994.4,52.01834806228195,44.61036020828129,NaN,NaN,-5.11410046551372,-12.51891766711492
2007-09-05T09:30:00-04:00,39.25,39.55991,39,39.35001,7115898,9202349.65,51.71717664619132,45.847246622955545,NaN,NaN,69.26289109970344,57.39949460282903,0.24763296507758142,-0.14908324073218182,-0.39671620580976324,51068574,52377553.6,53.348099195581064,45.544629518806296,NaN,NaN,-3.8292734692394657,-11.277539924561284
2007-09-06T09:30:00-04:00,39.42999,39.75,39.17999,39.55,5522000,9023120.15,52.964687633965326,47.51368409665343,NaN,NaN,89.25969721010335,71.383489011372,0.24713194874433075,-0.08780126987934977,-0.33493321862368053,56590574,53168733.2,54.190190721521674,46.97585547018433,NaN,NaN,-2.4110129173261248,-10.010893209241974
2007-09-07T09:30:00-04:00,39.11,39.21001,38.57001,38.62,11163500,9169843.2,46.89659274142428,48.44071463968949,NaN,NaN,30.425601050635645,71.58516010008476,0.17756595116423324,-0.11297577966838901,-0.29054173083262225,45427074,52889133.2,53.820461192007336,48.541962483232645,NaN,NaN,-2.932947757123653,-8.999758144653644
2007-09-10T09:30:00-04:00,38.96001,38.96001,37.97,38.38,10154500,9056196.5,45.449462315795664,48.87276412366039,NaN,NaN,-1.171143232801833,55.67786898796258,0.11198760520873074,-0.15055722432170882,-0.26254482953043956,35272574,49308653.6,49.19190227888374,49.890336312701834,NaN,NaN,-3.784579676601793,-8.254732649217665
2007-09-11T09:30:00-04:00,38.60001,38.92999,38.45,38.88,7284898,9128646.5,48.98159270170772,49.431917427039124,NaN,NaN,28.884524161441036,43.332314057816326,0.09931619611598883,-0.13839958438545352,-0.23771578050144235,42557472,46183253.6,45.51249304411622,50.97452432627557,NaN,NaN,-3.5001912927227194,-7.575512455432673
2007-09-12T09:30:00-04:00,38.63,39.10001,38.5,39.10001,3939100,8975423,50.50037898136792,49.417650851678374,NaN,NaN,39.16959087834535,37.313654013544706,0.1023754168814176,-0.10974650939967034,-0.21212192628108795,46496572,45268853.2,44.464606148044474,51.41963294895772,NaN,NaN,-2.836154309896894,-6.898461291784704
2007-09-13T09:30:00-04:00,39.28,39.53999,39.03,39.23,4776000,8416180.6,51.42056251271087,49.7730941107004,NaN,NaN,69.88205728536424,33.438126028596876,0.10915572190100625,-0.07567727390483014,-0.1848329958058364,51272572,44205252.8,43.21815078009259,51.16585529772749,NaN,NaN,-2.0318613568200403,-6.203232729646895
2007-09-14T09:30:00-04:00,39.14999,39.74001,39.14,39.5,4481301,7797789.65,53.35997359902036,49.892714768461516,NaN,NaN,95.60391844271373,46.473789507012505,0.1265992187896432,-0.0265839723187824,-0.1531831911084256,55753873,46270612.6,46.362513316448364,50.729490591216994,NaN,NaN,-0.8198560868539149,-5.4341789235336115
2007-09-17T09:30:00-04:00,39.67999,40.10001,39.46001,39.46001,9080000,7557317,53.02233772295116,50.13356378503121,NaN,NaN,119.85511014725002,70.67904018302288,0.12974039799567,0.008992306386161886,-0.1207480916095081,46673873,48550872.4,49.67590193153854,50.334666881511055,NaN,NaN,0.10850264633051787,-4.642367270695879
2007-09-18T09:30:00-04:00,39.94,41.35001,39.64,41.3,13579801,7675469.75,64.23561348742365,51.524012026882644,NaN,NaN,249.38245708590944,114.77862676791656,0.24343272276876873,0.18354281185145283,-0.05988991091731591,60253674,52090112.8,54.38582875617682,50.265473912872366,NaN,NaN,4.60677233053275,-3.3210616133775037
2007-09-19T09:30:00-04:00,41.60001,42.47,41.59,41.77,14488199,8010894.55,66.43924941866348,52.75202664342083,NaN,NaN,333.354574477081,173.61562348766367,0.3324720306493156,0.35570012739432855,0.023228096745012985,74741873,57739173,60.70708294939806,50.75537856916213,NaN,NaN,9.060323397066183,-1.552292326171263
2007-09-20T09:30:00-04:00,41.95,41.96001,41.53,41.64,14116379,7881483.4,65.24183248940548,53.93498598002217,NaN,NaN,227.94973214638117,205.22915845986708,0.36234334819971137,0.47615728199465224,0.11381393379494084,60625494,59609757.4,62.55743695440415,51.476264947836206,NaN,NaN,12.314039328433543,0.4286121959151379
2007-09-21T09:30:00-04:00,42.12,42.12,41.55,41.57001,5395801,7822178.55,64.56713434949484,54.91737223277248,NaN,NaN,181.1575820439287,222.33989118011004,0.356567256080248,0.5595230038952508,0.20295574781500283,55229693,59504921.4,62.38013859956734,52.273796709290174,NaN,NaN,14.783841229230232,2.4793592006744367
2007-09-24T09:30:00-04:00,41.60001,42.06,41.46001,41.62,10873000,8089143.6,64.84676226153977,55.68881120440442,NaN,NaN,143.04569087914706,226.9780073264895,0.33559500488034444,0.6224495039154334,0.286854499035089,66102693,63390685.4,66.20352211159181,53.28702342709801,NaN,NaN,16.904197627646145,4.540050404527538
2007-09-25T09:30:00-04:00,41.32001,41.63,41.17,41.48,5929801,8129963.75,63.339196131102895,56.518955453326676,NaN,NaN,103.27809151444222,197.75713421219604,0.2933078887815084,0.6534893600119744,0.36018147123046607,60172892,63374529,66.17340820944455,54.20311692808826,NaN,NaN,18.308143544226862,6.5069208530560125
2007-09-26T09:30:00-04:00,41.77,42.17999,41.63,42,7027527,8004280.15,66.45832167773887,57.48278645645336,NaN,NaN,114.58608289245393,154.0034358952706,0.28132893891467675,0.711842644873812,0.43051370595913524,67200419,61866238.2,63.27956757223268,54.85235813171047,NaN,NaN,20.420908936044345,8.49463343634006
2007-09-27T09:30:00-04:00,42.14,42.5,42.10001,42.49001,5244398,7867055.15,69.1241720348852,59.070470691700564,NaN,NaN,119.22702373454,132.25889421290236,0.28641941952492456,0.788537980365291,0.5021185608403664,72444817,64230102.8,65.80359331173386,55.70829614026237,NaN,NaN,23.042403633612906,10.572886321664752
2007-09-28T09:30:00-04:00,42.22,42.99001,41.98,42.11,5385621,7845856.1,64.82143890369214,60.45418330512174,NaN,NaN,104.42933928657459,116.91324566143157,0.2457663853947445,0.809326542583797,0.5635601571890525,67059196,66596003.4,68.16236230210737,57.06332899906405,NaN,NaN,24.10754455211101,12.506408926014217
2007-10-01T09:30:00-04:00,42.14999,42.89999,42.14999,42.89999,5913898,7824056.1,69.12417135678547,61.89293892334158,NaN,NaN,105.60299237900516,109.42470596140318,0.2526798170103911,0.8794099284520414,0.6267301114416503,72973094,67970083.6,69.47910951404872,58.775230175487806,NaN,NaN,26.359418600915106,14.485410308142916
2007-10-02T09:30:00-04:00,42.81,42.81,42.23,42.60001,6478500,7897506.1,65.83144926854303,62.98801537242552,NaN,NaN,90.54297001466807,106.87768166144835,0.21890932688457,0.9003667700473628,0.6814574431627928,66494594,69234424,70.68068752033865,60.64780741636596,NaN,NaN,27.279566414494354,16.31314689476455
2007-10-03T09:30:00-04:00,42.21001,42.46001,41.94,42.05,5692781,7826350.25,60.17190015182359,63.61311091807642,NaN,NaN,65.48875551735723,97.05821618642901,0.14495397856412562,0.8626499163679497,0.7176959378038241,60801813,67954702.8,67.77235936647847,62.40167945825067,NaN,NaN,26.371679584068236,17.750080136093647
2007-10-04T09:30:00-04:00,42.10001,42.27,41.73,42.23,4288102,7764655.35,61.34318124011211,64.18334003529726,NaN,NaN,56.7838736895213,84.56958617742526,0.0959455545269412,0.8376278809625006,0.7416823264355594,65089915,66483722.4,64.48766116092729,63.696332875713445,NaN,NaN,25.956995833798207,18.922496664337157
2007-10-05T09:30:00-04:00,42.58,43.5,42.5,42.95,4756613,7444311,65.68969267725663,65.08815110346195,NaN,NaN,96.2441685913119,82.93255203837273,0.0993853410338652,0.8659140027278909,0.7665286616940257,69846528,67041188.8,65.17649090805584,64.80351780260754,NaN,NaN,26.894309015459672,20.0613270002118
2007-10-08T09:30:00-04:00,42.92,42.92,42.45,42.7,1939800,7033576,63.039252735964,65.00269676407197,NaN,NaN,78.60112731186965,77.53217902494562,0.07338867732753962,0.8582645083534501,0.7848758310259105,67906728,66027915.6,62.792350114372255,65.40398361390722,NaN,NaN,26.882028600598918,21.035712943124246
2007-10-09T09:30:00-04:00,42.91,43.8,42.83,43.5,4813398,6910001,67.5511090191894,65.08211530696668,NaN,NaN,118.95347429427328,83.21427988086666,0.09714588434320337,0.9063081864549147,0.8091623021117114,72720126,67273022,64.51029001776308,65.67564126164758,NaN,NaN,28.2714040948257,22.069383107653024
2007-10-10T09:30:00-04:00,43.24001,43.42999,42.82001,43.24001,5559098,6991000.9,64.78334399713671,65.04936612894748,NaN,NaN,105.19575270018983,91.15567931743318,0.0829749609949808,0.9128810033554373,0.8299060423604565,67161028,68544865,66.22572207689709,65.93766162753992,NaN,NaN,28.570855644738526,22.998164898665237
2007-10-11T09:30:00-04:00,43.45,43.87,42.58,43,9325199,7218460.85,62.247760924751674,64.88369659860868,NaN,NaN,101.73466285399506,100.14583715032794,0.04686024374577702,0.8884813470426778,0.8416211032969008,57835829,67094047.8,62.51370322227204,65.94720195773313,NaN,NaN,28.06463511198391,23.721946357710763
2007-10-12T09:30:00-04:00,43.06,43.42999,42.77,43.35001,5566406,7272716.1,64.43394144476892,64.85420939741076,NaN,NaN,100.350150512945,100.96703353465455,0.03643166878766313,0.8871606892814796,0.8507290204938165,63402235,65805189.2,59.332069163637264,65.45638389002208,NaN,NaN,28.27118140503062,24.371837078756457
2007-10-15T09:30:00-04:00,43.53999,43.81,42.75999,43.10001,5493398,7093386,61.68620182739914,64.73613837571763,NaN,NaN,100.28093176445347,105.30299442517132,0.004275081716274998,0.8560728726391602,0.8517977909228852,57908837,63805611,54.682219249299365,64.63558467858314,NaN,NaN,27.64745393330474,24.839782343691926
2007-10-16T09:30:00-04:00,42.78,42.78,42.22,42.34,6840301,6756411,54.129094032439816,63.855479258196276,NaN,NaN,0.6229431555183113,81.63688819742032,-0.07237189147528889,0.761332926578774,0.8337048180540629,51068536,59475293,46.23216079724132,63.41791276608377,NaN,NaN,24.75239731981226,24.827298768851975
2007-10-17T09:30:00-04:00,42.64,42.82001,41.931,42.32001,8492102,6456606.15,53.94190859177211,62.77103186940248,NaN,NaN,-14.669827657341054,57.663772125914136,-0.12549531801879843,0.6768356705305649,0.8023309885493634,42576434,54558374.2,38.88451521846923,61.49512147370772,NaN,NaN,22.36882795806057,24.476088653024632
2007-10-18T09:30:00-04:00,42.14,42.94,42.14,42.64999,5733199,6037447.15,56.609362050792704,62.18445495133824,NaN,NaN,10.50538231227024,39.417916017569176,-0.13846952642730248,0.6292440805152353,0.7677136069425378,48309633,52653135,36.46608112318643,59.23110138949908,NaN,NaN,21.084931697243732,23.991637659341645
2007-10-19T09:30:00-04:00,43.11,43.11,41.69,41.72,13548660,6445090.1,48.14627265836037,60.68603361573645,NaN,NaN,-55.27435712876757,8.293014489226682,-0.20569159510486235,0.5105991130614598,0.7162907081663221,34760973,46924882.6,30.353511379493852,56.43641580845945,NaN,NaN,17.220112764651486,23.024276960100195
2007-10-22T09:30:00-04:00,41.23,41.57001,40.78999,41.41,13371477,6570013.95,45.69400435492587,59.247644693335225,NaN,NaN,-184.94256719329096,-48.7516853023222,-0.2633561535814033,0.38709551618956795,0.6504516697709712,21389496,39621014.4,24.674225521490342,53.15023995139886,NaN,NaN,13.25080696874273,21.62806696133484
2007-10-23T09:30:00-04:00,41.67,42.17999,41.399,42.07001,8198199,6683433.85,51.37282156259805,58.61913907981911,NaN,NaN,-100.59884368666657,-68.99604267075918,-0.249503364356927,0.33857246432481247,0.5880758286817395,29587695,35324846.2,22.059675573154053,49.88504825187568,NaN,NaN,11.560665971594892,20.18986681994342
2007-10-24T09:30:00-04:00,41.77,42.41,41.47,42.14999,12526395,6958377.25,52.027485115224565,57.95373221375571,NaN,NaN,-82.0480738857688,-82.47169191644473,-0.22799856412396013,0.30307762352678935,0.5310761876507495,42114090,35232377.4,22.005626806830136,46.85061722658303,NaN,NaN,10.401690373788185,18.7915558990641
2007-10-25T09:30:00-04:00,42.31,42.64,41.96001,42.48,7624801,7077397.4,54.73535972012324,57.17127985967476,NaN,NaN,-26.891890863707964,-89.95114655164038,-0.1863489634668346,0.29813998331720626,0.48448894678404086,49738891,35518229,22.636659654844763,43.812057851353664,NaN,NaN,10.225240640454878,17.56779657640564
2007-10-26T09:30:00-04:00,42.7,43.42,42.64,43.28,7529199,7184576.3,60.548924085554695,56.99339924178838,NaN,NaN,82.0843093246066,-62.47941326096554,-0.10383794226270354,0.3546915189556614,0.45852946121836496,57268090,40019652.4,31.970869022162006,41.61052348762437,NaN,NaN,11.90330361911552,16.758583296792768
2007-10-29T09:30:00-04:00,44.14,44.14,43.48,43.75999,4391301,7108446.45,63.57197796917081,56.70917559535849,NaN,NaN,154.27943115802205,5.364986409297063,-0.02022676127512263,0.4332460096244617,0.4534727708995843,61659391,48073631.4,44.80310373710485,40.20286732472021,NaN,NaN,14.285886518431173,16.405340899883967
2007-10-30T09:30:00-04:00,43.09,43.55,42.67999,42.73,14756645,7522353.7,54.008148426626775,55.939518768893485,NaN,NaN,43.572856914706996,34.19932652957178,-0.03662635284818844,0.40768982983934876,0.4443161826875372,46902746,51536641.6,49.236972629516366,38.989385221335866,NaN,NaN,13.215545394561664,15.949655827695066
2007-10-31T09:30:00-04:00,43.3,43.98,42.96001,43.86,9645242,7719976.75,60.94921201572468,55.84676527539157,NaN,NaN,109.1947592909573,72.44789316491699,0.023077929094068528,0.47316359405512287,0.45008566496105434,56547988,54423421.2,52.65141461236059,38.28493603491363,NaN,NaN,14.762850708452216,15.780112239231801
2007-11-01T09:30:00-04:00,43.74001,43.74001,42.23,42.34,11278039,8069473.6,50.01484010199825,54.81682946519366,NaN,NaN,2.006503444980914,78.22757202665477,-0.041816560922771084,0.3978149638075905,0.4396315247303616,45269949,53529632.8,51.49648483716082,37.72525144016531,NaN,NaN,11.904650650663521,15.226474869436332
2007-11-02T09:30:00-04:00,43.10001,43.10001,41.74001,42.72,10723734,8367829.65,52.317902930965396,54.14766525830554,NaN,NaN,-27.978956584461354,56.21491884484118,-0.060056401269959925,0.3645610231429117,0.42461742441287165,55993683,53274751.4,51.15190058788702,37.473085821492994,NaN,NaN,10.56237855765934,14.560175396325333
2007-11-05T09:30:00-05:00,42.23,42.48,41.81,42.22,9228176,8732248.45,49.11149380852006,53.78926524231127,NaN,NaN,-67.33723067498393,11.891586478239983,-0.10412051195695476,0.2944667844666782,0.39858729642363294,46765507,50295974.6,47.178634029899015,37.540691052397115,NaN,NaN,8.373440801690792,13.676356168520398
2007-11-06T09:30:00-05:00,42.5,43.25999,42.39,43.21001,9535078,8968332.45,54.99317217840286,53.86435549849917,NaN,NaN,35.19906286899937,10.216827669098459,-0.06673459252586278,0.3151690557663045,0.3819036482921673,56300585,52175542.4,49.826899879727776,38.32228995677273,NaN,NaN,8.630843135646547,12.955568592395561
2007-11-07T09:30:00-05:00,42.36,43.03,41.87,42,9619074,9171331.25,47.73173111894562,53.23023900336725,NaN,NaN,-45.49908563745195,-20.72194131658339,-0.12050523895668547,0.23127209959631045,0.3517773385529959,46681511,50202247,47.153961613478565,39.08570999179359,NaN,NaN,6.178053329039844,11.987352126201888
2007-11-08T09:30:00-05:00,42.5,42.77,41.52,42.39999,18878592,9649000.9,50.07837721154803,53.36824647145208,NaN,NaN,-50.107968787802996,-31.144835763140172,-0.12557121417419548,0.1948133208352516,0.3203845350094471,65560103,54260277.8,52.76561970115293,40.6865748719121,NaN,NaN,5.091417036680978,11.002218541984615
2007-11-09T09:30:00-05:00,41.95,42.31,41.34,41.53,14597297,10100545.45,45.313150684093735,53.34104263782121,NaN,NaN,-109.69464561247167,-47.487973568742234,-0.18060543274707036,0.09462774407560914,0.2752331768226795,50962806,53254102.4,51.310730229845454,42.58918235108032,NaN,NaN,2.5287172232121122,9.791718353588543
2007-11-12T09:30:00-05:00,41.33,41.47,39.87,39.87,16541551,10652953.1,37.90216702777821,52.37885302819122,NaN,NaN,-247.5880817554941,-83.53814378484427,-0.31407874981065215,-0.11736526044063567,0.19671348937001648,34421255,50785252,47.82615243589918,44.42964498413355,NaN,NaN,-2.4924810311411716,8.036832727198584
2007-11-13T09:30:00-05:00,40.7,41.00999,40.32001,40.92999,14034816,11012678.85,44.18013038326259,51.81832769019394,NaN,NaN,-169.65739588468819,-124.50943553558177,-0.3154200259458527,-0.19756154306229945,0.11785848288355329,48456071,49216349.2,45.70210542831421,46.12225059995384,NaN,NaN,-4.246575933689501,6.28206006135743
2007-11-14T09:30:00-05:00,41.28,41.72,41.05,41.14,9046832,11040415.35,45.35878236403289,51.14857216475891,NaN,NaN,-96.02360743077864,-134.61433989424714,-0.2873980185885029,-0.2413890403520753,0.046008978236427564,57502903,51380627.6,49.062846999957294,48.00983541031902,NaN,NaN,-5.17408378804681,4.64546808287111
2007-11-15T09:30:00-05:00,41.33,41.33,39.87,40.25,18303376,11668924.2,41.37187042270798,49.77878261741272,NaN,NaN,-151.32520917262056,-154.85778797121063,-0.31198566408625517,-0.3439731018713914,-0.03198743778513624,39199527,46108512.4,42.20928191184473,48.74115061672494,NaN,NaN,-7.301157532023004,2.93880728074338
2007-11-16T09:30:00-05:00,40.67,40.67,39.761,40.17,12261875,11604584.95,41.02282218137503,48.168128632570166,NaN,NaN,-146.98999940900524,-162.31685873051734,-0.315855709640116,-0.42680707483528124,-0.11095136519516524,26937652,41303481.6,37.1198843416875,48.19234923133798,NaN,NaN,-9.060071570947397,1.2246817305018405
2007-11-19T09:30:00-05:00,40.25,40.25,38.94,39.12,19124944,11892258.3,36.65201049068945,46.928404494288934,NaN,NaN,-178.0745253520893,-148.41414744983638,-0.3677207255826982,-0.570602272173538,-0.2028815465908398,7812708,35981772.2,32.45275676832162,46.99347666982407,NaN,NaN,-12.005401177158046,-0.6653301134495717
2007-11-20T09:30:00-05:00,39.59,40.05,38.98,39.72,10815875,12023142.1,40.54995273936469,45.471314545977506,NaN,NaN,-139.13104556170737,-142.30887738524024,-0.34081195409425363,-0.6288964892086568,-0.2880845351144032,18628583,30016274.6,28.176102184305435,45.24524006782013,NaN,NaN,-13.18438584631555,-2.45376664671614
2007-11-21T09:30:00-05:00,39.07001,39.45,38.66,38.94,11011355,11947390.1,37.333826380898486,44.56552785161323,NaN,NaN,-144.6216782725488,-152.02849155359425,-0.35323149769779205,-0.7296239072366433,-0.3763924095388512,7617228,20039139.6,22.77125516078921,43.1934379480793,NaN,NaN,-15.203301020265009,-4.2751287000802645
2007-11-23T09:30:00-05:00,38.95,39.92,38.95,39.52,2323409,11682320.5,41.076235886307565,43.76255163413767,NaN,NaN,-104.74520022545842,-142.71248976416183,-0.30205310546022635,-0.7539587913641341,-0.4519056859039078,9940637,14187361.6,20.310391949774754,40.990473045356985,NaN,NaN,-15.697130996798442,-5.906843313897147
2007-11-26T09:30:00-05:00,39.61,40.22,38.69,38.69,18036400,12207680.55,37.61439580188185,42.94133034794923,NaN,NaN,-105.10703673400347,-134.33589722916147,-0.30299008088010315,-0.8306432870040368,-0.5276532061239336,-8095763,7180678.6,17.82628313936692,38.89387655317613,NaN,NaN,-17.20874385935353,-7.52140053467663
2007-11-27T09:30:00-05:00,38.63,39.44,38,39,10899871,12533109.05,39.65985580439345,41.84609346409142,NaN,NaN,-111.85382461255266,-121.09175708125413,-0.2631001288703624,-0.8565283672118866,-0.5934282383415243,2804108,6178958.6,17.49680275388205,36.58458390133001,NaN,NaN,-17.813081046013775,-8.991640607724793
2007-11-28T09:30:00-05:00,39.58,41.42,39.14,40.85001,16412500,12615901.8,50.16172637753815,42.019664553990886,NaN,NaN,-25.943130952278917,-98.45417415936843,-0.1008322480269096,-0.7194685483751613,-0.6186363003482517,19216608,6296563.6,17.689151769103077,34.47995462673176,NaN,NaN,-14.83687703146875,-9.82667438254536
2007-11-29T09:30:00-05:00,41.02,41.67999,40.75,41.25999,11894691,12728374.25,52.1492941445887,42.16758719206523,NaN,NaN,21.872011005996153,-65.15543630365944,0.03796386396844165,-0.5711814703876996,-0.6091453343561413,31111299,10995377.8,25.193385591791028,32.51050933320591,NaN,NaN,-11.808504795102087,-10.109793012910606
2007-11-30T09:30:00-05:00,41.89999,42.39999,41.24001,41.64999,8808285,12604886.55,54.02750210050905,42.79004086466632,NaN,NaN,58.38832176530249,-32.52873190550728,0.15341080018467212,-0.41738183412530105,-0.5707926343099732,39919584,16991167.2,33.52195314310339,31.239882398438624,NaN,NaN,-8.760169445271943,-9.916989646105083
2007-12-03T09:30:00-05:00,41.89999,41.89999,41.11,41.44,6544426,12395921.15,52.82519577369976,43.855971489375,NaN,NaN,46.96370144187646,-2.114584270331291,0.20953139184838876,-0.3088783944994873,-0.518409786347876,33375158,25285351.4,42.97940327576466,30.893686029857584,NaN,NaN,-6.641931191105072,-9.449124152533653
2007-12-04T09:30:00-05:00,41.2,41.44,41.11,41.19,7139047,12291464.7,51.35981735007587,44.36880627271881,NaN,NaN,36.38959622157378,27.534099896494002,0.22249453678378062,-0.24029161536815025,-0.46278615215193086,26236111,29971752,47.52218596471282,31.023691782457487,NaN,NaN,-5.307694056469563,-8.857491281667354
2007-12-05T09:30:00-05:00,41.55,41.95,41.5,41.95,5803844,12104903,55.40939994365832,45.086707528406336,NaN,NaN,82.03714232816439,49.13015455258266,0.27167661113093355,-0.12319038823826389,-0.39486699936919745,32039955,32536421.4,49.87569169658864,31.081752117931156,NaN,NaN,-2.9484477651565344,-8.013342207880093
2007-12-06T09:30:00-05:00,42.24001,42.77,41.85001,42.62,5462621,11897080.35,58.675772385056604,46.32270052571695,NaN,NaN,124.46000342991395,69.64775303736621,0.33461900745442524,0.02340675994883412,-0.3112122475055911,37502576,33814676.8,51.05391713370373,31.713511776635368,NaN,NaN,0.0591567703650573,-6.860128068130786
2007-12-07T09:30:00-05:00,42.86,43.22,42.7,43.02,7082949,11307298.2,60.53447595078914,47.716390080675104,NaN,NaN,155.64779696926655,89.09964807815903,0.3848931289530673,0.16990416368574301,-0.2149889652673243,44585525,34747865,51.94205720291529,32.772238409580204,NaN,NaN,3.1304067127259825,-5.432908813722676
2007-12-10T09:30:00-05:00,43.47,43.72,43.17,43.63,5413383,10848102.5,63.24920594445807,49.61618975594428,NaN,NaN,169.58074126340313,113.62305604246437,0.4371160287987099,0.3314060707310631,-0.10570995806764683,49998908,38072615,55.07010490274845,34.387763276324975,NaN,NaN,6.57857462555321,-3.7169826081118353
2007-12-11T09:30:00-05:00,43.66,43.66,41.82001,41.82001,9096340,10475841.95,51.85185139089545,50.423468231053626,NaN,NaN,91.1372918303244,124.5725951642145,0.332388390342758,0.3097755298608007,-0.02261286048195732,40902568,41005906.4,57.6868671759605,36.495675061443194,NaN,NaN,6.16448303127412,-2.305344659628128
2007-12-12T09:30:00-05:00,43.17999,43.25,41.78,42.38,10875070,10317854.65,54.57891498188308,51.655260273981106,NaN,NaN,83.50360638603004,124.86588797578762,0.2852661974963958,0.3339698863885374,0.04870368889214163,51777638,44953443,60.9804372178335,39.22490235123207,NaN,NaN,6.690908535372304,-1.0201656317709236
2007-12-13T09:30:00-05:00,42.35001,42.75,42.0174,42.71001,7228496,10226937.85,56.154956625738684,52.73231175536904,NaN,NaN,77.97915092435034,115.56971747467489,0.2613932394776253,0.3754452382391733,0.11405199876154798,59006134,49254154.6,64.24570483912024,42.36313898618532,NaN,NaN,7.6013906086000365,0.21148525971064225
2007-12-14T09:30:00-05:00,42.55,42.55,41.72,41.96001,6515418,9637539.95,51.75935909257996,53.74266627613319,NaN,NaN,51.26961606957882,94.69408129473734,0.18382442817689798,0.34383253398267044,0.16000810580577246,52490716,50835192.8,65.39226356513106,45.76070901659705,NaN,NaN,7.020071806082593,1.184140480620921
2007-12-17T09:30:00-05:00,41.75,41.75,40.44,40.47,8555199,9452206.15,44.33455818378659,54.076573588946985,NaN,NaN,-13.709115179279909,58.03611000620073,0.029021699107971755,0.19628522969073714,0.16726353058276539,43935517,49622514.6,63.704823750233814,49.06128194490788,NaN,NaN,4.031629456620193,1.5909246200493885
2007-12-18T09:30:00-05:00,41.3,41.3,40.07001,40.92,8879938,8939955.85,46.81589539646137,53.8375856617272,NaN,NaN,-25.71532203807569,34.665587232520714,-0.0423339788311011,0.114346057043889,0.1566800358749901,52815455,52005092,65.5839217594555,52.48233694421875,NaN,NaN,2.397645254345641,1.7061704249488532
2007-12-19T09:30:00-05:00,40.82001,41.23,40.56,40.86,5628305,8680577.35,46.51814936809007,53.43536103483444,NaN,NaN,-24.01653283322015,13.161559388670677,-0.09009660005875045,0.04405928580155205,0.1341558858603025,47187150,51086994.4,64.20451419114232,55.268846129886704,NaN,NaN,1.0105392355000966,1.606794540741888
2007-12-20T09:30:00-05:00,41.5,41.61,40.66,41.61,5563031,8408161.15,50.73587310365361,53.200244677916196,NaN,NaN,-6.268674036265339,-3.6880056034524586,-0.06867009881588634,0.04831826234044456,0.1169883611563309,52750181,49835803.8,62.2819676998261,57.32313288393833,NaN,NaN,1.085760884856286,1.532361161329659
2007-12-21T09:30:00-05:00,41.87,42.27,41.60001,42.11,6028691,8593425.25,53.375711518993974,53.2395672311515,NaN,NaN,36.49698066561425,-6.642532684245367,-0.02079831153399725,0.09099047173883434,0.1117887832728316,58778872,51093435,63.46615706734746,58.78647244047995,NaN,NaN,1.9363668335432145,1.590076257360167
2007-12-24T09:30:00-05:00,42.39999,42.59,42.25999,42.5,1318270,7757518.75,55.3839574070636,53.527005806650614,NaN,NaN,64.94011708296281,9.087313768203177,0.03416681105223676,0.15449729708812754,0.12033048603589078,60097142,54325760,66.38710892413403,60.13396693758147,NaN,NaN,3.2357813553446544,1.8251769856436653
2007-12-26T09:30:00-05:00,42.61,42.75,42.22,42.72,2006731,7312861.75,56.52163864007353,53.60645142782313,NaN,NaN,69.1661665945961,28.063611494737536,0.07976966031233623,0.22004256142631107,0.14027290111397483,62103873,56183443.6,67.97200295817662,61.42656059912347,NaN,NaN,4.636793595699068,2.2268365013658658
2007-12-27T09:30:00-05:00,42.58,42.61,41.92,41.92,5096734,6747073.45,51.38995607469577,53.08603597708308,NaN,NaN,22.351192059779873,37.337156473337544,0.05183801303002661,0.2050704174015081,0.1532324043714815,57007139,58147441.4,69.60380516218915,62.75155260115814,NaN,NaN,4.389208996015199,2.535746857744342
2007-12-28T09:30:00-05:00,42.32001,42.50999,41.87,41.95,2136894,6259183.6,51.5675375018129,52.44554037358477,NaN,NaN,14.067157697472846,41.40432282008518,0.032131102671483586,0.19339628271083598,0.1612651800393524,59144033,59426211.8,70.6522575105404,64.08799548027422,NaN,NaN,4.2360497681668985,2.7786472735189927
2007-12-31T09:30:00-05:00,42.16,42.16,41.60001,41.7,2064275,5921983.1,49.930564773831975,51.49420886139718,NaN,NaN,-19.802631693370135,30.144400348288297,0.0006701877308601667,0.1621029147029276,0.16143272697206743,57079758,59086389,69.96164551880366,65.1516769528496,NaN,NaN,3.6617854024934573,2.9048098633724875
2008-01-02T09:30:00-05:00,41.7,41.95,40.98,41.3,9539234,6071723.5,47.34111099860554,51.17201311909077,NaN,NaN,-66.40878300344328,3.8746203310070824,-0.04608285348707672,0.10382916011322152,0.14991201360029824,47540524,56575065.4,64.91192429352449,65.66775246124702,NaN,NaN,2.4586544081211095,2.8410733697651476
2008-01-03T09:30:00-05:00,41.52,42.17,41.45,42.05,8798109,6154676.6,52.33279752522318,51.01157615790078,NaN,NaN,-15.86312154591848,-13.131237297095831,-0.026474485986527407,0.11681890611713897,0.14329339210366637,56338633,55422017.4,62.67510027615962,65.78879982255602,NaN,NaN,2.776321453281068,2.8318230959817074
2008-01-04T09:30:00-05:00,41.57001,41.57001,40.7,40.78,14374914,6583230.1,44.619691272199276,50.18762863264796,NaN,NaN,-109.27882888395669,-39.45724148584314,-0.09515131636390035,0.024354246648790934,0.11950556301269129,41963719,52413333.4,57.141905885907846,65.28138561161228,NaN,NaN,0.7015406068625347,2.52749702610754
2008-01-07T09:30:00-05:00,40.81,41.06,39.67,40.22,19606208,7290409.45,41.70110889393083,49.469182189887306,NaN,NaN,-157.14351440582317,-73.69937590650235,-0.17003603506352394,-0.09303948081671365,0.0769965542468103,22357511,45056029,46.3629079258392,63.922145923091435,NaN,NaN,-1.9511343930681169,1.8876925376538747
2008-01-08T09:30:00-05:00,40.39999,41.07001,39.47,39.60001,22922880,8082406,38.684211853225534,49.06558602341865,NaN,NaN,-155.47026525116274,-100.83290261806087,-0.24832703233513964,-0.23341223617211426,0.014914796163025393,-565369,33527003.6,35.16781683772095,61.88378828648337,NaN,NaN,-5.142635761824762,0.883359923442641
2008-01-09T09:30:00-05:00,39.47,40.08,38.75,39.85001,25711760,9097324.85,40.551843749876966,48.61815376294834,NaN,NaN,-172.80768583444853,-122.11268318426191,-0.26856215869556693,-0.3207879022064333,-0.05222574351086634,25146391,29048177,31.941084389062084,59.480728474312414,NaN,NaN,-7.215048389431359,-0.27355554982507324
2008-01-10T09:30:00-05:00,39.61,40.81,39.17999,40.39,14763508,9380683.25,44.48515649471919,48.472939986278995,NaN,NaN,-109.40738185561753,-140.82153524620173,-0.23222963932252072,-0.34251279266401724,-0.11028315334149652,39909899,25762430.2,29.78220247708704,57.02199192330847,NaN,NaN,-7.8275759364206925,-1.352701319338733
2008-01-11T09:30:00-05:00,39.94,40.50999,39.78999,39.98,10909500,9382404.75,42.20199867776791,47.86337752728715,NaN,NaN,-100.51034565293435,-139.0678385999973,-0.22244307033022484,-0.38833699125427756,-0.16589392092405272,29000399,23169766.2,28.1645723739735,54.58503511431899,NaN,NaN,-9.012577895148196,-2.4469694015972276
2008-01-14T09:30:00-05:00,40.35001,41.44,40.2,41.32001,13800059,9710982.9,51.045466356963416,47.69693144428497,NaN,NaN,-20.79717921608672,-111.79857156204999,-0.11761947426373026,-0.31291826375371556,-0.1952987894899853,42800458,27258355.6,34.23128865766738,52.49683022791328,NaN,NaN,-7.293162671649084,-3.1392827258903497
2008-01-15T09:30:00-05:00,40.71001,41.28999,39.94,40.19,16597980,10215111,44.81787680200429,46.94221140106645,NaN,NaN,-60.16990958943062,-92.73850042970355,-0.11608636432797845,-0.34040674489995837,-0.22432038057197992,26202478,32611925,41.230104183496984,50.69990131786778,NaN,NaN,-7.840730711007844,-3.8109181523357063
2008-01-16T09:30:00-05:00,39.60001,40.12,38.28999,38.85001,19177696,10746235.85,38.77650670774835,45.67470197732894,NaN,NaN,-159.4644796854128,-90.06985919989641,-0.19250994692817602,-0.46495781423219995,-0.2724478673040239,7024782,28987603.2,38.261608413213466,48.577730278941836,NaN,NaN,-10.42139847462932,-4.755272484091937
2008-01-17T09:30:00-05:00,38.37,38.84,36.64999,36.92999,23172080,11460842.95,32.099633675070535,44.29682180592714,NaN,NaN,-229.32049705254647,-114.0524822392822,-0.3503664140882676,-0.7104058849143584,-0.36003947082609083,-16147298,17776163.8,30.85984707362087,45.81030470118696,NaN,NaN,-15.228898220274184,-6.251504732117972
2008-01-18T09:30:00-05:00,37.08,37.95,36.47,37.35001,18311184,12094986.9,34.74664724779922,43.09532964492616,NaN,NaN,-192.91960590853827,-132.53433429040302,-0.40085389684995554,-0.8611068418885353,-0.4602529450385797,2163886,12408861.2,28.0611452123034,42.76808239417003,NaN,NaN,-17.990762917025407,-7.928541615676177
2008-01-22T09:30:00-05:00,35.38,37.45,34.83,37.00999,22056000,12919635.35,33.60455451238846,41.92918605482305,NaN,NaN,-195.1826301083177,-167.4114244688492,-0.428988293093286,-0.9964883114051872,-0.5675000183119012,-19892114,-129653.2,22.848137608330916,39.402831829136254,NaN,NaN,-20.533646596841486,-9.729270898699792
2008-01-23T09:30:00-05:00,36.08,37.69,34.64999,37.64999,28003520,14018376.8,37.75194067509974,41.24424531742977,NaN,NaN,-156.7137661819794,-186.72019578735893,-0.37811701822723975,-1.040146291095951,-0.6620292728687112,8111406,-3747867.6,21.60106693052873,36.30919916035085,NaN,NaN,-21.26247106198561,-11.376870922026336
2008-01-24T09:30:00-05:00,38.09,38.8,37.86,38.25,19114496,14908188.1,41.44481669942698,40.46653240130148,NaN,NaN,-74.17670734295376,-169.66264131886714,-0.28208353879962544,-1.014633696368243,-0.7325501575686175,27225902,292356.4,26.429850396468936,33.72025274037294,NaN,NaN,-20.677792216752987,-12.705573964130144
2008-01-25T09:30:00-05:00,39.46001,39.53999,38.17,38.44,17651072,15690405.15,42.60595916869817,40.322694393908534,NaN,NaN,-48.373221319775354,-133.47318617231292,-0.1883004530668415,-0.9679257239021695,-0.779625270835328,44876974,12497210.8,38.71059797352493,32.40373074663131,NaN,NaN,-19.854586495779518,-13.726861468651483
2008-01-28T09:30:00-05:00,38.55,39.24001,38.12,39.2,13922141,16131675.5,47.12278565510109,40.70995701970641,NaN,NaN,-36.18032313828424,-102.12532961826211,-0.06403889163004572,-0.8596738853728851,-0.7956349937428394,58799115,23824256.6,47.47388753251126,32.48308643282217,NaN,NaN,-17.757935480084093,-14.302729184570428
2008-01-29T09:30:00-05:00,39.59,40.03,39.22,39.39999,13991309,16724396.25,48.2763326355638,41.395108504159154,NaN,NaN,2.331796635706045,-62.62244426945737,0.03721941920204774,-0.7491107197402798,-0.7863301389423275,72790424,42360764.2,58.0457922968775,34.11722753704764,NaN,NaN,-15.708112329242919,-14.503498205237927
2008-01-30T09:30:00-05:00,39.2,40.64999,39.00999,39.25,13589824,17300673.7,47.44043312209981,41.88715060217506,NaN,NaN,13.0481650743396,-28.670058018193565,0.09633187365891027,-0.6659152968686897,-0.7622471705275999,59200600,52578603,62.52347314331948,36.301683876637455,NaN,NaN,-14.252840203106546,-14.467689919219158
2008-01-31T09:30:00-05:00,39.24001,40.33,38.62,39.95,13310324,17489228.2,51.648210653625284,42.39879732781122,NaN,NaN,18.73135064402056,-10.088446420798702,0.17995416554174315,-0.537304463600421,-0.7172586291421641,72510924,61635607.4,65.98855074062556,38.88785160974736,NaN,NaN,-11.756505147683534,-14.080377808999783
2008-02-01T09:30:00-05:00,40.75999,41.06,40.14,40.92,13193191,17708982.3,56.80832596795516,43.442106419967445,NaN,NaN,87.00273911962982,16.986745667082324,0.2913757472554428,-0.3530389450728606,-0.6444146923283034,85704115,69801035.6,68.7902587164049,41.78968634849246,NaN,NaN,-7.960668818804501,-13.206133667543314
2008-02-04T09:30:00-05:00,40.75999,41.09,40.22,40.28,8166328,17398553,52.804195585470545,43.56772993628938,NaN,NaN,79.30592590894663,40.0839954765285,0.31096993883083923,-0.25570226878975433,-0.5666722076205936,77537787,73548770,70.01129876929522,44.34540135646588,NaN,NaN,-5.907142246185856,-12.163420607349392
2008-02-05T09:30:00-05:00,39.55,39.75,38.81,39.12,10189148,16927700,46.41795958615224,43.682021563728526,NaN,NaN,3.7255253086760396,40.3627412111225,0.23808739278093927,-0.26906296664441953,-0.5071503594253588,67348639,72460413,69.16501989281787,46.340752478560226,NaN,NaN,-6.082550207383433,-11.294724835925685
2008-02-06T09:30:00-05:00,39.14999,39.72,38.53,38.85001,12145234,16388817.7,45.05222242917294,44.13028697240171,NaN,NaN,-5.448696886652702,36.66336881892404,0.16731855230234965,-0.2980021690474217,-0.46532072134977137,55203405,71660974,68.50993503348856,48.50134723715131,NaN,NaN,-6.639911111648841,-10.629751446743278
2008-02-07T09:30:00-05:00,38.5,39.42,38.03999,39,10788934,15642676.4,46.00272271247025,45.12336476078741,NaN,NaN,-17.04370431176243,29.508357827767476,0.1280051507088062,-0.3053142829637636,-0.4333194336725698,65992339,70357257,67.38899414638871,51.1105720280633,NaN,NaN,-6.819688812869475,-10.085456784761305
2008-02-08T09:30:00-05:00,38.64999,39.87,38.64999,39.83,16088426,15708922.3,51.04892676163309,46.287813297489826,NaN,NaN,27.289154791245075,17.565640962090527,0.15357318223054572,-0.24135295588438765,-0.3949261381149334,82080765,69632587,66.73537182215735,53.87301678591001,NaN,NaN,-5.475590441181005,-9.42690444996412
2008-02-11T09:30:00-05:00,39.88,40.37,39.35001,39.97,10378035,15682349.05,51.86603429909895,47.592204710826294,NaN,NaN,58.66404718632977,13.43726521756715,0.17408310822401685,-0.17732225283491232,-0.35140536105892917,92458800,72616789.6,68.10721071531493,57.10580772212315,NaN,NaN,-4.14078078844386,-8.671743926889796
2008-02-12T09:30:00-05:00,40.21001,41.2,40.02,40.69,22395264,16112109.3,55.93942702336977,48.891310878559864,NaN,NaN,111.95305924082207,35.082772003996354,0.22696502184974676,-0.06769908374674571,-0.2946641055964925,114854064,82117874.6,72.05818842977251,60.70988782921199,NaN,NaN,-1.7731934535212053,-7.686236716408569
2008-02-13T09:30:00-05:00,41.99001,42.87,39.97,40.52,11137313,15839075.95,54.7610679329587,49.842471680954986,NaN,NaN,139.16781249091326,64.00607387950956,0.24004989288545459,0.00539826051032577,-0.23465163237512882,103716751,91820543.8,75.40859915557546,64.20836988343389,NaN,NaN,-0.14410361747896255,-6.608789130847197
2008-02-14T09:30:00-05:00,40.85001,41.23,40,40,16066992,15683540.75,51.207747133171516,50.45688510698879,NaN,NaN,82.02725329763865,83.82026540138978,0.2046215134619922,0.021125259452361433,-0.18349625400963077,87649759,96152027.8,76.74894340952491,66.92539455743389,NaN,NaN,0.2653155344782594,-5.626774178657846
2008-02-15T09:30:00-05:00,40.10001,40.50999,39.75,40.25,10859625,15067918,52.793677187737806,50.86194878789142,NaN,NaN,61.396472390765204,90.64172892129379,0.1893164100203064,0.05314925851575225,-0.13616715150455416,98509384,99437751.6,77.74008480668621,69.08726579130352,NaN,NaN,1.0492905852561578,-4.673050640955846
2008-02-19T09:30:00-05:00,40.48,41.67,40.48,41.25,15282371,14916477.35,58.59152802290874,51.59874845841607,NaN,NaN,118.14412420220316,102.53774432446846,0.2348582623942967,0.15740567648831671,-0.07745258590597998,113791755,103704342.6,78.99237375376136,70.58345018108095,NaN,NaN,3.4823144896513494,-3.5079984794405323
2008-02-20T09:30:00-05:00,40.64999,41.7,40.64999,41.49001,8953930,14261373.85,59.86561051307661,52.486261129200116,NaN,NaN,122.1388193723008,104.57489635076422,0.26711435290460994,0.2564403552247825,-0.010673997679827477,122745685,105282666.8,79.45287622493505,71.7926932583392,NaN,NaN,5.872708143465506,-2.1678975333110984
2008-02-21T09:30:00-05:00,41.95,42.02901,40.83,40.92999,14741020,13598248.85,55.56924040446363,52.766334682831435,NaN,NaN,112.27721846805072,99.19677754619171,0.2376874144755534,0.28643527041461425,0.04874785593906087,108004665,106140249.6,79.71309303605769,72.77301770801293,NaN,NaN,6.706971400447316,-0.9000591142027536
2008-02-22T09:30:00-05:00,41.50999,41.50999,40.39999,41.32001,12645938,13274820.95,57.83861983354007,52.83992710180178,NaN,NaN,87.64546390878806,100.3204196684216,0.23122895288082768,0.33778404704009546,0.10655509415926778,120650603,112740418.4,81.64024057046106,73.69087355473123,NaN,NaN,8.06749837311675,0.3810205268428897
2008-02-25T09:30:00-05:00,41.5,42.37,40.96001,42.27,14668930,13125713.85,62.819999121040546,53.55534164005678,NaN,NaN,139.82686483408438,116.00649815708543,0.27471421047297423,0.4499478572504856,0.17523364677751135,135319533,120102448.2,83.5207043906166,74.65583109911132,NaN,NaN,10.809607928827447,1.8708187271263979
2008-02-26T09:30:00-05:00,42.28,42.75,41.78999,42.47,19620528,13410633.2,63.78997136064037,54.79619962394879,NaN,NaN,160.66001960774778,124.50967723819436,0.2987349156806166,0.5486522913782821,0.2499173756976655,154940061,128332109.4,85.3295833712622,75.81044277614306,NaN,NaN,13.346963698181424,3.5102680087056872
2008-02-27T09:30:00-05:00,42.25999,42.88,41.86,42.46001,12548074,13338471.45,63.70057631575267,56.12822490156162,NaN,NaN,146.45162078249996,129.3722375202342,0.2952144629596016,0.6189354543971675,0.3237209914375659,142391987,132261369.8,86.11334167686637,77.06782896495577,NaN,NaN,15.390219037500882,5.207403869962143
2008-02-28T09:30:00-05:00,42.25,42.52,41.92999,42.23,10960164,13206988.45,61.561453033263,57.23956278161825,NaN,NaN,118.60455604158304,130.63770503494067,0.25990227808872157,0.6485988390484678,0.38869656095974625,131431823,136946801.4,87.00488664832044,78.46896414366516,NaN,NaN,16.54660311389806,6.827289476238702
2008-02-29T09:30:00-05:00,42.10001,42.10001,40.66,40.87,10201480,13051546.25,50.716686669235074,57.21583134644696,NaN,NaN,36.81899120941774,120.47241049506658,0.13380908269414632,0.5559579143274291,0.4221488316332828,121230343,137062749.4,87.02708299439648,79.9183720845394,NaN,NaN,14.33285710634476,7.89951342339671
2008-03-03T09:30:00-05:00,40.99001,41.55,40.84,41.55,12861641,13034968.75,54.98649927916472,57.43872170216594,NaN,NaN,41.367290487016895,100.78049562565307,0.08730917850723208,0.5312853047673229,0.44397612626009086,134091984,136817239.6,86.68943990409277,81.24567416945209,NaN,NaN,13.737573189601907,8.733521961426025
2008-03-04T09:30:00-05:00,40.97,41.55,39.8,40.55,26244224,13938863.55,48.35212117145735,56.896771284172196,NaN,NaN,-10.8675580233171,66.4749800994401,-0.014278261406407033,0.4261282995020821,0.4404065609084891,107847760,127398779.4,74.71376924341067,81.43535851328339,NaN,NaN,11.037375661328975,9.062643918555018
2008-03-05T09:30:00-05:00,40.41,41.948,40.41,41.69,12355332,14047172.75,55.015527741273175,56.9149469847661,NaN,NaN,39.00287070914633,44.985230084769384,-0.00846577640934093,0.42982434039681294,0.4382901168061539,120203092,122961000.4,69.81957401765091,81.03614243200306,NaN,NaN,10.916997081019323,9.327551513192777
2008-03-06T09:30:00-05:00,41.02,41.81,41,41.32001,14301695,14154995.8,52.64172956997843,57.017374301680874,NaN,NaN,36.163095245464156,28.4969379255456,-0.03198653819991609,0.39830694405625877,0.43029348225617486,105901397,117854915.2,64.57788189514334,80.16678089526151,NaN,NaN,10.042228951351513,9.429648290072596
2008-03-07T09:30:00-05:00,40.5,41,39.3,39.59,26670448,14949071.5,43.245693341337414,56.335375455509414,NaN,NaN,-116.89701105239466,-2.246262526816875,-0.15938020895281935,0.23106822106515068,0.39044843001797,79230949,109455036.4,56.997058136063444,78.68513613307417,NaN,NaN,5.856802597529366,8.91924176256642
2008-03-10T09:30:00-04:00,39.31,39.39999,38.11,38.74001,33544464,15821873.4,39.51392567343124,54.97268957340388,NaN,NaN,-226.4620853315561,-55.81213769053147,-0.2886771397134007,0.029602005376219154,0.31827914508961985,45686485,91773936.6,45.01762817625689,76.25836859182387,NaN,NaN,1.1136751942347478,7.804160824233325
2008-03-11T09:30:00-04:00,39.81,41.10001,39.07001,41.10001,29883744,16797158.85,51.91965221264626,54.40512112337314,NaN,NaN,-65.55336033629457,-66.74929815312697,-0.20687702193815272,0.059682867666928985,0.2665598896050817,75570229,85318430.4,41.58135223652138,73.55325973550859,NaN,NaN,1.6342370121628782,6.92274313679469
2008-03-12T09:30:00-04:00,40.99001,41.17,40.2,40.50999,11746758,16264733.55,49.20262201325798,53.95036266685845,NaN,NaN,-44.08266185614067,-83.36640466618437,-0.18484533114761179,0.03550322567056696,0.22034855681817875,63823471,74042506.2,36.36049584821555,70.45664565066272,NaN,NaN,1.0249447918998793,6.080200516095431
2008-03-13T09:30:00-04:00,40.2,41.5,39.61,41.5,19586416,16687188.7,53.59116991308989,53.646973386826296,NaN,NaN,-17.01188602166978,-94.00140091961116,-0.10017514685924175,0.09512962324412655,0.1953047701033683,83409887,69544204.2,34.499533827630856,67.08945231188913,NaN,NaN,2.1327563889854826,5.516279926508296
2008-03-14T09:30:00-04:00,41.75,41.92999,40.09,40.77,25349232,17151300.7,50.15065000263067,52.742019878368446,NaN,NaN,-14.172516375660512,-73.45650198426434,-0.09022161984693644,0.08252774529469775,0.1727493651416342,58060655,65310145.4,32.797972265505194,63.46640001723832,NaN,NaN,1.8045937844310684,4.986039049068692
2008-03-17T09:30:00-04:00,39.14999,40.78,39.14999,39.95,17679568,17492297.85,46.53654589654824,51.50963234521901,NaN,NaN,-116.41447973703481,-51.44698086536007,-0.1331587828684806,0.006300886556033447,0.13945966942451404,40381087,64249065.8,32.36713382370702,59.68336790669867,NaN,NaN,0.29587614686115615,4.3160157773247585
2008-03-18T09:30:00-04:00,40.83,41.38,40.19,41.35001,15617348,17509046.7,52.79178150824306,50.73043271611118,NaN,NaN,-7.273546349243131,-39.79101806794978,-0.0650166210511511,0.05818889311057518,0.12320551416172627,55998435,60334707,30.761760686990527,55.72968355027897,NaN,NaN,1.212826881066248,3.8727030778592573
2008-03-19T09:30:00-04:00,41,41.60001,38.55,38.55,25600128,18341356.6,42.16597440375393,49.34504138543196,NaN,NaN,-134.62914329779198,-57.90031435628005,-0.1987114934675739,-0.12518385267274112,0.07352764079483279,30398307,53649674.2,28.190196085181498,51.52863422434048,NaN,NaN,-2.078682148602658,3.022505188364698
2008-03-20T09:30:00-04:00,38.17999,38.85001,37.10001,38.3,31078160,19158213.6,41.36540678666172,48.677092822391,NaN,NaN,-216.184629463946,-97.73486304473529,-0.28871681797569704,-0.2873683816747885,0.0013484363009085287,-679853,36831726.2,22.984532771459314,46.95416635127354,NaN,NaN,-4.811954165814057,1.9032967091963044
2008-03-24T09:30:00-04:00,39.08,40.39,38.88,39.66,22942240,19673028.7,47.234481903636826,48.123377295567586,NaN,NaN,-81.25110055595684,-111.15057988079457,-0.2432156696486289,-0.3026711507598776,-0.0594554811112487,22262387,29672072.6,21.190528563245664,42.27567268407018,NaN,NaN,-4.9711759460628935,0.9212291870164191
2008-03-25T09:30:00-04:00,40.22,41.08,40.22,40.85001,16423957,19760780.05,51.782448731122365,48.368400692686514,NaN,NaN,3.910950433904635,-87.08549384660668,-0.1254609616912274,-0.21628168322528296,-0.09082072153405556,38686344,29333124,21.106537844929363,38.446584727035805,NaN,NaN,-3.493834913420196,0.2905057440969028
2008-03-26T09:30:00-04:00,41,41.14999,40.47,40.67,13400016,19449754.45,51.065439316094135,48.08625151945944,NaN,NaN,15.032355931467027,-82.62431339046464,-0.05573754358679463,-0.16049265101754884,-0.10475510743075421,25286328,23190702.6,19.59109790948878,34.85883643359565,NaN,NaN,-2.59176658789994,-0.12124744618836047
2008-03-27T09:30:00-04:00,40.72,41.11,40.3,40.56,15185621,19581631.8,50.604322851892945,47.940722468167614,NaN,NaN,14.495275028924963,-52.79942972512125,-0.01517931245075542,-0.12372924799419849,-0.10854993554344307,10100707,19131182.6,18.638619311503746,31.577460534764242,NaN,NaN,-2.0231184677859684,-0.3929433064165902
2008-03-28T09:30:00-04:00,40.69,40.71001,40.06,40.22,9017793,19484513.25,49.12766263756997,48.36086313218423,NaN,NaN,-7.8310283761799155,-11.128709507568027,-0.009670850932918001,-0.12063849920959058,-0.11096764827667258,1082914,19483736,19.006900364381025,28.863877836786916,NaN,NaN,-1.993022342681744,-0.6215260258830407
2008-03-31T09:30:00-04:00,40.59,40.69,39.82001,40.17,12261996,19587539.05,48.901670970465716,49.03141636768669,NaN,NaN,-13.790805103960896,2.3633495828311673,-0.007890504307344254,-0.1208307786608529,-0.11294027435350865,-11179082,12795442.2,17.397978429385986,26.891045712010428,NaN,NaN,-2.0317488218817967,-0.8229864253114344
2008-04-01T09:30:00-04:00,40.53,41.75,39.72,41.45,15229602,19705937.1,54.65266294391052,49.22663141991985,NaN,NaN,67.98063050001468,15.177285596053185,0.07635528035023909,-0.01749617391570979,-0.09385145426594887,4050520,5868277.4,15.897033920709404,25.056451546595287,NaN,NaN,-0.37141312904292034,-0.7584759544159324
2008-04-02T09:30:00-04:00,41.28999,41.83,40.88,41.73,12019656,18994708.7,55.823929887941844,49.69958198239727,NaN,NaN,111.78140051447966,34.52709451265571,0.14388080775728768,0.08599955543066073,-0.05788125232662695,16070176,4025047,15.51351667896175,23.567381605934298,NaN,NaN,1.3367618489722237,-0.4591562682176244
2008-04-03T09:30:00-04:00,41.14999,42.84,41.14999,42.49001,16905072,19222195.7,58.92510651583451,50.080577454021885,NaN,NaN,168.5844372947294,65.3449269658166,0.22769178546173782,0.22673347950054534,-0.0009583059611924863,32975248,8599955.2,20.63156134830406,22.57681214312524,NaN,NaN,3.7159699797676513,0.13729033863741497
2008-04-04T09:30:00-04:00,42.66,43.21001,42.05,42.91,14388367,19226529.3,60.572302104576636,50.82498117558946,NaN,NaN,199.16486005473806,106.74410465200019,0.29509842028099437,0.3679147193900505,0.07281629910905613,47363615,17856095.4,29.886070134651163,22.368819133778526,NaN,NaN,6.191762263905195,1.002214899389955
2008-04-07T09:30:00-04:00,43.24001,43.8,42.47,42.67999,21601024,18973058.1,59.17276933689217,51.72756856418545,NaN,NaN,191.09795569019286,147.72185681083096,0.30653549312976414,0.4559856655212613,0.14945017239149716,25762591,25244430,36.27351031960357,22.647846026342567,NaN,NaN,7.883235829873168,1.9852178894589854
2008-04-08T09:30:00-04:00,42.48,43.08,42.25,43.08,13575105,17974590.15,60.866208997147105,52.304313384821455,NaN,NaN,157.42387010841344,165.6105047325107,0.32180012675224196,0.5517003308317996,0.22990020407955764,39337696,32301865.2,41.733898577238236,23.431570161360266,NaN,NaN,9.794321440052526,3.1008041109723483
2008-04-09T09:30:00-04:00,42.72,43.25999,42.34,42.62,9768547,16968830.3,57.892400300660995,53.427629520314824,NaN,NaN,129.61591170492719,169.1774069706002,0.2830463273552239,0.5837081132735875,0.3006617859183636,29569149,35001659.8,43.72055091948152,24.540881220953118,NaN,NaN,10.649298787113148,4.179160493278177
2008-04-10T09:30:00-04:00,42.59,42.78999,41.96001,42.73,6294543,16696219.55,58.415622920888076,54.64550210133098,NaN,NaN,95.90436103330615,154.64139171831556,0.24819730739619772,0.6109084201636108,0.3627111127674131,35863692,35579348.6,44.15928842701063,26.053363767778215,NaN,NaN,11.504645429812907,5.225658341354567
2008-04-11T09:30:00-04:00,42.3,42.66,41.98,42.17999,12305508,16332174.15,54.75217528803836,55.18248020021681,NaN,NaN,71.84663827715012,129.17774736279796,0.17493658258727657,0.5813818410015088,0.40644525841423224,23558184,30818262.4,41.301577188210175,27.489867240989962,NaN,NaN,11.291406106337696,6.092193736352157
2008-04-14T09:30:00-04:00,42.00999,42.37,41.78,41.97,4805566,15304990.85,53.37585802764226,55.29629514996824,NaN,NaN,51.76954094122366,101.31206441300412,0.10274115978244658,0.5348717081422905,0.4321305483598439,18752618,29416267.8,40.47102774920585,28.87304509129542,NaN,NaN,10.750285067220586,6.757635355047647
2008-04-15T09:30:00-04:00,42.10001,42.59,41.7,42.2,11167148,14979369.85,54.71847498726227,55.557226269337384,NaN,NaN,53.12660763345285,80.452611918012,0.06284301701375605,0.510684319627039,0.4478413026132829,29919766,27532681.8,39.326803116196935,30.282738320346006,NaN,NaN,10.625053108717616,7.310123605571928
2008-04-16T09:30:00-04:00,42.56,44.22,42.56,44.22,17189504,15057977.65,64.41149724906572,56.54345301199259,NaN,NaN,126.05532416128287,79.74049440928313,0.15937009652792067,0.6470539232731838,0.4876838267452631,47109270,31040706,42.58270705368042,31.99303030193005,NaN,NaN,13.424438012281453,8.183597092244717
2008-04-17T09:30:00-04:00,43.92999,44.53999,43.33,44,15530660,14554504.25,62.83392821962917,57.52247198213968,NaN,NaN,129.3403682036072,86.42769584334334,0.19303094972284918,0.7289725138988246,0.5359415641759754,31578610,30183689.6,41.98987655578605,33.63467145845898,NaN,NaN,15.263776640397325,9.195051313409376
2008-04-18T09:30:00-04:00,43.95,44.62,43.8,44.24001,10487324,13524962.45,63.8734714353641,58.59188630106099,NaN,NaN,139.88399590128904,100.03516736817112,0.2144407195878636,0.8039924636608049,0.5895517440729413,42065934,33885239.6,45.51789098344419,35.643236640891715,NaN,NaN,17.091551091929997,10.323122710340893
2008-04-21T09:30:00-04:00,44.10001,44.50999,43.84,44.35001,9763277,12866014.3,64.36541538031892,59.28565433223302,NaN,NaN,132.99873662536103,116.2810065049986,0.21826372400054828,0.8623813990736267,0.6441176750730784,51829211,40500558.2,51.226876726363855,38.1667968412956,NaN,NaN,18.745408055876258,11.526306331131659
2008-04-22T09:30:00-04:00,44.46001,44.46001,43.39999,44,11269266,12608279.75,61.49590351317217,59.69079530546376,NaN,NaN,103.75619828657331,126.40692463562269,0.18100904562148057,0.870378982099929,0.6893699364784485,40559945,42628594,52.9353672333966,40.83978616661238,NaN,NaN,19.39691747570532,12.650679351785039
2008-04-23T09:30:00-04:00,43.89,44.03999,43.14999,43.31,7736879,12325122.9,56.17873162397688,59.49462567033107,NaN,NaN,68.03544345453825,114.80294849427375,0.09785069952586789,0.8116833108857833,0.7138326113599154,32823066,39771353.2,50.3834169077114,42.96491870657004,NaN,NaN,18.489313236308124,13.484769906716908
2008-04-24T09:30:00-04:00,43.44,43.44,42.35001,42.67999,13195164,12225600.05,51.77671160305968,58.866369205937005,NaN,NaN,17.217428586622898,92.3783605708769,-0.006114478162632331,0.706189513656625,0.7123039918192573,19627902,37381211.6,48.28635070195086,44.27922446137717,NaN,NaN,16.421754596779444,13.904339148154413
2008-04-25T09:30:00-04:00,43,44.03999,42.77,43.89999,8766836,12213052.2,58.550028447727776,58.821887713853826,NaN,NaN,66.58514153836991,77.71858969829307,0.0004063039823882786,0.7128118717972427,0.7124055678148544,28394738,34646972.4,45.9311423678438,44.969055321965755,NaN,NaN,16.57532935437559,14.285909177614581
2008-04-28T09:30:00-04:00,43.95,44.06,43.28999,43.64999,8076434,12003774.1,56.789757799072554,58.530712628277065,NaN,NaN,66.62607407198063,64.44405718761699,-0.01797717675373689,0.6899340968726833,0.7079112736264201,20318304,28344791,40.97073057875531,44.91454332207412,NaN,NaN,16.17601487780036,14.55592427764112
2008-04-29T09:30:00-04:00,43.16,43.16,42.06,42.21001,10703512,11777469.6,47.8636992206332,57.81437683684651,NaN,NaN,-50.97733787562107,33.49734995517811,-0.12690724451807522,0.5492772179788261,0.6761844624969013,9614792,22155760.4,36.770905328112015,44.418140065547725,NaN,NaN,12.893965258225345,14.318501560581723
2008-04-30T09:30:00-04:00,42.23,42.95,42.19,42.31,9060418,11629507.7,48.46937460139296,57.103930528311146,NaN,NaN,-58.712097518095135,8.147841760651437,-0.18831332967195846,0.44079280040695323,0.6291061300789117,18675210,19326189.2,35.00421460036176,43.764206220787095,NaN,NaN,10.471168031895555,13.768882485055128
2008-05-01T09:30:00-04:00,42.19,42.34,41.34,42.00999,15522824,11560395.3,46.7157879460215,56.52990286102423,NaN,NaN,-116.58156910857802,-18.61195777838875,-0.24181115612251058,0.32684218492577344,0.568653341048284,3152386,16031086,33.014918141139674,43.172302003139194,NaN,NaN,7.943667349502862,12.936708894261947
2008-05-02T09:30:00-04:00,42.2,42.86,42.2,42.44,7165188,11199236.35,49.534077063854795,56.255489935039414,NaN,NaN,-52.82940111488186,-42.4948663090391,-0.24040848728439657,0.26814273194278826,0.5085512192271848,10317574,12415653.2,30.937426376517664,42.49133047651861,NaN,NaN,6.626067607363696,12.035188710419341
2008-05-05T09:30:00-04:00,42.66,43.39999,42.66,43.39999,6552941,10446832.2,55.22747361515264,56.291846979888724,NaN,NaN,12.308035526517463,-53.35847401813173,-0.17029875677473444,0.29567777325876676,0.4659765300335012,16870515,11726095.4,30.542668207926425,41.863892268785,NaN,NaN,7.193319485416332,11.343493106847482
2008-05-06T09:30:00-04:00,43.07001,43.85001,43.07001,43.75,9672621,10251708,57.12662386390867,55.77149888094893,NaN,NaN,47.9236322443218,-33.57827999414315,-0.09933939227138933,0.3418022896942645,0.44114168196565384,26543136,15111764.2,34.93270513768921,41.31746356049992,NaN,NaN,8.235139155963152,10.899442542435436
2008-05-07T09:30:00-04:00,43.82001,44.05,43.03,43.25999,10515824,10289071.85,53.69283763686809,55.118563839323144,NaN,NaN,33.7115768097184,-15.093545128580445,-0.08494900017383894,0.3349554317483552,0.4199044319221941,16027312,14582184.6,34.564699625243776,40.7870937797469,NaN,NaN,8.099304166989347,10.499422774514565
2008-05-08T09:30:00-04:00,43.42999,44.2,43.25999,44,13220180,10635353.7,57.81659978661472,54.685930150126765,NaN,NaN,64.48397869122472,21.119564431380105,-0.028078693386063447,0.3848060651896148,0.41288475857567825,29247492,19801205.8,41.145030644804585,40.47474661270121,NaN,NaN,9.237547517789173,10.319154880696653
2008-05-09T09:30:00-04:00,43.89,43.89,43.14999,43.45,12075988,10623877.7,53.96974667804234,53.94338238567843,NaN,NaN,28.038693734946076,37.29318340134569,-0.02982546197816832,0.37560293110296783,0.40542839308113615,17171504,21171991.8,42.772838458798155,39.870886736446515,NaN,NaN,9.03844694048145,10.136196603523052
2008-05-12T09:30:00-04:00,43.74001,44.36,43.23,44.34,9498316,10858515.2,58.75234907226261,53.74741421132775,NaN,NaN,74.56817972568007,49.74521224117821,0.02374470483743074,0.43510927412792455,0.4113645692904938,26669820,23131852.8,45.11033442283312,39.311955821406265,NaN,NaN,10.364684401991966,10.168837717590039
2008-05-13T09:30:00-04:00,44.42,44.60001,43.96001,44.59,10411508,10820733.2,60.00928956327937,54.02102549270651,NaN,NaN,118.770120242953,63.91450984090445,0.06828079460579267,0.49671556254773463,0.42843476794194196,37081328,25239491.2,47.58959238531268,39.11239692694921,NaN,NaN,11.82729693016435,10.405760462243512
2008-05-14T09:30:00-04:00,44.63,45.42999,44.47,44.84,10426238,10482569.9,61.27996864405681,54.699829567063446,NaN,NaN,164.12833086830378,89.99786065262154,0.10466421873934617,0.5592650413661246,0.4546008226267785,47507566,31535542,54.23900649929226,39.53758662675931,NaN,NaN,13.409858939607972,10.834917387581292
2008-05-15T09:30:00-04:00,45.03999,45.56,44.96001,45.35001,8954605,10153767.15,63.80653272031509,55.075294157962546,NaN,NaN,180.88299825393844,113.27766456516429,0.15038511062587778,0.6425822109091257,0.4921971002832479,56462171,36978477.8,59.073192774944474,40.47630451298079,NaN,NaN,15.513729527186145,11.503319121810557
2008-05-16T09:30:00-04:00,45.66,46,45.3,45.91,11230387,10190920.3,66.39910972364778,55.76167643828934,NaN,NaN,194.3520729533878,146.54034040885261,0.20240863045098756,0.7452078883469824,0.5427992578959948,67692558,47082688.6,66.20953914842168,42.279076553671246,NaN,NaN,18.100889003402568,12.44582910489513
2008-05-19T09:30:00-04:00,46.07001,46.53999,45.7,45.78999,12701699,10337841.4,65.31925692653178,57.00850198871068,NaN,NaN,184.65296728715566,168.55729792114772,0.21179801488391803,0.8075467765008923,0.5957487616169743,54990859,52746896.4,69.42776626168981,44.61170947749822,NaN,NaN,19.923317501167354,13.51404173293402
2008-05-20T09:30:00-04:00,45.47,46.03,45.17,46.03,8863500,10217553.1,66.49289918404364,58.29589660175715,NaN,NaN,137.74510264338943,172.35229440123504,0.21646584697567728,0.866331070336571,0.6498652233608937,63854359,58101502.6,72.13005486929411,47.263555210993395,NaN,NaN,21.79007950362078,14.696332843032128
2008-05-21T09:30:00-04:00,46.05,46.07001,44.44,44.67999,11077977,10384608,55.18113581923592,58.90056430698676,NaN,NaN,78.20588195144734,155.16780461786374,0.11596487478501893,0.7948213168421674,0.6788564420571485,52776382,59155265.8,72.64253911665134,50.094099566387094,NaN,NaN,20.082651561536263,15.465806945675576
2008-05-22T09:30:00-04:00,44.52,45.13,44.21001,44.48,10172586,10233479.1,53.72308727857072,59.19977932232361,NaN,NaN,41.85338371528728,127.3618817101335,0.02794184289734669,0.7137837456788318,0.6858419027814852,42603796,56383590.8,69.04614087161349,52.81615060175107,NaN,NaN,18.25133681302629,15.863739783868535
2008-05-23T09:30:00-04:00,44.07001,44.38,43.35001,43.87,13409316,10465603.1,49.43265072327945,58.785863401475524,NaN,NaN,-9.449675158194585,86.60153208781702,-0.07387551041746443,0.5934975147596546,0.667373025177119,29194480,48683975.2,60.138891656326415,54.93016656235107,NaN,NaN,15.362171133469074,15.792087119525755
2008-05-27T09:30:00-04:00,44.02,44.02,43.03999,43.67,9543785,10538970.65,48.07695471597264,58.13945846233724,NaN,NaN,-28.940602246350597,43.88281818111577,-0.1526678238594673,0.4765382453527849,0.6292060692122522,19650695,41615942.4,53.33676018915856,56.24474192317031,NaN,NaN,12.5818493924674,15.33348172994599
2008-05-28T09:30:00-04:00,43.38,44.89,43.38,44.75999,10131547,10510372.4,55.275876530074186,58.25253266899482,NaN,NaN,18.026887280792437,19.939175108596366,-0.1302259561093424,0.46642362407557414,0.5966495801849165,29782242,34801519,47.73133657920263,57.18521599131022,NaN,NaN,12.260883830340493,14.89453917285949
2008-05-29T09:30:00-04:00,44.67,44.67,43.94,44.46001,12773047,10696003.85,53.09411076384839,57.915212024511504,NaN,NaN,13.198896601245274,6.937778038555955,-0.13391673149154726,0.4292536658204824,0.5631703973120297,17009195,27648081.6,42.662602562650775,57.2936139854421,NaN,NaN,11.334330094987138,14.385937876020582
2008-05-30T09:30:00-04:00,44.64,44.75,44.33,44.50999,8302984,10335011.85,53.423966182467304,57.876227703399,NaN,NaN,18.867218438786487,2.340544983255808,-0.1311546118221385,0.3992271325343566,0.5303817443564951,25312179,24189758.2,40.42744712761585,57.12608603321479,NaN,NaN,10.679270548492838,13.856413972088047
2008-06-02T09:30:00-04:00,44.33,44.59,43.85001,44.17,8872848,10420394.85,50.80656291729576,57.308671549472805,NaN,NaN,-20.041005747937017,0.22227886530732094,-0.14908078389377,0.3440307644892826,0.4931115483830526,16439331,21638728.4,38.81211330361426,56.67621309612772,NaN,NaN,9.375207225559976,13.216241579726894
2008-06-03T09:30:00-04:00,44.36,44.77499,43.61,44.22,14638492,10824672.4,51.1853310263969,56.67838879683835,NaN,NaN,-27.16132548378951,0.5781342178195381,-0.15380622089360046,0.30085377226605203,0.4546599931596525,31077823,23924154,41.08333920824908,56.21148072633746,NaN,NaN,8.400866465279258,12.528330849091518
2008-06-04T09:30:00-04:00,44.09,44.75999,43.82001,44.03,13008223,10991452.5,49.62179815408051,55.845662333268606,NaN,NaN,-31.749975693283687,-9.377238376995686,-0.16497566150223464,0.2484404162818592,0.41341607778409384,18069600,21581625.6,39.46628854701657,55.1562865868892,NaN,NaN,7.151374469164627,11.760194223387677
2008-06-05T09:30:00-04:00,44.13,45.50999,44.13,45.50999,13166383,11123980.45,59.89771314294732,55.56646093488519,NaN,NaN,54.72441956322002,-1.0721337846007373,-0.07264768489587414,0.32260647166425116,0.3952541565601253,31235983,24426983.2,42.43035617114382,53.967512543760584,NaN,NaN,9.08686089488549,11.378289462173079
2008-06-06T09:30:00-04:00,45.12,45.48,44.17,44.17,10723629,10999152.9,49.961120799390514,54.39231886886682,NaN,NaN,-0.15007651641003553,-4.875592775640042,-0.10008847419931965,0.2701435638109757,0.37023203801029536,20512354,23467018.2,41.68868360684776,52.21602286221959,NaN,NaN,7.510544187682404,10.825754422960125
2008-06-09T09:30:00-04:00,44.5,45.06,44.17999,44.84,9185859,10854646.45,54.06443022361398,53.58840267580126,NaN,NaN,3.306240950389555,-0.20614343597473236,-0.0726585261740314,0.2794088802927561,0.3520674064667875,29698213,26118794.6,44.57098179225878,50.440538257260236,NaN,NaN,7.589615668638951,10.363448886628529
2008-06-10T09:30:00-04:00,44.38,44.50999,43.99001,44.27,17576608,11258561.05,50.28642792953485,52.43079758619349,NaN,NaN,-56.16117037637139,-6.006112414491108,-0.09124288587069052,0.23801379912842435,0.32925668499911487,12121605,22327551,41.41878792047095,48.24687633234429,NaN,NaN,6.399435580683082,9.797161271493465
2008-06-11T09:30:00-04:00,44.27,44.62,43.39,43.48,11183465,11297158.9,45.5368948306361,51.74192322986494,NaN,NaN,-104.30121734986729,-20.516360745807827,-0.15152582440414236,0.1398494044939369,0.29137522889807926,938140,18901259,38.75146147240048,45.82608507204066,NaN,NaN,3.799592157277438,8.940365683748318
2008-06-12T09:30:00-04:00,43.62,44.005,43.07001,43.46001,9424637,11247078.85,45.41999400177136,51.14884513866498,NaN,NaN,-128.947510743535,-57.250746807158826,-0.1852988957454469,0.05975160921627065,0.24505050496171754,-8486497,10956763,33.38320265141763,43.27873234202667,NaN,NaN,1.7387490899850109,7.911563313210703
2008-06-13T09:30:00-04:00,43.66,44.7,43.65199,44.53999,9746965,11286696.85,52.512803718050904,51.36885606686294,NaN,NaN,-30.186112692334774,-63.25795404234377,-0.1300658063700892,0.08246824699910604,0.21253405336919523,1260468,7106385.8,31.132196253124064,41.20682552751223,NaN,NaN,2.2303896891569406,7.0999670812030224
2008-06-16T09:30:00-04:00,44.62,44.92999,44.34,44.5,5869391,11018647.05,52.24208045989745,51.666365048571855,NaN,NaN,16.37156302694879,-60.64488962703193,-0.0931182122703477,0.09613628803126062,0.1892545003016083,-4608923,244958.6,27.56517751751086,39.365998193823096,NaN,NaN,2.5339329901269774,6.447676496763588
2008-06-17T09:30:00-04:00,44.92999,45.21001,44.60001,44.74001,5456551,10656389.65,53.78212386820684,51.559668429867045,NaN,NaN,72.51782043854682,-34.90909146404829,-0.051487285185584264,0.124895393819628,0.17638267900521226,847628,-2009836.8,26.491011198202543,37.848832095180235,NaN,NaN,3.2418161990372196,5.989696454231249
2008-06-18T09:30:00-04:00,44.60001,44.83,44.16,44.44,8663461,10646387.7,51.54462894944654,51.448991157409765,NaN,NaN,24.689615595319143,-9.110924875011003,-0.04344876258374836,0.12207172577552683,0.1655204883592752,-7815833,-3760631.4,25.655030939985707,36.63400555070416,NaN,NaN,3.188111120572735,5.589469977994319
2008-06-19T09:30:00-04:00,44.49001,44.92999,44.36,44.52,6675922,10426284.95,52.11669629122036,51.35561473660641,NaN,NaN,59.213119012862684,28.52120107626853,-0.032536322010541296,0.12485008584609858,0.15738640785663988,-1139911,-2291314.2,27.71661484966917,35.726088959422256,NaN,NaN,3.3030885927297144,5.262844065813661
2008-06-20T09:30:00-04:00,44.2,44.27,43.21001,43.42,10822934,10458802.35,44.36140817306442,50.89524654058989,NaN,NaN,-132.54008450335942,8.050406714063602,-0.0956252999422802,0.03785478292878963,0.13348008287106983,-11962845,-4935976.8,26.30280534705426,34.832566962525114,NaN,NaN,1.0615794681292952,4.662663409001609
2008-06-23T09:30:00-04:00,43.5,43.89999,43.1801,43.7,5669680,10071820.55,46.54204542295061,50.56358328320086,NaN,NaN,-131.84350477391445,-21.592606846109042,-0.1135033794044853,-0.00839914138453679,0.1051042380199485,-6293165,-5272825.2,26.12004852920991,33.76376048545088,NaN,NaN,-0.15647060743979616,3.9742156923671224
2008-06-24T09:30:00-04:00,44,44,42.56,42.87,14636711,10326466.85,41.36645028547034,49.973915578300144,NaN,NaN,-200.816995660777,-76.2595700659738,-0.1726858547956688,-0.1107530804746375,0.0619327743210313,-20929876,-9628326,23.81582097359015,32.64586994449186,NaN,NaN,-2.8413870821183473,3.0005581531549126
2008-06-25T09:30:00-04:00,42.81,43.41,42.245,43,10519711,10345875.05,42.44599424005817,48.72736422809378,NaN,NaN,-193.0289039343404,-119.80327397190572,-0.1929961389428132,-0.17931239935748522,0.013683739585327995,-10410165,-10147192.4,23.54929992026281,31.297223069428924,NaN,NaN,-4.7033665830865035,1.899997476548996
2008-06-26T09:30:00-04:00,42.98,42.98,41.57001,41.94,9319645,10173204.95,36.538631773568056,47.768615011963604,NaN,NaN,-222.43893254139994,-176.13368428275822,-0.26338053074479967,-0.3155419238456716,-0.05216139310087192,-19729810,-13865172.2,21.677294099239276,29.867838104599745,NaN,NaN,-8.278336376106623,0.44594978331247903
2008-06-27T09:30:00-04:00,41.64999,42.14999,41.28,41.89999,8066391,10161375.3,36.333086934861946,46.50209049133846,NaN,NaN,-208.176899299524,-191.26104724199115,-0.29576706058186547,-0.42187021882820375,-0.12610315824633828,-27796201,-17031843.4,20.204133631378582,28.127348950251164,NaN,NaN,-11.188558063432078,-1.2161227662224574
2008-06-30T09:30:00-04:00,42.07001,42.14,41.56,41.73,12152605,10325363.15,35.42137177264273,45.44030076584617,NaN,NaN,-167.53767999846025,-198.39988228690032,-0.3102604182543978,-0.5139286810643355,-0.20366826280993772,-39948806,-23762971.6,17.484189061915814,26.417734746068657,NaN,NaN,-13.855026525203936,-3.021680446076954
2008-07-01T09:30:00-04:00,41.12,41.45,40.23,40.96001,14847891,10335833.1,31.55842602792825,44.4418387085099,NaN,NaN,-196.19472711820012,-197.47542857838494,-0.350362368542389,-0.6416212234879239,-0.29125885494553494,-54796697,-30536335.8,15.258193971827453,24.739644210313447,NaN,NaN,-17.412025283497716,-5.077443994279919
2008-07-02T09:30:00-04:00,41.23,41.52,39.14,39.21001,16892640,10530053.95,24.90944697088956,42.97679963487548,NaN,NaN,-203.18348550680452,-199.50634489287776,-0.4661564800704617,-0.873954455033612,-0.40779797496315034,-71689337,-42792170.2,12.225276807640356,23.22836379290078,NaN,NaN,-23.18306527152146,-7.663961319600139
2008-07-03T09:30:00-04:00,39.11,39.88,38.35001,39.45,13904465,10566958.05,27.17543347518344,41.166987474670655,NaN,NaN,-196.47033201733421,-194.31262478806462,-0.4952638754636114,-1.0268778192926646,-0.5316139438290532,-57784872,-50403182.6,10.790794874026687,21.775406551536683,NaN,NaN,-26.991091224408738,-10.424979877429939
2008-07-07T09:30:00-04:00,40.19,40.19,38.87,39.64999,11275949,10594574.05,29.095626372659495,39.51366932558223,NaN,NaN,-149.12272815426635,-182.50179055901307,-0.4699357588189095,-1.11903364235269,-0.6490978835337806,-46508923,-54145727,10.15951961330343,20.532145272664724,NaN,NaN,-29.44314178891539,-13.141860150499289
2008-07-08T09:30:00-04:00,39.35001,39.35001,37.98,39.23,14347336,10852647.9,27.458226377267835,37.633390933372304,NaN,NaN,-150.95281658376757,-179.18481787607453,-0.45031085610833943,-1.2119864536692049,-0.7616755975608654,-60856259,-58327217.6,9.491414034161934,19.317888332376103,NaN,NaN,-31.98939010454231,-15.834364429648291
2008-07-09T09:30:00-04:00,39.58,40.24001,38.66,39.3,18214272,10884531.1,28.183654104370063,35.964749873009694,NaN,NaN,-112.24559124706752,-162.39499070184803,-0.40299302060715947,-1.2654168733198148,-0.8624238527126553,-42641987,-55896275.6,13.070461475446763,18.41899051348047,NaN,NaN,-33.834644429958686,-18.405833001121206
2008-07-10T09:30:00-04:00,39.64,40.14999,38.67999,39.45,13753059,11013010.8,29.803593488160203,34.370956815648256,NaN,NaN,-98.61540747243,-141.48137509497312,-0.33477435474359574,-1.28089179614215,-0.9461174413985542,-28888928,-47336193.8,24.40624616524505,18.182535607450173,NaN,NaN,-34.910377974618314,-20.76362514019222
2008-07-11T09:30:00-04:00,39.32001,40.02,38.99001,39.42,10344629,11059010.4,29.659496826942487,33.32082029092526,NaN,NaN,-86.424066684576,-119.47212202842147,-0.2677557495306544,-1.2808121283118723,-1.013056378781218,-39233557,-43625930.8,28.743550132168508,18.35687452067262,NaN,NaN,-35.83807851336423,-22.917118479216793
2008-07-14T09:30:00-04:00,39.98,40.32001,39.25,39.86,9769430,11060133.65,34.650028269710816,32.47139049426527,NaN,NaN,-67.39969254350106,-103.12751490626843,-0.1743979736038488,-1.231053845786029,-1.0566558721821802,-29464127,-40216971.6,32.57160839533586,18.817700225395903,NaN,NaN,-35.28825948347213,-24.684424336967556
2008-07-15T09:30:00-04:00,39.59,39.89,38.62,39.47,15286840,11531006.1,32.45225532079533,31.834662282502773,NaN,NaN,-76.25013581767435,-88.18697875304977,-0.1219964573383463,-1.209151443855113,-1.0871549865167667,-44750967,-36995913.2,36.06658093144869,19.692754508100084,NaN,NaN,-35.40241426127268,-26.215565754725432
2008-07-16T09:30:00-04:00,39.09,40.17999,38.39,39.62,15578176,12037087.35,34.1814305459954,31.244336304355432,NaN,NaN,-67.37427587622855,-79.21271567888198,-0.06327291218082554,-1.1662461267427986,-1.102973214561973,-29172791,-34302074,38.91806849250056,20.79052369183135,NaN,NaN,-35.029917153872674,-27.474758811746465
2008-07-17T09:30:00-04:00,39.57001,40.11,39.3,39.87,18899360,12548882.3,37.07277710889219,31.282489542592874,NaN,NaN,-48.541555653215745,-69.19794531503912,0.002860751082371049,-1.0993972757090091,-1.1022580267913802,-10273431,-30578974.6,42.720491917259416,22.293609250261365,NaN,NaN,-33.92650422681487,-28.39643672818481
2008-07-18T09:30:00-04:00,40.03999,40.375,39.28999,39.60001,21099440,13270058.2,35.2707601073721,31.206609054915024,NaN,NaN,-43.54564200822385,-60.62226037976869,0.03698102966846295,-1.0560317397058014,-1.0930127693742644,-31372871,-29006837.4,44.297355153542526,24.014553644701643,NaN,NaN,-33.44056785830555,-29.11702688963063
2008-07-21T09:30:00-04:00,39.8,40.45,39.69,40.42,11015449,13279683.95,44.14994200555343,31.830078357265787,NaN,NaN,-17.61000285647959,-50.664322442364394,0.11872298751757371,-0.9446090349772973,-1.063332022494871,-20357422,-27185496.4,46.14700743852177,26.061897814459208,NaN,NaN,-30.376289382816857,-29.296921531514375
2008-07-22T09:30:00-04:00,40.23,40.48,39.61,40.48,11902871,13591343.5,44.74718931066269,32.77213287746111,NaN,NaN,-10.079671111331013,-37.43022950109573,0.17725686281234676,-0.8417609439794376,-1.0190178067917843,-8454551,-19926213.2,52.86507349410442,28.74810349462185,NaN,NaN,-27.687107133956605,-29.06694804614898
2008-07-23T09:30:00-04:00,40.78,40.78,39.58501,39.97,11200098,13419512.85,40.757477913605896,33.904135087655135,NaN,NaN,-6.758012311522933,-25.30697678815461,0.18139584648994078,-0.7922729986793584,-0.9736688451692992,-19654649,-18022584.8,54.46910799811207,31.765520008226975,NaN,NaN,-26.419352556399055,-28.688720119041847
2008-07-24T09:30:00-04:00,39.67999,40.16,38.84,38.96001,11935793,13490316.95,34.245526536513495,34.40914173489299,NaN,NaN,-66.84631662815549,-28.96792898314256,0.11890256198338367,-0.8250406426900696,-0.9439432046734533,-31590442,-22285987,50.33748050053834,34.59028326726352,NaN,NaN,-27.267625306719285,-28.485706574424338
2008-07-25T09:30:00-04:00,38.91,39.485,38.67,39.02,9401648,13494417.1,34.910737911197444,34.82450684478856,NaN,NaN,-91.73013131565574,-38.60482684462894,0.08593408484098364,-0.8365255986222238,-0.9224596834632074,-22188794,-20449171.6,52.02586718865174,37.580736665502684,NaN,NaN,-27.7479084982858,-28.38030684926169
2008-07-28T09:30:00-04:00,39.03999,39.42,38.84,38.97,6131277,13397661.4,34.596583328615665,35.33438948417055,NaN,NaN,-88.94565813204133,-52.871957899741275,0.06598428100816534,-0.8399793322030007,-0.905963613211166,-28320071,-22041701.4,50.42521251435338,40.50457941408779,NaN,NaN,-28.228340363174276,-28.358597351249202
2008-07-29T09:30:00-04:00,39.08,39.94,39.08,39.74001,8485992,13214330.75,43.09002672044009,36.39913038531841,NaN,NaN,-5.716172296960275,-51.99925813686714,0.10742086205803703,-0.7716875356386197,-0.8791083976966567,-19834079,-24317607,48.14547345008192,43.00993741227602,NaN,NaN,-26.08351016872483,-28.033584896602864
2008-07-30T09:30:00-04:00,40.10001,41.02,39.92999,40.67999,9871773,12965524.85,51.38900784062642,37.94094569620885,NaN,NaN,179.34546042253936,-14.778563590054697,0.19576332029659105,-0.6344042473259179,-0.830167567622509,-9962306,-22379138.4,50.21022032688001,44.853078423821366,NaN,NaN,-21.3922229372332,-27.084818902407196
2008-07-31T09:30:00-04:00,40.98,41.06,40.22,40.38,15752270,12908506.35,48.93632929085419,39.317862300773974,NaN,NaN,159.2807481783474,30.44684937124588,0.22929624318951958,-0.5435472636356096,-0.7728435068251291,-25714576,-21203965.2,51.47176442813581,46.47652230210475,NaN,NaN,-18.33305277051703,-25.83456659785146
2008-08-01T09:30:00-04:00,40.38,40.45,39.33,39.64999,9061902,12666378.2,43.49598611192707,39.949716432360844,NaN,NaN,26.388231498678564,54.07052193411274,0.19875227562141884,-0.5244031622983556,-0.7231554379197744,-34776478,-23721502,48.62915255124151,47.62348974181229,NaN,NaN,-17.439831924197666,-24.63531878732949
2008-08-04T09:30:00-04:00,39.25,39.28999,37.60001,37.92999,18181472,13011654.35,33.92599007672746,40.05498320064171,NaN,NaN,-202.28624049121038,31.40240546227894,0.0660154740969936,-0.6406360952985324,-0.706651569395526,-52957950,-28649077.8,43.55850269236657,48.15862701044928,NaN,NaN,-20.174246888371318,-23.998022801764037
2008-08-05T09:30:00-04:00,37.92999,38.60001,37.56,38.37,13619090,12975242.05,37.702183117490776,40.30646552717709,NaN,NaN,-197.01285925926425,-6.856931930181855,0.013880795929782641,-0.6893005744832976,-0.7031813704130803,-39338860,-32550034,40.00239158379374,48.23607865982736,NaN,NaN,-20.960598393811605,-23.564105029199403
2008-08-06T09:30:00-04:00,38.44,39.28,38.44,38.75,8194242,12474240.55,40.846385849763855,40.57600900866793,NaN,NaN,-95.09289507300363,-61.74460302929045,0.011137617990826021,-0.6892593479245477,-0.7003969659153737,-31144618,-36786496.4,36.515806691125405,47.79288685796065,NaN,NaN,-20.504343528640366,-23.126996243405255
2008-08-07T09:30:00-04:00,38.63,39.19,38.32001,38.63,11978730,12385524.1,40.15712648686399,40.92503517863163,NaN,NaN,-98.02541940434028,-113.20583654582799,0.007561660649883839,-0.6909448901030188,-0.6985065507529027,-43123348,-40268250.8,33.90062731806364,47.05026344114073,NaN,NaN,-20.369374227608166,-22.73305024114853
2008-08-08T09:30:00-04:00,38.11,38.98,37.75999,38.47,11668164,12451700.85,39.20713958463314,40.57197786285162,NaN,NaN,-118.17918500639297,-142.1193198468423,0.0010812497992900294,-0.6971549885037902,-0.6982362383030802,-54791512,-44271257.6,31.13939100757453,45.978290838930214,NaN,NaN,-20.55154457173097,-22.421406574088877
2008-08-11T09:30:00-04:00,38.60001,38.815,38.14,38.52,9812711,12453864.9,39.687313284620224,40.21055814670573,NaN,NaN,-96.6113082131206,-120.98433339122434,0.006519342617336776,-0.6900870600314093,-0.6966064026487461,-44978801,-42675427.8,33.46600516985659,44.59264310148394,NaN,NaN,-20.559557793137667,-22.155428176810133
2008-08-12T09:30:00-04:00,39.03999,39.21001,38.60001,38.84,10937910,12236418.4,42.80116299106419,40.356535652238456,NaN,NaN,-49.692525459226154,-91.52026663121673,0.03635855915376751,-0.6511582037065367,-0.6875167628603042,-34040891,-41615834,35.03552554767455,43.20453006930983,NaN,NaN,-19.673342725709546,-21.80084454093862
2008-08-13T09:30:00-04:00,38.89999,39.88,38.75,39.67999,24241840,12669601.6,50.0860048030033,41.48799838555916,NaN,NaN,8.284908606326626,-70.84470589535067,0.11302938476840074,-0.5462300318998032,-0.659259416668204,-9799051,-37346720.6,41.067521369026096,42.542390131344675,NaN,NaN,-16.63367207260405,-21.06267704546225
2008-08-14T09:30:00-04:00,39.64,39.80499,39.06,39.60001,10545332,12251900.2,49.440341129107296,42.52582718683844,NaN,NaN,15.458810616844513,-48.147859891113725,0.15606619128925947,-0.4641766775566296,-0.6202428688458891,-20344383,-32790927.6,46.74973847073609,42.1655237943507,NaN,NaN,-14.357065727198604,-20.104732571424588
2008-08-15T09:30:00-04:00,39.55,39.55,38.94,39.35001,8701590,11632007.7,47.3841369874774,43.43922387675713,NaN,NaN,-4.463549117905414,-25.404732713416212,0.1645598001074151,-0.4145431187116202,-0.5791029188190353,-29045973,-27641819.8,52.342739209901296,42.30248998688983,NaN,NaN,-13.020813646218365,-19.092744153537986
2008-08-18T09:30:00-04:00,39.67999,39.82001,38.78999,38.99001,6010113,11381740.9,44.51321799553182,43.540880396406536,NaN,NaN,-8.436985138929142,-7.769868098577922,0.14356214471777906,-0.3996502379218114,-0.5432123826395905,-35056086,-25657276.8,54.33356585807792,42.74449658746098,NaN,NaN,-12.687746978686892,-18.177744557130687
2008-08-19T09:30:00-04:00,38.58,39.14999,38.58,38.75,9172129,11245203.8,42.65757000847441,42.91720626553854,NaN,NaN,-47.276909049480984,-7.286744816628887,0.11251094236997317,-0.40257370467712406,-0.5150846470470972,-44228215,-27694741.6,51.93485671314737,42.86768490076579,NaN,NaN,-12.928144731084645,-17.427801724838396
2008-08-20T09:30:00-04:00,39,39.64999,38.89999,39.42999,9197824,11145090.1,49.128134090030834,42.930906608336876,NaN,NaN,22.14549490702287,-4.5146275564896445,0.1352419424110683,-0.34603221903326187,-0.48127416144433016,-35030391,-32741009.6,46.463599701797214,42.509958848884466,NaN,NaN,-11.234588719936802,-16.543057009852454
2008-08-21T09:30:00-04:00,39.55,40.02,39.5,39.77,7358145,10916207.7,52.04219860236385,43.541350357653776,NaN,NaN,75.04755841192605,7.403122002526667,0.1684860153036633,-0.270666642314751,-0.4391526576184143,-27672246,-34206582.2,44.98147885203128,42.24941072751229,NaN,NaN,-8.93637050772917,-15.456387509549128
2008-08-22T09:30:00-04:00,39.75,40.08,39.52,39.75,7178730,10805061.8,51.8540387034255,44.821925259560786,NaN,NaN,69.92650975362352,22.281133776832455,0.183217758492162,-0.21013045950321185,-0.39334821799537384,-34850976,-35367582.8,43.78981526967772,42.2659330544631,NaN,NaN,-7.117111331368947,-14.265062341237673
2008-08-25T09:30:00-04:00,39.8,39.8,38.62,38.89,9723691,10984682.5,44.4173849641066,45.30158253431906,NaN,NaN,-14.985920980787785,20.971346608460728,0.13154964180498008,-0.22891116573914871,-0.3604608075441288,-44574667,-37271299,41.83281247291981,42.39667740368639,NaN,NaN,-7.669102692253231,-13.322782391382752
2008-08-26T09:30:00-04:00,38.62,39.16051,38.61,39.10001,5805371,10850651.45,46.43752652853639,45.70094972565995,NaN,NaN,-29.747550218752654,24.47721837460639,0.10895761759913941,-0.22426378554520454,-0.33322140314434395,-38769296,-36179515.2,43.39520684046771,42.88806312863941,NaN,NaN,-7.534046673854866,-12.495820146021625
2008-08-27T09:30:00-04:00,39.10001,39.69,39.10001,39.46001,4085212,10561323.4,49.80533654870273,46.390107587219866,NaN,NaN,39.854010908306904,28.018921574863207,0.1150979110491458,-0.18934901433291174,-0.30444692538205753,-34684084,-36110253.8,43.498890157124706,43.57365333142949,NaN,NaN,-6.4299129945765285,-11.629261981529469
2008-08-28T09:30:00-04:00,39.7,40.14999,39.61,40.02,5173480,10032383.9,54.588500402302245,47.48877621705337,NaN,NaN,124.90589844004008,37.99058958048602,0.1514257434050406,-0.11516474612575678,-0.2665904895307974,-29510604,-36477925.4,43.04811156741127,44.424276228560686,NaN,NaN,-4.008744379755693,-10.5406166098475
2008-08-29T09:30:00-04:00,40.14999,40.14999,39.55,39.75,3952712,9776924.4,52.01482919287874,48.36931306764326,NaN,NaN,108.06823865191522,45.618935360144356,0.15145702262482125,-0.07726921124977082,-0.22872623387459207,-33463316,-36200393.4,43.52387130619939,45.14269523829945,NaN,NaN,-2.7473750542158406,-9.427296387614406
2008-09-02T09:30:00-04:00,39.22,39.56,38.58,38.75,8809895,9308345.55,43.78169186252701,48.43935084417632,NaN,NaN,-28.93032253248588,42.830055049804734,0.08180459003352455,-0.12647049633268637,-0.20827508636621092,-42273211,-35740102.2,44.354136315498074,45.80831029314398,NaN,NaN,-4.253444279652352,-8.688174657905542
2008-09-03T09:30:00-04:00,38.55,39.202,38,38.55,10353539,9145068,42.33829349067928,47.88594289329603,NaN,NaN,-99.77265222930049,28.82503464769517,0.022994734334574468,-0.17953166844799284,-0.2025264027825673,-52626750,-38511593,40.493956943525546,45.767341405608235,NaN,NaN,-5.92293923304062,-8.293141025781981
2008-09-04T09:30:00-04:00,38.22,38.48,36.69,37.17999,15272668,9498989.3,34.05576810201545,46.787044819932326,NaN,NaN,-240.7217149655823,-27.290110527082675,-0.10065600890366094,-0.3283464139121435,-0.22769040500848253,-67899418,-45154659.8,33.06564379917852,44.78990607192555,NaN,NaN,-10.434347769210776,-8.599027703414666
2008-09-05T09:30:00-04:00,37.07001,37.57001,36.13,37.22,18445376,9822321.6,34.459015787205175,45.86382187705574,NaN,NaN,-246.06680783630284,-101.48465178235126,-0.16825219024998306,-0.4380056428209613,-0.26975345257097827,-49454042,-49143347.4,29.5594030501654,43.16252491765869,NaN,NaN,-13.771500260748798,-9.3379523544624
2008-09-08T09:30:00-04:00,38,38.44,36.8,37.14999,15491602,10013493.5,34.066462769472594,45.11762507519437,NaN,NaN,-165.25270129768842,-156.148839772272,-0.20380869323392642,-0.5245143191133863,-0.3207056258794599,-64945644,-55439813,25.04467455812828,41.070461253376585,NaN,NaN,-16.540400886937473,-10.36687357338741
2008-09-09T09:30:00-04:00,37.25,37.25,35.71001,35.97,15861363,10315926.1,28.229336874747617,44.08703699421388,NaN,NaN,-226.21725747840793,-195.6062267614564,-0.28779122513747857,-0.6804446573013081,-0.39265343216382953,-80807007,-63146572.2,20.847559794274318,38.84994004488565,NaN,NaN,-21.10185700962776,-11.90044263570746
2008-09-10T09:30:00-04:00,36.05,36.84,35.55,36.28,16429746,10590517.9,31.54773064583867,42.83129389105729,NaN,NaN,-178.8998173044138,-211.43165977647905,-0.3019801353748816,-0.7701286013824316,-0.46814846600754995,-64377261,-65496674.4,19.760073836490093,36.94254534022085,NaN,NaN,-23.708444870351247,-13.58730009779943
2008-09-11T09:30:00-04:00,35.66,37.23,35.63,36.89999,15374734,10147162.6,37.747109219880784,41.81021607802279,NaN,NaN,-126.95474047675116,-188.6782648787128,-0.251208838138716,-0.7821595136809449,-0.530950675542229,-49002527,-61717296.2,26.40843714121796,35.615899503734184,NaN,NaN,-23.894577448001243,-15.059768290685403
2008-09-12T09:30:00-04:00,36.94,38.315,36.72,38.08,13210008,10280396.4,47.49378853462002,41.49876963739383,NaN,NaN,-48.61155187660073,-149.1872136867724,-0.12607153279557237,-0.6885400915366944,-0.562468558741122,-35792519,-58984991.6,30.86804338761536,34.69291579787258,NaN,NaN,-20.63306869267277,-15.855954062397883
2008-09-15T09:30:00-04:00,36.59,38.00999,36.28,36.5,13306656,10510649.7,38.746298498637984,41.0936920327175,NaN,NaN,-84.82307081335601,-133.1012875899059,-0.13673300639413932,-0.7333848167337962,-0.5966518103396569,-49099175,-55815697.8,35.732954347770985,34.25721164607624,NaN,NaN,-21.02015036042059,-16.59369639068684
2008-09-16T09:30:00-04:00,35.92,37.31,35.28999,36.89999,20740352,11247161.65,41.675019328419324,40.75351294699485,NaN,NaN,-96.68102041411686,-107.19404017704771,-0.10528165334840289,-0.7282538770251605,-0.6229722236767576,-28358823,-45326061,48.62046056352044,34.63044405486572,NaN,NaN,-20.260615031871712,-17.117541910856108
2008-09-17T09:30:00-04:00,36.19,37.14,35.39999,36.21001,18763168,11726713.6,38.275348679593684,39.92994238491563,NaN,NaN,-97.77872184963373,-90.96982108609168,-0.11840290916767082,-0.7709758601363461,-0.6525729509686753,-47121991,-41875007,52.02875810103353,35.23972033657349,NaN,NaN,-20.84719871771529,-17.650350026121707
2008-09-18T09:30:00-04:00,35.94,37.33,34.85001,36.2,25874480,12560546.4,38.22662845408663,38.761237245757364,NaN,NaN,-94.2377189695274,-84.42641678464695,-0.1151096137501556,-0.7964599681563698,-0.6813503544062142,-72996471,-46673795.8,47.3273884508822,35.54538297110713,NaN,NaN,-21.309498514107204,-18.173085524405348
2008-09-19T09:30:00-04:00,38.69,38.77,37,38.28,16148332,13000055.75,51.921426901264375,38.75456565349919,NaN,NaN,9.112818906650688,-72.88154262799665,0.031941278041740406,-0.6414237568540386,-0.673365034895779,-56848139,-50884919.8,43.603842018832424,35.55109516486663,NaN,NaN,-16.639551631132797,-17.95400925393784
2008-09-22T09:30:00-04:00,38.99001,39,37.28999,37.78999,10632828,13172760.65,49.156633022694535,39.13849002208259,NaN,NaN,15.895965903293137,-52.73773528466681,0.09730316063409383,-0.5517360841031618,-0.6490392447372556,-67480967,-54561278.2,40.600658914928324,35.282989636254506,NaN,NaN,-13.98230250286171,-17.38662257521268
2008-09-23T09:30:00-04:00,37.24001,37.52,36.22,36.91,8762531,13124702.65,44.566913226908866,39.29767714609899,NaN,NaN,-48.9613893103243,-43.19380906390832,0.08292819082727987,-0.5453790062031558,-0.6283071970304357,-76243498,-64138213.2,34.02615091297555,34.82100349121522,NaN,NaN,-13.41874122116404,-16.81978238177716
2008-09-24T09:30:00-04:00,36.75999,36.81,35.8,36.17999,6640320,13166450.1,41.13561989530534,39.8033808456197,NaN,NaN,-81.472335308744,-39.93253175573037,0.02871162946482131,-0.5924176601994091,-0.6211292896642304,-82883818,-71290578.6,30.105294856217384,34.60954999528942,NaN,NaN,-14.152856860852541,-16.438793021645072
2008-09-25T09:30:00-04:00,36.13,36.42,35.62,36.08,7455617,13334970.35,40.67369500833469,40.24728650427181,NaN,NaN,-89.38707478186933,-38.962402918198755,-0.007493782942499472,-0.6304965183423548,-0.6230027353998553,-90339435,-74759171.4,28.396383945878043,34.52647720212604,NaN,NaN,-14.869350760419648,-16.214586984327156
2008-09-26T09:30:00-04:00,35.14999,35.42999,34.575,35.24001,8788637,13515728.2,36.922680311266426,40.45130204297137,NaN,NaN,-147.79325266485898,-70.34361723250069,-0.07772019995158175,-0.7201529853393325,-0.6424327853877507,-99128072,-83215158,24.71336412095623,34.50281217089947,NaN,NaN,-16.703872064982896,-16.28448485299226
2008-09-29T09:30:00-04:00,34.38,34.44,31.69,32.7,17620496,14199117.4,28.39511938491293,40.46314365084032,NaN,NaN,-272.9915278838573,-128.1211159899308,-0.2739031035118359,-0.9848116647775456,-0.7109085612657097,-116748568,-93068678.2,21.25401901038309,34.53184497205009,NaN,NaN,-21.705172625594145,-17.058868820506817
2008-09-30T09:30:00-04:00,32.5,33.39999,32.17,33.39999,8561785,14186711.9,32.98839715660617,40.56604840160943,NaN,NaN,-232.33691703252407,-164.79622153437074,-0.3313553493311713,-1.1251027479296738,-0.7937473985985025,-108186783,-99457335.2,19.361644426949724,34.503385728511496,NaN,NaN,-23.957313648442778,-18.04436093878338
2008-10-01T09:30:00-04:00,32.75999,33.19,32.13,32.85001,14639441,14401007,31.29005141882986,40.10482998724865,NaN,NaN,-206.50436336031268,-189.80262714468446,-0.37785710425152597,-1.26606877891291,-0.888211674661384,-122826224,-107445816.4,17.28878502928727,33.85198200623073,NaN,NaN,-26.315729166883266,-19.22598497136908
2008-10-02T09:30:00-04:00,31.53999,31.86,29.92999,30.49001,12581234,14266435.3,25.276493403951704,38.51788033505806,NaN,NaN,-230.3648504844622,-217.9981822852031,-0.5297076398792575,-1.5503462245104558,-1.0206385846311983,-135407458,-116459421,15.298580502547281,32.73987751444015,NaN,NaN,-30.74710056373143,-20.871858627420846
2008-10-03T09:30:00-04:00,30.19,31.69,29.78,30.19,16770551,14182694.05,24.6284985222771,37.509466051032284,NaN,NaN,-183.282882082874,-225.09610816880604,-0.6069574341627417,-1.7793353773346254,-1.1723779431718837,-152178009,-127069408.4,13.35040246817708,31.141123808754877,NaN,NaN,-34.318532736777016,-22.792812071614584
2008-10-06T09:30:00-04:00,29.50999,29.50999,26.89,28.7,22512688,14533748.35,21.658727836873126,36.079730944493264,NaN,NaN,-202.5138520533689,-211.00057300270836,-0.7079583701616663,-2.0573259058739666,-1.3493675357123003,-174690697,-138657834.2,11.611204428651021,28.49760551340706,NaN,NaN,-38.40186842620043,-25.02267726512685
2008-10-07T09:30:00-04:00,29.16,29.53,27.05,27.22,16004992,14540929.8,19.184217864712053,34.71607874343029,NaN,NaN,-170.4841388123117,-198.63001735866592,-0.8162996687215269,-2.369742121614209,-1.553442452892682,-190695689,-155159615.4,9.677801202112477,25.47253716348413,NaN,NaN,-42.700295856890484,-27.54805134966451
2008-10-08T09:30:00-04:00,26.28999,29.53999,26.10001,28.10001,30171104,15227997.7,24.693550705956326,33.74943033284955,NaN,NaN,-142.0006319853209,-185.72927108366758,-0.771091497580312,-2.517306824868072,-1.74621532728776,-160524585,-162699287.6,8.944928782093271,22.73093290142778,NaN,NaN,-44.17592409663463,-29.923461742088815
2008-10-09T09:30:00-04:00,28.89,29.35001,26.10001,26.3,25460704,15732296.2,21.469532975232923,31.574295052418734,NaN,NaN,-133.87589223173515,-166.43147943312215,-0.8012865224980747,-2.7478234804103536,-1.9465369579122789,-185985289,-172814853.8,8.062748749724832,20.192283382205808,NaN,NaN,-46.59591020444444,-32.305240093853904
2008-10-10T09:30:00-04:00,24.92,27.11,24.05,25.67999,28436992,16493645.4,20.47777629677516,29.525805286281635,NaN,NaN,-145.64430156543597,-158.90376332963456,-0.8000287994286284,-2.9465729571980646,-2.146544157769436,-214422281,-185263708.2,7.130704274659536,17.801572336472322,NaN,NaN,-48.8260883974589,-34.66536128008319
2008-10-13T09:30:00-04:00,26.89999,29.28999,26.44,29.28999,13280258,16492325.5,38.338205364394625,29.080897581816334,NaN,NaN,-83.34434224187264,-135.06986136733528,-0.5073502515949322,-2.7807319722631014,-2.2733817206681692,-201142023,-190553973.4,6.772418130632985,15.854877137733569,NaN,NaN,-43.90397029623983,-35.985162568105565
2008-10-14T09:30:00-04:00,30.09,30.09,27.39,28.44,33050384,17107827.1,36.272482980786435,28.73353065935069,NaN,NaN,-69.1083347431135,-114.79470055349563,-0.33082725826473913,-2.686915793499093,-2.356088535234354,-234192407,-199253317,6.219048576832563,14.148716689206083,NaN,NaN,-40.91261793388243,-36.68908476321655
2008-10-15T09:30:00-04:00,27.21001,27.49001,24.64999,24.91,21872512,17263294.3,29.228840085193923,27.9160410219835,NaN,NaN,-110.28174618931533,-108.45092339429452,-0.40663989815800416,-2.864388407931859,-2.4577485097738547,-256064919,-218361383.8,5.211727061244062,12.492669768875084,NaN,NaN,-41.074094326535985,-37.31551470083361
2008-10-16T09:30:00-04:00,25,25.89999,23.535,25.08,29863424,17462741.5,29.93448024781611,27.41688387459419,NaN,NaN,-113.01294703882293,-104.27833435571208,-0.3995852298364517,-2.9572300470694195,-2.5576448172329678,-226201495,-226404625,4.855232263583332,11.074231779062734,NaN,NaN,-40.93445146924429,-37.83250566774942
2008-10-17T09:30:00-04:00,24.92999,26.85001,24.60001,25.75,22301920,17770420.9,32.77921087766754,27.730033266933805,NaN,NaN,-90.52611100495861,-93.25469624361658,-0.30814118802768276,-2.9428213022675713,-2.6346801142398886,-203899575,-224300083.8,6.654419318835636,10.03140322966649,NaN,NaN,-39.846603895124346,-38.12023398594584
2008-10-20T09:30:00-04:00,25.91,27.53,25.91,27.05,13916578,17934608.4,38.03609956798674,28.090583439175273,NaN,NaN,-64.23273747564235,-89.43237529037053,-0.12768972528350542,-2.79429227084427,-2.6666025455607647,-189982997,-222068278.6,8.627702831873364,9.264693115732461,NaN,NaN,-37.16838260314725,-37.98425521697461
2008-10-21T09:30:00-04:00,26.7,27.34,25.91,25.91,13245813,18158772.5,35.420192706826725,28.385593531175044,NaN,NaN,-67.89957688434261,-89.19062371861635,-0.056333768318463484,-2.737019755958844,-2.6806859876403806,-203228810,-215875559.2,14.056675734255023,9.0338281660873,NaN,NaN,-35.84628667796317,-37.67883113997298
2008-10-22T09:30:00-04:00,25.48,25.48,23.368,24.49001,16674262,18660469.6,32.42849181861412,28.89645056079379,NaN,NaN,-105.73597296946814,-88.2814690746469,-0.07483726965801063,-2.7742325747128938,-2.699395305054883,-219903072,-208643189.8,20.03253473944565,9.371967754437183,NaN,NaN,-35.73352172167369,-37.40092979450165
2008-10-23T09:30:00-04:00,24.14,24.78999,22.61,23.92999,20298016,19302589.55,31.30546445890873,29.373376699124627,NaN,NaN,-120.07277081812651,-89.69343383050763,-0.09364110885122345,-2.8164466911189123,-2.722805582267689,-240201088,-211443108.4,19.468166285817105,9.808950884268613,NaN,NaN,-35.999050013139566,-37.200661254307064
2008-10-24T09:30:00-04:00,21.55,23.53,21.55,22.89999,17140768,19720196.1,29.29595689760592,29.91889306060554,NaN,NaN,-140.68852627619597,-99.7259168847551,-0.1414270642825275,-2.8995894126208483,-2.758162348338321,-257341856,-222131564.6,17.447417866342036,10.225823272675116,NaN,NaN,-36.84941459740602,-37.150483160464056
2008-10-27T09:30:00-04:00,22.39,23.48,21.2,21.2,12421277,19460235.15,26.295764413657437,30.426860671244494,NaN,NaN,-146.11209569164672,-116.10178852795597,-0.2473082856426596,-3.0672977053916455,-2.819989419748986,-269763133,-238087591.8,14.952306862379501,10.602573676979901,NaN,NaN,-38.5498058130873,-37.35038639655309
2008-10-28T09:30:00-04:00,22.41,24.49001,21.7,23.87,13243480,19694319.9,37.177672029127656,31.31858362289959,NaN,NaN,-99.11687250418699,-122.34524765192486,-0.10460580729567237,-2.950746678868576,-2.8461408715729037,-256519653,-248745760.4,13.55759682881235,10.932049966031267,NaN,NaN,-36.35763403354195,-37.208564630408645
2008-10-29T09:30:00-04:00,24.58,26.09,24.10001,24.85001,16424578,19783576.75,40.641824968905546,32.68803305101906,NaN,NaN,-43.08605861561701,-109.81526478115464,0.07881062256076987,-2.7476275933719414,-2.8264382159327113,-240095075,-252784161,13.060493351152587,11.289031723276107,NaN,NaN,-33.44294667640864,-36.670619208408645
2008-10-30T09:30:00-04:00,25.85001,26.08,24.56,25.63,15886992,19948864.65,43.32068978880732,34.319669729021356,NaN,NaN,-22.81792773223469,-90.36429616397626,0.2651863416612912,-2.4949552888560973,-2.7601416305173885,-224208083,-249585560,15.697080057821864,11.900915707787702,NaN,NaN,-30.229902937308633,-35.75051688396579
2008-10-31T09:30:00-04:00,25.37,26.49001,25.02,25.92,10041691,19612421.65,44.326719297136776,34.74742072421723,NaN,NaN,0.4995948561831257,-62.126671937500454,0.411772332354178,-2.2454262150746658,-2.6571985474288438,-214166392,-240950467.2,22.527741025362104,13.026295914554067,NaN,NaN,-27.354910531515365,-34.551144547901444
2008-11-03T09:30:00-05:00,25.97,26.33,25.39999,25.8,8696313,18921602.9,43.978864412753545,35.297876540786305,NaN,NaN,8.159462920331583,-31.272360215104783,0.49863085767865334,-2.033909975330527,-2.5325408330091803,-222862705,-231570381.6,29.235254274143117,14.670310607219106,NaN,NaN,-25.13158565597144,-33.20549327762573
2008-11-04T09:30:00-05:00,26.52,27.3,26.45,27.00999,11348844,18688795.5,48.37786198521438,36.66566381935919,NaN,NaN,64.05981094085175,1.3629764739029482,0.6272404715126338,-1.748490243618388,-2.375730715131022,-211513861,-222569223.2,35.04680612291524,16.801387683052763,NaN,NaN,-21.90823615421115,-31.591599402852218
2008-11-05T09:30:00-05:00,26.78,27.058,25.42,25.88,13857914,17873136,44.83694813162687,37.73012581105996,NaN,NaN,30.624979359706852,16.105184068967727,0.6245152654045469,-1.5950866333753382,-2.219601898779885,-225371775,-219624563.2,36.87326512839916,19.088390030539607,NaN,NaN,-20.155240184202114,-29.957833800187917
2008-11-06T09:30:00-05:00,25.13,25.57001,24,24.47,11325570,17166379.3,40.821897102191436,38.304603398525956,NaN,NaN,-38.58594275244581,12.951581064925497,0.5203218176805393,-1.569199626679211,-2.0895214443597503,-236697345,-222122415.6,35.94979648696682,21.180916971120407,NaN,NaN,-19.826921193159034,-28.510560570612363
2008-11-07T09:30:00-05:00,24.5,25.03,24.08,24.87,8976852,16193372.3,42.39776539974688,38.61615095793739,NaN,NaN,-36.19982239535391,5.611697614618085,0.4723160874165728,-1.4991263350890343,-1.971442422505607,-227720493,-224833235.8,34.9274546848559,23.059470674904873,NaN,NaN,-19.102032046391095,-27.16648506715218
2008-11-10T09:30:00-05:00,25.61,25.87,24.44,24.88,8129285,15935823.65,42.439033231535554,39.11749670970231,NaN,NaN,-7.479977718037145,2.483809486944339,0.436078876833895,-1.4263438264632384,-1.8624227032971334,-219591208,-224178936.4,35.40493941207316,24.58434665189188,NaN,NaN,-18.49999935302389,-25.92841567941957
2008-11-11T09:30:00-05:00,24.5,24.5,23.36,23.89,12893426,14927975.75,39.42747565757326,39.61742412677082,NaN,NaN,-67.18504658379857,-23.765162017985716,0.34430598506357524,-1.4320402219676645,-1.7763462070312397,-232484634,-228373091,33.69799885377017,25.560451231486493,NaN,NaN,-18.811641757319215,-24.91173369054809
2008-11-12T09:30:00-05:00,23.46001,23.46001,22.37,22.37,7923641,14230532.2,35.287142776417284,39.901829720878574,NaN,NaN,-124.7473800982902,-54.83963390958513,0.18792718605462921,-1.5414372244629533,-1.7293644105175825,-240408275,-231380391,32.48851142683087,26.490475884416046,NaN,NaN,-20.307358342494556,-24.2539657836833
2008-11-13T09:30:00-05:00,22.47,24.24001,21.71001,24.19,12854375,13380079.75,43.00482452663307,40.88103455152337,NaN,NaN,-76.653621754089,-62.453169709913766,0.21197496414090677,-1.464395705341449,-1.6763706694823557,-227553900,-229551702,34.0388733497101,27.675579847513767,NaN,NaN,-19.296696942105772,-23.545784520600794
2008-11-14T09:30:00-05:00,23.7,24.10001,22.67,22.72,11602164,12845091.95,38.96298436588632,41.78583597668257,NaN,NaN,-79.71450495479797,-71.15610622180257,0.13740675326093843,-1.5046122279061827,-1.642018981167121,-239156064,-231838816.2,33.017619175139274,28.96595929842518,NaN,NaN,-19.6901425090574,-22.994978518951736
2008-11-17T09:30:00-05:00,22.49001,23.07001,22.03999,22.25,9930883,12645807.2,37.74161331473382,41.82611749708302,NaN,NaN,-106.63194695373949,-90.98650006894304,0.06844142587102775,-1.5564671988283365,-1.6249086246993643,-249086947,-237737964,30.47766182544784,30.17453536961343,NaN,NaN,-20.381004068868457,-22.62155359751127
2008-11-18T09:30:00-05:00,22.39999,22.53999,21.49001,22,11154523,12541242.7,37.07585979189578,41.57140569872517,NaN,NaN,-117.16681355922603,-100.98285346402854,0.020487047914419465,-1.59929981480634,-1.6197868627207594,-260241470,-243289331.2,28.273442896983354,31.26117462288705,NaN,NaN,-21.137973250969203,-22.40961354800526
2008-11-19T09:30:00-05:00,21.97,22.3999,20.52,20.67999,12586695,12336864.35,33.696038382324005,40.883930598262076,NaN,NaN,-138.9262823869845,-103.8186339217674,-0.08011645884162899,-1.7199324362727957,-1.6398159774311667,-272828165,-249773309.2,25.91586997431972,31.99108818835119,NaN,NaN,-22.813285174537704,-22.46728092322418
2008-11-20T09:30:00-05:00,20.16,20.95,18.81,19.88,11783414,11911134.25,31.803809425142788,39.98943703597679,NaN,NaN,-171.02160107924433,-122.69222978679848,-0.17507655432842384,-1.8586616703416965,-1.6835851160132727,-284611579,-261184845,22.379033274582838,31.980466206152666,NaN,NaN,-24.795113805420947,-22.79982847782372
2008-11-21T09:30:00-05:00,19.39999,20.23,18.92999,20.10001,15550742,11831632.95,32.919474511074355,39.19948061442828,NaN,NaN,-155.46888966400013,-137.8431067286389,-0.19602845186748263,-1.9286206808476258,-1.7325922289801432,-269060837,-267165799.6,20.77846648889951,31.376409935778124,NaN,NaN,-26.11197486307944,-23.272992247145964
2008-11-24T09:30:00-05:00,20.5,22.02,20.42,21.25999,19469008,12184019.5,38.62094268396443,38.50255780719614,NaN,NaN,-93.21202846610026,-135.15912303111105,-0.10906163366661192,-1.8689192710634082,-1.7598576373967962,-249591829,-267266776,20.751481909378086,30.3553153490969,NaN,NaN,-25.63185977294636,-23.609973322260306
2008-11-25T09:30:00-05:00,21.82001,22.37,21.27,22.03999,17020944,12372892.7,42.17970772444104,38.31275492096859,NaN,NaN,-62.066753437426705,-124.13911100675118,0.01698673813773821,-1.7386242147246236,-1.7556109528623618,-232570885,-261732659,26.393463714583845,29.606758105252943,NaN,NaN,-24.193407668298033,-23.69332108597998
2008-11-26T09:30:00-05:00,22.14,23.17,21.52,23.05,10324680,12067897.8,46.50493170527355,38.71868596404588,NaN,NaN,-32.576133880456105,-102.8690813054455,0.17556299131261666,-1.5361572137215909,-1.7117202050342075,-222246205,-251616267,35.44152969722877,29.570453334557374,NaN,NaN,-21.674663111021157,-23.404941375271576
2008-11-28T09:30:00-05:00,22.78,23.21001,22.63,23.14999,2409699,11394033.15,46.92819224232396,39.042287881372815,NaN,NaN,-12.791899477334146,-71.22314098506347,0.2877387671372045,-1.352046746112702,-1.6397855132499064,-219836506,-238661252.4,44.79945701688806,30.27559635827396,NaN,NaN,-19.493663208367657,-22.84618735142816
2008-12-01T09:30:00-05:00,22.77,22.88,21.00999,21.19,8073891,11295643.15,40.211886593606934,38.883205978663625,NaN,NaN,-59.83732850731501,-52.096828753726435,0.23283225718986822,-1.3487451917625712,-1.5815774489524395,-227910397,-230431164.4,49.77976742254598,31.302369787593445,NaN,NaN,-19.474218691241443,-22.36447754283006
2008-12-02T09:30:00-05:00,21.46001,22.03,21.14,22.00999,8013488,11261501.9,43.8335883973624,39.19792831721999,NaN,NaN,-53.071707476714565,-44.068764555849306,0.25296125467117925,-1.2653758806134654,-1.5183371352846446,-219896909,-224492180.4,53.07020799170439,32.6860990117316,NaN,NaN,-18.371764973334603,-21.794090032902137
2008-12-03T09:30:00-05:00,21.5,22.14,21.03999,21.97,10257773,11206948.35,43.69457620180149,39.79845927617601,NaN,NaN,-47.74631596170106,-41.204677060704185,0.26360739482174855,-1.1888278917574588,-1.4524352865792074,-230154682,-224008939.8,53.33810854682609,34.17535594887412,NaN,NaN,-17.51954796933336,-21.183441166678026
2008-12-04T09:30:00-05:00,21.53,22.23,21.14999,21.53,9914379,11009771.6,42.11209457616545,39.734692851142604,NaN,NaN,-45.554677999090195,-43.80038588443101,0.2416232571734791,-1.1504062151123584,-1.3920294722858375,-240069061,-227573511,51.02428378824755,35.3885995516268,NaN,NaN,-17.239106840228313,-20.619964834328066
2008-12-05T09:30:00-05:00,21.14,22.09,20.47,21.92999,12992254,11093105.8,44.09429874327162,40.10121530667012,NaN,NaN,-47.909114853147415,-50.82382895959366,0.2533950295287606,-1.0752856853748867,-1.3286807149036473,-227076807,-229021571.2,50.07396601907613,36.60691004047943,NaN,NaN,-16.46017778772264,-20.025709541955862
2008-12-08T09:30:00-05:00,22.69,23.92,22.63,23.58,11461684,11217347.4,51.47574631677382,41.08222480681584,NaN,NaN,79.50729218605225,-22.95490482092021,0.3649030741513368,-0.8725518722144763,-1.237454946365813,-215615123,-226562516.4,51.71848574892563,38.124111749299274,NaN,NaN,-13.560050066868728,-19.1020439026577
2008-12-09T09:30:00-05:00,23.46001,24.39999,23.13049,23.33,10266762,11324221.25,50.39014793030213,42.03324538813058,NaN,NaN,109.52370135953262,9.56417694632923,0.41099255871245743,-0.7237142479752414,-1.1347068066876989,-225881885,-227759511.6,50.84061276964778,39.73605245448959,NaN,NaN,-11.470735583748775,-18.011856999956425
2008-12-10T09:30:00-05:00,24.07001,24.38,23.64,24.05,8630246,11111062.25,53.43590245933658,43.44323567934576,NaN,NaN,137.7408001378524,46.66160016623992,0.47462926898179747,-0.5414202204604521,-1.0160494894422496,-217251639,-225178903,52.70450199783239,41.649526170454784,NaN,NaN,-8.795109286860141,-16.695178755228383
2008-12-11T09:30:00-05:00,24.02,24.39,22.74001,23.00999,10442117,11236986.05,48.77750783309776,44.6556427084854,NaN,NaN,85.32030030712022,72.836595827482,0.43252679626442936,-0.47539099411171293,-0.9079177903761423,-227693756,-222703842,54.48687558599458,43.94294347841276,NaN,NaN,-7.789341755126765,-15.422916326642438
2008-12-12T09:30:00-05:00,22.53,23.46001,22.17999,23.10001,15586855,11373610.05,49.1903985256049,45.81785156666616,NaN,NaN,55.80239228924022,93.57889725595953,0.3974861919342797,-0.41106005045829264,-0.8085462423925723,-212106901,-219709860.8,56.61672600802813,46.50281915835052,NaN,NaN,-6.850335301562234,-14.198261894488123
2008-12-15T09:30:00-05:00,23.5899,23.67,22.74001,23.05,10877953,11337399.5,48.954313802529015,46.555949503706486,NaN,NaN,73.14025515170314,92.3054898490897,0.35886637737995875,-0.3599632706676239,-0.7188296480475826,-222984854,-221183807,55.2460619451092,48.96671773233131,NaN,NaN,-6.134600859065003,-13.046310317999106
2008-12-16T09:30:00-05:00,23.46001,24.56,23.32001,24.46001,11640375,11422874.1,55.446870888286725,47.50360401540975,NaN,NaN,124.02222023760567,95.20519362470432,0.4123848341549159,-0.20334860535393773,-0.6157334395088536,-211344479,-218276325.8,57.43512179937407,51.183979024102044,NaN,NaN,-3.6076302792855564,-11.697927455325742
2008-12-17T09:30:00-05:00,24.46001,24.87,24.08,24.48,12411070,11485701.45,55.53322194925613,48.14848188997993,NaN,NaN,126.97349281190878,93.05173215951558,0.43120051093117895,-0.07673280084487999,-0.5079333117760589,-198933409,-214612679.8,60.08453012925766,52.94419334067554,NaN,NaN,-1.5112376551001212,-10.242686055293511
2008-12-18T09:30:00-05:00,24.71001,24.72,23.24001,23.53999,11567520,11434742.7,50.56975973712746,48.408593853894466,NaN,NaN,80.5491484074374,92.09750177957902,0.3650310581885224,-0.05164448904040597,-0.41667554722892836,-210500929,-211174114.4,62.44712452007918,54.2047410194749,NaN,NaN,-1.0347202702969613,-8.927262371722575
2008-12-19T09:30:00-05:00,23.3,23.42,22.69,22.78,7805852,11235864.6,46.918552050846785,48.887641386554456,NaN,NaN,22.443042021203823,85.42563172597174,0.25971976097222427,-0.09202584601364805,-0.3517456069858723,-218306781,-212414090.4,61.043951469987256,55.009325594292136,NaN,NaN,-1.6713142133372834,-7.890698349096105
2008-12-22T09:30:00-05:00,22.89999,22.89999,21.59,21.95,7064586,10811556.8,43.24616735185807,48.845682740447,NaN,NaN,-46.587539931791866,61.48007270927275,0.1303358776470957,-0.18882575992700268,-0.3191616375740984,-225371367,-212891393,60.4805991612248,55.538639249257876,NaN,NaN,-3.3106316211730795,-7.236403102249959
2008-12-23T09:30:00-05:00,22.14999,22.41,21.81,21.87,6975664,10186889.6,42.897642642809814,48.788758914804745,NaN,NaN,-61.84382672118113,24.30686331751539,0.04021246670693068,-0.26889605419043505,-0.30910852089736574,-232347031,-217091903.4,55.616174302337924,55.70135823179444,NaN,NaN,-4.753882864525689,-6.881757354003635
2008-12-24T09:30:00-05:00,22.07001,22.07001,21.77,21.89,4375188,9554601.8,43.021272505440066,48.85370019546722,NaN,NaN,-71.77605490279588,-15.443046225425542,-0.014288708584728194,-0.326969406628276,-0.3126806980435478,-227971843,-222899590.2,49.668070857619846,55.60448587960674,NaN,NaN,-5.916983911974562,-6.74393257657091
2008-12-26T09:30:00-05:00,22.08,22.31,21.84,22.16,2462192,9161477.4,44.76003861708695,48.90125304359689,NaN,NaN,-52.369073115739226,-42.02669053006086,-0.027618532209986946,-0.3472038633060315,-0.31958533109604453,-225509651,-225901334.6,46.87747577652633,55.37616514799605,NaN,NaN,-6.464926952869165,-6.704074630327804
2008-12-29T09:30:00-05:00,22,22.02,21.39999,21.75999,6553953,9368690.1,42.68194827371068,48.27312461194952,NaN,NaN,-73.61031263991579,-61.23736146228479,-0.05713970356436443,-0.39100996055150006,-0.3338702569871356,-232063604,-228652699.2,44.41426738930413,54.85443526516593,NaN,NaN,-7.4926952269485705,-6.816734715559342
2008-12-30T09:30:00-05:00,22,22.39999,21.87,22.35001,3533802,9141685.65,46.61874777551689,48.003738886607714,NaN,NaN,-40.497613254002395,-60.0193761267269,-0.031950114761000514,-0.3738079004383863,-0.3418577856773858,-228529802,-229284386.2,43.84463862838153,54.35472282650405,NaN,NaN,-7.3607735138357295,-6.89445454388454
2008-12-31T09:30:00-05:00,22.24001,22.92,22.24001,22.74001,3050541,8893538.3,49.10698954095765,47.69453082100922,NaN,NaN,-11.462174035103265,-49.94304558951133,0.013518650374352847,-0.3249594727094447,-0.33847812308379754,-225479261,-227910832.2,45.48197534172228,53.83882806535333,NaN,NaN,-6.581489914226078,-6.849745311076188
2009-01-02T09:30:00-05:00,22.89999,23.71001,22.69,23.57001,7110070,8736153.15,54.019215783738396,48.06893853176926,NaN,NaN,40.22189917148588,-27.543454774654958,0.09736342290073158,-0.21677384445788306,-0.31413726735861464,-218369191,-225990301.8,47.77488179486409,53.359399937415446,NaN,NaN,-4.497552245777902,-6.51371773031929
2009-01-05T09:30:00-05:00,23.44,24.00999,23.11,23.62,10553797,8768124.05,54.30528813827687,48.434287789817255,NaN,NaN,56.80342491026185,-5.708955169454742,0.15086592498044005,-0.12555486113306458,-0.2764207861135046,-207815394,-222451450.4,51.79778039288304,53.01518953633366,NaN,NaN,-2.6895061855984457,-5.967401795359169
2009-01-06T09:30:00-05:00,23.97,24.39999,23.57001,24.14999,13355223,8786272.5,57.33590656929265,49.03297298744322,NaN,NaN,90.79692070370524,27.172491499269462,0.21283441487633165,-0.010377767518090053,-0.2232121823944217,-194460171,-214930763.8,59.02199039592527,53.28489871139195,NaN,NaN,-0.26121333304390454,-5.152232015028417
2009-01-07T09:30:00-05:00,23.92999,24.30991,23.5799,23.59,11351359,8780756.25,53.31251960083438,48.88051932405377,NaN,NaN,66.63088376050577,48.5981909021711,0.20681566139209778,0.035307394345700516,-0.17150826704639727,-205811530,-210387109.4,62.66279683650879,53.65830407118729,NaN,NaN,0.7700019299256886,-4.306198594320688
2009-01-08T09:30:00-05:00,23.59,24.03,23.395,23.92,9109273,8722881.8,55.30301729822569,48.86407613469446,NaN,NaN,61.156897889360955,63.12200528706394,0.21482504178640807,0.09702303518661282,-0.11780200659979526,-196702257,-204631708.6,66.6988835669544,54.130757888165626,NaN,NaN,2.201458196167742,-3.3765333385366265
2009-01-09T09:30:00-05:00,23.94,23.98,23.3,23.34,9760742,8779406.6,51.17344886658117,48.907196786798295,NaN,NaN,42.66873996142749,63.611373445052266,0.17264341597158622,0.09800226336468754,-0.07464115260689869,-206462999,-202250470.2,68.22912471156634,54.54375790184328,NaN,NaN,2.30655859182987,-2.5646630627699842
2009-01-12T09:30:00-05:00,23.24001,23.28,22.35001,22.37,7739336,8644267.55,45.1070779753131,48.777805781403025,NaN,NaN,-35.42474677619162,45.16573910776157,0.0759318921972389,0.020273712639649943,-0.05565817955758896,-214202335,-203527858.4,66.46472491548192,54.9309560050929,NaN,NaN,0.5834648256823066,-2.1149305072768
2009-01-13T09:30:00-05:00,22.37,22.78,22.2,22.49001,7943883,8262118.95,45.960620203820675,48.97169527082893,NaN,NaN,-48.427854655710284,17.32078403587846,0.01950069028213438,-0.03128231670492099,-0.05078300698705537,-206258452,-205887514.6,63.21278410582913,55.12611207256464,NaN,NaN,-0.5901237151431608,-1.897100965543423
2009-01-14T09:30:00-05:00,22.19,22.19,21.48,21.64999,9776660,8207054.3,41.13873894258152,48.84605929224119,NaN,NaN,-100.04617079987446,-16.01462687619759,-0.07003668721118717,-0.13832886600103933,-0.06829217878985216,-216035112,-207932231,60.45261588537675,55.471572185638834,NaN,NaN,-3.0955319566737556,-2.068305392847756
2009-01-15T09:30:00-05:00,21.7,22.48,21.09,22.28999,14954746,8372772.85,45.80396978803684,49.04482338385525,NaN,NaN,-77.52711498277466,-43.75142945062471,-0.0810196303214906,-0.1695667166917154,-0.08854708637022482,-201080366,-208807852.8,59.25930027923419,56.15666000146843,NaN,NaN,-3.866840700187895,-2.3252390081820615
2009-01-16T09:30:00-05:00,22.77,22.84,21.91,22.53999,15905824,8547510.55,47.55265564278118,49.244296028547694,NaN,NaN,-30.69450686599465,-58.42407881610914,-0.06689466054931621,-0.17216541205687008,-0.10527075150755387,-185174542,-204550161.4,63.07602604133076,57.31369930609732,NaN,NaN,-3.995208307238074,-2.563806050904349
2009-01-20T09:30:00-05:00,22.53,22.53,21.22,21.27,13430191,8640644.1,40.418124275173156,49.08259431436645,NaN,NaN,-97.60033119771393,-70.8591957004136,-0.13462273602279146,-0.2735491715360432,-0.13892643551325173,-198604733,-201430641,65.61756862379897,58.82822082284696,NaN,NaN,-6.392685885000597,-3.1107888843466704
2009-01-21T09:30:00-05:00,21.64999,22.09,21.0574,22.02,12055359,8853119.45,45.608156998108164,49.01040925883725,NaN,NaN,-84.25145458115071,-78.02391568550168,-0.12088642168576488,-0.29003446262045784,-0.16914804093469296,-186549374,-197488825.4,68.56222060228876,60.593762392411755,NaN,NaN,-6.7755075371204665,-3.634320120457213
2009-01-22T09:30:00-05:00,21.57001,22,21.38,21.67999,9366340,8968207.15,43.74767278160326,48.62760091888337,NaN,NaN,-83.24943251081751,-74.66456802769028,-0.12609625346879968,-0.3267683577706926,-0.2006721043018929,-195915714,-193464945.8,71.26745466222599,62.43558234387631,NaN,NaN,-7.668152064054726,-4.210581826685429
2009-01-23T09:30:00-05:00,21.25,22.41,21.17,22.00999,11772715,9208059.7,46.04804231998056,48.0582313857578,NaN,NaN,-64.88818197238766,-72.1367814256129,-0.09986218279835943,-0.3254998327998422,-0.22563765000148275,-184142999,-190077472.4,73.34676144569063,64.2621451760782,NaN,NaN,-7.710292710560639,-4.710540524381887
2009-01-26T09:30:00-05:00,22.25,22.74001,21.64999,21.75,15345926,9756596.6,44.50391633442781,47.35813339976858,NaN,NaN,-48.50232373285869,-75.69834479898569,-0.0927190939351348,-0.34153651742040125,-0.24881742348526645,-199488925,-192940349,68.81429543515858,65.47761053624075,NaN,NaN,-8.19845519840672,-5.208814049242577
2009-01-27T09:30:00-05:00,21.92999,22.22,21.60001,21.91,9244129,10095693.45,45.71044016093071,46.527742942028446,NaN,NaN,-59.99251284659306,-68.17678112876152,-0.07090220893949833,-0.33744518465963935,-0.266542975720141,-190244796,-191268361.6,69.98101032256181,66.26039767385764,NaN,NaN,-8.26152202740578,-5.644915188980177
2009-01-28T09:30:00-05:00,22.25999,22.78999,22.25,22.53,8683223,10202156.95,50.22619922134837,46.30729148635088,NaN,NaN,-5.969934166122521,-52.52047704575589,-0.011514024136560441,-0.2809355058908416,-0.26942148175428116,-181561573,-190270801.4,70.68567083620499,66.83346010240737,NaN,NaN,-7.006747257468193,-5.8394626273356085
2009-01-29T09:30:00-05:00,22.28999,22.28999,21.82001,21.92,8368121,10443872.9,46.158154601909494,45.65408700804257,NaN,NaN,-55.24889133697472,-46.92036881098733,-0.010159586978805035,-0.2821209654777874,-0.2719613784989824,-189929694,-189073597.4,71.54884319145238,67.1798857898715,NaN,NaN,-7.106999333889839,-6.0205392997004985
2009-01-30T09:30:00-05:00,21.98,22.02,20.92999,21.06,9741727,10778432.2,41.10354133258695,44.93480789847156,NaN,NaN,-108.37734001567334,-55.618200419644474,-0.06118184057905307,-0.3484386792227987,-0.2872568386437456,-199671421,-192179281.8,66.11055509206939,67.02855938847887,NaN,NaN,-8.755734300614822,-6.411281442688259
2009-02-02T09:30:00-05:00,20.84,21.14,20.52,20.75999,5659680,10705912.7,39.47937060426327,44.532828800539434,NaN,NaN,-141.4241749898591,-74.20257067104455,-0.10648141904554798,-0.4203586124506806,-0.31387719340513265,-205331101,-193347717,64.1354520868559,66.86218275786273,NaN,NaN,-10.609304779428056,-7.010999062222516
2009-02-03T09:30:00-05:00,20.94,21.3,20.84,21.16,7860477,10571246.7,42.72881003542594,44.30198521708267,NaN,NaN,-106.93228538628013,-83.59052517898196,-0.10090312312900729,-0.44000609731639173,-0.33910297418738444,-197470624,-194792882.6,61.680926838743524,66.75276438164232,NaN,NaN,-11.215115680154693,-7.611587150498541
2009-02-04T09:30:00-05:00,21.44,22.05,21.42,21.42,11113785,10459174.8,44.80327223340252,44.56373759499844,NaN,NaN,-53.911589344261394,-93.17885621460975,-0.07243311718994161,-0.4296443706748114,-0.3572112534848698,-186356839,-195751935.8,60.03878375297732,66.7232049436138,NaN,NaN,-11.121570918442101,-8.113013403061906
2009-02-05T09:30:00-05:00,21.56,22.28,21.22,21.99001,17496000,10766406.85,49.15176739178856,44.80286599526642,NaN,NaN,-26.71877379763631,-87.47283270674207,-0.01115827196475161,-0.37115909344080933,-0.3600008214760577,-168860839,-191538164.8,64.50957342494777,67.09822445402192,NaN,NaN,-9.758686016435046,-8.34810949068664
2009-02-06T09:30:00-05:00,22.19,22.77,22.13,22.64999,12418770,10931881.7,53.699971064949935,45.24195995399276,NaN,NaN,81.63593922641628,-49.47017685832414,0.07323298952361307,-0.2684595845715414,-0.34169257409515447,-156442069,-182892294.4,71.54417100355421,67.70309195132359,NaN,NaN,-7.186009299352883,-8.182095177638962
2009-02-09T09:30:00-05:00,22.7,23.03,22.34,22.57001,9413313,10914510.25,53.08034019202402,46.14640394805354,NaN,NaN,122.17771777101126,3.250201693849931,0.1202998121940132,-0.19131780885263794,-0.31161762104665114,-165855382,-174997150.6,76.18606491808298,68.45798454377244,NaN,NaN,-5.267026634279199,-7.7656568143018525
2009-02-10T09:30:00-05:00,22.53999,22.96001,21.39,21.56,16694227,11362254.8,45.88059688111894,46.16586393969717,NaN,NaN,13.956290703389083,27.427916911783775,0.08187854960275204,-0.20926943404321108,-0.2911479836459631,-182549609,-172012947.6,77.66888153911248,69.10846032497413,NaN,NaN,-5.708735601269839,-7.47181092672585
2009-02-11T09:30:00-05:00,21.82001,22.06,21.342,21.56,10198000,11474960.65,45.88059688111894,46.318215661091145,NaN,NaN,-40.09007903781061,30.19221897307393,0.05615897827767902,-0.22094926079886434,-0.27710823907654336,-182549609,-171251501.6,78.04454091526372,69.59253791447682,NaN,NaN,-6.062511047032667,-7.270482372483967
2009-02-12T09:30:00-05:00,21.28999,21.92,21.07001,21.92,15739848,11773120.05,48.75395566087134,46.51149518544048,NaN,NaN,-41.3438145477287,27.26721082305546,0.06259520469710916,-0.1988642332051569,-0.26145943790226606,-166809761,-170841286,78.25675096319486,69.94325145144141,NaN,NaN,-5.539220196194391,-7.023159204442599
2009-02-13T09:30:00-05:00,21.95,21.97,21.52,21.59,8600984,11455431.95,46.32590951638723,46.64163755558044,NaN,NaN,-27.582110314549908,5.423600914862215,0.044671809389798645,-0.20561967616501775,-0.2502914855548164,-175410745,-174635021.2,71.38496394144764,70.12687063046205,NaN,NaN,-5.784700622819961,-6.846236549925079
2009-02-17T09:30:00-05:00,20.89,21,20.58,20.64999,11854188,11252850.15,40.18645247152117,46.247067006336906,NaN,NaN,-188.1556033984985,-56.64306331903974,-0.02661138008770808,-0.2835557106644515,-0.25694433057674343,-187264933,-178916931.4,64.50055652298013,69.73540964477765,NaN,NaN,-7.892015136816507,-6.995633490909569
2009-02-18T09:30:00-05:00,20.8,20.8174,20.21001,20.53,6926133,10927647.25,39.46743055712635,45.478583530321046,NaN,NaN,-189.94923876634556,-97.42416921298665,-0.07521025881588927,-0.350957154096605,-0.2757468952807157,-194191066,-181245222.8,61.05270021278244,69.04734031453319,NaN,NaN,-9.820589324144029,-7.399198609943063
2009-02-19T09:30:00-05:00,20.78999,21.08,20.3,20.32001,6847648,10667261.7,38.17996325823277,44.908712720058425,NaN,NaN,-150.21840204263782,-119.44983381395211,-0.1126155878560321,-0.41651638010075587,-0.30390079224472377,-201038714,-184943043.8,55.93837030024657,67.93230653658992,NaN,NaN,-11.803196155484367,-8.028341116448964
2009-02-20T09:30:00-05:00,20.07001,20.67999,20,20.48,9982641,10698076.75,39.79147780217742,44.81499389645774,NaN,NaN,-142.66470710149133,-139.71401232470464,-0.11717623468536675,-0.45037108560143224,-0.3331948509160655,-191056073,-189792306.2,50.0207323222992,66.78303348160634,NaN,NaN,-13.02272252908282,-8.741824175396657
2009-02-23T09:30:00-05:00,20.72,20.72,19.13699,19.24001,10080875,10613484.75,32.680844684065946,44.32938490215793,NaN,NaN,-179.8588439463507,-170.1693590510648,-0.18998777901958863,-0.5706795746905513,-0.3806917956709627,-201136948,-194937546.8,44.626317715044294,65.38952388361979,NaN,NaN,-16.43124694303528,-9.840313142202174
2009-02-24T09:30:00-05:00,19.37,19.97,19.02,19.85001,7749496,10233663.25,38.502812405545924,44.02752792859508,NaN,NaN,-157.97487186646157,-164.1332127446574,-0.18326570173588824,-0.609773922840823,-0.42650822110493475,-193387452,-196162050.6,43.426034903864895,64.08560303112846,NaN,NaN,-17.521630399333745,-10.937644178935255
2009-02-25T09:30:00-05:00,19.96001,20.08,19.39,19.55,10614063,10302159.95,36.81640279928842,43.45703725472979,NaN,NaN,-130.485503173432,-152.2404656260747,-0.18470288628890663,-0.657386828966068,-0.4726839426771614,-204001515,-198124140.4,41.499915644058795,62.7613981662057,NaN,NaN,-18.937014345490066,-12.080411345585942
2009-02-26T09:30:00-05:00,19.89,20.32001,19.48,19.57001,5971621,10166579.85,37.014558619176604,42.5900937709718,NaN,NaN,-108.13004974733104,-143.82279516701334,-0.17033489448657502,-0.6856025607853802,-0.5152676662988052,-198029894,-197522376.4,42.34454353389215,61.17818174541601,NaN,NaN,-20.017100281366353,-13.214224050697428
2009-02-27T09:30:00-05:00,19.2,19.83,19,19.37,8327852,10164566.4,35.805784958526175,41.31193762051295,NaN,NaN,-123.7408585013614,-140.03802544698735,-0.16046665292753848,-0.7158509824582282,-0.5553843295306897,-206357746,-200582711,39.24153939890845,58.870850916512744,NaN,NaN,-21.264047144825867,-14.364198778430062
2009-03-02T09:30:00-05:00,19,19.08,17.95,18.08,9852453,10170102.7,29.18567952365433,39.60517614420083,NaN,NaN,-173.82346117834254,-138.8309488933857,-0.22313095659889604,-0.8342980252793097,-0.6111670686804137,-216210199,-203597361.2,36.41099396011388,56.02977441951496,NaN,NaN,-24.587133363918046,-15.824618004928345
2009-03-03T09:30:00-05:00,18.32001,18.52,17.92999,18.14999,9882828,10381260.1,29.94250764700938,38.46674119890729,NaN,NaN,-156.07866565211208,-138.45170765051586,-0.24067234288522354,-0.9120074972869432,-0.6713351544017196,-206327371,-206185345,34.134694351887376,52.92018962042744,NaN,NaN,-27.01129492432895,-17.42271470769986
2009-03-04T09:30:00-05:00,18.61,19.09,18.59,18.78,9118574,10444164.95,36.519298345526735,37.79807701779357,NaN,NaN,-103.95862464890641,-133.1463319456107,-0.192724301232287,-0.9122405309420785,-0.7195162297097915,-197208797,-204826801.4,36.38305717029565,49.94436935292972,NaN,NaN,-27.096412343660635,-18.804671512837114
2009-03-05T09:30:00-05:00,18.77,18.77,17.95,18.17,5288766,10152914,33.26324765370468,36.691597874424524,NaN,NaN,-119.27087436100655,-135.37449686834583,-0.18493755410581636,-0.9506881723420619,-0.7657506182362456,-202497563,-205720335.2,35.52413216128207,46.89203943850738,NaN,NaN,-28.184052943133985,-20.144583145736668
2009-03-06T09:30:00-05:00,18.46001,18.74001,17.83,18.39999,8464910,9701359.5,35.59484298894894,35.925093122464645,NaN,NaN,-105.05487968534744,-131.63730110514305,-0.1487036129612942,-0.9516301344378633,-0.8029265214765691,-194032653,-203255316.6,39.749919062418925,44.63239337571962,NaN,NaN,-28.36613264055089,-21.319090216424414
2009-03-09T09:30:00-04:00,18.17,18.67,18.06,18.17999,7281574,9444499.7,34.35827535197913,35.50879475678307,NaN,NaN,-97.72195392914129,-116.41699965530279,-0.1249173497162579,-0.9590732086218914,-0.8341558589056335,-201314227,-200276122.2,44.485569232464485,43.20275142639708,NaN,NaN,-28.87792172940112,-22.3989232897068
2009-03-10T09:30:00-04:00,18.64999,19.38,18.53999,19.19,16396969,9793682.5,43.98016356998169,35.83113282912988,NaN,NaN,-50.71414253121002,-95.34409503112236,-0.03139888847071737,-0.8734044694940302,-0.8420055810233128,-184917258,-195994099.6,50.5070105763298,42.44948788093617,NaN,NaN,-26.2779985978962,-22.95307690516243
2009-03-11T09:30:00-04:00,19.63,19.97,19.34,19.77,5738438,9245893.05,48.63627966134016,36.57801257220897,NaN,NaN,-1.9956479837909464,-74.95149969809928,0.07355330207388233,-0.7500639534309599,-0.8236172555048422,-179178820,-192388104.2,54.93953497752495,42.378142500741774,NaN,NaN,-22.56632733664169,-22.897826966802324
2009-03-12T09:30:00-04:00,19.83,20.35001,19.39999,20.25999,5047824,8988384.25,52.247252598371794,37.46771077193714,NaN,NaN,29.023217098355275,-45.29268140622692,0.17425829460740905,-0.6057943872455809,-0.7800526818529899,-174130996,-186714790.8,60.87622640170269,43.15353493498488,NaN,NaN,-18.295981585887088,-22.240420483814432
2009-03-13T09:30:00-04:00,20.46001,20.61,20.07001,20.35001,4251512,8413967.45,52.90234642525122,38.912103753450374,NaN,NaN,65.4427333565772,-11.193158797841983,0.2410997826943858,-0.47867795348500763,-0.7197777361793934,-169879484,-181884157,65.09328651567259,44.6154612778869,NaN,NaN,-14.67686315770271,-21.1599122943699
2009-03-16T09:30:00-04:00,20.58,21.23,20.58,20.67,5711879,8269512.2,55.25229311183738,40.108495232471185,NaN,NaN,115.32664881360252,31.41656175070678,0.29733897395744147,-0.34810401873259167,-0.6454429926900331,-164167605,-174454832.6,70.381014685612,46.54081697658312,NaN,NaN,-10.932455098211003,-19.698846980632915
2009-03-17T09:30:00-04:00,20.59,20.85001,20.27,20.84801,4068782,7880241.9,56.551058239109224,41.51811347817267,NaN,NaN,101.00250821467064,61.7598918998829,0.3342461720590484,-0.2276352776162227,-0.5618814496752711,-160098823,-169491145.6,73.29200762714484,48.8116806896607,NaN,NaN,-7.448353546470668,-17.94877649003831
2009-03-18T09:30:00-04:00,20.60001,21.50999,20.41,21.46001,8603758,7964123.15,60.76707411439771,43.21472172783132,NaN,NaN,135.92853223527544,89.3447279436962,0.384036128342318,-0.08183628924737363,-0.4658724175896916,-151495065,-163954394.6,76.11222140098138,51.22365768016708,NaN,NaN,-3.0894484564497624,-15.826015342382803
2009-03-19T09:30:00-04:00,21.89999,22.12,21.64999,21.66,8407617,8042121.6,62.0625597454802,45.09020564118517,NaN,NaN,178.0784106906,119.15576666214515,0.4121218644024522,0.049279912913373636,-0.36284195148907855,-143087448,-157745685,78.81384018634319,54.05025059355527,NaN,NaN,0.915242472242145,-13.434407083150667
2009-03-20T09:30:00-04:00,21.49001,21.77499,20.981,21.14999,6808504,7883414.75,56.90235168776267,47.06996793862148,NaN,NaN,126.71593401839301,131.4104067945083,0.378881664610402,0.11076012927392398,-0.26812153533647803,-149895952,-153748978.6,80.3541389031559,57.189046660915416,NaN,NaN,2.912050032247288,-11.099198923808103
2009-03-23T09:30:00-04:00,21.63,22.42999,21.42999,22.39999,7574742,7758108.1,64.6583887965851,49.549673735019745,NaN,NaN,155.21907843601,139.38889271898978,0.42040224104913043,0.25738126597493505,-0.16302097507419538,-142321210,-149379699.6,81.90312825725982,60.601077654156306,NaN,NaN,7.363790465067444,-8.461629011111597
2009-03-24T09:30:00-04:00,22.11,22.67,22.02,22.31,5501027,7645684.65,63.768650156815404,51.49605600725466,NaN,NaN,143.53346723184745,147.89508452242518,0.4201316333609656,0.36214356662701164,-0.057988066733953986,-147822237,-146924382.4,82.72730432108656,63.91138102206993,NaN,NaN,10.610651487196039,-5.737017511353364
2009-03-25T09:30:00-04:00,22.47,23.09,21.91,22.50999,7954930,7512728,64.92382703663431,53.75752596317822,NaN,NaN,130.90603301603784,146.89058467857765,0.4112295879715352,0.456048918230465,0.04481933025892981,-139867307,-144598830.8,83.49406473614597,67.33780477741736,NaN,NaN,13.617629010131552,-2.9720680082840905
2009-03-26T09:30:00-04:00,22.95,23.53999,22.83,23.41,9158887,7672091.3,69.61842115863536,56.187781546727244,NaN,NaN,145.08965855878398,140.29283425221442,0.4411205501904008,0.5962200179969308,0.15509946780653,-130708420,-142123025.2,84.29344907098917,70.51948549231523,NaN,NaN,17.837123283623637,0.0006736048455846522
2009-03-27T09:30:00-04:00,23.21001,23.21001,22.77,22.89999,9974082,7754402.8,64.36153825748477,58.33087175426336,NaN,NaN,115.22975802451215,137.99559905343827,0.40276969910112775,0.6585615916829397,0.25579189258181195,-140682502,-140280335.2,84.88036672747026,73.40482817052994,NaN,NaN,19.72110392963517,2.8178779369583826
2009-03-30T09:30:00-04:00,22.27,22.34,21.75,22.11,9605828,7742071.55,57.16149217404978,59.272395225982514,NaN,NaN,68.2124542065873,120.59427420755374,0.3048709533479577,0.6368805842667591,0.33200963091880137,-150288330,-141873759.2,82.02598812372753,75.65618370962977,NaN,NaN,18.984916875137795,5.12745492812687
2009-03-31T09:30:00-04:00,22.34,22.50999,21.87,22.21001,6229355,7559397.9,57.805032891412985,59.92730617098772,NaN,NaN,68.08797892836384,105.505176546857,0.23088361310225847,0.6206141472966245,0.389730534194366,-144058975,-141121106.8,82.32828304913531,77.61252285760193,NaN,NaN,18.598298507204447,7.051861153709381
2009-04-01T09:30:00-04:00,21.86,23.02,21.651,22.66,10418414,7624389.9,60.66809516246842,60.528794925566054,NaN,NaN,73.30240575502367,93.98445109465416,0.19757069274739453,0.6366939001286092,0.43912320738121463,-133640561,-139875757.6,82.84247106585491,79.1815403336128,NaN,NaN,19.143989728601206,8.779308092979642
2009-04-02T09:30:00-04:00,23.53999,23.88,23.19,23.50999,7879602,7753931.7,65.43853015815287,61.42423662077331,NaN,NaN,118.64722038796526,88.69596346049043,0.2165747910714914,0.7098416962205789,0.4932669051490875,-125760959,-138886265.4,83.25926710555223,80.47911037574706,NaN,NaN,21.154967645436866,10.547259457616388
2009-04-03T09:30:00-04:00,23.56,23.85001,23.06,23.81,5495422,7605457.3,66.96166298949285,62.26062018346299,NaN,NaN,112.86079250341164,88.22217035627031,0.23178190041368296,0.7829942806661911,0.5512123802525082,-120265537,-134802872.4,84.89048798045025,81.51550132537837,NaN,NaN,23.27077679977629,12.364904792210659
2009-04-06T09:30:00-04:00,23.46001,23.55,22.88,23.39,4473727,7465064.95,62.78977404956864,62.706242741352945,NaN,NaN,92.08469572417614,92.99661865978808,0.1973343148605864,0.7978802738282411,0.6005459589676547,-124739264,-129693059.2,86.64426588883956,82.46923405835655,NaN,NaN,23.750386914029082,13.991402238184719
2009-04-07T09:30:00-04:00,23.08,23.08,22.53,22.59,5542918,6922362.4,55.67454966412271,62.34249099490473,NaN,NaN,54.65885575355206,90.31079402482574,0.10886945080413801,0.7366327724728272,0.6277633216686892,-130282182,-126937700.6,87.4876416567655,83.28176407662686,NaN,NaN,21.87302930776864,15.117348962410993
2009-04-08T09:30:00-04:00,22.77,23.02,22.44,22.85001,6525277,6961704.35,57.36555523902751,62.00699067301525,NaN,NaN,52.81626468957207,86.2135658117354,0.0585843037484286,0.7009937013542249,0.6424093976057963,-123756905,-124960969.4,88.06969025189755,83.94289622416646,NaN,NaN,20.8632918912286,15.93819795224208
2009-04-09T09:30:00-04:00,23.5,23.9801,23.42999,23.84,5740473,6996336.8,63.132674769322946,62.45201375026956,NaN,NaN,121.54372384566476,86.7928665032753,0.08131758690066115,0.7440563812316228,0.6627387943309616,-118016432,-123412064,88.52031196860932,84.52619430027028,NaN,NaN,21.834184975324774,16.780481812682464
2009-04-13T09:30:00-04:00,23.8,24.42,23.549,24.14999,5886492,7078085.8,64.74098589295284,62.45791354286723,NaN,NaN,135.3602531680157,91.29275863619611,0.10504434061194368,0.7940442200958913,0.6889998794839476,-112129940,-121784944.6,88.9907447236808,85.03245261930034,NaN,NaN,23.129369523240598,17.687465771333624
2009-04-14T09:30:00-04:00,23.91,24.31,23.64,23.7,5643391,7074661.4,60.60769416445814,62.232130971984574,NaN,NaN,110.95429168544563,95.06667782845003,0.0794104213380793,0.7882629061565467,0.7088524848184674,-117773331,-120391758,89.39160382291003,85.50847401228773,NaN,NaN,22.91224466735411,18.433862756479407
2009-04-15T09:30:00-04:00,23.62,24.25999,23.53999,24.25999,5840496,7163247.1,63.7125095194544,62.14560829218601,NaN,NaN,113.91027626389287,106.91696193051818,0.0884555326079074,0.8194219005783516,0.7309663679704442,-111932835,-116721888.6,90.38476495164444,86.00066688482333,NaN,NaN,23.69783758167118,19.18585916007823
2009-04-16T09:30:00-04:00,24.50999,24.625,23.83,24.27,7174375,7091777.95,63.76748402805067,61.72768421142996,NaN,NaN,121.64031326896671,120.6817716463971,0.08346258190098976,0.8352945953466815,0.7518320134456917,-104758460,-112922199.6,91.29361072136275,86.50067843127859,NaN,NaN,24.33838614652566,19.921934443856436
2009-04-17T09:30:00-04:00,24.33,24.59,24.14999,24.45,6377113,6990252.75,64.80016958540094,61.75901502056683,NaN,NaN,121.59558588677343,120.69214405461885,0.08059072120148392,0.8525704149475466,0.7719796937460627,-98381347,-108995182.6,92.12236460099307,87.01796399367308,NaN,NaN,25.163427180931798,20.670719120581488
2009-04-20T09:30:00-04:00,23.94,24.14,23.14999,23.32001,8164309,7058043,54.331164659952236,61.55684876955986,NaN,NaN,36.47164935987876,100.91442329299144,-0.004585317670271705,0.7662480466582231,0.7708333643284948,-106545656,-107878325.8,92.34552758015423,87.7550739548464,NaN,NaN,22.638772783819217,20.951869643901162
2009-04-21T09:30:00-04:00,22.89999,23.85001,22.85001,23.78999,8085457,7083578.75,57.412909598879395,61.52883996295032,NaN,NaN,27.40273718225721,84.20411239235376,-0.03476615377427006,0.7273756721106572,0.7621418258849273,-98460199,-104015699.4,93.07607517160801,88.52277339216587,NaN,NaN,21.471406536345754,21.026089199964677
2009-04-22T09:30:00-04:00,23.61,24.7,23.41,23.89999,11302098,7373632.3,58.12515226757566,61.347201184743696,NaN,NaN,77.00620694666104,76.8232985289074,-0.05178877644169333,0.6974058553328106,0.749194631774504,-87158101,-99060752.6,93.88263833391896,89.31135676845618,NaN,NaN,20.7397824688247,20.98518823837325
2009-04-23T09:30:00-04:00,23.99001,24.21001,23.69,23.96001,9899348,7470853.2,58.53266774125546,60.85392529782245,NaN,NaN,65.75974648513214,65.64718517214048,-0.0627433015755543,0.6707655048050611,0.7335088063806154,-77258753,-93560811.2,94.63035243374497,90.12357714904137,NaN,NaN,20.257694680411216,20.88126058723582
2009-04-24T09:30:00-04:00,24.34,25.28,24.2,25.10001,10194035,7522610.6,65.41680499028479,60.74357829787902,NaN,NaN,153.66123147594962,72.06031428997571,-0.0002554011791909838,0.7331895549066267,0.7334449560858177,-67064718,-87297485.4,95.3303371573064,90.86928066167395,NaN,NaN,21.94788975092173,21.03363618204809
2009-04-27T09:30:00-04:00,24.7,24.92,24.31,24.55,7542152,7401014.1,60.222222794446765,60.56018177965603,NaN,NaN,112.66581903038818,87.29914822407758,-0.0028628381893829324,0.7298664083490891,0.732729246538472,-74606870,-80909728.2,95.91518542478657,91.53148919995587,NaN,NaN,21.749784281953833,21.135943053463198
2009-04-28T09:30:00-04:00,24.11,24.69,24.05,24.42,9953008,7418373.1,59.029100639736804,60.79979256362846,NaN,NaN,83.58708847529373,98.5360184826849,-0.019323503455711766,0.7085748672188323,0.7278983706745441,-84559878,-78129664,96.14167469504528,92.14963441697584,NaN,NaN,21.231393073936083,21.14957877067361
2009-04-29T09:30:00-04:00,24.64,25.2,24.64,24.97,6312176,7422514.15,62.42124650936833,61.16091336865281,NaN,NaN,140.7558305930661,111.2859432119659,-0.00016415496900423765,0.7276931769632888,0.7278573319322931,-78247702,-76347584.2,96.28391350340863,92.73636464922664,NaN,NaN,21.810273986482326,21.243963801503426
2009-04-30T09:30:00-04:00,25.52,25.92999,25.495,25.67,10041145,7403650.7,66.2510724213349,61.38365605808223,NaN,NaN,214.075221062624,140.94903812746426,0.04988978707180136,0.7902195657720448,0.7403297787002434,-68206557,-74537145,96.42798370878764,93.30119834495368,NaN,NaN,23.516618638337913,21.568628778194068
2009-05-01T09:30:00-04:00,25.7,26.10899,25.39,25.73,13420480,7680694.6,66.5656067149729,61.513986116797945,NaN,NaN,180.14983847812613,146.24675952789957,0.07572693771287187,0.8349884508413332,0.7592615131284614,-54786077,-72081416.8,96.61943516206195,93.84610480483805,NaN,NaN,24.97709518314625,22.055552550330095
2009-05-04T09:30:00-04:00,26.07001,27.24001,26.05,27.17999,13348887,8073367.85,73.09217711345349,62.40573489886905,NaN,NaN,231.75996219642283,170.06558816110652,0.1735643640522082,0.9762169681937216,0.8026526041415134,-41437190,-65447480.8,97.07545088695325,94.39495102369827,NaN,NaN,28.579973642662072,22.98761270637752
2009-05-05T09:30:00-04:00,27.24001,27.2997,26.67999,27.02,6250426,8162202.8,71.43520055957957,62.957355687449414,NaN,NaN,199.31038002120812,193.2102464702894,0.20826061807739538,1.0629783767382577,0.8547177586608623,-47687616,-58073028.4,97.48206161270387,94.90190078520251,NaN,NaN,30.905496586508598,24.118738974967673
2009-05-06T09:30:00-04:00,27.41,27.49139,26.87,27.13,15471020,8658607.9,71.90675506763566,63.53873219027691,NaN,NaN,174.06065985785764,199.87121232324768,0.21831783655375347,1.127615054353054,0.9092972177993006,-32216596,-48866807.2,97.87859503990798,95.37225680795574,NaN,NaN,32.9140234652559,25.37520818786599
2009-05-07T09:30:00-04:00,27.56,27.62,25.92999,26.24001,10946113,8879649.7,62.86438060791112,63.40046154902764,NaN,NaN,116.35459316709934,180.32708674414275,0.14808995272256475,1.0944096587025065,0.9463197059799417,-43162709,-43858037.6,98.05780489647931,95.7962168290619,NaN,NaN,31.846872028540435,26.299731593676626
2009-05-08T09:30:00-04:00,26.48,26.99001,26.41,26.8,7174547,8951353.4,65.78025860296576,64.2182539735286,NaN,NaN,107.4525101420287,165.78762107692324,0.12341919308697435,1.1005936973386596,0.9771745042516853,-35988162,-40098454.6,98.18195209946452,96.21310429472693,NaN,NaN,31.86345771441868,27.09454961092549
2009-05-11T09:30:00-04:00,26.31,26.62,26.11,26.41,5866578,8950357.7,62.121851064738344,64.55460693537567,NaN,NaN,75.13151161276757,134.4619309601922,0.06768859853929166,1.0617852524257998,0.9940966538865081,-41854740,-40181964.6,98.03205415503746,96.56710279354331,NaN,NaN,30.73293048813856,27.614318307670214
2009-05-12T09:30:00-04:00,26.52,26.83,26.185,26.674,6756438,9006010.05,63.5977242594,64.94550493479169,NaN,NaN,76.45107147671271,109.89006925129311,0.036994267183024565,1.040339487865289,1.0033452206822644,-35098302,-37664101.8,98.12500276664332,96.8701288244522,NaN,NaN,30.24586273519172,27.99025322588757
2009-05-13T09:30:00-04:00,26.17999,26.2,25.25999,25.52,10295613,9228765.9,53.74061644471775,64.60321555646757,NaN,NaN,19.534437827950025,78.98482484531159,-0.06697653657973712,0.919624549957593,0.9866010865373301,-45393915,-40299565.6,93.16488819487172,96.76545280738983,NaN,NaN,26.55219735741121,27.78481667324809
2009-05-14T09:30:00-04:00,25.39999,26.07001,25.28,25.74001,11563656,9448229.95,55.16728874920813,63.87110725353353,NaN,NaN,18.07121903455871,59.32815001880348,-0.12358653097193129,0.832117922822416,0.9557044537943473,-33830259,-38433075.6,93.4186241515041,96.62890187840397,NaN,NaN,24.030061242455194,27.24842304027768
2009-05-15T09:30:00-04:00,26,26.3,25.47,25.83,15662008,9912474.7,55.76817977142191,63.55296132331747,NaN,NaN,25.196375177519798,42.87692302590169,-0.15555999207888394,0.7612544636957423,0.9168144557746263,-18168251,-34869093.4,93.88539062274495,96.483916535401,NaN,NaN,22.17993740437743,26.5243536637205
2009-05-18T09:30:00-04:00,26.12,26.63,25.9301,26.57001,12059473,10107232.9,60.461197972390764,63.65525398993561,NaN,NaN,54.6187889469874,38.77437849274566,-0.12857833922349382,0.756091531745259,0.8846698709687528,-6108778,-27719901,94.69775179062616,96.38077918508533,NaN,NaN,21.979413972829974,25.875076565021853
2009-05-19T09:30:00-04:00,26.64,27.13,26.5999,26.88,6042961,10005108.1,62.26725161436831,63.64425435457846,NaN,NaN,85.08329063262327,40.50082232392778,-0.0932090016656637,0.7681586188866731,0.8613676205523368,-65817,-20713404,95.34980131839878,96.31405688615605,NaN,NaN,22.3564880843962,25.372421067789617
2009-05-20T09:30:00-04:00,27.35001,28.02,26.89,27,15409648,10210485.6,62.97235288934258,63.41006010229329,NaN,NaN,109.09278464397697,58.41249168713316,-0.06634882073231885,0.7784315946369382,0.8447804153692571,15343831,-8565854.8,96.21815502532792,96.29906912305178,NaN,NaN,22.868413284857343,25.014705670227862
2009-05-21T09:30:00-04:00,26.61,26.64999,26.05,26.39999,13215480,10376292.2,57.21521633513012,62.74217507516166,NaN,NaN,26.14403243085406,60.02705436639222,-0.09202820313223847,0.729745161453959,0.8217733645861974,2128351,-1374132.8,96.62050656604053,96.29914565190737,NaN,NaN,21.61626998572148,24.529214858155523
2009-05-22T09:30:00-04:00,26.53,26.66,26.11,26.3,8422039,10287692.4,56.29161807578006,61.54213514389927,NaN,NaN,20.099610352721307,59.00770140143253,-0.117172351157951,0.6753079256387586,0.7924802767967096,-6293688,1000779.8,96.74371044637326,96.27544990615168,NaN,NaN,20.326272555143156,23.928794529153755
2009-05-26T09:30:00-04:00,26.17,26.97,25.83,26.92999,7886836,10304926.6,60.60640136388689,60.76864948706408,NaN,NaN,37.007718684184425,55.485487348871935,-0.09381024913544445,0.6752174653774041,0.7690277145128486,1593148,2541165,96.82457188322701,96.22848635404618,NaN,NaN,20.441450103082673,23.43060246828646
2009-05-27T09:30:00-04:00,26.78999,26.85001,25.86,25.92,7216551,10168103.75,51.78102903142169,59.33109762733451,NaN,NaN,-19.671846259034464,34.5344599705404,-0.14571592907104802,0.5868828031740385,0.7325987322450865,-5623403,1429647.8,94.99151978739455,96.02226669315236,NaN,NaN,17.742086435461804,22.61795732074008
2009-05-28T09:30:00-04:00,26.19,26.44,25.761,26.38,8773320,10291160.95,54.995406144982155,58.769028022839585,NaN,NaN,-36.33176820637241,5.449549400470585,-0.1479335713334673,0.5476817680782524,0.6956153394117197,3149917,-1009135,90.92418197430277,95.5127221987112,NaN,NaN,16.4927494138132,21.742927619750525
2009-05-29T09:30:00-04:00,26.67,27.2,26.5,27.17,7792141,10178710.75,59.93506822234857,58.35151442422408,NaN,NaN,83.55614074696093,16.931971063691957,-0.09749446213493473,0.5737472617430512,0.671241723877986,10942058,753606.4,91.21691561105611,95.0152195923963,NaN,NaN,17.010001618161745,21.06679533380927
2009-06-01T09:30:00-04:00,27.62,28.17,27.52,28,9267617,9971067.6,64.3609716420745,58.51145160831954,NaN,NaN,212.71778959616663,55.455606912381015,-0.013920306549319639,0.6538413406913364,0.667761647240656,20209675,6054279,92.04755856861604,94.58775562193762,NaN,NaN,18.941187993762874,20.76313714237407
2009-06-02T09:30:00-04:00,27.85001,28.38,27.8,28.28,9859434,9796594.95,65.73608691974604,58.664191798344255,NaN,NaN,204.7071116116764,88.99548549787941,0.05097317093835174,0.7314781109135957,0.680504939975244,30069109,11749471.2,92.83194610099105,94.20968014581959,NaN,NaN,20.934771594534446,20.787656349825554
2009-06-03T09:30:00-04:00,27.95,27.96001,26.94,27.31,9871742,9977660.75,57.4641264993715,58.930156802248106,NaN,NaN,95.40653810009182,112.01116236970468,0.020867880038354825,0.7065897900231874,0.6857219099848326,20197367,16913625.2,93.46169955624785,94.23088095734647,NaN,NaN,19.92662918340237,20.664652468907956
2009-06-04T09:30:00-04:00,27.50999,28.03,27.271,27.94,10409281,9724573.8,60.90507725495072,59.33999883837257,NaN,NaN,127.45328307189723,144.7681726253586,0.034858070629078086,0.7292944982711802,0.6944364276421021,30606648,22404971.4,94.05937543219348,94.27664890596712,NaN,NaN,20.232922493478544,20.602976758132325
2009-06-05T09:30:00-04:00,28.28999,28.3,27.25999,27.53999,9358559,9645196.1,57.71273295478127,59.478895494326814,NaN,NaN,105.03937736688054,149.0648199493425,0.009940785335428304,0.7068624093113876,0.6969216239759592,21248089,24466177.6,94.27106621800394,94.30419716277133,NaN,NaN,19.45038306550514,20.438320516328442
2009-06-08T09:30:00-04:00,27.39,27.53999,26.83,27.39999,8986520,9735794.75,56.59465139231912,59.20271359575026,NaN,NaN,50.81695628283843,116.68465328667688,-0.02148617310188483,0.6700639075986032,0.6915500807004881,12261569,22876556.4,91.56125840638089,94.08016192103955,NaN,NaN,18.482420843769155,20.158906277391402
2009-06-09T09:30:00-04:00,27.55,28.11,27.39,27.89,8012000,9843065.85,59.54856233313871,59.00852150423386,NaN,NaN,95.75102829024667,94.89343662239094,-0.015091077743983772,0.6726862335205084,0.6877773112644922,20273569,20917448.4,88.19644812680374,93.5692081216399,NaN,NaN,18.562914079648582,19.930907391999572
2009-06-10T09:30:00-04:00,28.31,28.36,27.38,27.92,14989121,10254700,59.729256772831214,58.776871781625914,NaN,NaN,93.15154287249906,94.44243757687238,-0.014647461182211496,0.6694679847867278,0.6841154459689393,35262690,23930513,88.87367666973599,93.04460252481192,NaN,NaN,18.67979436072514,19.752176958960366
2009-06-11T09:30:00-04:00,28,28.66,27.99001,28.31,12869371,10383387.9,62.09945319816372,59.12574584327116,NaN,NaN,121.32486040366574,93.21675304322609,0.005050372157509142,0.6904284111658257,0.6853780390083165,48132061,27435595.6,89.61978740128137,92.54455115590055,NaN,NaN,19.46274505376672,19.710829543932704
2009-06-12T09:30:00-04:00,28.08,28.12,27.7,28.02,11822684,10396339.3,59.30434095747449,59.34094033482078,NaN,NaN,78.8358149338113,87.97604055661225,-0.007623739631057336,0.6758483644694948,0.6834721041005521,36309377,30447853.2,90.22636486075466,92.07902647121351,NaN,NaN,19.335750613522915,19.65724683958845
2009-06-15T09:30:00-04:00,27.7,27.7,26.89,27.08,11306938,10178585.8,51.25176482128893,58.67275201034949,NaN,NaN,-0.41710599077969984,77.72922810188862,-0.08138766703104339,0.5817375203117479,0.6631251873427912,25002439,32996027.2,90.72037093668992,91.64301211788941,NaN,NaN,16.761056113490884,19.243505307288796
2009-06-16T09:30:00-04:00,27.28999,27.35001,26.31,26.35001,17737392,10462481.75,46.02518444061239,58.26162025386311,NaN,NaN,-66.26405360333415,45.326211723172456,-0.17598683385190428,0.44314164502791087,0.6191284788798151,7265047,30394322.8,85.94392458165993,90.99675531747981,NaN,NaN,12.85754670665001,18.33122550719754
2009-06-17T09:30:00-04:00,26.2,26.42999,25.67999,26.05,19228752,11121771.3,44.03755460376276,57.47891657234744,NaN,NaN,-122.92998183947839,2.10990678077697,-0.2508446517725015,0.30557266416418827,0.5564173159366897,-11963705,20949043.8,71.27274324965398,89.59308112286203,NaN,NaN,9.03283340713365,17.002883778616983
2009-06-18T09:30:00-04:00,26.09,26.64999,25.92,26.27,11394625,10921020.15,45.883181291709874,56.4752103630161,NaN,NaN,-86.74944014379263,-39.504953328714706,-0.2756472550799528,0.21185824708674872,0.4875055021667015,-569080,11208815.6,59.914286702041075,87.35717905793238,NaN,NaN,6.424008228795406,15.491615842928187
2009-06-19T09:30:00-04:00,26.42,26.50999,25.87,26.07001,12793898,10899941.05,44.44811869685302,55.05286372407171,NaN,NaN,-96.90777682280408,-74.65367168003777,-0.2939505509235459,0.12006731351226918,0.41401786443581506,-13362978,1274344.6,50.988817004797255,84.42441180337391,NaN,NaN,3.8419515184512005,13.827378082288618
2009-06-22T09:30:00-04:00,25.64999,25.71001,24.72,24.75,15027836,11230230.9,36.363849011399466,52.954846730618385,NaN,NaN,-178.64461617866098,-110.29917371761402,-0.3780278048118435,-0.058516891578989316,0.3195109132328542,-28390814,-9404306,43.48920980831728,80.8999306396115,NaN,NaN,-1.2547219163599337,11.672792368195967
2009-06-23T09:30:00-04:00,24.84,25.3,24.59,25.07001,13384449,11505111.55,39.248640461544646,51.653740585059325,NaN,NaN,-159.53541945918823,-128.95344688878487,-0.3933995859207672,-0.17223856916810476,0.2211610167526624,-15006365,-13858588.4,40.7939222928798,77.13794654937092,NaN,NaN,-4.522298762254981,9.35920792098869
2009-06-24T09:30:00-04:00,25.48,25.92,25.17999,25.32001,11639367,11726252.35,41.480526774740454,50.26627269361574,NaN,NaN,-112.50789715216487,-126.86902995132213,-0.36847353098238966,-0.23943089697532471,0.12904263400706495,-3366998,-12139247,42.28092581006058,73.43948586207571,NaN,NaN,-6.527097879800553,7.089735663733084
2009-06-25T09:30:00-04:00,25.28999,25.91,25,25.86,10998535,11837513.1,46.08769783018285,49.435913041858704,NaN,NaN,-97.37879183787017,-128.99490029013765,-0.30024992805447914,-0.24626977606103395,0.05398015199344516,7631537,-10499123.6,43.73270585681378,69.82960297913357,NaN,NaN,-6.840142913230168,5.099753009881191
2009-06-26T09:30:00-04:00,25.87,26.032,25.67,25.82001,6945285,11795170.3,45.80012295290307,48.66487529618613,NaN,NaN,-70.56084205637185,-123.72551333685121,-0.24479329319988394,-0.25201146450640977,-0.007218171306525828,686252,-7689277.6,46.22803616316718,66.59151567604688,NaN,NaN,-7.174865284610517,3.34623611066809
2009-06-29T09:30:00-04:00,26.00999,26.24001,25.7,26.05,5011332,11582356.05,47.81681123504562,47.82689307489377,NaN,NaN,-53.797307250101284,-98.75605155113927,-0.18245844872390113,-0.23529123221140225,-0.05283278348750112,5697584,-871598,51.81208144021824,63.992632341290765,NaN,NaN,-6.883520531272505,1.8848423046765765
2009-06-30T09:30:00-04:00,26.13,26.28,25.64,25.8,7835527,11481160.7,45.820994221125424,46.83344574977193,NaN,NaN,-54.27869188416995,-77.7047060361356,-0.14929615200482116,-0.23945297349352757,-0.0901568214887064,-2137943,1702086.4,53.76406460356927,61.484802907993135,NaN,NaN,-7.186655528661174,0.5889140427711834
2009-07-01T09:30:00-04:00,26.08,26.42,25.8,25.86,7568867,11366016.95,46.39923276986721,45.71200143346503,NaN,NaN,-41.281553182003016,-63.45943724210325,-0.11603331353231452,-0.23519846340409956,-0.11916514987178503,5430924,3461670.8,55.1031050710141,59.01932559868833,NaN,NaN,-7.283438957199026,-0.5357078143674179
2009-07-02T09:30:00-04:00,25.49001,25.49001,25.11,25.14999,8963820,11293743.9,40.84400096057944,44.393405719401095,NaN,NaN,-90.07795761310621,-61.99927039715046,-0.1333269263171146,-0.2858238077681783,-0.1524968814510637,-3532896,1228784.2,53.00525600815552,56.36067496635982,NaN,NaN,-8.95073263893965,-1.7378542178777365
2009-07-06T09:30:00-04:00,24.73,24.96001,24.48,24.95,10207809,11336206.4,39.41262014403241,43.54775252816849,NaN,NaN,-115.54378904157883,-70.99585979419184,-0.14854961961562815,-0.3381839059705989,-0.18963428635497073,-13740705,-1656607.2,50.33827896029003,53.476239825188394,NaN,NaN,-10.756601191354672,-3.0262466426601558
2009-07-07T09:30:00-04:00,24.92,25,24.24001,24.24001,10496281,11411694.45,34.75586265269175,42.74280097188845,NaN,NaN,-128.16409283817737,-85.86921691180706,-0.19388473587890115,-0.4319902062035972,-0.23810547032469603,-24236986,-7643521.2,45.25072684269143,50.56958284383351,NaN,NaN,-13.784814073612484,-4.563184847081917
2009-07-08T09:30:00-04:00,24.45,24.759,23.85001,24.25999,12882418,11655215.35,34.98865323814576,42.09645087434438,NaN,NaN,-135.90972042388074,-102.19542261974922,-0.20869031118576342,-0.4989683593069003,-0.2902780481211369,-11354568,-9486846.2,43.78347614747492,48.606063765106434,NaN,NaN,-16.179797592545146,-6.222700953576664
2009-07-09T09:30:00-04:00,24.57001,24.71001,24.37,24.45,9698113,11390664.95,37.28053353981352,41.4819760349232,NaN,NaN,-109.16767760637677,-115.77264750462396,-0.19225786414218737,-0.5306003782988711,-0.3383425141566837,-1656455,-10904322,42.63854450260794,47.37208217943264,NaN,NaN,-17.578191356679895,-7.844913868305698
2009-07-10T09:30:00-04:00,24.23,24.60001,23.91,24.31,10302520,11262322.4,36.26606299514656,40.89754348480131,NaN,NaN,-118.62307340773735,-121.4816706635502,-0.17772971857208875,-0.5605046623717946,-0.3827749437997059,-11958975,-12589537.8,41.25722579226124,46.67696852139435,NaN,NaN,-19.034725461956555,-9.44345838168439
2009-07-13T09:30:00-04:00,24.36,25.05,23.94,25.05,7472012,11044788.8,44.81422656186334,41.501141881263024,NaN,NaN,-76.36694951324748,-113.64630275788393,-0.1085921155313262,-0.5185150882138636,-0.4099229726825374,-4486963,-10738789.4,43.42489705326435,46.67237475317628,NaN,NaN,-17.89563200969996,-10.650911757115185
2009-07-14T09:30:00-04:00,25.22,25.37,24.8499,25.24001,5818254,10770354.6,46.78775364880947,42.03964996606765,NaN,NaN,-23.553396474793146,-92.72416348520707,-0.04370224343067519,-0.46455077697088143,-0.42084853354020624,1331291,-5625134,49.0223161560233,47.26011717197225,NaN,NaN,-16.371137652197596,-11.468086884984102
2009-07-15T09:30:00-04:00,25.69,26.23,25.64999,26.23,8886953,10327832.65,55.68073770868162,43.053950747063446,NaN,NaN,78.0500800944298,-49.93220338154497,0.06627605984167612,-0.3380034587381111,-0.4042795185797872,10218244,-1310571.6,53.22712731657719,48.04198870815201,NaN,NaN,-12.075011331094114,-11.554790377285531
2009-07-16T09:30:00-04:00,26.21001,26.64999,26.10001,26.48,7129801,9722885.1,57.60746051664961,43.87679093895393,NaN,NaN,114.56813108442608,-5.1850416433844035,0.15137418428123744,-0.2150617882282404,-0.36643597250947785,17348045,2490328.4,56.62161435547253,48.962625029484784,NaN,NaN,-7.9381558623512785,-11.038128303723495
2009-07-17T09:30:00-04:00,26.5,26.83,26.3401,26.61,5027855,9404546.6,58.61499009822295,44.792138592191066,NaN,NaN,129.54655988120103,44.44888501440327,0.20841377829251784,-0.10591874964383052,-0.31433252793634836,22375900,9357303.4,61.98889507907278,50.08840066633518,NaN,NaN,-4.256528751397005,-10.069328367676853
2009-07-20T09:30:00-04:00,26.95,27.25,26.73,27.17999,10786938,9304198.6,62.79068375458708,45.86170091501545,NaN,NaN,162.00353719513768,92.1229823560803,0.27248083598851813,0.026268517049299334,-0.2462123189392188,33162838,16887263.6,66.83480540191982,51.16145237788529,NaN,NaN,0.29285143483894827,-8.589016967317454
2009-07-21T09:30:00-04:00,27.75,27.94,26.92171,27.5,17301568,9417885.2,64.93012693570167,47.2266389660566,NaN,NaN,170.04307388568472,130.84227642817586,0.3210198922037228,0.1550625463154347,-0.1659573458882881,50464406,26713886.6,71.87407890678504,52.455024828114986,NaN,NaN,4.780758550706459,-6.679049036171181
2009-07-22T09:30:00-04:00,27.27,27.81,27.17999,27.58,12103164,9353820.95,65.4647198176099,48.588459469466784,NaN,NaN,151.50852620398544,145.533965650087,0.34123325362149665,0.2605842211385827,-0.08064903248291393,62567570,37183751.8,76.04967326195529,53.951208270325075,NaN,NaN,8.59887697412304,-4.496488177557721
2009-07-23T09:30:00-04:00,27.55,28.692,27.53999,28.52,11952895,9369497.35,71.04908512336027,50.74596548109399,NaN,NaN,176.70872978843096,157.96208539088798,0.3967384517674223,0.41527403222636394,0.01853558045894166,74520465,48618235.8,79.60999359347747,55.85154666927664,NaN,NaN,13.988458099359283,-1.8557815665695774
2009-07-24T09:30:00-04:00,28.37,28.75,28.19501,28.75,7983852,9218763.2,72.23222628510462,53.090223062599144,NaN,NaN,167.97632912412283,165.64803923947233,0.4252394267592021,0.5500848639079443,0.12484543714874219,82504317,60643919.2,82.5482778025801,58.15226087229736,NaN,NaN,18.77435102299971,1.0913802319403203
2009-07-27T09:30:00-04:00,28.84,28.99001,28.52,28.81,7229680,9232982.95,72.54741137986679,55.7896194002545,NaN,NaN,150.825020723189,163.4123359450826,0.42350240011232393,0.6542234372891471,0.23072103717682318,89733997,71958151,84.77172642534592,60.975189413915544,NaN,NaN,22.73565233669169,4.183419104047658
2009-07-28T09:30:00-04:00,28.45,28.71001,28.09,28.57001,11127195,9538776.1,69.16565971725599,58.230834148762376,NaN,NaN,113.96046534562636,152.19581423707092,0.38279392904866055,0.7092134484876489,0.32641951943898834,78606802,77586630.2,85.7447310401126,63.9724219062468,NaN,NaN,25.116842648102256,7.173908181769743
2009-07-29T09:30:00-04:00,28.10001,28.17,27.78,27.97,14646164,9879307.95,61.452862154169,59.95742904978777,NaN,NaN,79.64208745981819,137.82252648823746,0.2959448168244286,0.696350540469524,0.40040572364509547,63960638,77865243.8,85.79312139742811,67.05489168444825,NaN,NaN,24.924848221748913,9.709756758909624
2009-07-30T09:30:00-04:00,28.48,29.08501,28.46001,28.82001,11880090,10094869.1,67.0572864674003,62.15680215494876,NaN,NaN,104.8189412841416,123.44456878737958,0.27659078937552517,0.746144210364502,0.4695534209889768,75840728,78129296.4,85.84217295871794,70.23953076776658,NaN,NaN,26.54771137448102,12.115178846848394
2009-07-31T09:30:00-04:00,28.85001,29.39,28.67,29.12,8883203,10090838.25,68.78235530998845,63.8688113512434,NaN,NaN,104.50810478989159,110.75092392053332,0.26482454575605885,0.8005841031840504,0.5357595574279915,84723931,78573219.2,85.9301250337778,73.27561848066041,NaN,NaN,28.4227017790055,14.444824980013696
2009-08-03T09:30:00-04:00,29.63,30.14999,29.49989,30.14999,10059789,10083437.25,73.84632109448259,65.80156616879148,NaN,NaN,127.55898126732288,106.09771602936011,0.30441428985302743,0.9162774197442758,0.6118631298912484,94783720,79583163.8,86.14106273095845,75.9269575217272,NaN,NaN,31.864627978980547,16.933368265580388
2009-08-04T09:30:00-04:00,29.92999,30.27,29.67,30.03999,6669742,9892110.3,72.49382504577139,67.0025009785836,NaN,NaN,119.12025877214516,107.12967471466388,0.3006722919965761,0.9877034948869685,0.6870312028903924,88113978,81484599,86.54990699695519,78.30715607032562,NaN,NaN,34.11876429923297,19.38842484181647
2009-08-05T09:30:00-04:00,30.12,30.38,29.67,30.28,8559719,9675975.35,73.62873007320803,68.14687737548063,NaN,NaN,115.73458165589844,114.34817355387995,0.2916184870096652,1.051554311652474,0.7599358246428087,96673697,88027210.8,87.87532370604843,80.53956388108104,NaN,NaN,36.30697337507057,21.805360346567056
2009-08-06T09:30:00-04:00,30.44,30.60001,29.8,30.03,8518188,9616979.1,70.37169320493601,68.98664188310299,NaN,NaN,108.22498544941844,115.0293823869353,0.24777400867076338,1.069653335481263,0.8218793268104996,88155509,90490167,88.34109749362496,82.42186405354906,NaN,NaN,37.12359550728983,23.99367965524174
2009-08-07T09:30:00-04:00,30.39999,30.53,29.78999,30.21001,20546224,10129164.3,71.3542920102002,69.59832818707535,NaN,NaN,103.7038058724951,114.86852260345601,0.21129931681921332,1.0860034728345163,0.8747041560153029,108701733,95285727.4,89.21022712074667,84.02010846203669,NaN,NaN,38.0833048035734,26.006483247860547
2009-08-10T09:30:00-04:00,29.96001,30.11,29.55,29.81,15310922,10521109.8,66.10766583205518,69.68243810824347,NaN,NaN,81.34016158255191,105.62475866650182,0.14385881272786094,1.054527671925129,0.9106688591972681,93390811,95007145.6,88.79611408419973,85.22882526042346,NaN,NaN,37.347918346587754,27.626688261964436
2009-08-11T09:30:00-04:00,29.57001,29.85001,29.36,29.74001,14740242,10967209.2,65.20425398955075,69.66383340623925,NaN,NaN,66.79775805316207,95.1602585227052,0.08127810217594988,1.0122664869172056,0.9309883847412557,78650569,93114463.8,85.87934186886565,85.93094444663133,NaN,NaN,36.48762419236272,28.892536252021333
2009-08-12T09:30:00-04:00,29.59,30.25999,29.509,30.00999,11806738,11113198.45,67.07347289695252,69.37986110435297,NaN,NaN,77.12374010926642,87.43809021337879,0.046534842253927344,0.9891569375586649,0.9426220953047375,90457307,91871185.8,83.92906502152705,86.23944954863488,NaN,NaN,36.268093375619294,29.946187269678184
2009-08-13T09:30:00-04:00,30.33,30.67999,30.13,30.56,12884145,11400915.65,70.54497251363075,69.25934297781912,NaN,NaN,102.23947883419234,86.24098889033357,0.04882565426164054,1.0036541631317881,0.9548285088701476,103341452,94908374.4,84.83508098260525,86.40279263292238,NaN,NaN,37.08265318709113,30.965682400737176
2009-08-14T09:30:00-04:00,30.61,30.61,29.5,29.78999,14843742,11891710,60.86932297033886,68.42519380570998,NaN,NaN,62.925341856733915,78.08529608718133,-0.010143259200188992,0.9421494348699113,0.9522926940701003,88497710,90867569.8,78.49469383903276,85.95443316247145,NaN,NaN,34.75502946682773,31.50701769589297
2009-08-17T09:30:00-04:00,28.96001,29.13,28.52,28.66,13819281,12043327.15,50.0257873198985,67.0580600630416,NaN,NaN,-33.782827773661076,55.060698215938736,-0.1273672979846434,0.7930835715892961,0.9204508695739395,74678429,87125093.4,73.04926540520542,85.0476141885495,NaN,NaN,28.77842512502341,31.117218757197318
2009-08-18T09:30:00-04:00,28.84,29.17999,28.72,29.09,8498379,11603167.7,53.4259156190477,66.48470673910434,NaN,NaN,-23.980826096482676,36.904981386009794,-0.1751142297005932,0.701558082448198,0.8766723121487912,83176808,88030341.2,73.52765016903044,84.17150910080682,NaN,NaN,25.078435211013627,30.25453539345679
2009-08-19T09:30:00-04:00,28.66,29.64999,28.50999,29.47,12775949,11636806.95,56.25825489061934,65.71334734076285,NaN,NaN,-14.116393154965255,18.656954733163467,-0.1796030460820559,0.6521685045462213,0.8317715506282772,95952757,89129431.2,74.12811187859688,83.33479045222673,NaN,NaN,23.005827071854974,29.21900563322796
2009-08-20T09:30:00-04:00,29.52,29.69,29.36,29.53,9856914,11532007.9,56.70594913245984,64.85074689951081,NaN,NaN,12.12357525113877,0.6337740165527486,-0.17675550339836144,0.6108271713803255,0.7875826747786869,105809671,89623075,74.40887963920918,82.5118443526147,NaN,NaN,21.515351452900983,28.118483607466963
2009-08-21T09:30:00-04:00,29.98,30.32001,29.83,30.31,10784809,11672055.75,62.13202127000865,64.01401119776266,NaN,NaN,74.11912336001916,2.8725303172098022,-0.1231073663794151,0.6336984668044181,0.7568058331838332,116594480,95242429,77.41371881457465,81.88846264430155,NaN,NaN,21.95724187721703,27.23830621743126
2009-08-24T09:30:00-04:00,30.59,30.67,29.9274,30.07001,8380031,11729573.3,59.65468411113118,63.096929702431225,NaN,NaN,75.97153087977611,24.82340204789724,-0.10524351732140658,0.6252514365320749,0.7304949538534815,108214449,101949633,80.37560293147534,81.44744092533873,NaN,NaN,21.537025351509463,26.423837522299575
2009-08-25T09:30:00-04:00,30.21001,30.53999,29.8499,29.92,6733582,11509892.65,58.09540742624718,61.98740665621973,NaN,NaN,58.0040098167256,41.22036923053889,-0.10476283453181856,0.5995414106887083,0.7043042452205268,101480867,105610444.8,81.78000708867702,81.01206116695505,NaN,NaN,20.72659303505276,25.609945452692887
2009-08-26T09:30:00-04:00,29.85001,30.19,29.571,29.81,7998246,11177496.75,56.92049774757713,61.026606980694105,NaN,NaN,18.028406539163623,47.64932916936467,-0.1124106613569209,0.5637909185243757,0.6762015798812966,93482621,105116417.6,80.93820980546909,80.48328347494392,NaN,NaN,19.72353663595786,24.769029907445027
2009-08-27T09:30:00-04:00,29.87,30.17,29.25999,30.02,10624281,11114706.3,58.640196740171085,60.118457318549176,NaN,NaN,4.102325244755085,46.04507916808793,-0.10407450975627841,0.5461084426859486,0.650182952442227,104106902,104775863.8,80.32440898046679,79.84858217920964,NaN,NaN,19.36281595464921,23.996713628474197
2009-08-28T09:30:00-04:00,30.35001,30.38,29.84,30.21001,9034309,11122261.6,60.18876123622865,59.69567841884727,NaN,NaN,62.31668438732292,43.68459137354867,-0.08719541322111979,0.5411886859158273,0.628384099136947,113141211,104085210,79.01568950305001,79.14998042341323,NaN,NaN,19.48761394742294,23.35255653118116
2009-08-31T09:30:00-04:00,29.74001,29.81,29.4799,29.81,7207707,10979657.5,55.47940341239342,59.00104623476461,NaN,NaN,-28.563611407633584,22.77756291606673,-0.10330155645825623,0.4992571535641268,0.602558710022383,105933504,103629021,78.11042165467437,78.59505755097099,NaN,NaN,18.262369856188833,22.625387006182258
2009-09-01T09:30:00-04:00,29.60001,30.11,28.89999,28.92999,13650207,11328680.75,46.80330872061748,57.553177365026386,NaN,NaN,-94.50340550024406,-7.7239201473272034,-0.16963493180130396,0.3905150452707531,0.560149977072057,92283297,101789507,74.40848327139766,77.91501599739033,NaN,NaN,14.397820817111812,21.450020407743622
2009-09-02T09:30:00-04:00,28.92,29.27,28.67,29.2,9122074,11356798.5,49.417112852121505,56.044044532061434,NaN,NaN,-123.81468257913843,-36.092537970987614,-0.19019423595217622,0.32240718213183683,0.512601418084013,101405371,103374057,75.4862326887377,77.24724111925693,NaN,NaN,11.982914853404546,20.097576757123754
2009-09-03T09:30:00-04:00,29.39,29.64999,29.10001,29.62,6893680,11275573.1,53.263874274316635,55.50079819663127,NaN,NaN,-45.79553659693271,-46.07211033932517,-0.17097998384260737,0.29887643828075383,0.4698564221233612,108299051,104212486.8,76.06071723017219,77.07338564719545,NaN,NaN,11.094207588682432,18.811381161632138
2009-09-04T09:30:00-04:00,29.66,30.05,29.33,30.03,5532785,10524901.15,56.72375006437561,55.97922410695107,NaN,NaN,19.631356126171873,-54.609175991555375,-0.12809215872575874,0.30974122371616275,0.4378333824419215,113831836,104350611.8,76.15983870276366,77.2955694541639,NaN,NaN,11.403086194867566,17.7530533092372
2009-09-08T09:30:00-04:00,30.58,30.66,30.28999,30.44,7849387,10151824.4,59.919178513501976,56.443028599412095,NaN,NaN,125.76051416575245,-23.744350876878176,-0.07232249940254742,0.3474302581887372,0.4197527575912846,121681223,107500155.6,78.36008917247311,77.64074366869552,NaN,NaN,12.65637521879571,17.02495643917413
2009-09-09T09:30:00-04:00,30.50999,30.74001,30.27,30.58,9607594,9895192,60.97870072423808,56.78020330181344,NaN,NaN,121.1500260610978,19.386335435390198,-0.028468225283400206,0.3841674759870344,0.4126357012704346,131288817,115301259.6,82.63502969434627,78.24838065553476,NaN,NaN,13.996623825918558,16.592337494423333
2009-09-10T09:30:00-04:00,30.35001,30.82001,29.96001,30.75,9817227,9795716.45,62.28253245333914,57.17853068187624,NaN,NaN,107.26514529972572,65.60230101116302,0.007598217472617019,0.42213347311120586,0.41453525563858884,141106044,123241394.2,85.72589440028395,79.05673885275438,NaN,NaN,15.490848949376954,16.434981987988134
2009-09-11T09:30:00-04:00,30.99001,31.12,30.53999,30.78999,10128801,9657949.25,62.599116370733306,57.21189461764228,NaN,NaN,145.56803210698328,103.87501475194622,0.028578483531832066,0.45025836005337894,0.42167987652154687,151234845,131828553,88.17689683480762,79.82553728277102,NaN,NaN,16.808128053597375,16.488288568789454
2009-09-14T09:30:00-04:00,30.46001,31.21001,30.32001,31.17999,9321539,9381839.1,65.62906686429974,57.63863624286863,NaN,NaN,137.02138696929828,127.3530209205715,0.0612748904582483,0.49827348959435724,0.43699859913610895,160556384,141173462.6,90.1575496803744,80.52424776483522,NaN,NaN,18.8380277448113,16.82396559393543
2009-09-15T09:30:00-04:00,31.24001,32.02,31.14999,31.87,12373707,9309560.4,70.22506599996389,58.505040426705534,NaN,NaN,205.86936193891333,143.3747904752037,0.11860702727347372,0.5852573832279511,0.46665035595447735,172930091,151423236.2,91.78343850071008,81.23877857998046,NaN,NaN,22.119995019331437,17.58054122613486
2009-09-16T09:30:00-04:00,32.31,32.49001,31.94,32.31,8049801,9287131.5,72.72925758437555,59.63423755790542,NaN,NaN,231.27347911457142,165.39948108589843,0.17214953342294492,0.6818372727331585,0.5096877393102136,180979892,161361451.2,92.99221778513586,82.09977914995666,NaN,NaN,25.733486959155798,18.745247759423563
2009-09-17T09:30:00-04:00,32.28999,32.78,31.99001,32.16,11541234,9225395.75,70.55083481732018,60.48499742055893,NaN,NaN,193.56621701526623,182.65969542900652,0.18246520057994853,0.7377692400351492,0.5553040394552007,169438658,167027974,93.57280971190154,83.04609348791628,NaN,NaN,28.05538183326486,20.075266912829463
2009-09-18T09:30:00-04:00,32.23,32.25999,31.78,32.00999,9958563,9230478.2,68.34608020330049,61.06766306106406,NaN,NaN,141.0098468664687,181.74805838090361,0.1647298449036333,0.7612163455847423,0.596486500681109,159480095,168677024,93.7354697148637,84.09750636018869,NaN,NaN,29.35218085461186,21.40054033308409
2009-09-21T09:30:00-04:00,31.59,31.82001,31.22,31.69,10406672,9211571.35,63.76821262382375,61.6597208618805,NaN,NaN,88.97837622024925,172.1394562310938,0.11911918907116825,0.7453854870200693,0.6262662979489011,149073423,166380431.8,90.30764291591481,84.96873645027729,NaN,NaN,29.147857834673413,22.50729997616828
2009-09-22T09:30:00-04:00,32.05,32.25999,31.92,32.03999,6854535,9135296.55,66.41771192678345,63.06074966232093,NaN,NaN,111.79403275221999,153.3243903937551,0.10091288275923294,0.7524074013979423,0.6514945186387093,155927958,162980005.2,85.33187190838902,85.74897849577665,NaN,NaN,29.74146402159359,23.54075198265761
2009-09-23T09:30:00-04:00,32.08,32.19,31.42,31.53,8420590,9219646.95,59.58064319417648,63.78671611532486,NaN,NaN,74.75646187015091,122.020986944871,0.04572558107536007,0.7086514949829095,0.6629259139075494,147507368,156285500.4,76.4063233677893,85.81469925856607,NaN,NaN,28.18704163868545,24.204507647804444
2009-09-24T09:30:00-04:00,31.58,31.64999,30.63,30.84,12743211,9456895.2,51.80977013222138,63.68285153374662,NaN,NaN,21.371631635129344,87.58206986884363,-0.041339718032167516,0.61125126636734,0.6525909843995075,134764157,149350600.2,68.42220197186535,85.26909102582987,NaN,NaN,24.271679759610855,24.21410366377679
2009-09-25T09:30:00-04:00,30.60001,31,30.34,30.53999,10299449,9440653.6,48.82780117171403,63.1188551842708,NaN,NaN,-13.651172080694154,56.64986607941107,-0.1188389492057963,0.5040422978922621,0.6228812470980584,124464708,142347522.8,61.44014402742852,84.21768426330593,NaN,NaN,20.082151564332815,23.62382479242765
2009-09-28T09:30:00-04:00,30.61,31.3,30.55,31.12,6657758,9321826.05,54.30371698176148,62.717750789146486,NaN,NaN,12.21443854817748,41.29707854499671,-0.12984803804774958,0.46057119953837145,0.590419237586121,131122466,138757331.4,58.16334978253207,82.77506002116728,NaN,NaN,18.20529468201049,22.84974906236806
2009-09-29T09:30:00-04:00,31.17999,31.56,31.0401,31.14999,10292547,9476068.05,54.57439257351578,62.26030020695203,NaN,NaN,28.668576199523564,24.671987234457426,-0.13341032068429315,0.42365633673075465,0.5570666574150478,141415013,135854742.4,55.5823584622894,80.84272636173463,NaN,NaN,16.805587262860065,21.98629737672406
2009-09-30T09:30:00-04:00,31.36,31.42,30.62,30.94,10057840,9296449.7,52.24100657880233,61.54304835877083,NaN,NaN,-0.8714707480001774,9.546400710827214,-0.1471292425736822,0.37315510419794506,0.5202843467716273,131357173,132624703.4,52.77577073290246,78.48914609977881,NaN,NaN,14.946282505733318,20.980580966582526
2009-10-01T09:30:00-04:00,30.83,30.92,29.73,29.73,18966256,9788658.8,41.286811699388345,60.02074088224619,NaN,NaN,-96.59865387547951,-14.047656391294558,-0.22997794531436472,0.2328119151286714,0.4627898604430361,112390917,128150055.4,49.07859916959088,75.69641055226332,NaN,NaN,9.371325012613438,19.32211583030123
2009-10-02T09:30:00-04:00,29.28,29.98,29.17,29.61,11905352,10039242.4,40.38245002349861,58.21741110790325,NaN,NaN,-154.63692751071918,-42.24480747729956,-0.28172736970919154,0.11063064830654668,0.3923580180157382,100485565,123354226.8,45.40706237264583,72.49994717313986,NaN,NaN,4.699395416950535,17.23315577125113
2009-10-05T09:30:00-04:00,29.82001,30.3174,29.64,30.11,9971055,10261155.9,45.71778627901917,56.46689112783577,NaN,NaN,-111.6702460579691,-67.02174439852888,-0.27106251336122134,0.05352987631421158,0.3245923896754329,110456620,119221057.6,42.45904420976818,68.9767761523583,NaN,NaN,2.458212364445497,15.122449570278897
2009-10-06T09:30:00-04:00,30.61,31.00999,30.32001,30.74001,12052328,10471302.95,51.595827088675705,54.95736037814293,NaN,NaN,-42.584434180135815,-81.27234647446076,-0.2129219236306274,0.05843998513714865,0.27136190876777605,122508948,115439844.6,39.9064460998544,65.18493531769533,NaN,NaN,2.490976775246049,13.317953456702776
2009-10-07T09:30:00-04:00,30.69,30.9901,30.52991,30.75,6155680,10298707.25,51.68516961611008,53.60981286377078,NaN,NaN,-37.16560574693666,-88.53117347424805,-0.16715522554664494,0.062417876834469865,0.2295731023811148,128664628,114901335.6,39.54184692016243,61.32558083257112,NaN,NaN,2.5443508225554674,11.778867366110303
2009-10-08T09:30:00-04:00,31.34,31.60001,31.06,31.47,7527543,10184223.05,57.73944679271074,52.85219619158579,NaN,NaN,26.38477912575239,-63.93448687400168,-0.08585124890586068,0.12225904124878895,0.20811029015464963,136192171,119661586.4,44.37944214182538,57.80015029163982,NaN,NaN,4.573080794815082,10.7494692844967
2009-10-09T09:30:00-04:00,31.5,31.62,31.21001,31.5,6688133,10012189.65,57.9757422290708,52.43844830624629,NaN,NaN,30.37002161809693,-26.933097048238448,-0.030373799013139163,0.17014304138822567,0.20051684040136483,142880304,128140534.2,51.78050538350094,55.04821189646741,NaN,NaN,6.245323960266567,10.106019952463823
2009-10-12T09:30:00-04:00,31.62,31.98,31.46001,31.58,7109758,9901600.6,58.63987575843515,51.882888579935695,NaN,NaN,51.06260756495779,5.613473676346925,0.009267975884169777,0.21210181025657704,0.20283383437240726,149990062,136047222.6,57.464430784086794,53.05768038758868,NaN,NaN,7.799297939206264,9.776488236284171
2009-10-13T09:30:00-04:00,31.56,31.8367,31.25,31.75,9286203,9747225.4,60.08349121132493,51.9188062954463,NaN,NaN,44.933498264305705,23.117060165235227,0.042628635289146954,0.25611962848384096,0.213490993194694,159276265,143400686,61.955961022471676,52.02551164863742,NaN,NaN,9.51499069719442,9.739131444985636
2009-10-14T09:30:00-04:00,32.16,32.46941,32.03,32.42999,10159336,9852702.15,65.30060050118962,52.8824370360869,NaN,NaN,121.2153924844136,54.79325981150528,0.10275280338473661,0.34193199742561475,0.23917919404087815,169435601,151554880.6,66.21611667658956,51.86793412754629,NaN,NaN,12.689152762068346,10.160563061711738
2009-10-15T09:30:00-04:00,32.28,32.605,32.13,32.49001,7482305,9649755.7,65.72640979204007,54.08948050896733,NaN,NaN,130.5734184775498,75.63098768186477,0.13670078052952123,0.41005516970277966,0.27335438917325844,176917906,159700027.6,69.84819125465361,52.468508929490945,NaN,NaN,15.39054728901183,10.90770366561175
2009-10-16T09:30:00-04:00,32.3,32.39,32,32.03999,8991828,9601418.95,59.80095360601674,54.4821402678427,NaN,NaN,99.96617275934085,89.55021791011356,0.11960128926101699,0.42285600074952967,0.3032547114885127,167926078,164709182.4,71.85237336108852,53.44629632795926,NaN,NaN,16.025737714076527,11.638851386821004
2009-10-19T09:30:00-04:00,32.16,32.64,32.09,32.53,7290727,9445621.7,63.64432140754096,55.129992327415934,NaN,NaN,117.85926532873937,102.90954946286988,0.13112054032017167,0.46715538688872726,0.3360348465685556,175216805,169754531,73.74533454318595,54.743651762309014,NaN,NaN,17.756381555166246,12.512784268013181
2009-10-20T09:30:00-04:00,32.67,32.67,31.86,32.19,8190320,9512410.95,59.40061075996014,55.64139262607006,NaN,NaN,97.43702948318055,113.41025570664483,0.1067054570783027,0.469416667916434,0.3627112108381313,167026485,171304575,74.31679563327833,56.28229639805014,NaN,NaN,17.93798054740468,13.287812307926252
2009-10-21T09:30:00-04:00,32.05,32.49001,31.71001,31.81,9583504,9570556.65,54.98755065863084,56.62001683744452,NaN,NaN,70.63300893669691,103.2937789971015,0.05825139839415999,0.43552545883083127,0.3772740604366713,157442981,168906051,71.7155680838814,57.89922274907089,NaN,NaN,16.744262297003615,13.781590877794446
2009-10-22T09:30:00-04:00,31.71001,32.32001,31.33051,32.19,7977961,9332294.15,58.32211631796877,57.90142157276381,NaN,NaN,59.190743382077606,89.01724397800706,0.045638875219340014,0.4343226544608463,0.38868377924150627,165420942,166606658.2,69.21440705002462,59.599747368883655,NaN,NaN,16.74284488180534,14.204627164081717
2009-10-23T09:30:00-04:00,32.36,32.36,31.41,31.55,9051629,9269903.15,51.41386762547809,58.30828452608231,NaN,NaN,38.2962690827816,76.68326324269522,-0.009045735880572836,0.3773766093907902,0.38642234527136304,156369313,164295305.2,66.69633599097142,61.33098249611246,NaN,NaN,14.525802808087812,14.25050939893973
2009-10-26T09:30:00-04:00,31.60001,32.02,30.71001,30.74001,11912230,9532626.75,44.267235087530786,57.78481366885767,NaN,NaN,-24.20116881217667,48.27117641451201,-0.09806140655477968,0.2638455870778884,0.3619069936326681,144457083,158143360.8,60.398012882595886,62.794665837736844,NaN,NaN,10.116716799426015,13.6599675990092
2009-10-27T09:30:00-04:00,30.7,30.98,30.44,30.49001,14539641,9744981.45,42.31229783191808,57.11532282712967,NaN,NaN,-69.87051313973156,14.809667889929594,-0.1679680163762634,0.15194697316233885,0.31991498953860226,129917442,150721552.2,53.79764345103997,63.81293701851382,NaN,NaN,5.937376507285801,12.55674030019157
2009-10-28T09:30:00-04:00,30.42,30.53,29.48,29.55,14243336,9954256.25,35.89362931203,55.55490729279533,NaN,NaN,-126.97482811339836,-24.711899520089457,-0.2658848101823248,-0.012441023189303735,0.25344378699302106,115674106,142367777.2,47.50487846980866,64.03618247051263,NaN,NaN,-0.053059097438926985,10.755340386244356
2009-10-29T09:30:00-04:00,30.06,30.56,29.86,30.42999,10953727,9553629.8,44.39726146648964,54.58501580975382,NaN,NaN,-91.27255940995529,-54.80456007849604,-0.2594707311178128,-0.07089462690424497,0.18857610421356785,126627833,134609155.4,42.52920351790479,63.375375194398615,NaN,NaN,-2.1363446180902215,8.913671099910845
2009-10-30T09:30:00-04:00,30.34,30.41,29.07001,29.34,18591456,9887935,37.72253327220339,53.09091991788012,NaN,NaN,-151.3607856655355,-92.73597102815945,-0.3131284538720088,-0.20283446312644315,0.11029399074556565,108036377,124942568.2,37.28879215217859,61.93425814926231,NaN,NaN,-6.445990722605225,6.719433696694264
2009-11-02T09:30:00-05:00,29.45,30.13,28.95,29.60001,16294172,10204090.85,40.03834492842156,51.659123754815596,NaN,NaN,-147.99465918900685,-117.49466910352548,-0.3147576624904229,-0.28315308736746303,0.0316045751229599,124330549,120917261.4,35.3362130683536,60.03284758111103,NaN,NaN,-8.91968139462914,4.485274397933777
2009-11-03T09:30:00-05:00,29.3,30.015,29.12,29.89999,12381207,10220534.8,42.68634116901026,50.043819516802785,NaN,NaN,-123.95534336482247,-128.31163514854367,-0.28042281219589804,-0.3189239401219126,-0.038501127926014594,136711756,122276124.2,36.54420193949392,57.91342509988991,NaN,NaN,-9.97413569514823,2.4196443846363476
2009-11-04T09:30:00-05:00,30.28999,30.52,29.8,29.89999,12757391,10550620.35,42.68634116901027,48.398100329443515,NaN,NaN,-85.80279243705193,-120.07722801327438,-0.24385115858175666,-0.34331507615321044,-0.09946391757145377,136711756,126483654.2,40.26524890738456,55.80035778937069,NaN,NaN,-10.789961671912387,0.5325578051293856
2009-11-05T09:30:00-05:00,30.10001,30.63,30.03,30.42999,10062148,10677350.6,47.442249316674584,47.51533573734765,NaN,NaN,-57.540841689606374,-113.3308844692046,-0.17341551855541992,-0.31623331576572866,-0.14281779721030874,146773904,130512868.4,43.67167149226198,53.78745051302593,NaN,NaN,-9.982557380617342,-0.9696015071201469
2009-11-06T09:30:00-05:00,30.25999,31,30.23,30.69,9714711,10828679.5,49.64962813919183,46.515714789608424,NaN,NaN,-34.062840338420315,-89.87129540378157,-0.10228182254890655,-0.27067007539644194,-0.1683882528475354,156488615,140203316,50.920673565819165,52.15711758607116,NaN,NaN,-8.64126425902812,-2.0655533288212857
2009-11-09T09:30:00-05:00,31.07001,31.7,31.07001,31.69,9994223,10972902.75,57.110443448284535,46.35213141020302,NaN,NaN,27.03771575030232,-54.86482041591974,0.013018009546380188,-0.15211574091456015,-0.16513375046094034,166482838,148633773.8,56.20150768250953,50.863168446730526,NaN,NaN,-4.9486363764762755,-2.477422335629141
2009-11-10T09:30:00-05:00,31.62,31.92,31.23,31.73,9860410,11001613.1,57.38247327430427,46.523197311322555,NaN,NaN,37.00324256474858,-22.673103230005523,0.08866148443750449,-0.05430689491405971,-0.1429683793515642,176343248,156560072.2,60.50436526716228,50.0623682455363,NaN,NaN,-1.9636914568917991,-2.4040322100952354
2009-11-11T09:30:00-05:00,32.10001,32.35001,31.92999,32.03999,12410906,11114191.6,59.524990411010286,46.60911688939695,NaN,NaN,72.85776519664623,9.059008296734085,0.1525118205523818,0.04767139633891304,-0.10484042421346876,188754154,166968551.8,65.32219036737015,49.7843527682039,NaN,NaN,1.1766452285171174,-1.8925068617220422
2009-11-12T09:30:00-05:00,31.98,32.38,31.74001,31.89,17706992,11625425.95,58.00547757438978,47.07994617146206,NaN,NaN,68.19269954346274,34.205716543347904,0.17592085133469598,0.11506063995490123,-0.060860211379794756,171047162,171823203.4,67.32427581705062,49.82920561292384,NaN,NaN,3.3200272542111686,-1.1478591308744406
2009-11-13T09:30:00-05:00,32.00999,32.3,31.8,32.00999,12776195,11814644.3,58.90916336711936,48.12579819143268,NaN,NaN,71.42806533212747,55.30389767745746,0.18958344900981197,0.1761190998824702,-0.013464349127341763,183823357,177290151.8,69.46242078895375,50.476663320520835,NaN,NaN,5.351214321062633,-0.2194200663120015
2009-11-16T09:30:00-05:00,32.25,32.92,32.25,32.67,11921395,12046177.7,63.5548953876852,49.643126588273184,NaN,NaN,112.44237462289135,72.38482945197526,0.23045167107235517,0.2746002397131022,0.04414856864074703,195744752,183142534.6,71.60449245297005,51.74858110637298,NaN,NaN,8.572969495881704,1.0366355854299565
2009-11-17T09:30:00-05:00,32.57001,33.10001,32.44,33.05,8493477,12061335.55,65.94238333707435,51.789466161490644,NaN,NaN,124.67850277707177,89.9198814944399,0.2678346416888159,0.3789418707517669,0.11110722906295101,204238229,188721530.8,73.51196032491114,53.606229810308875,NaN,NaN,12.042495194461186,2.6089012438629893
2009-11-18T09:30:00-05:00,33.10001,33.28,32.81,33.05,9099672,12037143.95,65.94238333707435,53.32840343796098,NaN,NaN,127.47967733414512,100.84426392193969,0.27621228555076793,0.45637258600141095,0.18016030045064302,204238229,191818345.8,74.53455323083145,55.89232621837506,NaN,NaN,14.854470051607018,4.358268216397851
2009-11-19T09:30:00-05:00,32.74001,32.77,32.03,32.55,9600434,12118267.6,59.9494058691773,54.916037194887686,NaN,NaN,83.16103530968432,103.837931075184,0.23343240701530724,0.47195080921977706,0.23851840220446982,194637795,196536472.4,76.05149981690619,58.66109105156989,NaN,NaN,15.641449842403235,5.970151305827191
2009-11-20T09:30:00-05:00,32.2,32.57001,32.11,32.44,8768648,12104118.55,58.685780733945755,56.24799689528228,NaN,NaN,73.90471791460506,104.3332615916795,0.1851874256650603,0.47000268428579517,0.28481525862073487,185869147,196945630.4,76.18399316528094,61.57878962992184,NaN,NaN,15.943891733156065,7.394971366874173
2009-11-23T09:30:00-05:00,32.95,33.239,32.64999,32.77,10630477,12040030.9,61.31985152903793,57.578961920998545,NaN,NaN,94.79930301083905,100.80464726926905,0.16370379786768635,0.4894450059553428,0.32574120808765644,196499624,197096604.8,76.23623614415547,64.4139349302548,NaN,NaN,16.94183412241771,8.758808903380393
2009-11-24T09:30:00-05:00,32.82001,32.82001,32.41,32.73,7025258,11664311.75,60.81372369166745,58.873774958331204,NaN,NaN,73.83905216674583,90.63675714720387,0.13613422561108435,0.4959089901015119,0.35977476449042756,189474366,194143832.2,72.86944763126309,66.7428062676747,NaN,NaN,17.633673210279575,10.026646661508847
2009-11-25T09:30:00-05:00,32.8,33.25999,32.73,33.25999,7817926,11343041.25,64.94259428809491,60.12379959914694,NaN,NaN,92.60343031514765,83.66150774340437,0.14226049656816186,0.5376003852006299,0.39533988863246805,197292292,192754644.8,71.27465208943687,68.71444773890148,NaN,NaN,19.42922869660031,11.369872666521912
2009-11-27T09:30:00-05:00,32.13,32.7095,31.96001,32.35001,7449684,11167839.1,54.353197359206334,60.45976882914797,NaN,NaN,42.80484193938615,75.59026906934474,0.0769657581923176,0.49154708637286504,0.41458132818054744,189842608,191795607.4,70.13349764671695,70.08679231610846,NaN,NaN,17.821147719158077,12.291483388327078
2009-11-30T09:30:00-05:00,32.44,32.7,32.16,32.5,9186738,10697603.2,55.63722806580498,60.35453915897086,NaN,NaN,45.67260267574661,69.94384602157305,0.0377979614868979,0.46182878003916983,0.4240308185522719,199029346,194427647.2,71.48294392688436,71.17832347642094,NaN,NaN,16.893345312523326,12.948892234640828
2009-12-01T09:30:00-05:00,33.03,33.31,32.94,33.13,11356125,10450700.85,60.64482968385562,60.587564616795966,NaN,NaN,93.08805091806558,69.60159560301835,0.047606233891687166,0.4835386109168809,0.4359323770251937,210385471,197204816.6,72.87554540517993,72.06197920056506,NaN,NaN,17.62811274034094,13.617352306883701
2009-12-02T09:30:00-05:00,33.14999,33.60001,33.12,33.45,9158676,10289574.3,62.93351762854871,60.83103084662014,NaN,NaN,113.3827930218213,77.51034377403344,0.06770561172349598,0.5205643916795637,0.4528587799560677,219544147,203218772.8,75.64877340846324,72.79959227492886,NaN,NaN,18.94731867236325,14.378776073380779
2009-12-03T09:30:00-05:00,33.46001,33.61,32.88,32.91,14467652,10375087.35,56.91812679748033,60.753362933983745,NaN,NaN,87.76344870696634,76.5423474523972,0.038164106798785014,0.500563913454549,0.46239980665576397,205076495,204775613.4,76.32362510194612,73.44240293813569,NaN,NaN,18.19125935494915,14.92341654217626
2009-12-04T09:30:00-05:00,33.41,33.55,32.09,32.55,23463184,11045139.15,53.26301225833301,60.35006642621329,NaN,NaN,37.00254703561798,75.38188847164356,-0.009542531462844284,0.4504716423272086,0.4600141737900529,181613311,203129754,73.98915229973105,73.7657409031912,NaN,NaN,16.41141420546917,15.135987636932391
2009-12-07T09:30:00-05:00,32.42999,32.92999,32.39999,32.59,9843648,11051586,53.61940502537107,59.64038854319085,NaN,NaN,14.310043503989524,69.10937663729213,-0.04058504768726379,0.40928286418097315,0.44986791186823694,191456959,201615276.6,71.81252158365572,73.7806001268116,NaN,NaN,15.08966100485468,15.129369546635575
2009-12-08T09:30:00-05:00,32.35001,32.42999,31.989,32.07001,10568762,11080312.95,48.44740662921706,58.39074734977248,NaN,NaN,-75.78299262715205,35.33516792824861,-0.09520026708869817,0.3308675780073642,0.4260678450960624,180888197,195715821.8,63.92369616660126,73.09572411550376,NaN,NaN,12.3473567370311,14.731939145263507
2009-12-09T09:30:00-05:00,32.10001,32.49001,31.83,32.47,9048496,11039717.25,52.261928318439836,57.41357199129858,NaN,NaN,-70.01427951806731,-1.3442465797291163,-0.10279942508923778,0.2975685637345151,0.4003679888237529,189936693,189794331,57.1387449481297,71.85316638102506,NaN,NaN,11.157196539112842,14.221261630099127
2009-12-10T09:30:00-05:00,32.67,32.81,32.24001,32.35001,7830098,10810676.85,51.041825658902255,56.77731626199323,NaN,NaN,-35.287489788955114,-25.954434278913403,-0.11348107438472549,0.25851664584284606,0.37199772022757155,182106595,185200351,52.484407429545115,70.1698026390707,NaN,NaN,9.825467963276521,13.593291106267326
2009-12-11T09:30:00-05:00,32.57001,32.66,32.14,32.44,7931906,10321922.55,51.94788641566793,56.29603809640196,NaN,NaN,-53.8235324307022,-44.119650172177444,-0.11187574042761761,0.23215304469304954,0.34402878512066715,190038501,186885389,53.96561130552374,68.58277536337376,NaN,NaN,8.980008781538945,12.934250774163273
2009-12-14T09:30:00-05:00,32.67999,32.94,32.47,32.91,7573293,10061777.45,56.47819036291147,55.950205155964355,NaN,NaN,19.13214592583676,-43.155229687807996,-0.07814697979501106,0.2463450603769033,0.32449204017191435,197611794,188116356,55.06755681251041,67.07072683968482,NaN,NaN,9.543444131978172,12.449849825279687
2009-12-15T09:30:00-05:00,32.82001,33.13,32.44,32.59,12594770,10095446.2,52.826424956841116,55.379683817762476,NaN,NaN,5.187340010258407,-26.961163160325906,-0.07628983666437772,0.22912974434144218,0.3054195810058199,185017024,188942121.4,55.831369082283054,65.85372122904339,NaN,NaN,8.964029039056454,11.951875427247796
2009-12-16T09:30:00-05:00,32.75999,33.13,32.7,32.92,7612242,10051384.45,55.98690227786486,54.739991531317465,NaN,NaN,51.40981278754927,-2.6763446992025877,-0.052851198988751846,0.23935558226988007,0.2922067812586319,192629266,189480636,56.35245804170606,64.78785022563405,NaN,NaN,9.391171370932822,11.586060562059942
2009-12-17T09:30:00-05:00,32.61,32.67,32.11,32.19,6899801,9941390.9,48.28099616132131,54.30626287432568,NaN,NaN,-82.07129014738139,-12.033104770887842,-0.0846406558263515,0.18640596147569255,0.27104661730204405,185729465,190205210,57.08606961410411,63.855891080447414,NaN,NaN,7.36260231948768,10.982709384549619
2009-12-18T09:30:00-05:00,32.12,32.25,31.67,31.99001,9708332,9946785.8,46.396928024640204,53.64624144281391,NaN,NaN,-148.93213854193598,-31.054825993134603,-0.11536264332615626,0.1268433131443487,0.24220595647050497,176021133,187401736.4,53.3498050000807,62.56066687139001,NaN,NaN,5.121608452396218,10.145409251384848
2009-12-21T09:30:00-05:00,32.2,32.58,32.16,32.46001,5099434,9763325.1,51.21507743814447,52.972687710977404,NaN,NaN,-54.02074865499387,-45.685404909300715,-0.10078493299413807,0.11622479022783239,0.21700972322197046,181120567,184103491,49.26460201412606,60.87417091488616,NaN,NaN,4.670598892663317,9.3632934858532
2009-12-22T09:30:00-05:00,32.52,32.67,32.37,32.64999,4723797,9467991.1,53.052046973934665,52.26686837850497,NaN,NaN,-14.413589560305793,-49.60559082341356,-0.07621895029948303,0.12173603534761668,0.1979549856470997,185844364,184268959,49.47363489014783,59.00451816357791,NaN,NaN,4.852644003732389,8.71891498840737
2009-12-23T09:30:00-05:00,32.75999,33.16,32.61,33.14999,5254625,9379459.45,57.5793584128976,52.31409920817763,NaN,NaN,71.98060104675706,-45.491433171572,-0.02672183085713195,0.16455269707568476,0.1912745279328167,191098989,183962903.6,49.070919310752195,57.057896321349766,NaN,NaN,6.41515790017291,8.389806832945304
2009-12-24T09:30:00-05:00,33.3,33.49001,33.2,33.41,2721486,9124637.45,59.7528766324799,52.77766094918811,NaN,NaN,146.92567260405448,0.30795937871517937,0.020552224629201116,0.21696480871931811,0.196412584090117,193820475,185581105.6,51.326878212468216,55.43916245797386,NaN,NaN,8.38180611688985,8.388663873508811
2009-12-28T09:30:00-05:00,33.53,33.64999,33.28999,33.44,4014001,8952853.3,60.00748965064547,53.23395270813628,NaN,NaN,143.77723731153154,58.84983454940868,0.04922917905862095,0.2579490579133932,0.20871987885477222,197834476,189943774.2,56.87333230756212,54.37207750968146,NaN,NaN,10.04510591465212,8.625298450814999
2009-12-29T09:30:00-05:00,33.44,33.72,33.36,33.49001,3717523,8679392.55,60.45658669543042,54.09175128429438,NaN,NaN,133.92090821771004,96.43816592394947,0.06591132568955813,0.2911090359667199,0.22519771027716176,201551999,194030060.6,61.3194423667193,54.18605938111846,NaN,NaN,11.542837243018775,9.04208970684411
2009-12-30T09:30:00-05:00,33.25999,33.53999,33.179,33.45,2974152,8260293.9,59.87726490283025,54.63570389746513,NaN,NaN,103.82652319585218,120.08618847518105,0.06830576213751224,0.3105799129490521,0.24227415081153983,198577847,196576757.2,63.82268920940204,54.663483971209345,NaN,NaN,12.641466644168483,9.556286412176163
2009-12-31T09:30:00-05:00,33.53,33.62,32.99001,32.99001,2582295,7931474.85,53.52671470746914,54.813195972362756,NaN,NaN,75.31268136752587,120.75260453933481,0.034661593227604814,0.28560114234604583,0.250939549118441,195995552,197556069.8,64.76694587401917,55.54080814581464,NaN,NaN,11.879481482677843,9.888171422247831
2010-01-04T09:30:00-05:00,33.58,34.02,33.45,34.02,7567496,7586467.05,62.9916634245143,55.60203718728037,NaN,NaN,161.83598889389893,123.7346677973037,0.07520084954456452,0.34494061104914664,0.2697397615045821,203563048,199504584.4,66.6330557816722,56.44562560839666,NaN,NaN,14.170958039017933,10.499998081786417
2010-01-05T09:30:00-05:00,34.08,34.17999,33.81,34.13,8839152,6855265.45,63.83870213815433,56.12778802836914,NaN,NaN,160.14310009819033,127.00784035463546,0.10122869433458231,0.39627562942281,0.2950469350882277,212402200,202418129.2,69.25522639835832,57.45903057881437,NaN,NaN,16.272120298777242,11.324586969927964
2010-01-06T09:30:00-05:00,34.14,34.83,34.08,34.71001,8091941,6767680.1,67.99790060386061,57.2114648602991,NaN,NaN,186.2009695941246,137.46385262991836,0.146560864379497,0.478248015562599,0.331687151183102,220494141,206206557.6,72.30310498444472,58.63558314325449,NaN,NaN,19.466660494588968,12.487740330593821
2010-01-07T09:30:00-05:00,34.53999,34.58,34.16,34.44,5757207,6527102.35,64.29072620560855,57.80459514085222,NaN,NaN,144.97841917320378,145.69423182538873,0.147035891791218,0.5154820159221245,0.3684461241309065,214736934,209438375,74.61503823687785,59.94005315719534,NaN,NaN,20.948104371460268,13.696363765003314
2010-01-08T09:30:00-05:00,34.36,34.92,34.28,34.92,4642352,6306795.15,67.66560601346433,59.18921013029101,NaN,NaN,155.52689908485368,161.73707536885428,0.16689919100603456,0.5770701128884497,0.4101709218824151,219379286,214115121.8,77.53711408275825,61.40084204781348,NaN,NaN,23.30254741400567,15.068675714860793
2010-01-11T09:30:00-05:00,35.36,35.38,34.575,34.73,9108816,6370731.05,65.04507816547309,60.52122085463621,NaN,NaN,151.183084628928,159.60649451586005,0.1547351846320308,0.6035899026724536,0.4488547180404228,210270470,215456606.2,78.30843019891091,63.183600990587074,NaN,NaN,24.416190674971514,16.40403499487661
2010-01-12T09:30:00-05:00,34.23,34.41,33.73,34.07001,13162148,6632243.15,56.81420060029002,60.9211582233609,NaN,NaN,65.0956977735272,140.59701405092744,0.09278840429801655,0.5648402234129435,0.47205181911492694,197108322,212397830.6,72.21915074841206,64.82321161446464,NaN,NaN,22.731567637257818,17.307968229502496
2010-01-13T09:30:00-05:00,34.16,34.5,33.75,34.47,11943090,6850733,60.1088185660412,61.42521333708278,NaN,NaN,73.2395640885869,118.00473294981991,0.07032006203666341,0.5599518966607562,0.48963183462409277,209051412,210109284.8,67.96106652458583,66.14374244549592,NaN,NaN,22.377417698878975,18.03217529655628
2010-01-14T09:30:00-05:00,34.45,34.52,34,34.05,9615492,6701769.1,55.3351725862587,61.26491434946572,NaN,NaN,61.35385087902769,101.27981929098468,0.021283747763816696,0.5162365193288636,0.4949527715650469,199435920,207049082,62.64236861097213,67.11313168122591,NaN,NaN,20.530840821978007,18.389127514473667
2010-01-15T09:30:00-05:00,34.00999,34.14,33.63,33.8,7605246,6701419.3,52.65462253147447,60.7578961993939,NaN,NaN,25.5149761297511,75.27743469996416,-0.031033799153244168,0.4561605226234917,0.4871943217767359,191830674,201539359.6,54.38917879677986,67.33186743724818,NaN,NaN,18.170966877198644,18.357961709148665
2010-01-19T09:30:00-05:00,33.85001,34.35001,33.7,34.34,6801641,6696511.3,57.449383326761804,60.5751743191165,NaN,NaN,46.624481303552315,54.36571403488905,-0.03217870014190277,0.44697094659935743,0.4791496467412602,198632315,199211728.6,51.313410332088715,66.93473015328578,NaN,NaN,17.661130853704385,18.258414444085197
2010-01-20T09:30:00-05:00,33.89999,34,33.42,33.73,11503746,6786282,51.14796282425551,59.91027261403258,NaN,NaN,-7.139956201767591,39.9185832398301,-0.07450653206345598,0.38601648166194025,0.4605230137253962,187128569,197215778,48.76667048927763,66.03810359061137,NaN,NaN,15.1293318164715,17.811402640140383
2010-01-21T09:30:00-05:00,33.77,33.77,32.25999,32.27,19816352,7522127.9,39.874526148692425,58.481505560165594,NaN,NaN,-132.20131200043735,-1.1695919779747697,-0.19450333114236007,0.21739384979744614,0.4118971809398062,167312217,188867939,39.85690564775112,64.32626190763631,NaN,NaN,8.439365778612078,16.472540231350624
2010-01-22T09:30:00-05:00,32.17999,32.57001,31.55,31.63,20047728,8288324.45,36.11661247202488,57.23792682906243,NaN,NaN,-222.28604611714212,-57.897571377208735,-0.30411730687839283,0.03175054734181515,0.335867854220208,147264489,178433652.8,31.98961037321132,61.98502365757861,NaN,NaN,1.6591554466186733,14.356342404960346
2010-01-25T09:30:00-05:00,31.9601,32.24001,31.795,31.91,10305086,8540847.5,38.83263745226915,55.5122821167592,NaN,NaN,-189.56462654546837,-100.91349191225262,-0.34207198878400236,-0.09172213175979493,0.2503498570242074,157569575,171581433,28.070992903159137,59.230590594827675,NaN,NaN,-2.6254078523527533,11.930378082487046
2010-01-26T09:30:00-05:00,31.56,31.99001,31.36,31.46001,16784400,9243993.2,36.17107447258122,53.5360229977897,NaN,NaN,-188.56768986207277,-147.95192614537763,-0.37892897159906297,-0.22331135747462127,0.1556176141244417,140785175,160012005,22.95753716115486,55.92361279217029,NaN,NaN,-6.998932886637513,9.226190801183538
2010-01-27T09:30:00-05:00,31.31,31.53999,30.64999,31.19,19709200,10028753.15,34.63701571184873,51.153102648360274,NaN,NaN,-185.3782007447154,-183.5995750539672,-0.4008162750380594,-0.34540272967313257,0.05541354536492685,121075975,146801486.2,18.756146921803122,52.09883007341017,NaN,NaN,-10.988295055568377,6.338407107361837
2010-01-28T09:30:00-05:00,31.39,31.48,30.48,30.63,16372922,10661523.1,31.639868235807384,48.820898507660196,NaN,NaN,-164.80416090636442,-190.12014483515262,-0.42976644780457507,-0.481794514390792,-0.05202806658621692,104703053,134279653.4,15.80383108721442,47.89802956271992,NaN,NaN,-15.32972390459251,3.2429598199397875
2010-01-29T09:30:00-05:00,30.87,31.315,30.12,30.14,16120613,11318846.15,29.254512030985595,46.07724893748314,NaN,NaN,-152.11388792104023,-176.08571319593221,-0.4561791132061561,-0.6222519580939121,-0.16607284488775595,88582440,122543243.6,13.63715058923988,43.33374645604004,NaN,NaN,-19.720211344935926,-0.03749320361388575
2010-02-01T09:30:00-05:00,30.46001,31.34,30.46001,31.34,17280624,12053762.6,40.98803664183496,44.35888882865184,NaN,NaN,-105.24635073668858,-159.22205803417629,-0.37072514625946695,-0.6294792777120897,-0.2587541314526227,105863064,112201941.4,12.067271429984785,38.60223511540246,NaN,NaN,-19.546296306402592,-2.824465075440844
2010-02-02T09:30:00-05:00,31.48,31.60001,31.02,31.44,16039664,12477371,41.85351585085396,43.29026848940641,NaN,NaN,-79.45977416794877,-137.40047489535146,-0.2889894521281491,-0.6199909466128091,-0.33100149448466,121902728,108425452,11.54461100683453,34.2683394195755,NaN,NaN,-19.126126146681486,-5.1532737999037925
2010-02-03T09:30:00-05:00,31.32001,31.62,30.98,31.08,18106752,12940751,39.60177497690644,41.82547966161108,NaN,NaN,-76.75476848855648,-115.67578844411969,-0.24256647944895066,-0.6342095937958483,-0.39164311434689764,103795976,104969452.2,11.071996971748604,30.204834451515694,NaN,NaN,-19.496928017061695,-7.202367259497779
2010-02-04T09:30:00-05:00,30.66,30.75,29.89999,29.92,22808944,13676601.15,33.371558631081015,40.256650093384096,NaN,NaN,-112.13095611059859,-105.14114748496652,-0.27121167837432325,-0.7306577123148017,-0.45944603394047845,80987032,100226248,10.440280399708513,26.47611386499687,NaN,NaN,-21.963424611180272,-9.311089738309564
2010-02-05T09:30:00-05:00,30.00999,30.49001,29.48,30.48,32251632,15001322.4,38.40911203030354,39.239113629014746,NaN,NaN,-103.14545296566118,-95.34746049389071,-0.23502199624578723,-0.7532235292477125,-0.5182015330019253,113238664,105157492.8,15.817846614369145,23.72101870911039,NaN,NaN,-22.26856408728438,-11.162157502448823
2010-02-08T09:30:00-05:00,30.53999,30.72,29.96001,29.99001,20472288,15792819.2,35.85470535811449,37.696636631254215,NaN,NaN,-92.73199253496591,-92.84458885354618,-0.22656443583323338,-0.801407077793467,-0.5748426419602336,92766376,102538155.2,15.292587480823343,21.148102791162867,NaN,NaN,-23.360516565936987,-12.904780225804274
2010-02-09T09:30:00-05:00,30.45,31.03999,30.25101,30.72,28743968,16774576.8,42.039203911292596,37.04601099461401,NaN,NaN,-67.67321884658526,-90.48727778927349,-0.15755953166125003,-0.7717920565367962,-0.6142325248755461,121510344,102459678.4,15.276220195444509,18.75592777017479,NaN,NaN,-22.200818658536058,-14.232785716194527
2010-02-10T09:30:00-05:00,30.75999,30.82001,30.13,30.50999,21552528,17194095.8,40.81987981320587,37.113536256364974,NaN,NaN,-71.93970544142513,-89.52426517984722,-0.11385157046465288,-0.7565469879563622,-0.6426954174917093,99957816,101692046.4,15.105910622343544,16.987999554074246,NaN,NaN,-21.665314931189126,-15.294575604050898
2010-02-11T09:30:00-05:00,30.49001,31.07001,30.34,31.03,19472064,17570544.5,45.06845121683553,37.75295330956573,NaN,NaN,-49.91630730139992,-77.0813354180075,-0.041442824892649166,-0.6944989486075208,-0.6530561237148717,119429880,109380616,24.218906635861416,16.43294928712069,NaN,NaN,-19.864675153923024,-15.947446968318344
2010-02-12T09:30:00-05:00,30.48,31.14,30.34,30.97,19623200,18070929.9,44.66997079750437,38.16990569136824,NaN,NaN,-45.31120738704642,-65.51448630228454,0.008238803596676614,-0.6427576192190259,-0.6509964228157025,99806680,106694219.2,23.278640834728037,16.090638425089896,NaN,NaN,-18.547828152873993,-16.318929994683437
2010-02-16T09:30:00-05:00,31.36,31.80251,31.34,31.75,10514195,18216377.35,50.76450721760751,39.21229374458441,NaN,NaN,21.831794999096452,-42.60172879547206,0.09465918204249768,-0.5326724452625804,-0.6273316273050781,110320875,110205119,27.253668552993943,16.397504953078396,NaN,NaN,-15.477886502812305,-16.198780924416134
2010-02-17T09:30:00-05:00,31.95,32.09,31.55,31.77,29396672,19346128.9,50.91380701010705,40.37492169446001,NaN,NaN,54.61912471276278,-18.143260083602456,0.15085922624726833,-0.4387575944959927,-0.589616820743261,139717547,113846559.6,31.23328857925206,17.288729357181893,NaN,NaN,-12.982528568892604,-15.739316302198487
2010-02-18T09:30:00-05:00,31.63,32.22,31.60001,32.11,19628576,19752370.4,53.49552761752819,41.936040221725776,NaN,NaN,93.51729980561724,14.948140965806019,0.2052494649608816,-0.33305498954215906,-0.5383044545030407,159346123,125724221,42.317760722648835,19.182581473998642,NaN,NaN,-10.11226152273372,-14.93545133370352
2010-02-19T09:30:00-05:00,31.87,32.46001,31.85001,32.28999,15213414,19522223.5,54.849369221882036,43.76424430678981,NaN,NaN,129.18869069112006,50.76914056431002,0.2449748570296144,-0.23208588321602264,-0.47706074024563705,174559537,136750152.4,50.32279097522692,21.802984358712,NaN,NaN,-7.332433518215171,-13.8493059314909
2010-02-22T09:30:00-05:00,32.41,32.58,32.03,32.14999,11496863,19094680.25,53.54366276012755,44.661074743810715,NaN,NaN,129.26022427634038,85.68342689698738,0.25244677513378233,-0.1615022713284091,-0.41394904646219144,163062674,149401351.2,57.59460918663736,25.05493705561576,NaN,NaN,-5.3533245438344,-12.63559430468283
2010-02-23T09:30:00-05:00,32.05,32.22,31.45,31.64,20080352,19583443.55,48.970402690173195,45.169423803762086,NaN,NaN,75.56481555836399,96.43003100884088,0.21512387561564478,-0.14504420194263545,-0.36016807755828023,142982322,155933640.6,60.78644444329133,28.57221087250553,NaN,NaN,-4.864788800389819,-11.52547923264097
2010-02-24T09:30:00-05:00,31.69,31.955,31.39,31.56,15965305,19542488.8,48.2738677149281,45.78885899933506,NaN,NaN,59.089515767479895,97.32410921978432,0.17863162673492827,-0.13687854413961986,-0.31551017087454813,127017017,153393534.6,58.92898448140706,31.990567123195415,NaN,NaN,-4.6463894837547794,-10.542752125657229
2010-02-25T09:30:00-05:00,31.09,31.53999,30.78999,31.49001,20458992,19579978.4,47.63550035303695,46.807711979474774,NaN,NaN,15.046370617609059,81.62992338218268,0.1448046747723013,-0.1345043274091715,-0.2793090021814728,106558025,142835915,51.8386710713543,34.94759502831297,NaN,NaN,-4.6296463306488445,-9.698022726370317
2010-02-26T09:30:00-05:00,31.64999,31.64999,31.21001,31.5,15333461,19528005.35,47.74172561760463,47.47432723571057,NaN,NaN,32.842610113914226,62.36070726674151,0.11919564160817692,-0.13031445017125165,-0.24951009177942857,121891486,132302304.8,45.90416614315028,37.09661785179734,NaN,NaN,-4.588920813277211,-8.968151024499873
2010-03-01T09:30:00-05:00,31.67,32.00999,31.5,31.98,19751312,19709540.3,52.70601619284954,48.6779922953345,NaN,NaN,71.01197875996317,50.71105816346606,0.12980317776771044,-0.08725611956979051,-0.21705929733750096,141642798,128018329.6,43.71242181106865,39.12660601824343,NaN,NaN,-3.2411585738371973,-8.150009245833777
2010-03-02T09:30:00-05:00,32.23,32.50999,32.16,32.25,19429456,19816981.9,55.27946946336441,49.623725549053916,NaN,NaN,113.817794672966,58.361653986386465,0.1488569362738401,-0.030988126995200815,-0.17984506326904093,161072254,131636316,46.054997708742526,41.32509012633615,NaN,NaN,-1.372105841490272,-7.181737330927563
2010-03-03T09:30:00-05:00,32.45,33.00999,32.41,32.53,14108129,19720405.15,57.841445429217515,50.83955166448332,NaN,NaN,132.27414677835267,72.99858018856102,0.17250469538031082,0.035785805956347616,-0.1367188894239632,175180383,141268989.2,51.805942267398805,43.94652095812581,NaN,NaN,0.9593604995524674,-6.018723355144702
2010-03-04T09:30:00-05:00,32.63,32.87,32.49001,32.75,13373977,19483766.4,59.79059464500839,51.89113333792424,NaN,NaN,121.69635258610877,94.32857658226096,0.19356999753011847,0.10524360748868489,-0.08832639004143358,188554360,157668256.2,59.685647133998735,46.47985956513561,NaN,NaN,3.507069451378355,-4.657895811355694
2010-03-05T09:30:00-05:00,33.05,33.3833,32.92999,33.17,11670273,18926832.85,63.28089465986705,53.22048504237871,NaN,NaN,153.1847211715333,118.39699879378479,0.22423473532651836,0.19196702911671437,-0.03226770620980399,200224633,173334885.6,65.49049685587627,49.49499213807478,NaN,NaN,6.772440389530132,-3.024990639800576
2010-03-08T09:30:00-05:00,33.3,33.41,32.99001,33.17,14462895,18037396,63.28089465986705,54.11451271682582,NaN,NaN,144.50898778317296,133.09640059842675,0.23199422206461368,0.2577250713709631,0.025730849306349446,200224633,185051252.6,69.0765839428606,52.48234323735097,NaN,NaN,9.474624150528843,-1.2393313840392304
2010-03-09T09:30:00-05:00,32.97,33.28999,32.84,32.96001,15458387,17786700.95,60.24840484164669,54.78126970479293,NaN,NaN,117.18841901641343,133.77052546711622,0.21106054308630146,0.2895565281642263,0.07849598507792482,184766246,189790051,70.41565621026903,55.28108378242361,NaN,NaN,11.033323162064013,0.5139049796898043
2010-03-10T09:30:00-05:00,32.97,33.25,32.7301,32.97,20825088,17390756.95,60.34576200412071,55.27057216097812,NaN,NaN,101.1417077622083,127.54403766388734,0.18679748177499705,0.31199283729667115,0.1251953555216741,205591334,195872241.2,72.0863963511155,57.40741489874266,NaN,NaN,12.368414703682664,2.2074063688316414
2010-03-11T09:30:00-05:00,32.85001,33.16,32.58,33.16,14517246,17038992.85,62.23993182435013,55.79846948972584,NaN,NaN,90.4807424053582,121.30091562773723,0.1727816063025855,0.341172363399906,0.1683907570973205,220108580,202183085.2,73.74330712423722,59.08030890938625,NaN,NaN,14.03003521548018,3.8963533469242897
2010-03-12T09:30:00-05:00,33.33,33.53,33.22,33.28999,11531781,16641978.7,63.52368430519375,56.511328171516276,NaN,NaN,119.94239902208814,114.6524511978482,0.16169970150882587,0.3705153839833528,0.20881568247452695,231640361,208466230.8,75.3143979752626,60.34600810857376,NaN,NaN,15.803254023723607,5.597339157895621
2010-03-15T09:30:00-04:00,33.27,33.32001,33,33.28,9495395,16135588.45,63.34544472791174,57.538116888497605,NaN,NaN,93.71320735238862,104.49329511169135,0.14373594154783628,0.3884856094093223,0.24474966786148603,222144966,212850297.4,76.37655613087945,61.459587514830055,NaN,NaN,17.26826614589901,7.2646144418961045
2010-03-16T09:30:00-04:00,33.39,33.77,33.38,33.77,13585727,16289165.05,68.07684363372225,58.95261516841149,NaN,NaN,126.26356318413421,106.3083239452355,0.15398104851919192,0.43722597851047595,0.28324492999128403,235730693,223043186.8,78.67407073918353,62.86995081895695,NaN,NaN,19.936384970167236,9.074867374506265
2010-03-17T09:30:00-04:00,33.88,34.19,33.85001,33.96001,8827281,15260695.5,69.70963672352232,60.52933919487473,NaN,NaN,145.6205588392979,115.20409416065343,0.1618742464250998,0.48558773802265875,0.32371349159755897,244557974,230836514.8,80.25523627257355,64.8997054761869,NaN,NaN,22.704982487537748,11.022026676367906
2010-03-18T09:30:00-04:00,33.97,34.19,33.67,33.72,12124020,14885467.7,65.17498604087783,61.77457208225138,NaN,NaN,118.46168605564226,120.80028289071024,0.14006772286944613,0.4987981451843666,0.35873042231492047,232433954,233301589.6,80.74162209761325,67.38809518721997,NaN,NaN,23.907771186943993,12.862847320735918
2010-03-19T09:30:00-04:00,33.7,33.92,33.24001,33.28,10626316,14656112.8,57.75733819542713,62.13538079672121,NaN,NaN,73.3667515194396,111.48515339018051,0.08770698601915672,0.4683641548388664,0.3806571688197097,221807638,231335045,79.06826149395995,69.91351230742649,NaN,NaN,22.846797837718057,14.28912596601908
2010-03-22T09:30:00-04:00,33.00999,33.80499,32.85001,33.77,11267125,14644625.9,62.8307195156012,62.67475580045241,NaN,NaN,66.79128622937495,106.10076916557777,0.07809082194497696,0.4782706962509309,0.4001798743059539,233074763,233521004.4,79.57499226116843,72.30779763259977,NaN,NaN,23.416970645844014,15.593103777422641
2010-03-23T09:30:00-04:00,33.8,34.21001,33.61,34.21001,14731270,14377171.8,66.6984948729511,63.30740218929052,NaN,NaN,112.56537151059744,103.36113083087044,0.0924019934039858,0.5156823660609362,0.4232803726569504,247806033,235936072.4,80.14683125018446,74.33214684565588,NaN,NaN,25.13059060973451,16.955601896324335
2010-03-24T09:30:00-04:00,33.99001,34.33,33.89,34.11,8452398,14001526.45,65.0418272473571,63.68249023231543,NaN,NaN,117.56501596790243,97.75002225659134,0.08628672232092949,0.5311387755581123,0.4448520532371828,239353635,234895204.6,79.11871633630966,75.72022321724953,NaN,NaN,26.016340708786373,18.249993155247484
2010-03-25T09:30:00-04:00,34.42,34.42,33.39999,33.42999,19040224,13930588.05,55.03268991444266,63.09333275049941,NaN,NaN,74.06135373792853,88.86995579304859,0.030478215485210458,0.4829498225936959,0.45247160710848544,220313411,232471096,76.65254600209798,76.51751244197965,NaN,NaN,23.521990452797255,19.003135626326024
2010-03-26T09:30:00-04:00,33.58,33.99001,33.45,33.67999,15472359,13937532.95,57.61509585776764,62.68863283606373,NaN,NaN,62.22555179969033,86.64171584909874,0.005730124854062435,0.4596342631760635,0.45390413832200105,235785770,235266722.4,77.52270695014857,77.12080694250021,NaN,NaN,22.29067649899843,19.472784322422083
2010-03-29T09:30:00-04:00,34,34.2,33.87,34.03999,8591660,13379550.35,61.081145862697454,62.74811433756736,NaN,NaN,102.58924499924501,93.80130760307274,0.008754320071166055,0.46484703841095865,0.4560927183397926,244377430,237527255.8,78.22926780755134,77.67892205659182,NaN,NaN,22.357037446021444,19.884820482936277
2010-03-30T09:30:00-04:00,34.02,34.33,33.85001,34.09,8463176,12831236.35,61.55151828417541,62.83423978614269,NaN,NaN,103.57354730505355,92.00294276196396,0.009224322235738491,0.4676231211344657,0.4583987988987272,252840606,238534170.4,78.55267163895775,78.14079886286628,NaN,NaN,22.55216157023243,20.26586920969287
2010-03-31T09:30:00-04:00,34.00999,34.21001,33.82001,33.92,7774516,12514555.7,58.94359290696732,62.59878700632964,NaN,NaN,77.93767934464078,84.07747543731165,-0.005992780924964136,0.45090782274252206,0.4569006036674862,245066090,239676661.4,78.93503623619677,78.51163665657768,NaN,NaN,21.93605314153205,20.504466914241323
2010-04-01T09:30:00-04:00,34.25999,34.56,34.215,34.50999,7970844,12244399.05,64.55633878606164,62.67254804067734,NaN,NaN,142.56668958637238,97.7785426070004,0.018269892983663716,0.47973796989706585,0.46146807691340214,253036934,246221366,81.02226822758612,78.91934167460077,NaN,NaN,23.14557991178695,20.881768771033556
2010-04-05T09:30:00-04:00,34.61,34.94,34.49001,34.92999,6589242,11990347.5,67.91863940549976,62.999204803362204,NaN,NaN,179.54280719474335,121.241993686011,0.055115831396412074,0.5303628661589173,0.4752470347625052,259626176,250989447.2,82.39118900505551,79.3489583084705,NaN,NaN,25.26935891952784,21.508567363675596
2010-04-06T09:30:00-04:00,34.75999,35.10001,34.75,34.99001,8607492,11697577.35,68.3802625839885,63.02087758552408,NaN,NaN,177.5820990894954,136.24056450406107,0.07481848849576389,0.56877014538221,0.49395165688644616,268233668,255760694.8,83.66125340640878,79.70518564184373,NaN,NaN,27.103108636985347,22.30778754557699
2010-04-07T09:30:00-04:00,34.87,35.16,34.5862,34.77,10378105,11443563.25,64.70487659991636,62.66339471955223,NaN,NaN,144.6062862113098,144.44711228531233,0.06470183627781023,0.5748289522337089,0.5101271159558987,257855563,256763686.2,83.9237540017093,79.96722262249627,NaN,NaN,27.534696024033188,23.054488756785016
2010-04-08T09:30:00-04:00,34.55,34.88,34.39999,34.85001,8287578,10816687.75,65.43253287987605,62.68179092233782,NaN,NaN,115.27978734143343,151.91553388467088,0.05542445722789269,0.5794076874907645,0.5239832302628719,266143141,260979096.4,85.01353229657262,80.27235906527908,NaN,NaN,28.09764037020081,23.774938987272986
2010-04-09T09:30:00-04:00,35,35,34.71001,34.91,8375977,10509624.3,65.99854836266353,63.27044879142613,NaN,NaN,126.27675931948971,148.65754783129432,0.045755500701352037,0.5811776061395619,0.5354221054382099,274519118,265275533.2,86.05138977362726,80.77115394239819,NaN,NaN,28.720157676928803,24.48139880008096
2010-04-12T09:30:00-04:00,34.92999,35.03,34.69749,34.8,5752344,10220652.45,63.93139157921148,63.349068224541156,NaN,NaN,105.30660168801,133.81030672994765,0.025395322963042477,0.567166259142013,0.5417709361789705,268766774,267103652.8,86.48041483567016,81.26439841200545,NaN,NaN,28.68415016105139,25.081791851648166
2010-04-13T09:30:00-04:00,34.67999,34.77,34.44,34.67,7053695,10098567.45,61.480566886042986,62.97635908261915,NaN,NaN,63.53231078176529,111.00034906840165,-0.001932825301116825,0.5393549045525745,0.5412877298536913,261713079,265799535,84.48412437072516,81.57420506347265,NaN,NaN,27.990753297525018,25.497357772487717
2010-04-14T09:30:00-04:00,34.83,34.94,34.67999,34.92999,7314020,9784982.1,64.41836510875211,62.9318260727188,NaN,NaN,86.45130001920515,99.36935182998073,-0.007303119797147817,0.5321588301072566,0.5394619499044044,269027099,268033842.2,85.11796354617373,82.00272272132008,NaN,NaN,28.175309029356377,25.87992223775467
2010-04-15T09:30:00-04:00,34.88,35.02,34.74001,34.92999,7527492,9719992.65,64.41836510875211,63.6022314437409,NaN,NaN,83.40313414111601,92.99402118991723,-0.015204446362825252,0.5204563919508729,0.5356608383136982,269027099,268610633.8,85.28508083987668,82.61933235258998,NaN,NaN,28.328328284841824,26.22969453019569
2010-04-16T09:30:00-04:00,34.75,34.92,34.05,34.33,16872752,9957429.25,53.498016721911014,63.308154362608285,NaN,NaN,13.418247246882776,70.42231877539585,-0.06253328030578209,0.4574942379314706,0.5200275182372527,252154347,264137679.6,77.9726536842025,82.65147140502242,NaN,NaN,25.228032724698252,26.0865999865532
2010-04-19T09:30:00-04:00,34.07001,34.39,33.74001,34.34,11292895,9990758.2,53.639081794043456,62.77657835770443,NaN,NaN,-36.09598841226134,42.14180075534158,-0.09302279360544768,0.40374902623044306,0.49677181983589075,263447242,263073773.2,76.29697985082848,82.51345083668505,NaN,NaN,22.745487286397488,25.60929817224524
2010-04-20T09:30:00-04:00,34.61,34.72,34.3,34.44901,5805246,9717664.25,55.233322541999875,62.32527866183475,NaN,NaN,11.419508046377663,31.71924020826405,-0.10482883163125944,0.3657357802968164,0.47056461192807586,269252488,264581655,77.04978485165478,82.40610178044913,NaN,NaN,21.073411565347968,24.961314371259913
2010-04-21T09:30:00-04:00,34.52,34.52,34.02,34.36,11031957,9532698.6,53.61217534209843,61.944463121486976,NaN,NaN,-27.73029946856399,8.882920310710224,-0.11670378496982048,0.32468488071580026,0.44138866568562074,258220531,262420341.4,73.44897870420219,82.01424052816381,NaN,NaN,19.21211594654368,24.140000310586167
2010-04-22T09:30:00-04:00,34.11,34.7,33.8,34.7,12190195,9719588.45,58.60959434451495,61.519695661376495,NaN,NaN,-11.61719564341986,-10.121145646196954,-0.10035502092774673,0.31594488952593736,0.4162999104536841,270410726,262697066.8,73.61897361513763,81.48543377013176,NaN,NaN,18.922690666566183,23.394670361440454
2010-04-23T09:30:00-04:00,34.66,35.14,34.63,35.00999,9845961,9259875.3,62.56897228223565,61.13757658114334,NaN,NaN,87.2565533419153,4.646515572809555,-0.06885964554063806,0.3302253535278865,0.39908499906852457,280256687,268317534.8,76.85963093526128,81.09032247943219,NaN,NaN,19.833263913416673,22.88589801172277
2010-04-26T09:30:00-04:00,35.24001,35.47,35.05,35.16,7025094,8837512.05,64.34638411701937,60.84944240493127,NaN,NaN,140.4863969932186,39.962992653905545,-0.03957431201900796,0.3496171090447646,0.3891914210637726,287281781,273084442.6,79.19404568017713,80.77123621327279,NaN,NaN,21.122234169860402,22.63394603431386
2010-04-27T09:30:00-04:00,35.00999,35.06,33.88,33.88,16039102,9209884.15,44.79867313622238,59.42757072895313,NaN,NaN,-76.50843132421224,22.37740477978756,-0.10437907507170652,0.25871757722413946,0.363096652295846,271242679,273482480.8,79.38109068306288,80.44676026194088,NaN,NaN,15.241022593431024,21.57781411418774
2010-04-28T09:30:00-04:00,34.2,34.45,33.91,34.28999,16037695,9588610.1,50.03455129402506,58.32771490139235,NaN,NaN,-93.34460286567338,9.254544100365683,-0.1166714003640732,0.21725740184075448,0.3339288022048277,287280374,279294449.4,81.93486682804277,80.22685558561732,NaN,NaN,12.408197177303498,20.26786883748999
2010-04-29T09:30:00-04:00,34.49001,34.715,34.34,34.60001,10018914,9700830,53.617153153005596,57.44332952927392,NaN,NaN,-23.111454519221713,6.955692325205312,-0.10151949712953617,0.20702943079290748,0.30854892792244365,297299288,284672161.8,83.91948143544077,80.074576418604,NaN,NaN,11.437342663635265,19.006365098367887
2010-04-30T09:30:00-04:00,34.7,34.8,33.98,33.99001,10940887,9849332.15,46.545354262348646,56.201469720926575,NaN,NaN,-95.8836500069102,-29.672348344559786,-0.12844251453856176,0.14799578474924147,0.2764382992878032,286358401,285892504.6,84.33991566500511,79.92168362069935,NaN,NaN,8.000990965486489,17.434168793670544
2010-05-03T09:30:00-04:00,34.08,34.24001,33.64,33.97,11190172,10079378.65,46.32948759610177,55.11924977164506,NaN,NaN,-149.04966923823076,-87.57956159084965,-0.14238139807188693,0.09846155169794457,0.2408429497698315,275168229,283469794.2,79.87500027432499,79.59246047095648,NaN,NaN,5.3438428698875455,15.70697937598726
2010-05-04T09:30:00-04:00,33.49001,33.52,32.56,32.78999,26986928,10998350.45,35.7885989799949,53.07426647673383,NaN,NaN,-295.5656266010616,-131.39100064621954,-0.22115535275015935,-0.03560124116786767,0.18555411158229168,248181301,278857518.6,72.05441757327496,78.65935004432086,NaN,NaN,-1.2708239616489325,13.28157889918209
2010-05-05T09:30:00-04:00,32.28,33.005,32.13,32.55,17603136,11359602,34.089821124589875,50.90794190643653,NaN,NaN,-279.31796983730936,-168.58567404054673,-0.27594327496007626,-0.15937498211780365,0.11656829284227262,230578165,267517076.8,57.21986433522913,76.65469172256032,NaN,NaN,-6.9411844697521525,10.392612703620056
2010-05-06T09:30:00-04:00,32.28999,32.92,29.48,31.48,27430528,12316749.5,27.762429945665005,49.06968570813324,NaN,NaN,-318.0025362416819,-227.56389038503875,-0.36516551189457574,-0.3398885970259471,0.025276914868628667,203147637,248686746.6,41.82275633514262,74.07255619762748,NaN,NaN,-14.458130103942251,6.842506588254013
2010-05-07T09:30:00-04:00,31.52,32.03999,30.66,31.13,27338352,13264868.25,26.05862303377684,47.09965293954277,NaN,NaN,-226.61525038905262,-253.71021046146726,-0.4245123290863446,-0.5053634964893021,-0.0808511674029575,175809285,226576923.4,31.205076940646975,70.85170598975736,NaN,NaN,-20.852816751327584,2.8860318254566417
2010-05-10T09:30:00-04:00,32.39,32.7,32.22,32.61,18037376,13879119.85,42.209546436811216,46.16938321774358,NaN,NaN,-104.22535044968919,-244.7453467037589,-0.34426887948893975,-0.5111872667641322,-0.16691838727519243,193846661,210312609.8,25.98001436618408,67.20386524079517,NaN,NaN,-19.897826864589756,-0.36880513026427186
2010-05-11T09:30:00-04:00,32.25,32.66,32.14,32.2,14382641,14245567.15,39.62722495234132,45.17045818990378,NaN,NaN,-99.0307572295864,-205.43837282946387,-0.3005701754054455,-0.5426311065319993,-0.2420609311265538,179464020,196569153.6,22.54477468388187,63.567850667915145,NaN,NaN,-20.18499570977729,-3.1996894987661317
2010-05-12T09:30:00-04:00,32.39999,32.88499,32.34,32.87,12932984,14526515.35,45.495465248435174,44.23373468304094,NaN,NaN,-64.71862344660933,-162.5185035513239,-0.2124596309455159,-0.5076354698084486,-0.29517583886293275,192397004,188932921.4,20.8918170676195,59.80162520023528,NaN,NaN,-18.15040979687129,-5.335506684209726
2010-05-13T09:30:00-04:00,32.78999,33.06,32.36,32.38,13343660,14817323.75,42.26023898218679,42.78311087589459,NaN,NaN,-62.609872886927285,-111.43997088037297,-0.17467575722773077,-0.5135205353975962,-0.33884477816986547,179053344,184114062.8,19.900245656541244,55.73309768032671,NaN,NaN,-17.74667734677203,-7.10853106457577
2010-05-14T09:30:00-04:00,32.17,32.17,31.32001,31.59,20233488,14985360.55,37.61590199381843,40.87379072423738,NaN,NaN,-105.67239624243214,-87.25140005104888,-0.18916353659797014,-0.5752991989173282,-0.38613566231935803,158819856,180716177,19.20797081575361,51.448378047153604,NaN,NaN,-19.123912620737666,-8.825014144027469
2010-05-17T09:30:00-04:00,31.72,31.91,30.83,31.59,18783440,15359887.8,37.615901993818426,40.360735642637096,NaN,NaN,-106.47102804239134,-87.7005355695893,-0.18480760573936256,-0.6171451694935612,-0.4323375637541987,158819856,173710816,17.830771875907345,47.05192670378535,NaN,NaN,-20.151692856715485,-10.443111102982899
2010-05-18T09:30:00-04:00,31.87,32.35001,31.05,31.05,23404464,16239848.7,34.601362288158626,39.25836499936092,NaN,NaN,-94.23750938790786,-86.7418860012536,-0.20290947201141074,-0.6859744037684621,-0.48306493175705134,135415392,164901090.4,16.25259905827889,42.36033614880222,NaN,NaN,-22.005316636077627,-12.09485475056786
2010-05-19T09:30:00-04:00,30.84,31.145,30.35001,31.05,23751008,16875801.25,34.601362288158626,37.90009422330042,NaN,NaN,-118.13154537455145,-97.42447038684203,-0.19921451051060146,-0.7320830698953031,-0.5328685593847017,135415392,153504768,14.46858781030069,37.39955803272078,NaN,NaN,-23.442331676214685,-13.71592288280312
2010-05-20T09:30:00-04:00,30.08,30.42,29.61,29.64,27631488,17647865.9,27.844016663069013,36.564284394780444,NaN,NaN,-154.20500310495154,-115.74349643044688,-0.271580271440508,-0.8723438986853367,-0.6007636272448287,107783904,139250880,12.604921291051369,32.275629863152666,NaN,NaN,-27.15021588870097,-15.635107597931384
2010-05-21T09:30:00-04:00,29.14999,30.49001,29.10001,30.37,19505152,18130825.45,34.929294445771646,35.749984884042576,NaN,NaN,-136.64628074913077,-121.9382733317866,-0.25063709993877303,-0.914060002168295,-0.6634229022295219,127289056,132944720,11.876082322207452,27.41856429514427,NaN,NaN,-27.754928127358447,-17.36651053070668
2010-05-24T09:30:00-04:00,30.24001,30.48,29.85001,29.85001,13566789,18457910.2,32.48253505990641,35.513837461179115,NaN,NaN,-119.13345418705919,-124.47075856072017,-0.2515077618863799,-0.9778076045874968,-0.7262998427011169,113722267,123925202.2,10.904868411724067,23.050739355033492,NaN,NaN,-29.07436850918672,-19.03906167048954
2010-05-25T09:30:00-04:00,29.03999,30.39999,28.87,30.35001,18824576,18597183.9,37.04883973013716,35.72519593300392,NaN,NaN,-115.69855130777862,-128.76296694469434,-0.20033865451635502,-0.9767231608465607,-0.7763845063302057,132546843,123351492.4,10.844120735321283,19.738186240754356,NaN,NaN,-28.620637868210196,-20.40785827016392
2010-05-26T09:30:00-04:00,30.64999,30.875,30.00999,30.11,13437266,18467162.45,35.797304444625254,36.29911554007251,NaN,NaN,-83.59107289164184,-121.8548724481124,-0.16600349416090465,-0.9838888740313365,-0.8178853798704319,119109577,120090329.4,10.486514307514014,17.49988323878089,NaN,NaN,-28.654521683831597,-21.585953043545018
2010-05-27T09:30:00-04:00,30.75,31.33,30.35001,31.3,14691324,18700782.95,45.608115287721326,37.69550784392569,NaN,NaN,-41.06900376729472,-99.22767258058104,-0.05238117853029156,-0.8833618530332963,-0.8309806745030047,133800901,125293728.8,15.286740518609832,16.362859208635378,NaN,NaN,-25.3230405914248,-22.11982269324213
2010-05-28T09:30:00-04:00,31.22,31.27,30.53,30.75,14741371,18890807.15,42.38439025731504,37.707996688247384,NaN,NaN,-44.554242882315194,-80.80926500721793,-0.005942827299232123,-0.8384092086270449,-0.8324663813278128,119059530,123647823.6,15.01250187775915,15.57946545946217,NaN,NaN,-23.67422763079619,-22.34188054146414
2010-06-01T09:30:00-04:00,30.44,30.81,29.71001,29.75999,15771051,19119851.1,37.27679985037276,37.54010918096392,NaN,NaN,-91.76753669867851,-75.33608150954178,-0.03211532384228466,-0.8726105361306686,-0.840495212288384,103288479,121561066,14.653572390853839,15.015808152817312,NaN,NaN,-24.012306563560426,-22.58051283033504
2010-06-02T09:30:00-04:00,30,30.67999,29.89999,30.67999,8751707,18208090.05,44.027069163259945,37.43522374630855,NaN,NaN,-59.79134829090101,-64.15464090616626,0.019538685840191028,-0.8160718549881452,-0.8356105408283362,112040186,117459734.6,13.94774639725398,14.51980310493406,NaN,NaN,-21.930799963352328,-22.487696706480367
2010-06-03T09:30:00-04:00,30.95,30.95,29.95,30.31,12639625,17959914.5,42.066353572909335,37.42137478850301,NaN,NaN,-55.30125301428511,-58.496676930694925,0.034896372567643,-0.7919900751187825,-0.8268864476864255,99400561,113517931.4,13.285402399061638,14.047314300828376,NaN,NaN,-20.936242379823117,-22.26606037410076
2010-06-04T09:30:00-04:00,29.73,29.97,29.03999,29.11,15357313,17356253.75,36.40374171814294,37.33479191166906,NaN,NaN,-125.64069128905612,-75.41101443504719,-0.02634968310930308,-0.8598235515730543,-0.8334738684637513,84043248,103566400.8,11.766262641862014,13.515763716978975,NaN,NaN,-22.042175936871406,-22.234076883067996
2010-06-07T09:30:00-04:00,29.13,29.37,28.57001,28.59,12511500,16614911.15,34.252072245037326,37.094518358184686,NaN,NaN,-146.18717547235227,-95.73760095305462,-0.0889427933675172,-0.9446523601731478,-0.8557095668056306,71531748,94060844.4,10.527927377378674,12.994131967084071,NaN,NaN,-23.65669997537769,-22.437308753397954
2010-06-08T09:30:00-04:00,28.74001,29.35001,28.55,29.24001,21834912,16804787.95,39.097850458556415,37.415696084641674,NaN,NaN,-120.0922693797132,-101.40254748926155,-0.07422895360987125,-0.9484957588179697,-0.8742668052080984,93366660,92076480.6,10.284586552497046,12.567845359528224,NaN,NaN,-23.36974327103686,-22.570513684489224
2010-06-09T09:30:00-04:00,29.63,29.97,29.08,29.28,13832973,16777304.55,39.39379789539585,37.75801291373005,NaN,NaN,-84.7452384770535,-106.39332552649205,-0.05059280754215334,-0.93750781463579,-0.8869150070936367,107199633,91108370,10.1611894374023,12.26017404717834,NaN,NaN,-23.05417045665686,-22.639607509084602
2010-06-10T09:30:00-04:00,29.83,30.33,29.78,30.33,10801324,16670721.55,46.71540187642745,39.1059690003985,NaN,NaN,-22.593498467876298,-99.85177461721028,0.0419684113079134,-0.834454492958745,-0.8764229042666584,118000957,94828449.2,14.410799043046964,12.389165315178024,NaN,NaN,-20.40036809540165,-22.31971616427275
2010-06-11T09:30:00-04:00,30.00999,30.6701,29.98,30.67,7978402,16402458.65,48.86939540542619,40.10169049751669,NaN,NaN,17.214137487914456,-71.28080886181617,0.1274721226258696,-0.7170827509843214,-0.844554873610191,125979359,103215671.4,23.22814210531729,13.200026728257297,NaN,NaN,-17.572274553900673,-21.641510219933885
2010-06-14T09:30:00-04:00,30.95,31.06,30.32001,30.37,9101059,15845837.2,47.06165158774581,41.14305596379093,NaN,NaN,42.95494007052325,-33.45238575324106,0.16293623951813896,-0.6408845742125173,-0.8038208137306563,116878300,112284981.8,31.451640853689028,14.667653331254796,NaN,NaN,-15.798561320258237,-20.806803234265935
2010-06-15T09:30:00-04:00,30.64,31.14999,30.53,31.12,7054734,15259401.9,51.856373382554814,42.20073693896362,NaN,NaN,92.5812141784402,9.082310958389613,0.2318146028033341,-0.5140525602264887,-0.7458671630298228,123933034,118398256.6,36.39719736444505,16.49287309047792,NaN,NaN,-12.780116178652415,-19.660133654892576
2010-06-16T09:30:00-04:00,30.89,31.25999,30.78999,31.08,6365109,14407434.15,51.588008798465836,43.32864439280938,NaN,NaN,114.06118268913104,48.84359519162651,0.26708134397956496,-0.4120154830553666,-0.6790968270349316,117567925,120471915,38.0304172443515,18.460294728823452,NaN,NaN,-10.437695941483328,-18.34264255297697
2010-06-17T09:30:00-04:00,31.14999,31.21001,30.52,30.91,13689906,13904379.05,50.39435451409307,43.670518623264506,NaN,NaN,91.9810747022347,71.75850982564872,0.27052720203101543,-0.3409378244961623,-0.6114650265271777,103878019,117647327.4,36.649894244205235,19.986234280651697,NaN,NaN,-8.827922272029754,-16.983396798555937
2010-06-18T09:30:00-04:00,30.84,31.11,30.83,30.95,9447875,12995198.4,50.68350091328486,44.263312241548064,NaN,NaN,92.39697819692012,86.79507796744986,0.26663283262598725,-0.27817398574469365,-0.5448068183706809,113325894,115116634.4,35.40966084559386,21.4431742069256,NaN,NaN,-7.42000183993829,-15.617197518753416
2010-06-21T09:30:00-04:00,31.5,31.8,30.92,31.14,12072105,12623546.05,52.11139872650858,45.32292644698634,NaN,NaN,119.04023335345025,102.01213662403525,0.26730683954724554,-0.21067326893662397,-0.4779801084838695,125397999,116820574.2,36.956588034893926,23.036246752928466,NaN,NaN,-5.842629903151238,-14.220830716524533
2010-06-22T09:30:00-04:00,31.10001,31.299,30.37,30.37,11843289,12537371.05,46.26510956502119,45.48278647568356,NaN,NaN,42.215494438750035,91.93899267609721,0.2089346800662099,-0.2168117584011071,-0.425746438467317,113554710,114744909.4,35.830825532400624,24.59932383401037,NaN,NaN,-6.014131118799554,-13.04844505970668
2010-06-23T09:30:00-04:00,30.41,30.63,29.92,30.42999,10839188,12138101.65,46.76619055594282,45.81848911732881,NaN,NaN,-3.494886188717326,68.42777890052754,0.1691053108469754,-0.2143647999085978,-0.3834701107555732,124393898,116110104,37.18611660853265,26.306517706115443,NaN,NaN,-6.023031294371249,-12.044814521801618
2010-06-24T09:30:00-04:00,30.2,30.49001,29.64999,29.66,15760773,12254277,41.42644969039502,46.17725397248967,NaN,NaN,-48.88137055841865,40.255289848396885,0.08963331485438641,-0.27142846718759017,-0.3610617820419766,108633125,117061125.2,38.165865393347254,28.192203616935817,NaN,NaN,-7.555836245242048,-11.403531910864537
2010-06-25T09:30:00-04:00,29.78,30.24001,29.49001,30.10001,11308016,12085111.6,45.27201167949434,46.96439250352232,NaN,NaN,-41.53675240854196,13.468543727304473,0.06649522252061024,-0.2779427538912138,-0.34443797641182405,119941141,118384174.6,39.57783680742924,30.267197147653718,NaN,NaN,-7.7904227706247555,-10.887373462258854
2010-06-28T09:30:00-04:00,30.07001,30.17999,29.67999,29.75999,12885988,11992342.45,42.92663955453038,47.237877438949035,NaN,NaN,-44.39282970121999,-19.21806888362957,0.029947818294705997,-0.30700320354344157,-0.33695102183814757,107055153,114715605.4,37.05140469038901,32.17911272893171,NaN,NaN,-8.65972092866097,-10.569137386030585
2010-06-29T09:30:00-04:00,29.17999,29.25999,28.535,28.66,17029424,12055261.1,36.36343647501652,47.02142305177908,NaN,NaN,-147.62307914518044,-57.185783600415675,-0.06165617462962325,-0.4140212401251766,-0.35236506549555335,90025729,110009809.2,34.04892506902435,33.88537955976186,NaN,NaN,-11.52701289797084,-10.705976744879193
2010-06-30T09:30:00-04:00,28.63,29.06,28.25,28.37,10513566,12143354.05,34.85059610230513,46.17393692505606,NaN,NaN,-147.55761080093154,-85.99832852285851,-0.13113434163982546,-0.5162829925453352,-0.3851486509055097,79512163,101033462.2,29.189803509002374,34.941022735901534,NaN,NaN,-14.35543616876683,-11.227328091148856
2010-07-01T09:30:00-04:00,28.34,28.62,27.67,28.21001,16454910,12334118.3,34.0099490543065,45.112547899976086,NaN,NaN,-156.8416933404234,-107.59039307925946,-0.1745064931303491,-0.6032817673184461,-0.42877527418809697,63057253,91918287.8,25.249284185384937,35.08539002733494,NaN,NaN,-16.923929444477555,-12.041128284481527
2010-07-02T09:30:00-04:00,28.32001,28.44,27.8325,28.05,9666918,12049598.55,33.148738280339444,44.11876837801848,NaN,NaN,-143.21686471437212,-127.9264155404255,-0.19884580075688596,-0.6773325251342044,-0.47848672437731843,53390335,78608126.6,20.82779471803555,34.326543874788264,NaN,NaN,-19.305312495244074,-13.078868886019034
2010-07-06T09:30:00-04:00,28.63,28.7,27.8,28.08,10072473,11927647.2,33.48879947229989,42.80679881300027,NaN,NaN,-127.72576524630877,-144.59300264944326,-0.19740057974806635,-0.7252374490624014,-0.527836869314335,63462808,69889657.6,18.537871185394962,33.05087771914183,NaN,NaN,-21.182627574414155,-14.236548698646908
2010-07-07T09:30:00-04:00,28.10001,29.24001,28.07001,29.2,11851500,11428476.6,44.781839132888955,42.32064383688764,NaN,NaN,-76.6739654097375,-130.40317990235468,-0.10985870718079971,-0.6651602532903347,-0.555301546109535,75314308,66947373.4,17.825591249953405,31.607675862399105,NaN,NaN,-19.605818054541853,-15.003587178060473
2010-07-08T09:30:00-04:00,29.44,29.67999,29.1935,29.67999,8930770,11183366.45,48.7944920423384,42.20636794604802,NaN,NaN,-25.956138744423324,-106.08288549105302,-0.013535763806224232,-0.5722212508673152,-0.558685487061091,84245078,67893956.4,18.905141678960277,30.34019353631018,NaN,NaN,-17.032485796894413,-15.293429837893893
2010-07-09T09:30:00-04:00,29.59,30.39,29.59,30.39,9444680,11115534.25,54.10714769714983,42.45091414489551,NaN,NaN,19.859213205464997,-70.74270418187535,0.0979517665500057,-0.43624577887358384,-0.5341975454235895,93689758,74020457.4,25.70793487472936,29.64721310981986,NaN,NaN,-13.094979509894204,-14.979365505322509
2010-07-12T09:30:00-04:00,30.41,30.41,29.84,29.99001,9439113,11188569.8,50.90303337067912,42.364602333764836,NaN,NaN,18.20543332959142,-38.45824457308264,0.14203894694660296,-0.35664886174033583,-0.4986878086869388,84250645,80192519.4,31.905334411156815,29.28640927955292,NaN,NaN,-10.784035866805192,-14.380032699820035
2010-07-13T09:30:00-04:00,30.5,30.89,30.45,30.8,10704980,11268765.85,56.51835385188316,43.096976925683556,NaN,NaN,65.90924945470856,0.2687583671208273,0.21846413227774852,-0.22560764333975314,-0.44407177561750166,94955625,86491082.8,37.6238286436111,29.41448093035367,NaN,NaN,-6.934500750035065,-13.316385278422182
2010-07-14T09:30:00-04:00,30.53999,30.91,30.37,30.7,8638781,11347968.2,55.67178927411646,43.73309111983882,NaN,NaN,63.58019695452641,28.31959083997362,0.25258045826327,-0.12834620278841413,-0.38092666105168416,86316844,88691590,39.53431331452218,29.582209266495774,NaN,NaN,-4.116115797666331,-12.002061066885632
2010-07-15T09:30:00-04:00,30.73,30.78,30.27,30.67,8285641,11443994.8,55.40367797137023,44.73146456847991,NaN,NaN,59.848686794234474,45.480555947705184,0.26228153119812914,-0.05307474705402271,-0.31535627825215184,78031203,87448815,38.81131448727871,29.628312773205163,NaN,NaN,-1.9186369840808206,-10.56157191219923
2010-07-16T09:30:00-04:00,30.45,30.60001,29.75,29.83,12429012,11380950.1,48.37824961970246,44.9533387070662,NaN,NaN,23.522647970935648,46.213242900799315,0.20388094989337047,-0.06050509088543876,-0.26438604077880923,65602191,81831301.6,35.6386715848314,29.346943828733888,NaN,NaN,-2.0559555260345688,-9.346483857032851
2010-07-19T09:30:00-04:00,30,30.02,29.55,29.86,7614996,11289306.15,48.62879168075201,45.360635287510604,NaN,NaN,8.285012270788245,44.229158689038684,0.16091370762957488,-0.06324390624184062,-0.2241576138714155,73217187,79624610,34.44742461930437,29.160945252227844,NaN,NaN,-2.0945920604791306,-8.310499314668034
2010-07-20T09:30:00-04:00,29.42999,30.78999,29.42999,30.75999,10507563,11211079.05,55.59201189214132,46.73410496016237,NaN,NaN,59.14747203303812,42.87680320470459,0.1850261715782065,0.007125100601342638,-0.17790107097686386,83724750,77378435,33.229850743886445,29.102439943289422,NaN,NaN,0.017055299193693047,-7.12084865554493
2010-07-21T09:30:00-04:00,31.07001,31.23,30.39,30.66,9379801,11087904.65,54.704816088333025,48.152263530592926,NaN,NaN,97.16948403745772,49.59466062129085,0.18568078109041583,0.05419990538615593,-0.1314808757042599,74344949,74984056,31.934083467912984,29.298459940354466,NaN,NaN,1.4649286086455058,-5.894309046374868
2010-07-22T09:30:00-04:00,31.00999,31.59,30.95,31.32001,16256121,11358751.3,59.31978669832165,49.960109076594016,NaN,NaN,133.80193536332658,64.38531033510927,0.21967636662567488,0.14311458257783372,-0.07656178404784117,90601070,77498029.4,34.808451543084104,29.98125760876155,NaN,NaN,4.153581600050297,-4.458896096885558
2010-07-23T09:30:00-04:00,31.37,32.05,31.33,32.00999,14681113,11304768.3,63.50589361125383,52.12847731451648,NaN,NaN,156.29559377365004,90.93989949565214,0.27419925375045684,0.2661872831402299,-0.008011970610226946,105282183,85434027.8,42.992534018800384,31.564453273101893,NaN,NaN,7.828515081394909,-2.7035516428454915
2010-07-26T09:30:00-04:00,32.08,32.2,31.875,32.2,7497113,11114223.15,64.58662810682952,54.34975078841145,NaN,NaN,154.56809161163642,120.19651536382177,0.30619820305072976,0.37473578320318524,0.0685375801524555,112779296,93346449.6,49.76404938194291,33.79489457285532,NaN,NaN,11.147969835722503,-0.724762860192921
2010-07-27T09:30:00-04:00,32.39999,32.5,31.8,31.94,9174813,10928664.4,61.8859673292897,55.5714742310115,NaN,NaN,133.92119898634368,135.15126075448288,0.29298567214884447,0.4347696703385111,0.14178399818966664,103604483,97322396.2,52.79814322733946,36.29293399981147,NaN,NaN,13.118437080414752,1.2528371313224609
2010-07-28T09:30:00-04:00,31.78,32.07001,31.7,31.84,10534977,10603942.05,60.83237277503036,56.4313228547752,NaN,NaN,108.79719160174736,137.47680226734082,0.26167113664981484,0.4688729190019352,0.20720178235212033,93069506,101067307.6,55.522951990754336,38.90849187922533,NaN,NaN,14.440660045875841,3.1368118334015147
2010-07-29T09:30:00-04:00,32.05,32.33,31.53,31.81,8462750,10501401.25,60.49960610659889,56.88792702687871,NaN,NaN,100.34740396634032,130.78589598794355,0.2245230100752551,0.4878555449461892,0.2633325348709341,84606756,99868444.8,54.43951462465479,40.96074757564857,NaN,NaN,15.441930354519457,4.8946859078469345
2010-07-30T09:30:00-04:00,31.52,32.13,31.42,32.00999,8759273,10116619.4,61.99222593631792,57.68001221013863,NaN,NaN,90.5818410447806,117.64314544216968,0.19983155895452798,0.5131219835640941,0.31329042460956613,93366029,97485214,52.25651815873876,42.414403557618705,NaN,NaN,16.698656627154072,6.580967439176526
2010-08-02T09:30:00-04:00,32.52,32.92999,32.44099,32.87,16477250,10457136,67.6528432770424,58.47533288336429,NaN,NaN,139.08483377902107,114.54649387564662,0.22590755527910417,0.5956748687084463,0.36976731342934216,109843279,96898010.6,51.70635706949774,43.42029844518204,NaN,NaN,19.549937568874604,8.433677457704823
2010-08-03T09:30:00-04:00,32.55,32.56,32.2,32.27,9558480,10431436.35,60.84444817033014,58.84480851880812,NaN,NaN,99.2321722080949,107.60868851999685,0.18874734095231555,0.6057014896197366,0.41695414866742103,100284799,96234073.8,51.05189551992445,44.242982888425054,NaN,NaN,20.001023154495098,10.086155414389147
2010-08-04T09:30:00-04:00,32.46001,32.60001,32.2563,32.57001,5637801,10120751.4,62.85725394745726,59.37720680281434,NaN,NaN,99.01100211252938,105.65145062215325,0.17090623696043183,0.6305869448679609,0.459680707907529,105922600,98804692.6,53.50567625517891,45.292580157560785,NaN,NaN,20.97675898615168,11.641955924640937
2010-08-05T09:30:00-04:00,32.42999,32.66949,32.37,32.64,7035262,10025976,63.3308351824562,60.445248628725324,NaN,NaN,96.63129244576005,104.9082283180372,0.15104036828923428,0.6484811682690719,0.4974407999798376,112957862,104474913.8,58.453165099984176,46.922186837214554,NaN,NaN,21.907522691053085,13.108465462699815
2010-08-06T09:30:00-04:00,32.42,32.84,32.17999,32.49001,8688098,9988146.9,61.5205310314965,61.3660871537785,NaN,NaN,84.19299066806373,103.63045824269383,0.11656395676752174,0.6431457459392398,0.526581789171718,104269764,106655660.8,60.20697225954829,48.7621545258034,NaN,NaN,22.183318960274104,14.404873105210427
2010-08-09T09:30:00-04:00,32.75,32.75999,32.4791,32.69,6080965,9820239.5,63.03767324498318,61.89792010755292,NaN,NaN,88.39100192793644,93.4916918724769,0.09680648364886246,0.6475898937327962,0.5507834100839337,110350729,106757150.8,60.290983168010314,50.69509255609797,NaN,NaN,22.83080582463971,15.60857777941461
2010-08-10T09:30:00-04:00,32.33,32.53,32.00999,32.34,12725660,9921273.5,58.67741097362842,62.18167688507402,NaN,NaN,55.58484925149363,84.76222728115665,0.051990556875321836,0.615771606178086,0.5637810493027642,97625069,106225204.8,59.58097187266267,52.669870299294374,NaN,NaN,22.179828902891632,16.547327939911327
2010-08-11T09:30:00-04:00,31.71001,31.74001,31.23,31.25,17573536,10368011.25,47.628437941896316,61.34658054532935,NaN,NaN,-23.411566255458084,60.27771360755916,-0.0535257664706954,0.49687384121439493,0.5503996076850903,80051533,101050991.4,53.03818172498547,53.9719938837159,NaN,NaN,18.00944022487945,16.756201123478203
2010-08-12T09:30:00-04:00,30.87,31.56,30.86,31.45,11524621,10529960.25,49.50718675764047,60.3466729129284,NaN,NaN,-39.51568542806804,33.04831803279353,-0.10910980002527138,0.4140123576535011,0.5231221576787725,91576154,96774649.8,48.31583734102082,54.35222983530308,NaN,NaN,15.169225262796521,16.529490286237962
2010-08-13T09:30:00-04:00,31.33,31.47,31.19,31.3,6186016,10217810.45,48.11312284404107,59.169993965586364,NaN,NaN,-48.324518753941405,6.544816148392508,-0.1525709338318637,0.3324084903889428,0.48497942422080653,85390138,92998724.6,44.544472686629646,53.979402928494984,NaN,NaN,12.420923883691216,15.942552228731284
2010-08-16T09:30:00-04:00,31.16,31.64,31.10001,31.44,6534617,10163791.5,49.54126761176703,58.28822970004904,NaN,NaN,-58.1879002835529,-22.770964293905354,-0.16730050195850443,0.27585379677267596,0.4431542987311804,91924755,89313529.8,41.16708523700517,53.14861307204253,NaN,NaN,10.541702070332883,15.17100220610294
2010-08-17T09:30:00-04:00,31.88,32.42,31.88,32.17999,11975746,10237200.65,56.37601589906941,57.96991849462325,NaN,NaN,32.75134079760322,-27.33766598468344,-0.12457826123988436,0.2874314721813249,0.4120097334212093,103900501,90568616.2,42.75890129515271,52.236895165213845,NaN,NaN,10.892193611723753,14.559743835477342
2010-08-18T09:30:00-04:00,32.14999,32.46001,31.9001,32.3,9785281,10257474.65,57.3841847114101,57.747388394966904,NaN,NaN,34.861425235868204,-15.683067686418184,-0.08736764637389305,0.30280017545384297,0.390167821827736,113685782,97295466,50.49072392856429,51.95483868692167,NaN,NaN,11.475339966706889,14.119114711367278
2010-08-19T09:30:00-04:00,32.14,32.27,31.39999,31.56,12747867,10082061.95,49.74943121995004,56.87290305808349,NaN,NaN,-51.77678417946557,-18.135287436697695,-0.11024695425437975,0.2523591290097613,0.36260608326414107,100937915,99167818.2,52.41728865689572,51.96632229393288,NaN,NaN,9.60864285185601,13.474761588579954
2010-08-20T09:30:00-04:00,31.37,31.52,31.19,31.49001,13961734,10046093,49.084259156370706,55.54657562089265,NaN,NaN,-103.37182259256383,-29.144748204422182,-0.12658034240786065,0.20438065525431526,0.3309609976621759,86976181,99485026.8,52.75272942579973,52.04106317652588,NaN,NaN,7.908382152549589,12.679564526289901
2010-08-23T09:30:00-04:00,31.63,32.05,31.12,31.14,9450527,10143763.7,45.78725403072332,54.47106175377788,NaN,NaN,-86.24516394594269,-34.756200936900136,-0.15553637171264667,0.1365405330213676,0.29207690473401426,77525654,96605206.6,49.351234815705915,51.91958741193884,NaN,NaN,5.464812435969021,11.648885656244062
2010-08-24T09:30:00-04:00,30.59,30.83,30.39999,30.42,14872828,10428664.45,39.85646011996506,52.828147908957014,NaN,NaN,-188.14929165174732,-78.93632742677025,-0.21414350362914308,0.024397525197585423,0.2385410288267285,62652826,88355671.6,41.163151567068255,51.03797850564523,NaN,NaN,1.3651089551507491,10.179774698945018
2010-08-25T09:30:00-04:00,30.17999,30.60001,29.88,30.50999,12782398,10541035.5,40.88707666541099,51.22502230059664,NaN,NaN,-178.91985710176047,-121.69258389429596,-0.23608334364936448,-0.056563150734977086,0.1795201929143874,75435224,80705560,35.31213663122779,49.38504790073405,NaN,NaN,-1.6250776692415012,8.493367217775514
2010-08-26T09:30:00-04:00,30.8,30.97,30.41499,30.47,7480441,10491920.05,40.55450209871493,49.727448805397955,NaN,NaN,-124.12559363020418,-136.1623457844437,-0.2416476510528573,-0.12253937090168421,0.11910828015117308,67954783,74108933.6,31.194572031056154,47.3127335986989,NaN,NaN,-4.1493312361910295,6.687267438637437
2010-08-27T09:30:00-04:00,30.67,31.39999,30.36,31.38,10366320,10572272.4,50.434505389309194,48.82722252999266,NaN,NaN,-70.02696926275942,-129.49337511848282,-0.17547949534311366,-0.100241089027719,0.07523840631539466,78321103,72377918,30.199443579726122,45.163337913821465,NaN,NaN,-3.427069175318294,5.242362208072333
2010-08-30T09:30:00-04:00,31.31,31.46001,30.91,30.91,5066785,10001749.15,46.166668569762905,47.9335980725737,NaN,NaN,-59.21410761352069,-124.08716385199841,-0.15548788830536917,-0.1191214540663168,0.036366434239052364,73254318,71523650.8,29.69597185236603,43.02869505522885,NaN,NaN,-4.164937749174584,3.898462214179916
2010-08-31T09:30:00-04:00,30.72,31.2,30.71001,31.03999,9565301,10002090.2,47.490149210977975,47.92372030607954,NaN,NaN,-65.4283733585042,-99.54298019334979,-0.1268424919989396,-0.12218668075962213,0.0046558112393174644,82819619,75557009.4,35.18982595566489,41.75381250027738,NaN,NaN,-4.356863231863209,2.7191300076023266
2010-09-01T09:30:00-04:00,31.44,32.03999,31.41499,31.97,12036945,10322047.4,55.85260406329254,48.376964399340395,NaN,NaN,31.88146576390156,-57.38271562021737,-0.04293020013503819,-0.04900693892948027,-0.006076738794442083,94856564,79441277.4,40.048564538914675,41.16329301441265,NaN,NaN,-1.751496710747971,2.0804690478379984
2010-09-02T09:30:00-04:00,32.07001,32.35001,31.88,32.35001,6157820,10278175.3,58.743780036458155,49.13629705594162,NaN,NaN,83.05506606758455,-15.946583680659634,0.03622162167887758,0.039200288304154896,0.002978666625277312,101014384,86053197.6,47.29222563843646,41.35956108239885,NaN,NaN,1.3467246720423864,1.9756484227243396
2010-09-03T09:30:00-04:00,32.60001,32.75,32.45,32.73,7812801,10234410.45,61.46162487961775,49.98775114650238,NaN,NaN,135.7173432016172,25.202278812215702,0.10815657104346388,0.13817438042960717,0.030017809386143283,108827185,92154414,52.9423996485548,42.20065496893811,NaN,NaN,4.797957678984634,2.378835459332953
2010-09-07T09:30:00-04:00,32.60001,32.7,32.36,32.41,6096688,10235196.6,57.9966459472381,50.10351043565729,NaN,NaN,119.99205747938157,61.04351183079616,0.126878938459343,0.18861648246032203,0.061737544000979035,102730497,98049649.8,57.664754937830885,43.26535880055798,NaN,NaN,6.564871802234867,2.976840651176084
2010-09-08T09:30:00-04:00,32.50999,32.87,32.47,32.66,5021945,9850010.85,59.89872873260953,50.28312072288582,NaN,NaN,133.98264088061782,100.92571467862057,0.14735411858195938,0.24593019222842827,0.09857607364646889,107752442,103036214.4,61.210653416470954,44.03106804969417,NaN,NaN,8.606862262584048,3.781129452805793
2010-09-09T09:30:00-04:00,32.97,33.07001,32.47,32.55,4726781,9207673.1,58.64044080435512,50.91819283605761,NaN,NaN,117.77371544422557,118.10416461468537,0.14454437615859278,0.2792565438447099,0.1347121676861171,103025661,104670033.8,62.32411431892873,44.7386984541251,NaN,NaN,9.902919867305068,4.655670940591404
2010-09-10T09:30:00-04:00,32.58,32.89999,32.58,32.82001,5632957,8913089.9,60.81634237192657,51.75619878002588,NaN,NaN,109.82721355053529,123.45859411127552,0.15120929128379487,0.3237237817908607,0.17251449050706583,108658618,106198880.6,63.38333368826581,45.49802733001553,NaN,NaN,11.636417156373485,5.652920399988844
2010-09-13T09:30:00-04:00,33.08,33.47,33.05,33.35001,12066613,9207119.75,64.7378481482801,53.10981264556563,NaN,NaN,140.72495829278162,124.46011712950835,0.17971067019633427,0.39715282825248366,0.2174421580561494,120725231,108578489.8,65.03122736342439,46.61802679770971,NaN,NaN,14.359013555327552,6.896647993608659
2010-09-14T09:30:00-04:00,33.19,33.52,33.08,33.28999,8552680,9308022.9,63.95722344184935,54.83129573998594,NaN,NaN,123.2690248904085,125.11551061171374,0.1823413372144687,0.4453688295742353,0.2630274923597666,112172551,110466900.6,66.32636494294223,48.41539918170071,NaN,NaN,16.352168156433393,8.247436588297907
2010-09-15T09:30:00-04:00,33.10001,33.28999,32.97,33.23,6444242,9031447.7,63.13773918676307,56.420628777225375,NaN,NaN,100.83174670598545,118.48533177678726,0.16820516104264827,0.4732839436630769,0.30507878262042865,105728309,110062074,65.76404782939767,50.59053569585569,NaN,NaN,17.77591290539487,9.60864749074033
2010-09-16T09:30:00-04:00,33.13,33.48,33.10001,33.39,12863672,9185367.25,64.44620616280241,58.12717906751733,NaN,NaN,102.46080976173305,115.42275064028877,0.15795676837777695,0.5025247430926498,0.3445679747148729,118591981,113175338,68.01019539283952,53.22022307884022,NaN,NaN,19.345149248961206,10.999576313343312
2010-09-17T09:30:00-04:00,32.83,32.8999,32.5101,32.7325,8169617,8956454.75,55.69692322391367,58.50306605570337,NaN,NaN,51.21858201602127,103.70102433338596,0.09815144517689661,0.46725728118599363,0.369105836009097,110422364,113528087.2,68.26425715900187,55.93913833450277,NaN,NaN,18.249872350637837,12.035332890099673
2010-09-20T09:30:00-04:00,32.75999,33,32.53,32.94,8300340,8673385.05,57.65092976032923,59.323370426458105,NaN,NaN,54.38600259860216,86.43323319455007,0.06539846406385608,0.4508539160889171,0.38545545202506104,118722704,113127581.8,67.60773238787112,58.647121229896,NaN,NaN,17.884765184490476,12.870966075012644
2010-09-21T09:30:00-04:00,32.94,32.95,32.48,32.78999,16897536,9045735.5,55.737014864611545,59.912432258860505,NaN,NaN,44.28457359125205,70.63634293471878,0.02835382295239286,0.42089773071555214,0.3925439077631593,101825168,111058105.2,64.17334520738649,60.717372605018966,NaN,NaN,17.037010414346476,13.46611526634605
2010-09-22T09:30:00-04:00,32.78,33.12,32.75999,32.87,10198242,8812006.2,56.56526632895092,59.96333670640753,NaN,NaN,53.79015948218433,61.228025489958554,0.005175908731055334,0.3990137936769784,0.3938378849459231,112023410,112317125.4,65.32732214807879,62.52299814853069,NaN,NaN,16.55180442947743,13.906928003936246
2010-09-23T09:30:00-04:00,32.58,32.96001,32.42999,32.56,7173090,8531540.8,52.4686655941445,59.51511424624227,NaN,NaN,25.504485685031522,45.83676067461824,-0.03299690916402287,0.3525917484908945,0.38558865765491734,104850320,109568793.2,60.728913194805344,63.48276154541418,NaN,NaN,14.98116950500167,14.060391075517021
2010-09-24T09:30:00-04:00,32.97,33.41,32.95,33.36,8602969,8587667.2,60.432548371836546,59.44160878140076,NaN,NaN,85.62993208018688,52.71903068745136,-0.007654346522414701,0.37602072450189894,0.38367507102431364,113453289,110174978.2,61.37472351337553,64.08507039290137,NaN,NaN,15.919586616584272,14.32599043852663
2010-09-27T09:30:00-04:00,33.37,33.42,33.13,33.17,5773164,8358009.4,57.949183845996636,59.43821863131209,NaN,NaN,87.08582186499841,59.2589945407306,-0.006992114243530412,0.3749349282199006,0.381927042463431,107680125,107966462.4,57.65469115220502,64.08435155107095,NaN,NaN,15.948344432004472,14.557755294737749
2010-09-28T09:30:00-04:00,33.13,33.23,32.57001,33.17,8701594,8539749.85,57.94918384599665,59.29896542512545,NaN,NaN,46.0234868999269,59.60677720246557,-0.009692457640812724,0.36981147041241513,0.37950392805322786,107680125,109137453.8,59.07121503013864,63.931534523475776,NaN,NaN,15.971546935542468,14.759725529138423
2010-09-29T09:30:00-04:00,33.07001,33.13,32.8,32.91,9874844,8555227,54.401311017741364,58.99617044036732,NaN,NaN,26.491131003894015,54.1469715068075,-0.030929343386056796,0.34084224882065683,0.37177159220671363,97805281,106293828,54.319224367434096,63.3597566697976,NaN,NaN,14.979658588037264,14.791144537552544
2010-09-30T09:30:00-04:00,33.13,33.28,32.53999,32.78,10236473,8465203.4,52.66511620202365,58.41393999965997,NaN,NaN,-4.392040018398595,48.16766636612149,-0.05430451159321653,0.30389095271519295,0.3581954643084095,87568808,102837525.6,49.14437770883724,62.3426883855527,NaN,NaN,13.658635345325878,14.629357510091591
2010-10-01T09:30:00-04:00,32.98,33.24001,32.96001,33.21001,7769176,8545771.2,57.49712067444721,57.896745180100474,NaN,NaN,61.054080723435675,43.252496094771246,-0.04193224799790918,0.305780154311023,0.3477124023089322,95337984,99214464.6,44.372330206228966,60.86705287432445,NaN,NaN,13.863932261309362,14.520011045979844
2010-10-04T09:30:00-04:00,32.95,33.08,32.56,32.67999,13055535,8807907.9,50.63587851761152,56.945220542654916,NaN,NaN,-49.50756011121367,15.933819699528835,-0.06897406091317448,0.2614948261674641,0.3304688870806386,82282449,94134929.4,38.69870821025859,58.893648821989906,NaN,NaN,11.942643559588541,14.151815690781087
2010-10-05T09:30:00-04:00,33.06,33.72,33.06,33.60001,13122691,9159208.05,59.63925682818988,56.69532894561397,NaN,NaN,139.2049179190802,34.570105903359526,-0.026606905811226933,0.2972102548166049,0.32381716062783183,95405140,91679932.4,36.283946117441545,56.7879272711359,NaN,NaN,13.195603484257271,14.01521394699197
2010-10-06T09:30:00-04:00,33.67999,34.00999,33.64,33.92,6818250,9249023.3,62.22019510631761,56.536328155865064,NaN,NaN,207.77277561767784,70.8264348261163,0.018811619189762818,0.3473316846150354,0.32852006542527257,102223390,92563554.2,37.78863851545734,54.629244637037175,NaN,NaN,15.080624910094087,14.167415513149416
2010-10-07T09:30:00-04:00,34.02,34.03999,33.27,33.58,9139820,9469675.25,57.977833888447364,56.69925034618889,NaN,NaN,131.83345516606516,98.07153386300904,0.021599874169152766,0.3555199081367135,0.33392003396756076,93083570,93666506.6,39.70276778806335,52.58913825339871,NaN,NaN,15.241530507871135,14.320860512395376
2010-10-08T09:30:00-04:00,33.7,34.34,33.7,34.24001,7965039,9586279.35,63.2203539692121,57.0970663611091,NaN,NaN,206.7198674582365,127.2046912099692,0.061291208363040195,0.410534044421361,0.3492428360583208,101048609,94808631.6,41.70303962972937,50.73880305638858,NaN,NaN,17.173304090372092,14.728352452106336
2010-10-11T09:30:00-04:00,34.39999,34.41,34.05,34.17999,5867965,9276346.95,62.457265671568614,57.57708427589175,NaN,NaN,191.2185694639922,175.34991712501036,0.07594166481144582,0.4441699170726281,0.3682282522611823,95180644,97388270.6,46.05581503768457,49.44469375855274,NaN,NaN,18.43552968689184,15.257949199932836
2010-10-12T09:30:00-04:00,34.10001,34.32899,33.74001,34.27,7302590,9213842.45,63.17512379592338,58.049216952104075,NaN,NaN,145.54662833801373,176.61825920879707,0.08353046076267717,0.47264132821452876,0.3891108674518516,102483234,98803889.4,48.335549345363106,48.23099570121591,NaN,NaN,19.666836079177067,15.887790182682012
2010-10-13T09:30:00-04:00,34.67999,34.95,34.49001,34.82001,7310879,9257174.3,67.29085008077806,59.10794441543504,NaN,NaN,196.40892193683416,174.34548847262835,0.11546107003730105,0.5334372049984779,0.41797613496117686,109794113,100318034,50.733798983034546,47.517058971803706,NaN,NaN,22.056091667461132,16.76897610907903
2010-10-14T09:30:00-04:00,34.81,34.88,34.28999,34.49001,8266527,9027317.05,62.75867194589108,59.27409609929608,NaN,NaN,139.30333867218616,175.83946517385255,0.1045514595525524,0.5486654594018674,0.444113999849315,101527586,102006837.2,53.33565988460531,46.94284014117727,NaN,NaN,22.644851018952455,17.60838681048952
2010-10-15T09:30:00-04:00,34.75999,34.77,34.13,34.59,12297547,9233713.55,63.55954207245022,59.67483597261419,NaN,NaN,115.23861788957267,157.54321526011978,0.09456499242455091,0.5623202403800036,0.4677552479554527,113825133,104562142,57.033227180689025,46.89844985749755,NaN,NaN,23.36027377312578,18.430084948008986
2010-10-18T09:30:00-04:00,34.47,34.75,34.27,34.74001,6836586,9160525.85,64.78313226326908,60.162975145276505,NaN,NaN,109.54428757663983,141.2083588826493,0.08865726757489323,0.5785768324240692,0.489919564849176,120661719,109658357,63.2820609176678,47.19922456374964,NaN,NaN,24.3086680243759,19.269882530347118
2010-10-19T09:30:00-04:00,34.14,34.33,33.7,33.85001,15125063,9071902.2,53.339680359851336,60.08714438399864,NaN,NaN,37.241241795675535,119.54728157418167,0.019042635672273822,0.5137228594395182,0.4946802237672444,105536656,110269041.4,63.958491082638155,47.88774361483565,NaN,NaN,21.501344709924396,19.5886628417153
2010-10-20T09:30:00-04:00,33.99001,34.78,33.91,34.55,10184781,9071229.15,59.41229976435704,60.56908606702246,NaN,NaN,78.71167193158797,96.00783157313245,0.01457310794862332,0.5128966087030236,0.49832350075440024,115721437,111454506.2,65.29506335033125,49.041364017799516,NaN,NaN,21.076665040754637,19.801234584435207
2010-10-21T09:30:00-04:00,34.7,34.85001,34.17999,34.53999,11128520,9269000.65,59.29345992070017,60.697396013183386,NaN,NaN,83.34167495698836,84.81549883009289,0.005825813111382083,0.5056057671436278,0.49977995403224573,104592917,112067572.4,65.99733610015195,50.586007295936874,NaN,NaN,20.71018360204891,19.931084444094306
2010-10-22T09:30:00-04:00,34.56,34.61,34.17999,34.28999,8306801,9254192.25,56.26637067157409,61.09957402418071,NaN,NaN,59.39507472068843,73.64679019631605,-0.020473034975069304,0.4741886603134091,0.4946616952884784,96286116,108559769,58.680536027489445,52.013280711453355,NaN,NaN,19.472949363115085,19.86563657538299
2010-10-25T09:30:00-04:00,34.82001,35.17,34.74001,35.03,11364168,9533742.45,62.38751625449823,61.29587826891703,NaN,NaN,119.61414814313719,75.6607623096155,0.006832560009536137,0.5032023953003986,0.4963698352908624,107650284,105957482,53.905946016751244,53.271994989975475,NaN,NaN,20.356185184296976,19.93571494808499
2010-10-26T09:30:00-04:00,34.55,34.89999,34.31,34.82001,9339059,9565615.7,59.8285114853476,61.125043724562026,NaN,NaN,79.24644335646637,84.06180262177368,0.005662623597880667,0.5034481147882133,0.4977854911903326,98311225,104512395.8,51.404635870271385,54.24456622960505,NaN,NaN,20.262306489545313,19.98237088257932
2010-10-27T09:30:00-04:00,34.56,34.56,34.13,34.5,12326313,9688189.15,56.05506757140357,60.987703273344614,NaN,NaN,40.91546201503336,76.50256063846277,-0.020328019868143588,0.47237546635515315,0.49270348622329674,85984912,98565090.8,42.636227221469014,54.45409904627689,NaN,NaN,19.003485482381695,19.842530111122517
2010-10-28T09:30:00-04:00,34.78999,34.91,34.28999,34.52,10028781,9677804.55,56.24082660384808,60.489165604390045,NaN,NaN,60.01955840499825,71.83813732806473,-0.03876835363699194,0.44424304417705685,0.4830113978140488,96013693,96849246,40.49031419366056,54.367475800843394,NaN,NaN,18.052706468622524,19.586841019336806
2010-10-29T09:30:00-04:00,34.45,34.87,34.36,34.8,6784828,9628587.15,58.862574721097126,60.23240196507065,NaN,NaN,71.50437570700647,74.25999752532834,-0.034828673281529,0.4394755562121375,0.4743042294936665,102798521,98151727,42.84204759804307,54.13792098372614,NaN,NaN,18.006264657969123,19.361044396284278
2010-11-01T09:30:00-04:00,34.98,35.22,34.59,34.78,8097961,9380708.45,58.59253924575419,59.90507449720142,NaN,NaN,105.51641534993615,71.44045096668813,-0.036134075753885275,0.4291366348013099,0.4652707105551952,94700560,95561782.2,39.49937068604136,53.50676536520316,NaN,NaN,17.89333220247062,19.15137122573947
2010-11-02T09:30:00-04:00,35.09,35.36,34.99001,35.14,11729496,9311048.7,61.97410760385377,59.52530717742111,NaN,NaN,161.9228165606226,87.97572560751937,-0.016325494055376866,0.44486384298597414,0.461189337041351,106430056,97185548.4,42.52702000266777,52.92056686660554,NaN,NaN,18.7559705430895,19.09488541393233
2010-11-03T09:30:00-04:00,35.25,35.3,34.5,35.03999,17155920,9827932.2,60.4960472060305,59.363691124573926,NaN,NaN,106.23264335546193,101.03916187560509,-0.013641029138685645,0.44413805061799394,0.4577790797566796,89274136,97843393.2,43.75506347825198,52.236238551866016,NaN,NaN,19.069977854815072,19.091327191201295
2010-11-04T09:30:00-04:00,35.57001,36.19,35.56,36.19,10038152,9872848.8,69.5030641256453,59.78822841408786,NaN,NaN,292.2819496952556,147.49164013365657,0.057974093831691886,0.5302466970462945,0.47227260321460257,99312288,98503112.2,45.02372442189423,51.37841692623782,NaN,NaN,22.347274575429978,19.55646253180539
2010-11-05T09:30:00-04:00,36.24001,36.53999,36.11,36.32001,10102996,9979746.65,70.32675691498534,60.18420160349616,NaN,NaN,271.62000604854927,187.51476620196513,0.10381328299606268,0.6020392069596809,0.49822592396361826,109415284,99826464.8,47.57805182309736,50.25670199091136,NaN,NaN,25.230781155141845,20.367079477996313
2010-11-08T09:30:00-05:00,36.09,36.46001,36.05,36.41,7940895,10083393.15,70.91238163162075,61.43939455147969,NaN,NaN,207.48931682344886,207.90934649666764,0.12830305579478107,0.6586047437070945,0.5303016879123135,117356179,104357588.6,55.24553231927321,49.63434779352815,NaN,NaN,27.73990896876311,21.42034083382014
2010-11-09T09:30:00-05:00,36.59,36.71001,35.56,35.77,11364340,10286480.65,61.601029337638984,61.59573237814269,NaN,NaN,138.64438676759661,203.25366053806246,0.09124894863744548,0.6443628737091203,0.5531139250716748,105991839,104269945.2,55.077724002623555,48.904537840120454,NaN,NaN,27.072197333362276,22.227748905183304
2010-11-10T09:30:00-05:00,35.77,36.03999,35.35001,35.95,9327746,10387324,63.069785596549025,61.86546992641761,NaN,NaN,93.78879389293044,200.76489064555616,0.06968527687170878,0.6402205211613108,0.570535244289602,115319585,109479035,62.38992087881435,48.64686532431063,NaN,NaN,26.972755356134577,22.905606969604914
2010-11-11T09:30:00-05:00,35.77,36.34,35.75999,36.32001,9388605,10443427.9,65.95274110800653,62.55735352901992,NaN,NaN,114.48506151796514,165.20551301009806,0.07092828067619006,0.6591955951348396,0.5882673144586495,124708190,114558215.4,67.87999497567934,49.303969534895614,NaN,NaN,27.772386058592467,23.600861125174564
2010-11-12T09:30:00-05:00,35.91,36.048,35.21001,35.50999,17476656,10702383.35,55.70123051394151,62.07976169040874,NaN,NaN,49.69550761975478,120.82061332433918,0.010932488842222088,0.6019329255114272,0.5910004366692051,107231534,114121465.4,66.97466177588419,50.23744923197655,NaN,NaN,25.082032841527298,23.812457084653527
2010-11-15T09:30:00-05:00,35.61,35.71989,35.2,35.23,9725074,10846807.75,52.65458006034792,61.567338017194466,NaN,NaN,24.399061953030476,84.20256235025549,-0.050501156159242666,0.5278739914701518,0.5783751476293945,97506460,110151521.6,59.240370246101385,50.79714454453584,NaN,NaN,21.896521534217673,23.538752006019834
2010-11-16T09:30:00-05:00,34.82001,34.89,34.2,34.47,19878288,11084469,45.39629522320944,60.8059971351806,NaN,NaN,-72.5117681935131,41.971331358033545,-0.14013358094387063,0.4032081714495561,0.5433417523934267,77628172,104478788.2,50.301482350969664,51.34466276807159,NaN,NaN,16.57617138452611,22.54409763152073
2010-11-17T09:30:00-05:00,34.48,34.82001,34.3,34.46001,13330859,11241772.9,45.30788383466367,60.02507265166743,NaN,NaN,-72.94590471449837,8.624391636547793,-0.19455849596071406,0.30014363244253417,0.49470212840324823,64297313,94274333.8,38.92361241270709,51.232755498003485,NaN,NaN,12.439823458184678,21.100629892472725
2010-11-18T09:30:00-05:00,34.92,35.41,34.92,35.11,14432805,11406987.15,51.87512925227738,59.52596940389459,NaN,NaN,-8.150103086184966,-15.902641284282229,-0.1815011620260073,0.26782567587073913,0.44932683789674643,78730118,85078719.4,31.917399557079307,50.452423495077504,NaN,NaN,10.96220630672184,19.652283665936885
2010-11-19T09:30:00-05:00,35.12,35.39,34.92999,35.39,9048855,11444089.85,54.41447323997286,59.227536117767364,NaN,NaN,-3.0058417075418133,-26.442911149741548,-0.15002996839169613,0.26178937740712627,0.4118193457988224,87778973,81188207.2,29.498175685661693,49.738052423621816,NaN,NaN,10.57126051005799,18.354994643668473
2010-11-22T09:30:00-05:00,35.24001,35.50999,34.94,35.48,11731047,11462433.8,55.23216054745731,58.7459684708819,NaN,NaN,4.050220734840785,-30.512679393379493,-0.12045050368685428,0.2612562161902545,0.3817067198771088,99510020,81588919.2,30.085966999831854,48.84940578056211,NaN,NaN,10.507524924619824,17.23392754094724
2010-11-23T09:30:00-05:00,34.92999,35.02,34.63,34.8,13237266,11657344.15,48.19760273420289,57.86750815146564,NaN,NaN,-59.26291304701583,-27.862908364080045,-0.14247241252076065,0.203616204226158,0.34608861674691865,86272754,83317835.6,32.69336320006208,48.05928433211998,NaN,NaN,8.200099345444748,15.943380655875455
2010-11-24T09:30:00-05:00,35.08,35.47,35.03999,35.47,8013250,11441691,54.36489335657907,56.78621023938948,NaN,NaN,-0.6120460171662302,-13.396136624613618,-0.10920406815229194,0.20958353155655374,0.3187875997088457,94286004,89315573.8,40.9243079328616,47.76646886861764,NaN,NaN,8.236057174824179,14.842334444296702
2010-11-26T09:30:00-05:00,35.10001,35.16,34.87,34.94,4655688,11173036.35,49.358842335287974,55.288502055125385,NaN,NaN,-51.33982234987478,-22.03408047735158,-0.11935714423207533,0.16959116941875152,0.28894831365082685,89630316,91495613.4,43.62301177683851,47.483966008170576,NaN,NaN,6.594561734108447,13.664081199984095
2010-11-29T09:30:00-05:00,34.78999,35.28,34.3699,35.17,12834797,11475534.8,51.448227332490994,53.898205319473256,NaN,NaN,-61.68586294507658,-33.770084724858535,-0.10742022083425073,0.15467303760801343,0.26209325844226417,102465113,94432841.4,47.12757273470216,46.904111752129786,NaN,NaN,5.947870304933754,12.561765357834046
2010-11-30T09:30:00-05:00,34.88,35.48,34.7505,35.19,15605324,11850902.95,51.63509408450811,53.18635280139248,NaN,NaN,-35.50320049893737,-41.68076897161417,-0.09542034395717067,0.14281782849580082,0.2382381724529715,118070437,98144924.8,51.2519093698516,46.63083927836036,NaN,NaN,5.493260271891398,11.551978916985096
2010-12-01T09:30:00-05:00,35.78,36.17,35.7,36.14999,12299848,11879420.55,59.66068258335554,52.94284544330724,NaN,NaN,81.83043668915907,-13.462099024379189,-0.02380461435625819,0.20848240450764877,0.23228701886390696,130370285,106964431,59.362664815004734,46.414606702373966,NaN,NaN,7.727310550249604,11.005597721737168
2010-12-02T09:30:00-05:00,36.32001,36.78,36.22,36.7,9373754,11490312.25,63.40722337410901,52.76102274802884,NaN,NaN,136.82639826617648,14.025589832289356,0.0553132516152291,0.3014285833829433,0.24611533176771422,139744039,116056038,65.69842618257601,46.25878036000944,NaN,NaN,10.870354891101709,10.986277317360674
2010-12-03T09:30:00-05:00,36.55,37.09,36.53,37.00999,7872051,11382007.2,65.3599532525117,53.45093151506956,NaN,NaN,156.06920608219366,55.507395518703035,0.11954223629428856,0.39554312713557493,0.2760008908412864,147616090,127653192.8,71.74907269084203,46.59980971107785,NaN,NaN,14.064011813728477,11.425953673984646
2010-12-06T09:30:00-05:00,36.96001,37.13901,36.91,37.07001,4957238,11124719.3,65.7411529438439,54.385686721033565,NaN,NaN,159.90628773824233,99.82582565536683,0.1548472067526535,0.4695598992821033,0.3147126925294498,152573328,137674835.8,75.73272087740833,47.77783475617121,NaN,NaN,16.7138619792112,12.181369146159868
2010-12-07T09:30:00-05:00,37.53,37.61,37.05,37.12,10542402,11254794.65,66.07600493920441,55.86280884360463,NaN,NaN,163.62460852596325,139.65138746034694,0.16917940128398434,0.5261869441344302,0.3570075428504459,163115730,146683894.4,78.64759754088678,49.802557269736724,NaN,NaN,18.9541102792467,13.148903593743702
2010-12-08T09:30:00-05:00,37.14,37.27,36.53999,36.73,11792031,11276179.2,61.06165250552416,56.988078034380386,NaN,NaN,109.67762348343523,145.22082481920216,0.14115022087414736,0.5334453189431301,0.3922950980689827,151323699,150874577.2,79.85947825943569,52.726547687360195,NaN,NaN,19.442774549226584,14.048028015955543
2010-12-09T09:30:00-05:00,37.05,37.08,36.67999,36.92999,11514055,11385494.65,62.6278534379922,57.75612976193145,NaN,NaN,99.76970645327049,137.80948645662096,0.12536916085115474,0.5490065491329261,0.4236373882817714,162837754,155493320.2,81.13062129192309,56.24177781127761,NaN,NaN,20.30131511653428,14.941354744609649
2010-12-10T09:30:00-05:00,36.99001,37.28999,36.8,37.25,5218602,11176994.5,65.05029562430362,58.515831360812214,NaN,NaN,106.17203620557463,127.83005248129719,0.1254659089787346,0.5804697745051897,0.45500386552645505,168056356,159581373.4,82.20137033757402,60.006291714985636,NaN,NaN,21.739715158467362,15.912549089446465
2010-12-13T09:30:00-05:00,37.64,37.72,37.39999,37.45,6423238,10624323.6,66.51131057048107,59.32148493388534,NaN,NaN,118.6660367334359,119.58200228033589,0.12756476793363902,0.6144598254435039,0.48689505750986484,174479594,163962626.6,83.29540845382822,63.8069661045568,NaN,NaN,23.370405933203216,16.977957209983142
2010-12-14T09:30:00-05:00,37.44,37.66499,37.3,37.42,7113723,10493756.05,66.06518231261373,60.59774061805755,NaN,NaN,100.78662718508761,107.01440601216078,0.11583967692529107,0.6316946536664787,0.5158549767411876,167365871,164812654.8,83.50722471250761,67.43652764116005,NaN,NaN,24.5967492494964,18.066356072770752
2010-12-15T09:30:00-05:00,37.3,37.55,37.17,37.22,6694105,9834546.9,63.029865472040804,61.216667197733386,NaN,NaN,81.98421534494688,101.47572438446308,0.08495162563516545,0.6220445087851445,0.537092883149979,160671766,166682268.2,83.98813977953222,70.51251563020796,NaN,NaN,24.84148712947451,19.034231938014145
2010-12-16T09:30:00-05:00,37.28,37.58,36.99001,37.57001,9246184,9630313.15,65.97599581536963,62.403606732024926,NaN,NaN,79.27203850377099,97.3761907945632,0.0785785361149538,0.6353160532936712,0.5567375171787174,169917950,168098307.4,84.36011695325168,73.42230885709462,NaN,NaN,25.871224919236496,20.01094522104591
2010-12-17T09:30:00-05:00,37.22,37.59,37.17,37.56,7199668,9268656.3,65.81446306899036,63.42976642748916,NaN,NaN,77.00204792354006,91.54219313815626,0.06475030587582198,0.637675399523495,0.572925093647673,162718282,167030692.6,82.79833607085925,75.97022052396298,NaN,NaN,26.682227291247063,20.96398551678893
2010-12-20T09:30:00-05:00,37.8,37.86,37.47839,37.67999,5347305,9083578.8,66.8618298741772,64.51739041246553,NaN,NaN,87.72999855143746,85.35498550175657,0.0551229537949236,0.6418287858913274,0.5867058320964038,168065587,165747891.2,80.86123264330276,78.08517218635234,NaN,NaN,27.651759683528226,21.919381826323114
2010-12-21T09:30:00-05:00,37.83,38.12,37.82001,38.06,4813121,8737682.5,69.99696486934013,65.25569629003586,NaN,NaN,105.82693763785264,86.36304759230958,0.06510154504753896,0.6680827634058275,0.6029812183582886,172878708,166850458.6,81.26690109267582,79.64976049190027,NaN,NaN,29.390620074459186,22.986701576056838
2010-12-22T09:30:00-05:00,38.2,38.2,37.89,38.03999,3163089,8233973.65,69.62343963712226,65.69971173739394,NaN,NaN,107.22080552627003,91.41036562857421,0.06116894603886114,0.6794424009068649,0.6182734548680038,169715619,168659229.2,81.94308352619174,80.81009315930139,NaN,NaN,30.745014348624178,24.095031972137885
2010-12-23T09:30:00-05:00,37.84,38.25,37.84,38.14,3872365,8026929.4,70.4715690561388,66.06482715193873,NaN,NaN,106.65128620776369,96.88621516937275,0.056243215427456916,0.688577474152325,0.632334258724868,173587984,169393236,82.22349889885788,81.55826645987396,NaN,NaN,32.12938158211577,25.242796202134727
2010-12-27T09:30:00-05:00,38.11,38.22501,37.88,38.2,2408779,7914583.95,70.99479820442595,66.4400875276946,NaN,NaN,106.46302329928183,102.7784102445211,0.04827168971152063,0.6926738708642688,0.6444021811527482,175996763,172048932.2,83.23776772141807,82.09434123444609,NaN,NaN,33.44819036492389,26.414995368247464
2010-12-28T09:30:00-05:00,38.36,38.36,38.17,38.28,3437764,7444732.3,71.71447778498661,66.8428355881076,NaN,NaN,122.89520952785479,109.81145243980457,0.03997533151241517,0.6943713455432672,0.654396014030852,179434527,174322720.2,84.07554326549305,82.48205164334652,NaN,NaN,34.77162956937598,27.608800254122965
2010-12-29T09:30:00-05:00,38.44,38.5,38.34,38.44,2575149,6793223.55,73.149411303563,67.70624693082468,NaN,NaN,138.71679647498584,116.3894242072312,0.036924584650506076,0.7005517448439846,0.6636271601934786,182009676,176148913.8,84.73541912092492,82.83033313345291,NaN,NaN,36.31054663178321,28.851906879503
2010-12-30T09:30:00-05:00,38.42999,38.59,38.36,38.44,3577535,6357107.9,73.14941130356299,68.45778677836543,NaN,NaN,129.90751577558902,120.92676625709501,0.02702662573367387,0.6974104423605709,0.6703838166268971,182009676,178607725.2,85.60059658183053,83.14961708273201,NaN,NaN,37.62083823454128,30.104611358794184
2010-12-31T09:30:00-05:00,38.39,38.53999,38.31,38.41,2424684,6009654.4,72.3512616551209,68.97928435199525,NaN,NaN,109.70595307705372,121.53769963095301,0.011379705253874217,0.6846084481942398,0.6732287429403656,179584992,179807126.8,86.01693527038677,83.42215743507577,NaN,NaN,38.56701132852366,31.31352564018411
2011-01-03T09:30:00-05:00,38.82001,39.08,38.67,38.72,6056684,5918886.05,75.34493718328784,69.61025768148144,NaN,NaN,144.0201458719842,129.04912414549347,0.014621753517020553,0.6915059348366412,0.6768841813196207,185641676,181736109.4,86.68379005868809,83.66418469256577,NaN,NaN,40.224303878243425,32.58649395990687
2011-01-04T09:30:00-05:00,38.78,38.85001,37.97,38.46001,9489242,6145486.25,68.63308247499404,69.79367912165146,NaN,NaN,82.63765479482785,120.99761319888808,-0.006875668212449226,0.6682895960540591,0.6751652642665084,176152434,181079690.8,85.19484229796946,83.78472880581305,NaN,NaN,39.9428511985091,33.63740213685004
2011-01-05T09:30:00-05:00,38.25999,38.57001,38.09,38.55,7798871,6008309.7,69.64116450169205,70.26591476662655,NaN,NaN,72.39111644253454,107.73247719239782,-0.02040180305868189,0.649663010443156,0.6700648135018379,183951305,181468016.6,85.3551033286811,83.88236905932368,NaN,NaN,39.9626216376414,34.54100492267738
2011-01-06T09:30:00-05:00,38.57001,38.75,38.24001,38.35001,7772422,5807329.25,64.66715621381536,70.17242622365839,NaN,NaN,72.86794430108331,96.32456289749668,-0.04668197369428495,0.6117123463839818,0.6583943200782667,176178883,180301858,82.4681022146696,83.74722514942496,NaN,NaN,38.62779095092396,35.12483149814118
2011-01-07T09:30:00-05:00,38.47,38.58,37.98,38.315,11564105,5809831.75,63.807976594060264,70.0291057611634,NaN,NaN,46.23937613182616,83.63124750845117,-0.06894344106781403,0.5722150187434991,0.6411584598113131,164614778,177307815.2,75.41529576077545,83.21986512727612,NaN,NaN,37.27271638399786,35.4316721961207
2011-01-10T09:30:00-05:00,38.17,38.42999,37.72,38.36,10492676,6073535.45,64.46156389097773,69.85765819093486,NaN,NaN,20.634648742492416,58.954148082552805,-0.08225589285677137,0.5383385937403489,0.6205944865971202,175107454,175200970.8,70.82518838581368,82.50300482316977,NaN,NaN,36.27730176925605,35.55247642085432
2011-01-11T09:30:00-05:00,38.55,38.7,38.42,38.67,6610320,6082889.55,68.66030730500196,69.76218265062498,NaN,NaN,92.09024749813352,60.84466662321396,-0.07216225559785117,0.5303916670998063,0.6025539226976575,181717774,176314038.8,71.80166270464858,81.82691636688209,NaN,NaN,36.48230021819117,35.68530839190244
2011-01-12T09:30:00-05:00,38.97,39.11,38.83,39.05,6979582,6076182.5,72.88872222009228,69.99541712083713,NaN,NaN,154.2047135727627,77.20738604925958,-0.04329555147439679,0.5484344833546615,0.5917300348290583,188697356,177263249,72.64258000203226,81.16259468658498,NaN,NaN,37.92630391362592,36.00545060929151
2011-01-13T09:30:00-05:00,39.00999,39.08,38.62,38.71249,7299707,6106462.6,64.55735422851308,69.57297320457815,NaN,NaN,112.21277331789271,85.07635185262146,-0.04986662571133382,0.5293967526898911,0.5792633784012249,181397649,178307002.2,73.57573296897203,80.54489712016456,NaN,NaN,36.61599665243723,36.09267147259804
2011-01-14T09:30:00-05:00,38.64,38.8,38.39999,38.8,7921742,6040240.5,65.65356329660062,69.19145642544777,NaN,NaN,78.70405504174326,91.56928763460488,-0.05106750670825788,0.5154289950159026,0.5664965017241604,189319391,183247924.8,77.48998205351342,80.13434100102852,NaN,NaN,35.86830721152695,36.06061943530217
2011-01-18T09:30:00-05:00,38.845,39.05,38.81,39.0125,8238746,6092194.4,68.2237016059434,68.94211526980182,NaN,NaN,142.37233313395882,115.91682451289822,-0.04074653947580531,0.5155633273794038,0.5563098668552091,197558137,187738061.4,80.34010095701808,79.8675236932803,NaN,NaN,35.99888861959993,36.05180074734471
2011-01-19T09:30:00-05:00,39.08,39.10001,38.045,38.11,16018512,6625754.75,50.82773623009633,67.34770990741136,NaN,NaN,-6.515606355361383,96.19565374219924,-0.09480876869644173,0.437798905984657,0.5326076746810987,181539625,187702431.6,80.25326724354679,79.5473699877533,NaN,NaN,29.751072942936485,35.15169677528639
2011-01-20T09:30:00-05:00,37.71001,37.8222,37.241,37.57001,21857664,7477981.9,43.655204581101906,65.24098085580698,NaN,NaN,-238.71316546173148,17.6120779353004,-0.16304047708249214,0.3288070783279835,0.49184755541047565,159681961,181899352.6,67.4636977930242,78.25187721712427,NaN,NaN,21.688789113597487,33.22842425218798
2011-01-21T09:30:00-05:00,37.78,37.96001,37.42999,37.47749,11453121,7892483.5,42.547359810604796,63.11213072405584,NaN,NaN,-191.24955851914217,-43.080388432106574,-0.2076484293443932,0.23228701872998414,0.43993544807437734,148228840,175265590.8,56.39876309139872,76.1362934900537,NaN,NaN,15.181534761040627,30.65029718202407
2011-01-24T09:30:00-05:00,37.61,38.09,37.47,37.88,10497746,8223752.55,48.652403016325245,61.205521140701364,NaN,NaN,-132.42896237422556,-85.30699191530034,-0.2030461154740788,0.18612780373177884,0.38917391920585764,158726586,169147029.8,48.49788098867263,73.40872855648117,NaN,NaN,11.90730025419104,27.97272619233364
2011-01-25T09:30:00-05:00,37.75,37.92999,37.478,37.92751,13190781,8762852.65,49.33673208701445,59.827210398702825,NaN,NaN,-127.43725249434924,-139.26890904096194,-0.19003350853751472,0.15163203353396426,0.341665542071479,171917367,164018875.8,43.05391838715845,70.3986625628518,NaN,NaN,9.615447677755226,25.350257833108152
2011-01-26T09:30:00-05:00,38.06,38.8,38.05,38.73,11199289,9150928.9,59.22239619004715,59.083012662156754,NaN,NaN,31.998732369562376,-131.5660412959772,-0.12381745056456794,0.18689372886576905,0.310711179430337,183116656,164334282,43.47419284146372,67.40716895662199,NaN,NaN,11.135438326447627,23.31956933215665
2011-01-27T09:30:00-05:00,38.7,38.75,38.13,38.41,11238695,9584106.2,54.64364208712068,58.36704736739285,NaN,NaN,10.889793738930845,-81.64544945584474,-0.09907813982308811,0.18686350465147683,0.28594164447456494,171877961,166773482,46.74738821083703,64.85568938491966,NaN,NaN,10.716885621438324,21.519185944911175
2011-01-28T09:30:00-05:00,38.39999,38.69,37.78,37.81,14292277,10119843.3,47.264845421965326,57.18539514081465,NaN,NaN,-55.578553223447486,-54.511248396705795,-0.1192756530038504,0.13684707821975195,0.25612273122360235,157585684,168644850.8,49.17884386267829,62.98165710648415,NaN,NaN,7.6325905117435315,19.5353865973158
2011-01-31T09:30:00-05:00,38.06,38.48,37.92999,38.44,9979867,10497602.45,54.25048788828411,56.456032569193674,NaN,NaN,-14.680534759314064,-30.961562873723505,-0.08781232999647579,0.1463573187280076,0.2341696487244834,167565551,170412643.8,51.434684238284405,61.59662109594634,NaN,NaN,7.711376060493988,17.846242234912683
2011-02-01T09:30:00-05:00,38.8,39.55,38.73,39.47,16039000,10996718.25,62.90274254796374,56.04477794369094,NaN,NaN,170.81078116024034,28.6880438571944,0.00010885250391520773,0.23430571435437741,0.2341968618504622,183604551,172750080.6,54.32181100189501,60.34806026003537,NaN,NaN,11.337917701744303,16.9164815873172
2011-02-02T09:30:00-05:00,39.44991,39.60001,39.21001,39.405,6180875,10831299.9,62.1045148103608,55.2744774144244,NaN,NaN,170.56688864891322,56.40167511306457,0.048927163917285355,0.2953558167470689,0.24642865282978355,177423676,171611484.6,52.67898527030714,58.9220892077693,NaN,NaN,13.670587754497031,16.45278246834289
2011-02-03T09:30:00-05:00,39.42,39.645,38.96001,39.57001,10827234,10982718.05,63.37513247137306,55.19003300320012,NaN,NaN,141.371122013684,82.4979407680152,0.08524460268027478,0.35298440618012705,0.26773980349985227,188250910,174886074.4,56.73181082246023,57.718951911589876,NaN,NaN,15.905843490589838,16.37464832866388
2011-02-04T09:30:00-05:00,39.67999,39.73,39.245,39.575,8106891,10999441.5,63.415081339062006,55.0301414348045,NaN,NaN,136.3600409676851,120.88565960624173,0.10141652423965147,0.3945104587994166,0.2930939345597651,196357801,182640497.8,64.4881156433496,56.790247168006736,NaN,NaN,17.631859834061505,16.554249972292112
2011-02-07T09:30:00-05:00,39.7,40.0672,39.6956,39.78751,9181891,10880330.8,65.15806832883908,54.81116762929705,NaN,NaN,154.00674629175467,154.62311581645548,0.11712615987059272,0.43950163439800605,0.32237547452741333,205539692,190235326,70.13492237558324,56.06130584076139,NaN,NaN,19.592438312032726,16.988276877969344
2011-02-08T09:30:00-05:00,39.97,39.99001,39.64999,39.91499,7710109,10741202.45,66.19841128628502,55.90907299045339,NaN,NaN,133.20281390291842,147.1015223649911,0.12602914841390217,0.47991191004479106,0.3538827616308889,213249801,196164376,73.65662343418953,55.59011699723586,NaN,NaN,21.504391513272115,17.633436111584025
2011-02-09T09:30:00-05:00,39.82001,39.87,39.3,39.56,9668793,10894126.1,60.75794491160296,57.130697299774894,NaN,NaN,89.91975666731123,130.9720959686707,0.09912179887399736,0.4777850102233856,0.37866321134938824,203581008,201395842.4,76.31097825935883,56.22206560197405,NaN,NaN,21.51320551596797,18.187688883638874
2011-02-10T09:30:00-05:00,39.17,39.89,39.17,39.63,9011813,10995737.65,61.43106540060577,58.479533413346395,NaN,NaN,81.72018508320497,119.04190858257489,0.07807570122619933,0.4762578378821374,0.39818213665593805,212592821,206264224.6,78.48368603789731,57.799560098152526,NaN,NaN,21.714947186400295,18.691582926890504
2011-02-11T09:30:00-05:00,39.52,40,39.39999,39.85001,10078824,11134693.5,63.54746590470426,59.54346647680204,NaN,NaN,89.50883810749401,109.67166801053668,0.07120193136187425,0.48718455085828083,0.4159826194964066,222671645,211526993.4,80.55944603254822,60.08967188700079,NaN,NaN,22.495238936654026,19.234962356856723
2011-02-14T09:30:00-05:00,39.95,40.34,39.87,40.28,8574270,11167319.9,67.32163341887255,60.828102286220464,NaN,NaN,113.34476375119812,101.53927150242535,0.0868095858074619,0.5244946017557339,0.437685015948272,231245915,216668238,82.35076831253528,62.89658973881341,NaN,NaN,24.32219749442923,19.961710233652795
2011-02-15T09:30:00-05:00,40.3,40.31,39.75,39.82001,7201500,11115457.6,60.14725947052573,60.894163949111785,NaN,NaN,85.63998031223035,92.02670478428773,0.05869568138620318,0.511054617681026,0.4523589362948228,224044415,218827160.8,83.05678418362628,65.72391769182504,NaN,NaN,23.71675193681975,20.498144762676645
2011-02-16T09:30:00-05:00,40.05,40.44,40.02,40.33501,9793258,10804194.9,64.68492998916904,61.6113987992581,NaN,NaN,100.72742331160556,94.1882381131466,0.06673953293512691,0.5357833524637314,0.4690438195286045,233837673,224878493.8,84.88225276459238,68.44783658852184,NaN,NaN,24.641793198882706,21.090094539277512
2011-02-17T09:30:00-05:00,40.25999,40.72,40.13,40.7,8253273,10123975.35,67.5085262465412,63.057376001013516,NaN,NaN,115.46915142206593,100.93803138091877,0.08729929279913023,0.5781679355275173,0.4908686427283871,242090946,230778118.8,86.41857366978223,71.10781728902927,NaN,NaN,26.33108569815802,21.83880756197473
2011-02-18T09:30:00-05:00,40.75999,40.83,40.10001,40.25,7334270,9918032.8,61.02965064559122,63.541601912249746,NaN,NaN,101.49278019430085,103.33481979828014,0.06241627435425112,0.5688889856712009,0.5064727113169498,234756676,233195125,87.00138756305033,73.64829609794113,NaN,NaN,25.657775574493513,22.384374420905985
2011-02-22T09:30:00-05:00,39.73,40,38.89,38.96001,18530016,10319646.3,47.08067767418409,62.41145442126548,NaN,NaN,-11.917798222706145,78.28230740349929,-0.04339344696257752,0.4522309026137279,0.4956243495763054,216226660,230191274,82.27594284187191,75.64501980079662,NaN,NaN,19.736730333431154,22.006139551266724
2011-02-23T09:30:00-05:00,38.84,39.12,38.03,38.67,18820672,10601140.85,44.612000183536644,61.16198909077804,NaN,NaN,-97.86927477761398,41.58045638553044,-0.13046444748746522,0.3325437902169739,0.4630082377044391,197405988,224863588.6,74.54262179481516,77.20670812397576,NaN,NaN,14.25958021264995,20.899488217178614
2011-02-24T09:30:00-05:00,38.64999,39.00999,37.94,38.47,14233555,10752854.15,42.9398181298452,59.70232378066891,NaN,NaN,-112.74286856808958,-1.1136019904085799,-0.19518439233749196,0.21902774728257413,0.4142121396200661,183172433,214730540.6,62.50840569238863,77.61932204325636,NaN,NaN,9.414199398004257,19.258732671582276
2011-02-25T09:30:00-05:00,38.81,39.09,38.75999,39.03999,8357113,10608775.05,48.826844543190596,58.660306866678106,NaN,NaN,-61.38571135586121,-36.48457454599401,-0.19291857437390575,0.17306392165268392,0.36598249602658967,191529546,204618260.6,53.26651013528576,76.81777879268036,NaN,NaN,7.341274371689612,17.556238628740466
2011-02-28T09:30:00-05:00,39.19,39.46001,39.00999,39.46001,7958055,10292063.95,52.69955869890025,57.770413321682476,NaN,NaN,-29.57716150767641,-62.69856288638946,-0.15791719051867992,0.16858600787823974,0.32650319839691966,199487601,197564445.6,47.941792701154476,75.23255524450688,NaN,NaN,6.953776306298871,16.04160115410595
2011-03-01T09:30:00-05:00,39.55,39.64,38.47,38.49001,18092528,10697697,44.35178291772297,56.209939866785184,NaN,NaN,-102.93343971675465,-80.90169118519916,-0.19258052237388384,0.08577754542956484,0.2783580678034487,181395073,190598128.2,43.33455576796871,73.06669326834826,NaN,NaN,3.6039554321573464,14.264794622399007
2011-03-02T09:30:00-05:00,38.44,38.8781,38.38,38.63,11219895,10456741.75,45.6888787302806,55.13357799669073,NaN,NaN,-125.2908676197173,-86.38600975361982,-0.1978153406457833,0.03108889199621956,0.22890423264200285,192614968,189639924.2,42.72633489194195,70.66779017067563,NaN,NaN,1.4778488238110632,12.438088079743586
2011-03-03T09:30:00-05:00,39.08,39.41,39.00999,39.41,8716859,10583540.95,52.53255424132049,54.49797005674178,NaN,NaN,-32.51307129035673,-70.34005029807324,-0.1430357147095729,0.050109589255036724,0.19314530396460963,201331827,193271803,45.82979051482597,68.3353690618848,NaN,NaN,2.035973996168123,10.952071782089948
2011-03-04T09:30:00-05:00,39.45,39.46001,38.75,39.05,11563828,10620370.65,49.43628278079947,53.490028405034295,NaN,NaN,-54.899390273713784,-69.04278608164375,-0.12593796575248767,0.03572284677400006,0.16166081252648773,189767999,192919493.6,45.57182328766431,65.83625315153596,NaN,NaN,1.4420184411047836,9.593492733377783
2011-03-07T09:30:00-05:00,39.35001,39.44,38.19,38.38,18317728,11130912.5,44.213280269142345,51.83943175148214,NaN,NaN,-97.32706332967024,-82.59276644604253,-0.15285121720457046,-0.029403208979225326,0.12344800822534512,171450271,187312027.6,41.56187394852246,62.922760696963614,NaN,NaN,-0.8472392802349846,8.101959588575959
2011-03-08T09:30:00-05:00,38.47,38.955,38.07001,38.82001,10489383,11196287.1,48.09193975884606,50.97833748636217,NaN,NaN,-93.716227738851,-80.74932405046181,-0.13475225010831732,-0.04499230441005153,0.08975994569826579,181939654,187420943.8,41.669235965368436,59.966507252802344,NaN,NaN,-1.4078832225734275,6.743410615554618
2011-03-09T09:30:00-05:00,38.63,38.6304,38,38.19,17671168,11694340.05,43.43539110826322,49.46051328058318,NaN,NaN,-121.67032435827386,-80.02521539817312,-0.15736832322246275,-0.10695045832981265,0.0504178648926501,164268486,181751647.4,37.778591805176845,56.601960041415516,NaN,NaN,-3.4522785630360096,5.286883590041671
2011-03-10T09:30:00-05:00,37.64,37.82941,37.17999,37.355,31037040,12762752.4,38.16139496503237,47.36428961761826,NaN,NaN,-181.8198414121875,-109.88656942253927,-0.21704153150017103,-0.22088404948256368,-0.003842517982392657,133231446,168131571.2,30.428107237805065,52.60264101056,NaN,NaN,-7.042807307547198,3.5254991761004044
2011-03-11T09:30:00-05:00,37.21001,38.03,37.06,37.91,14695156,13046919.55,43.106231755312365,46.08404541116977,NaN,NaN,-139.21881020316985,-126.75045340843049,-0.20761203173934675,-0.2633575576565761,-0.055745525917229345,147926602,159763291.8,26.957601465535916,48.31379914645182,NaN,NaN,-8.27478403630127,1.839744431471594
2011-03-14T09:30:00-04:00,37.75999,38.10001,37.38,37.77,17616432,13423799.95,42.18976003416852,45.73469415116866,NaN,NaN,-117.52864188283544,-130.79076911906353,-0.19924468981819984,-0.30480138818997915,-0.1055566983717793,130310170,151535271.6,24.052735077587954,44.154998591860114,NaN,NaN,-9.53238630835474,0.2151543257821178
2011-03-15T09:30:00-04:00,36.60001,37.96001,36.44,37.77,22889360,14139554.45,42.18976003416853,45.56167699764236,NaN,NaN,-137.2334434259947,-139.49421225649226,-0.1825931258578114,-0.33379810569404356,-0.15120497983623216,130310170,141209374.8,20.995134888863603,40.33017809857785,NaN,NaN,-10.519723254851463,-1.3183996143083938
2011-03-16T09:30:00-04:00,37.73,37.83,36.56,37.00999,23415808,14950269.85,37.20908064508666,45.1523386058739,NaN,NaN,-144.3294390730404,-144.02603519944557,-0.20970797052292295,-0.41333994298988586,-0.2036319724669629,106894362,129734550,18.222863088371028,37.16692505543375,NaN,NaN,-12.962515634073354,-2.9818447599891025
2011-03-17T09:30:00-04:00,37.74001,38.00999,37.44501,37.67,22441104,15582662.15,43.45234887350942,44.76844605803952,NaN,NaN,-85.522232269871,-124.76651337098227,-0.1717330213970248,-0.4182982492132439,-0.2465652278162191,129335466,128955354,18.04858386960744,34.651358893599586,NaN,NaN,-13.059659768840618,-4.421532618396462
2011-03-18T09:30:00-04:00,38.09,38.19,37.64,37.73,14929059,15916451.45,43.99748889989212,44.146869643824665,NaN,NaN,-62.96206290133466,-109.51516391061523,-0.13285158227903404,-0.41262970566501167,-0.27977812338597763,144264525,128222938.6,17.875529194557913,32.5037686431284,NaN,NaN,-12.971215803901357,-5.642915930611447
2011-03-21T09:30:00-04:00,38.31,38.46001,38.06,38.38499,8467918,15973133.85,49.698389790490566,44.52877013473663,NaN,NaN,-7.40458910191128,-87.49035335443038,-0.05716653465872501,-0.35123629170938386,-0.29406975705065885,152732443,132707393.2,22.758961333874794,31.03408332640741,NaN,NaN,-11.110217297819498,-6.42395898306974
2011-03-22T09:30:00-04:00,38.35001,38.46001,38.07001,38.295,7588234,15426044.75,48.96094410436911,44.76248909002867,NaN,NaN,-5.014641471031891,-61.04659296343783,-0.009793822588214707,-0.3063120352859272,-0.2965182126977125,145144209,135674201,25.898348815932238,29.832084320978144,NaN,NaN,-9.828220748768915,-6.910282092455336
2011-03-23T09:30:00-04:00,38.31,38.959,38.08,38.85001,13165172,15143269.75,53.53982937223425,44.83443731366537,NaN,NaN,38.98965091369183,-24.3827749660914,0.05853462547950122,-0.223349930848336,-0.2818845563278372,158309381,145957204.8,35.659411730140775,29.105628693500627,NaN,NaN,-7.316700982513119,-6.968341933892162
2011-03-24T09:30:00-04:00,39.12,39.17999,38.63,39.02,11557508,15009467.4,54.87513384920723,45.222926675694495,NaN,NaN,71.94312718048899,7.110296923980601,0.11171134356019813,-0.14224537687758954,-0.25395672043778766,169866889,154063489.4,42.1308774930415,28.859846851027573,NaN,NaN,-4.857736357152135,-6.66682685150073
2011-03-25T09:30:00-04:00,39.21001,39.545,39.05,39.23,10549902,15119106.85,56.537013882488274,46.10319336236206,NaN,NaN,106.6537807674758,41.033465657742695,0.15490237137115873,-0.060328756223839264,-0.215231127594998,180416791,161293942.6,47.229332315505786,29.2646653058121,NaN,NaN,-2.3200428989717357,-6.045857715425159
2011-03-28T09:30:00-04:00,39.22,39.52,39.00999,39.05,11918328,15317120.5,54.6782002528592,46.573640540505856,NaN,NaN,98.86129410584836,62.28664229929463,0.16432847420160296,-0.009820534842994277,-0.17414900904459724,168498463,164447146.6,49.326085750901775,29.81158314763591,NaN,NaN,-0.6976581352173991,-5.2818292039669075
2011-03-29T09:30:00-04:00,39.06,39.46001,38.78661,39.46001,9726488,14898818.5,58.06064964870565,47.61830186482318,NaN,NaN,98.45489145027696,82.9805488835564,0.1893757662994114,0.06257069882966704,-0.12680506746974438,178224951,171063295,53.500900145884344,30.934605171972155,NaN,NaN,1.689259536682361,-4.285959383874155
2011-03-30T09:30:00-04:00,39.86,39.955,39.33,39.87,15092949,15092471.2,61.18052548763463,49.262525473580475,NaN,NaN,134.59342974089628,102.10130464899729,0.22246819472536986,0.15128017593696796,-0.07118801878840189,193317900,178064998.8,57.49211743434781,32.86774875743949,NaN,NaN,4.677330703434854,-3.0054893714014392
2011-03-31T09:30:00-04:00,39.83,40.229,39.8,40.02,10527859,15183021.2,62.28593113768356,50.6325040008927,NaN,NaN,152.8945622642089,118.29159166574127,0.24176939452847013,0.23102372437218577,-0.01074567015628436,203845759,184860772.8,60.991858860098,35.29876714276536,NaN,NaN,7.488310379174376,-1.5063751213191803
2011-04-01T09:30:00-04:00,40.25,40.37,40,40.17,9269684,15068314,63.40805852939865,52.148096750552,NaN,NaN,151.4064402156404,127.24212355537418,0.25086367726880365,0.3028339264297202,0.051970249160916554,213115443,191400503.2,64.05853466121235,38.15632425588139,NaN,NaN,10.17151296521187,0.1618946053281125
2011-04-04T09:30:00-04:00,40.37,40.56,40.3094,40.42999,7014688,14503162,65.3333677716287,53.80121158894201,NaN,NaN,148.54729218053637,137.17932317031176,0.2595312605845039,0.3763843248915464,0.11685306430704252,220130131,201726836.8,68.2967875913672,41.53501373463164,NaN,NaN,13.027755114281131,1.9998746780356864
2011-04-05T09:30:00-04:00,40.39999,41.07001,40.24001,40.91,9386617,14448023.7,68.6165435891202,56.04460179923012,NaN,NaN,144.7216667118457,146.43267822262553,0.2809266660800018,0.46801139690704474,0.18708473082704297,229516748,211985196.2,71.848291457468,45.36540147528142,NaN,NaN,16.53609359727312,4.07647738078389
2011-04-06T09:30:00-04:00,41.24001,41.28,40.45,40.57001,15107414,14319836,63.99359029857448,57.51183332959192,NaN,NaN,126.74883994664478,144.86376026377522,0.25620726840048386,0.5073438163276478,0.25113654792716394,214409334,216203483,73.17883629752869,49.30327664870436,NaN,NaN,18.265114480187872,6.103425537841602
2011-04-07T09:30:00-04:00,40.69,40.95,40.3,40.49001,13078844,13421926.2,62.91939381945507,58.863397966703566,NaN,NaN,103.51397791098609,134.98764339313067,0.21988784338216472,0.5259963521548698,0.3061085087727051,201330490,215700429.2,72.73732169034398,53.221976112689084,NaN,NaN,19.404348420324116,8.003557378196247
2011-04-08T09:30:00-04:00,40.8,40.92,40.03,40.2,8652422,13119789.5,59.049733370197636,59.53135107953978,NaN,NaN,82.68377845101213,121.24311104020504,0.16429815378007556,0.5114812009977996,0.34718304721772403,192678068,211612954.2,69.08979211273865,56.531321168322215,NaN,NaN,19.32089226695351,9.62031950516157
2011-04-11T09:30:00-04:00,40.31,40.495,39.57001,39.75,10379820,12757958.9,53.54666418010442,59.858902513520874,NaN,NaN,48.43437831561347,101.22052826722043,0.08895968228972762,0.45838265007988355,0.36942296779015593,182298248,204046577.6,62.81075489549077,59.16792160257639,NaN,NaN,17.653123111795136,10.767862877537793
2011-04-12T09:30:00-04:00,39.30009,39.52,39.06,39.21001,13367586,12281870.2,47.791052157689556,59.44827556962482,NaN,NaN,-4.928841949653102,71.29042653492067,-0.0007532846018237782,0.3684813620378762,0.36923464663969996,168930662,191929360.4,54.29982143471468,60.49937943861739,NaN,NaN,14.40933098519496,11.288072607203102
2011-04-13T09:30:00-04:00,39.49001,39.53,38.675,38.98,16093438,11915751.7,45.545366448665504,58.781863612443274,NaN,NaN,-30.519049230704066,39.836848699450904,-0.07498908844431423,0.27549828608430715,0.3504873745286214,152837224,179614938.4,47.28716893270836,60.86768597002216,NaN,NaN,11.016542032754442,11.249282525139007
2011-04-14T09:30:00-04:00,38.72,39.23,38.72,39.10001,15791484,11583270.7,46.94616148946685,58.096802727227455,NaN,NaN,-42.98864905947444,10.536323305358806,-0.11312416883310072,0.2090821634872455,0.32220633232034623,168628708,173074582,44.03443589737585,60.63947908301288,NaN,NaN,8.600273851684499,10.870852714645507
2011-04-15T09:30:00-04:00,39.28,39.42999,38.98,39.36,11342902,11403962.85,49.94994224356696,57.75907001227801,NaN,NaN,-30.166273459422907,-12.03368707672819,-0.11744188177449744,0.17540398010222447,0.2928458618767219,179971610,170533290.4,42.80243409394795,60.17350396465904,NaN,NaN,7.3717792735599375,10.370985080204711
2011-04-18T09:30:00-04:00,38.89999,39.00999,38.44,38.81,11250188,11543076.35,44.2431950914601,56.772108972474754,NaN,NaN,-84.97141228797214,-38.714845197445335,-0.151761178015125,0.10314438935781567,0.2549055673729407,168721422,167817925.2,41.467424462866454,59.31396998730062,NaN,NaN,4.539812174738514,9.537960379423826
2011-04-19T09:30:00-04:00,38.97,39.53999,38.92999,39.5,16135523,11970440.8,51.698796429896085,56.09484261120771,NaN,NaN,-34.45928480150421,-44.62093376781555,-0.12360601366485477,0.10039805029187221,0.22400406395672698,184856945,171003181.8,43.68628973738315,58.327839437517426,NaN,NaN,4.3424250921107586,8.795741052664816
2011-04-20T09:30:00-04:00,40.17,40.3,39.89,40.02,13241781,11974271.25,56.427442278755365,55.67637912128426,NaN,NaN,42.02415498831171,-30.1122929240124,-0.06833628772801043,0.13858370429671396,0.2069199920247244,198098726,180055482.2,49.540586264701254,57.50989139498909,NaN,NaN,5.7141448508180686,8.355513023829566
2011-04-21T09:30:00-04:00,40.24001,40.45,40.11,40.45,7676887,11780240.2,59.92157411632472,55.42734452035042,NaN,NaN,65.7523408448753,-8.364094943142451,-0.004556847768408312,0.20122393231421398,0.2057807800826223,205775613,187484863.2,53.78682795542611,56.776198058861496,NaN,NaN,8.008407676221783,8.305926545599883
2011-04-25T09:30:00-04:00,40.34,40.49001,39.95,40.14,6056719,11555581.05,56.409555322279054,54.78992934539688,NaN,NaN,44.20753187205846,6.510666123153823,0.013998207199652113,0.22327853908218742,0.2092803318825353,199718894,191434320,55.91087163287523,55.89148977611207,NaN,NaN,8.784008159622122,8.374223919031632
2011-04-26T09:30:00-04:00,40.31,40.74001,40.14,40.59,8722035,11395766.4,60.06826000073092,54.17933766051192,NaN,NaN,73.3394440520724,38.17283739116273,0.05170432691040508,0.27391074052054165,0.22220641361013657,208440929,199378221.4,59.90288469659433,55.03824643604967,NaN,NaN,10.617926020907403,8.69475279072817
2011-04-27T09:30:00-04:00,40.64999,40.72,39.89,40.72,13122613,11565572.65,61.0844496225937,53.97154189794186,NaN,NaN,62.82162273317474,57.629018898098515,0.07889784884107034,0.3208287246614745,0.24193087582040415,221563542,206719540.8,63.2174545695043,54.326719169762214,NaN,NaN,12.407825034044851,9.225191682630554
2011-04-28T09:30:00-04:00,40.67,41.02,40.52,40.71001,13802855,11501067.95,60.95607465938663,53.83130481507983,NaN,NaN,92.86919317377158,67.79802653519049,0.08896308987652657,0.35313473816606233,0.26417164828953577,207760687,208651933,64.05962974523057,53.70688403082554,NaN,NaN,13.808158959432326,9.879901293602236
2011-04-29T09:30:00-04:00,40.89,41,40.59,40.87,13400039,11644676.95,62.321765040327946,54.06502136294629,NaN,NaN,91.76676945698621,73.00091225761267,0.09840998132822082,0.3871841249498118,0.288774143621591,221160726,211728955.6,65.41743640255663,53.44457290866968,NaN,NaN,15.37128260956073,10.664384338739163
2011-05-02T09:30:00-04:00,41.02,41.16499,40.495,40.58,10242426,11693314.05,58.338459875614234,54.40729248405413,NaN,NaN,77.10673535205736,79.58075295361246,0.0780324747850416,0.386314737102893,0.3082822623178514,210918300,213968836.8,66.41219119716024,53.701818358788934,NaN,NaN,15.600391883078466,11.369528273644777
2011-05-03T09:30:00-04:00,40.55,40.60001,39.88499,40.21001,15248844,12105021.85,53.628909243225245,54.8242822758781,NaN,NaN,19.95238988543174,68.90334212028432,0.03474720921535218,0.3517162738370416,0.31696906462168944,195669456,211414542.2,64.14618862853379,54.405130301204586,NaN,NaN,14.435077359067492,11.807463857276593
2011-05-04T09:30:00-04:00,40.17,40.22,39.23,39.5,21349280,12703155,45.96105782166727,54.85397451680681,NaN,NaN,-40.89596936636442,48.15982370037649,-0.04240558873816114,0.263962078698988,0.30636766743714916,174320176,201965869,56.47047823305341,55.06108096551494,NaN,NaN,10.94497510716981,11.68425117868991
2011-05-05T09:30:00-04:00,39.22,39.75,38.83,39.03,24912160,13193392.3,41.70968038897852,54.47994015248621,NaN,NaN,-81.93875874750157,13.198233316121863,-0.12132789430166202,0.15470779956007163,0.27603569386173366,149408016,190295334.8,48.716441227526225,55.39550991766855,NaN,NaN,6.573464534267711,10.954138800915311
2011-05-06T09:30:00-04:00,39.73,39.92,39.12,39.35001,19618064,13520353.3,45.41210616396399,54.15580900394314,NaN,NaN,-46.425346660632314,-14.440189907401836,-0.14652893187766622,0.09287452901465088,0.2394034608923171,169026080,179868405.6,43.031300174697805,55.41185749486497,NaN,NaN,4.08068071910698,9.972216217799836
2011-05-09T09:30:00-04:00,39.42999,40.0401,39.39,39.92,13376645,13756564.45,51.340608163790534,54.66276708053817,NaN,NaN,-6.685707256123446,-31.198678429038,-0.12045033072389913,0.08884054748744319,0.20929087821134232,182402725,174165290.6,40.26360215539631,55.32587018718852,NaN,NaN,3.82450549464983,9.093971828778407
2011-05-10T09:30:00-04:00,40.08,40.34,39.82001,40.25999,12194840,13847315.45,54.51390621745156,54.86384635107785,NaN,NaN,33.79908836959751,-28.429338732204837,-0.07800126084106956,0.11178930216000538,0.18979056300107494,194597565,173950912.4,40.15904091142076,55.07392384247692,NaN,NaN,4.628819895165572,8.456092981119431
2011-05-11T09:30:00-04:00,40.14999,40.17999,39.021,39.19,18086560,14083264.15,44.646000205563055,54.022314774421254,NaN,NaN,-46.971019063223565,-29.644348671576672,-0.11732059767271,0.04313981591018745,0.16046041358289745,176511005,174389078.2,40.49915435100335,54.42810727721279,NaN,NaN,1.8994203373911296,7.519425460586817
2011-05-12T09:30:00-04:00,39.07001,39.39,38.67,39.14999,18068560,14182020.25,44.322913182452886,52.90812470771613,NaN,NaN,-93.76190344833256,-32.00897761174287,-0.13983128835433345,-0.014328696860019363,0.1255025914943141,158442445,176195964,41.96402554974114,53.58362139109243,NaN,NaN,-0.299278628356516,6.4024677335949125
2011-05-13T09:30:00-04:00,39.3,39.37,38.53101,38.64999,19660544,14375473.25,40.389318406934855,51.763822070905825,NaN,NaN,-117.1038594124218,-46.14468016210077,-0.17966338105239013,-0.09907663482117357,0.08058674623121656,138781901,170147128.2,38.54306313658578,52.34306364135747,NaN,NaN,-3.452020089597965,4.994683758853073
2011-05-16T09:30:00-04:00,38.50999,39.25,38.38,38.50999,19577008,14787178.55,39.33662682101416,50.28299112949749,NaN,NaN,-124.03596650352915,-69.6147320115819,-0.2048802806824404,-0.17551360462183396,0.02936667606060646,119204893,157507561.8,32.56840903409555,50.39060109403613,NaN,NaN,-6.301113531515274,3.380998431657595
2011-05-17T09:30:00-04:00,38.28999,38.46001,37.83,38.06,23337472,15391542.75,36.08142569287765,48.497060848803486,NaN,NaN,-177.6053233088656,-111.89561434727455,-0.23893062289739242,-0.2692966025611341,-0.030365979663741646,95867421,137761533,25.831650629898803,47.72018652692145,NaN,NaN,-9.759491575583308,1.5037855734803232
2011-05-18T09:30:00-04:00,38.24001,38.95,38.03999,38.91,17609184,15465225.8,45.29101231128564,47.37812782393913,NaN,NaN,-112.58976049305669,-125.01936263324117,-0.19322572458131068,-0.27189813539038,-0.07867241080906931,113476605,125154653,22.615261542800923,44.75987451246219,NaN,NaN,-9.782002506404531,-0.10846986650322732
2011-05-19T09:30:00-04:00,38.95,39.31,38.73,38.89999,12817859,15444029.7,45.208402419620946,46.15574477960291,NaN,NaN,-69.99271991793739,-120.26552592716214,-0.1543711414575968,-0.2716363376310653,-0.1172651961734685,100658746,113597913.2,20.13965892837753,41.52574755002082,NaN,NaN,-9.825108157037892,-1.4965610508653222
2011-05-20T09:30:00-04:00,38.8,38.91,38.21001,38.50999,17790944,15949732.55,41.994534605162315,44.988321545999206,NaN,NaN,-100.48062744273841,-116.94087953322546,-0.14574525565191848,-0.2994467657383666,-0.1537015100864481,82867802,102415093.4,18.077516067186778,38.07327075502271,NaN,NaN,-10.855410074501888,-2.833539482813403
2011-05-23T09:30:00-04:00,37.89,38.24001,37.73,38.11,13287234,16311258.3,38.93720126432732,43.93891383322078,NaN,NaN,-131.46584875344806,-118.42685598320925,-0.15682367042821385,-0.34973109812171543,-0.19290742769350158,69580568,92490228.4,16.46607410666917,34.66754828917524,NaN,NaN,-12.675335580715592,-4.239510353942287
2011-05-24T09:30:00-04:00,38.38,38.75,38.09,38.3,16593184,16704815.75,41.12968086053921,43.593815478854495,NaN,NaN,-90.85796746720538,-101.0773848148772,-0.14166239392190244,-0.36998542009587965,-0.2283230261739772,86173752,90551494.6,16.162981293035244,31.78844136488822,NaN,NaN,-13.510400372095546,-5.563923213678467
2011-05-25T09:30:00-04:00,38.23,39.06,38.14999,38.84,16084969,16852933.55,46.95872872431375,43.968747502807005,NaN,NaN,-57.95702770155473,-90.1508382565768,-0.08819030684695484,-0.3385609097326707,-0.2503706028857159,102258721,88307917.8,15.80051774801153,29.437303973494316,NaN,NaN,-12.435000832929,-6.5455057307142575
2011-05-26T09:30:00-04:00,38.73,39.06,38.51649,38.92999,10170766,16671329.1,47.88481341246062,44.14536944912819,NaN,NaN,-38.714261922508626,-83.89514665749104,-0.04202642442044241,-0.3029036334112689,-0.2608772089908265,112429487,90662066,17.88146746173649,27.64088735113993,NaN,NaN,-11.289613249175005,-7.22323537620865
2011-05-27T09:30:00-04:00,39.24001,39.50999,39.14999,39.35001,10602129,16531433.6,52.089448866340014,44.19885807073887,NaN,NaN,22.5610934125627,-59.28680248643084,0.018294360228963524,-0.23800925870462208,-0.2563036189335856,123031616,98694828.8,24.718335599142804,26.530511168550397,NaN,NaN,-9.029797193754456,-7.481315635858051
2011-05-31T09:30:00-04:00,39.71001,39.87,39.16,39.75,16058652,16822244.9,55.75073724283849,44.2872031439808,NaN,NaN,66.44547180822005,-19.70453837409721,0.08300633736640708,-0.15254569722557676,-0.23555203459198384,139090268,112596768.8,34.83073062254479,26.14991757648783,NaN,NaN,-5.970062701093745,-7.26542235946315
2011-06-01T09:30:00-04:00,39.57001,39.64,38.46001,38.50999,17749488,16947277.1,44.41825597802046,44.270935699156325,NaN,NaN,-21.499077741712732,-5.832760428998675,0.04222816321652173,-0.1827668305713317,-0.22499499378785343,121340780,119630174.4,39.27506578723684,26.062482679075938,NaN,NaN,-6.8802085399955955,-7.210391813824928
2011-06-02T09:30:00-04:00,38.58,38.99001,38.11,38.57001,20052176,16882421.9,45.001009092445486,44.31937112129865,NaN,NaN,-61.794193060471905,-6.6001935007821135,0.020337096162280188,-0.1995736235850032,-0.21991071974728338,141392956,127457021.4,43.86301791184272,26.198124990654623,NaN,NaN,-7.399964861605062,-7.237473677793519
2011-06-03T09:30:00-04:00,37.96001,38.35001,37.88,38.08,16478914,16460759.6,41.202848606195936,44.37748042124586,NaN,NaN,-117.17596809984816,-22.292534736250012,-0.023716314145769413,-0.24955611242949516,-0.22583979828372575,124914042,129953932.4,45.2832936664354,26.679570028501022,NaN,NaN,-9.062876878630675,-7.498245563627398
2011-06-06T09:30:00-04:00,38.08,38.33,37.63,37.7,14293031,16194507.95,38.48978555244204,44.316991759205,NaN,NaN,-135.3006792985642,-53.86488927847538,-0.07227666381238307,-0.3161856280492046,-0.2439089642368215,110621011,127471811.4,44.089141090022366,27.502479461067225,NaN,NaN,-11.310999534149403,-8.042924702273398
2011-06-07T09:30:00-04:00,37.98,38.23,37.73,37.84,11518078,16101579.6,40.05584628573709,44.600878944409246,NaN,NaN,-118.43212302655131,-90.84040824542964,-0.0877663436612478,-0.35361689381338124,-0.26585055015213344,122139089,124081575.6,42.442808532488584,28.68899073982364,NaN,NaN,-12.651716499470464,-8.701323530444407
2011-06-08T09:30:00-04:00,37.73,37.75,37.33,37.45,17467168,16365196,37.213462637284024,44.023911110551985,NaN,NaN,-166.48201334671492,-119.8369953664301,-0.11533929831336753,-0.4100246730438428,-0.2946853747304753,104671921,120747803.8,40.828308841815996,29.98992268975329,NaN,NaN,-14.65908773630501,-9.552432702710208
2011-06-09T09:30:00-04:00,37.62,38.28,37.55,38.07001,17570352,16339385.6,44.01500208474528,43.93866822948944,NaN,NaN,-87.00472878000896,-124.8791025103375,-0.0843210354511556,-0.4000866690444198,-0.3157656335932642,122242273,116917667.2,38.99310322767827,31.336597282560483,NaN,NaN,-14.285411415780056,-10.228572518863043
2011-06-10T09:30:00-04:00,37.84,38.10001,37.5,37.59,15463125,16209113.85,40.368938080717946,43.82255419202912,NaN,NaN,-108.30066555402193,-123.10404200117225,-0.08821348300247228,-0.42603248734635457,-0.3378190043438823,106779148,113290688.4,37.28402641472661,32.70849087881332,NaN,NaN,-15.119098863458916,-10.927219139519597
2011-06-13T09:30:00-04:00,37.74001,37.88499,37.10001,37.37,13351930,15893683.15,38.78322517012713,43.811555899586246,NaN,NaN,-130.1262502276291,-122.06915618698524,-0.09698895183479617,-0.4590551941373775,-0.36206624230258133,93427218,109851929.8,35.68695396091924,34.081410868402614,NaN,NaN,-16.286358732591776,-11.692810509958479
2011-06-14T09:30:00-04:00,37.87,38.255,37.71001,38.09,18577760,15843720.75,46.22764403174558,44.17569612610099,NaN,NaN,-46.80879621968477,-107.74449082561193,-0.04815531780055887,-0.42226038955327994,-0.37410507175272106,112004978,107825107.6,34.7423290639512,35.40850713775375,NaN,NaN,-14.92914976540695,-12.15514468930826
2011-06-15T09:30:00-04:00,37.7,37.92,37.05,37.21001,23599680,15856831.15,39.84926156321877,43.66787704316563,NaN,NaN,-119.09931871543941,-98.26795189935683,-0.06777122217471443,-0.4588190994711141,-0.39104787729639967,88405298,104571783,33.22221920846728,36.65291438492916,NaN,NaN,-15.8783664087184,-12.687033506366852
2011-06-16T09:30:00-04:00,37.17999,37.35001,36.37,36.845,26344208,16293582.35,37.53578045987037,42.928660403694906,NaN,NaN,-161.5699560279223,-113.18099734893948,-0.09624238817742264,-0.511350862518178,-0.4151084743407553,62061090,92535546.4,28.29043879622607,37.396412337392704,NaN,NaN,-17.411363391033703,-13.361937775604973
2011-06-17T09:30:00-04:00,36.99001,37.09,36.48,36.64,19353360,16620357.4,36.26246281694015,41.79816140016634,NaN,NaN,-158.12045647836158,-123.14495553380743,-0.11834053478779638,-0.5630341428255008,-0.4446936080377044,42707730,79721262.8,24.175698568341048,37.357652549478296,NaN,NaN,-19.043765532208056,-14.1736274551197
2011-06-20T09:30:00-04:00,36.44,37.10001,36.44,36.95,15561594,16508889.9,39.59923285410556,40.64448251525685,NaN,NaN,-132.11237407116965,-123.54218030251555,-0.10214995606548188,-0.5723810531195568,-0.4702310970540749,58269324,72689684,22.26225729817685,36.459904454880586,NaN,NaN,-19.3639769199225,-14.915105950091528
2011-06-21T09:30:00-04:00,37.24001,37.96001,37.24001,37.89999,14753027,16582179.55,48.49742824340719,40.93585196278447,NaN,NaN,-34.191171905880616,-121.01865543975471,-0.021733995891440983,-0.4973985919183761,-0.4756645960269351,73022351,64893158.6,20.33996575420865,35.107397309664286,NaN,NaN,-16.69733206619193,-15.169709680963013
2011-06-22T09:30:00-04:00,37.7,38.17999,37.66,37.745,13443754,16424708.05,47.27380046136178,41.098194203421336,NaN,NaN,-14.414298881751115,-100.08165147301705,0.024253945618469164,-0.44534716400384866,-0.4696011096223178,59578597,59127818.4,19.031304793975437,33.33370351553091,NaN,NaN,-14.958075604993873,-15.13947624153885
2011-06-23T09:30:00-04:00,37.11,37.75999,36.74001,37.71001,17766048,16508762,46.98558306675263,41.511246664889676,NaN,NaN,-59.79520004960294,-79.72670027735317,0.05385514813582437,-0.40228217445253733,-0.4561373225883617,41812549,55078110.2,18.148041526973927,31.39547121985509,NaN,NaN,-13.655826024477316,-14.92752621053006
2011-06-24T09:30:00-04:00,37.87,37.96021,37.33501,37.47,12763441,16638395.75,44.9606872234836,41.97345392710694,NaN,NaN,-33.87126065922791,-54.876861113526445,0.058427071954628484,-0.3831034826450761,-0.4415305545997046,29049108,52346385.8,17.55614130054768,29.500256949178326,NaN,NaN,-13.14761872154315,-14.673253712103358
2011-06-27T09:30:00-04:00,37.28,37.69009,37,37.55,10117531,16614165.85,45.799160860146245,42.38369068242188,NaN,NaN,-48.94175978810049,-38.24273825691261,0.06736058446429316,-0.3573298240193381,-0.42469040848363127,39166639,48525848.8,16.734100585461633,27.66392066724783,NaN,NaN,-12.494817416469129,-14.362048527012755
2011-06-28T09:30:00-04:00,37.77,38.28,37.62,38.28,10366238,16329545.15,52.85670918945462,43.501065436148345,NaN,NaN,60.207597311161564,-19.362984413504176,0.11988749986352643,-0.27483103365422323,-0.39471853351774966,49532877,43827954,15.75708032349334,25.87311863022478,NaN,NaN,-9.7809033438904,-13.707599215138133
2011-06-29T09:30:00-04:00,38.53999,39.05,38.39999,38.89,14442758,16164208.65,57.80138380646658,44.48580698769986,NaN,NaN,181.007190584498,19.72131347974565,0.18905300042648288,-0.1584022829846461,-0.34745528341112897,63975635,44707361.6,16.737076678868704,24.283402448166957,NaN,NaN,-5.844045362732231,-12.584234379080147
2011-06-30T09:30:00-04:00,38.96001,39.52,38.8299,39.37,12379574,15780578.55,61.245924283124175,45.977020287871746,NaN,NaN,232.5202903082725,78.18441155132074,0.25629428767126655,-0.027087423822045764,-0.2833817114933123,76355209,51615893.6,24.197364736681934,23.348640899735194,NaN,NaN,-1.3932713649219013,-10.985525377057542
2011-07-01T09:30:00-04:00,39.38,39.78999,39.1087,39.73,13441387,15628702.2,63.64292397435956,47.75271305960262,NaN,NaN,226.96434946684943,130.3515335765362,0.3105623497153713,0.1048212256509018,-0.20574112406446948,89796596,63765391.2,35.19435864647471,23.313455520132013,NaN,NaN,3.084266926223101,-8.97555504801745
2011-07-05T09:30:00-04:00,39.7,39.908,39.55499,39.78,10540465,15441073.9,63.97619105125268,49.020466418138845,NaN,NaN,200.47073573952878,180.23403268206206,0.33336291385196754,0.21096251825048995,-0.12240039560147759,100337061,75999475.6,44.003759755409106,23.974986283807578,NaN,NaN,6.787150814591833,-6.723739924787552
2011-07-06T09:30:00-04:00,39.64,40.09,39.5,39.94,14641930,15597266.5,65.07930654617937,50.822612488350316,NaN,NaN,168.75343612296106,201.94320044442196,0.34150515818558624,0.30448105213050525,-0.03702410605508101,114978991,89088698.4,51.58651425924268,25.286721644577252,NaN,NaN,10.19073025123063,-4.30738704249924
2011-07-07T09:30:00-04:00,40.39999,40.72,40.25,40.535,11570527,15302434.45,68.89398078618767,53.06248394023013,NaN,NaN,178.28814311122449,201.39939094976725,0.3670153461689403,0.4217450766560944,0.05472973048715407,126549518,101603475,57.51085517917621,27.373894243359405,NaN,NaN,14.397378942337829,-1.6352776160939446
2011-07-08T09:30:00-04:00,39.92,40.25999,39.8,40.23,11371578,14992495.75,64.97572070501192,55.113430932235254,NaN,NaN,122.88466377191652,179.47226564249607,0.34380173890190757,0.4844819041145385,0.14068016521263096,115177940,109368021.2,60.72227904368339,29.984364277312427,NaN,NaN,16.81199035182177,1.000046379322586
2011-07-11T09:30:00-04:00,39.64,39.82001,39.2,39.42,11561813,14797430.15,55.88538197235108,56.27672729782422,NaN,NaN,72.40370636693423,148.56013702251303,0.2582543824254897,0.4634981432444931,0.20524376081900342,103616127,112131927.4,61.82827448653486,32.810508362195144,NaN,NaN,16.13827969681979,3.1626511389650434
2011-07-12T09:30:00-04:00,39.14,39.66,39.14,39.25999,8535027,14556585,54.27014324484868,56.689064083641476,NaN,NaN,57.55212819702982,119.97641551401323,0.17901420266463094,0.4290115141497921,0.24999731148516116,95081100,111080735.2,61.12332573403049,35.72360550361099,NaN,NaN,15.097084339606056,4.867570167628045
2011-07-13T09:30:00-04:00,39.52,40.02,39.44,39.60001,10295430,14142468.5,57.10718094389694,57.39144840382256,NaN,NaN,70.20061953599993,100.26585219662101,0.13938387710003797,0.4242271578602086,0.2848432807601706,105376530,109160243,59.782236489334764,38.6343863389938,NaN,NaN,15.062861698269096,6.324040386291053
2011-07-14T09:30:00-04:00,39.69,39.92349,39.12,39.22,10807313,13502850.15,53.1393194861593,57.83100100520875,NaN,NaN,49.26896545602336,74.46201666558079,0.08038941139837485,0.38533004500813917,0.3049406336097643,94569217,102764182.8,55.42099904620575,41.29674044751035,NaN,NaN,13.827986442036075,7.396032679968913
2011-07-15T09:30:00-04:00,39.41,39.62,39.22501,39.57001,13431344,12857206.95,56.16066144140496,58.63099916363171,NaN,NaN,47.44608932161239,59.37430177551998,0.058755412390840145,0.3783848990983145,0.3196294867074744,108000561,101328707,54.46073843387858,43.93278309989114,NaN,NaN,13.680014626143963,8.293744386565349
2011-07-18T09:30:00-04:00,39.47,39.60001,38.92101,39.10001,16140199,12696548.9,51.37093359364396,59.028982930310114,NaN,NaN,24.893109567446498,49.87218241562242,0.009207282114160553,0.33113858935017504,0.3219313072360145,91860362,98977554,52.845659375976204,46.512180156356465,NaN,NaN,12.079046525614917,8.834501835001001
2011-07-19T09:30:00-04:00,39.42,39.72,39.41499,39.69,9541504,12395544.4,56.39801959348228,59.28193367345495,NaN,NaN,49.45445772222666,48.252648320661784,0.012385610219785625,0.33741332001074653,0.3250277097909609,101401866,100241707.2,53.64171086714064,49.21822519518842,NaN,NaN,12.250180672282326,9.32245595461262
2011-07-20T09:30:00-04:00,39.78999,39.8,39.48,39.66,6823371,11999061.6,56.08055596131897,59.159017398801545,NaN,NaN,48.932479780059296,43.999020369473655,0.00885070504560137,0.33609109109796265,0.3272403860523613,94578495,98082100.2,52.025870184473085,51.738853302731584,NaN,NaN,12.292188155659725,9.746703411905063
2011-07-21T09:30:00-04:00,39.86,40.2,39.67,40.14,9748949,11814321.35,59.9637426066752,59.0674329933409,NaN,NaN,78.53541332545197,49.85230994335938,0.0338202168788585,0.3695156571509344,0.3356954402720759,104327444,100033745.6,53.39223009085732,53.824200828029824,NaN,NaN,13.500472172481464,10.282956091987407
2011-07-22T09:30:00-04:00,40.12,40.13,39.82001,39.95,7226332,11287335.55,57.78578464343905,58.64906589827515,NaN,NaN,74.00489465880106,55.164071010797116,0.032511884126370294,0.37633529543003874,0.34382341130366845,97101112,97853855.8,51.62364885779003,54.99772155740949,NaN,NaN,13.860412020933522,10.794021224693994
2011-07-25T09:30:00-04:00,39.55,40.12,39.48,39.85001,5525199,10925423.45,56.620263125316626,58.12364247499401,NaN,NaN,53.54401097840581,60.894251292988976,0.020471819198609242,0.36941318530193,0.34894136610332077,91575913,97796966,51.57563395240849,55.53856971433802,NaN,NaN,13.826766624469736,11.2272705675191
2011-07-26T09:30:00-04:00,39.84,39.85001,39.35001,39.42,7172039,10778148.85,51.78306675091159,57.1739110610463,NaN,NaN,-2.0872852294175575,50.58590270266013,-0.01877129227971952,0.3254772507536714,0.3442485430333909,84403874,94397367.6,48.66288455800747,55.32973902139265,NaN,NaN,12.387647257335635,11.393038666064319
2011-07-27T09:30:00-04:00,39.28999,39.45,38.46001,38.52,15964152,11058044.55,43.42169964083475,55.35446240780681,NaN,NaN,-170.88968616266888,6.621469514114483,-0.10295843782100456,0.21555049575713525,0.3185089335781398,68439722,89169613,44.50090757518503,54.40045704967899,NaN,NaN,8.346372533306774,10.957800647098955
2011-07-28T09:30:00-04:00,38.64,39.03999,38.39,38.44,10046055,10838209.4,42.760752055409185,53.76767893283518,NaN,NaN,-204.87667816439878,-50.060948783855665,-0.15833725648376112,0.12058736297343842,0.27892461945719954,58393667,79982857.6,38.30151152311157,52.798973655352434,NaN,NaN,4.909736316609024,10.093791457028965
2011-07-29T09:30:00-04:00,37.87,38.405,37.63,38.00999,13326469,10885554.15,39.29812818874589,52.5828750911491,NaN,NaN,-265.8850721901355,-118.03894215364298,-0.21473246266258408,0.010509041128969443,0.22524150379155353,45067198,69576074.8,32.73775157902817,50.721079161959096,NaN,NaN,0.8785036958383627,8.77732177685888
2011-08-01T09:30:00-04:00,38.71001,38.74001,37.52,37.88,14542480,10940608.8,38.28876510969001,51.441348081494915,NaN,NaN,-201.0875857286962,-168.96526149506337,-0.24917239673233854,-0.08622399212386966,0.16294840460846888,30524718,57365835.8,27.660735371951787,48.33089413609633,NaN,NaN,-2.7230400228694265,7.134412948326265
2011-08-02T09:30:00-04:00,37.58,37.98,36.71001,36.71001,20799056,11453538.35,30.656478011764563,49.55201215777117,NaN,NaN,-240.40105793660527,-216.62801603650092,-0.33384824941102614,-0.2543619071553138,0.07948634225571233,9725662,42430193.4,22.968527174374472,45.701343470742025,NaN,NaN,-8.801866143715506,4.8578016494631555
2011-08-03T09:30:00-04:00,36.75999,37.0089,35.95,36.89999,19480784,11695481.05,32.992189429156625,48.11293143941384,NaN,NaN,-220.2484087734232,-226.49976055865176,-0.35802113857160933,-0.36804008095879936,-0.010018942387190019,29206446,34583538.2,20.957160132408006,43.239640691185045,NaN,NaN,-12.914291782480023,2.318931159185559
2011-08-04T09:30:00-04:00,36.3,36.34,34.39999,34.39999,39007808,13067345.1,22.33211973348604,45.69660703170535,NaN,NaN,-259.08523936489047,-237.3414727987501,-0.513856996263838,-0.6523401877169874,-0.13848319145314952,-9801362,20944532.4,18.005617676703423,40.63570349424396,NaN,NaN,-21.741987858716033,-1.1183429862289542
2011-08-05T09:30:00-04:00,34.96001,35.28,33.36,34.32001,33004928,14149012.6,22.086254538122972,43.60484424202527,NaN,NaN,-230.29013282523223,-230.22248492576946,-0.5884362719002622,-0.8740285313284772,-0.2855922594282151,-42806290,3369834.8,15.061956488451827,37.936867573706515,NaN,NaN,-28.206207175453095,-4.988037870403831
2011-08-08T09:30:00-04:00,33.33,33.78999,31.62,31.81,37772352,15459539.55,16.09681892333559,40.726187051300506,NaN,NaN,-241.84789617829767,-238.37454701568976,-0.7619135995551845,-1.2379842588721957,-0.4760706593170112,-80578642,-18850837.2,12.319566396698065,34.98528582581775,NaN,NaN,-37.00334268110145,-9.561652843360633
2011-08-09T09:30:00-04:00,32.32001,33.78999,31.61,33.77,31470912,16606333.8,31.677688195879682,38.98312506805485,NaN,NaN,-171.16681979348655,-224.527699387066,-0.7012821914140307,-1.3526733985845496,-0.6513912071705189,-49107730,-30617515.6,11.16073073590681,32.0663472937773,NaN,NaN,-37.075436548405065,-13.492193372652695
2011-08-10T09:30:00-04:00,33.02,33.89,32.50999,32.61,32877264,17735425.5,28.325161444092686,36.72322641358467,NaN,NaN,-141.96199852188408,-208.87041733675818,-0.6946071088612714,-1.5196500932471082,-0.8250429843858368,-81984994,-52855803.6,9.367340206234147,28.9217123020185,NaN,NaN,-38.5752503691371,-17.075487229293323
2011-08-11T09:30:00-04:00,32.99001,34.67999,32.81,34.22,27549280,18572523.85,38.11463425389657,35.31814424290305,NaN,NaN,-98.77329289819741,-176.80802804341957,-0.5437426458564587,-1.5047212917064101,-0.9609786458499514,-54435714,-61782674,8.758904627414935,25.859944856991707,NaN,NaN,-35.4863146187184,-19.70560542778262
2011-08-12T09:30:00-04:00,34.42999,34.8,34.16,34.44,14884633,18645188.3,39.333959923832545,34.08340829993991,NaN,NaN,-73.08825306894877,-145.3676520921629,-0.39787889026803547,-1.4583272586849958,-1.0604483684169603,-39551081,-61131632.2,9.222002975033064,22.83468550146489,NaN,NaN,-32.82106255529305,-21.579242160284107
2011-08-15T09:30:00-04:00,34.64999,35,34.435,34.99001,27846720,19230514.35,42.390021204451486,33.41247647519276,NaN,NaN,-56.61677076445433,-108.32142700939421,-0.2408285865947588,-1.361484101660409,-1.12065551506565,-11704361,-47356776,18.63218994306645,20.68963588611196,NaN,NaN,-29.6647000388949,-22.73430757151422
2011-08-16T09:30:00-04:00,34.69,34.89999,34.14059,34.42999,16357930,19571335.65,40.1710714838256,33.1802887496921,NaN,NaN,-58.77583764699276,-85.84323058009545,-0.1552902320372822,-1.3147683051122527,-1.1594780730749705,-28062291,-43147688.2,21.316226523051313,19.033587239530984,NaN,NaN,-27.96898533541161,-23.48211868064242
2011-08-17T09:30:00-04:00,34.63,35.10001,34.37,34.53,13762527,19918293.45,40.76737773312597,33.037904869529015,NaN,NaN,-47.99618575349876,-67.05006802641837,-0.07658273315987119,-1.2552064895248094,-1.1786237563649382,-14299764,-29610642.2,29.384097092945595,18.396629065947703,NaN,NaN,-26.47214976970459,-23.909265979079873
2011-08-18T09:30:00-04:00,33.63,33.64999,32.23,32.52,26537648,20757728.4,33.53345657193519,32.626142611185394,NaN,NaN,-92.9826915126675,-65.8919477493124,-0.14076402072813354,-1.3545787822751052,-1.2138147615469717,-40837412,-26890981.8,30.91667455385098,18.2665521355779,NaN,NaN,-27.65398686426717,-24.4442261055352
2011-08-19T09:30:00-04:00,32.08,33.10001,31.98,32,19462368,21369530.2,31.953755643989155,32.173641935063905,NaN,NaN,-98.83798065948378,-71.0418932674194,-0.19573159351066827,-1.458479253435307,-1.2627476599246388,-60299780,-31040721.6,29.85207728688509,18.42307655807314,NaN,NaN,-29.120278006361794,-25.112233519939
2011-08-22T09:30:00-04:00,32.89,32.91,31.89,32,12408020,21713671.25,31.953755643989155,32.26630462307995,NaN,NaN,-97.18277377489008,-79.15509386950654,-0.20841140029073402,-1.5232619102880562,-1.3148505099973222,-60299780,-40759805.4,27.466542721309523,18.74436338285422,NaN,NaN,-30.250859805343204,-25.84632298928246
2011-08-23T09:30:00-04:00,32.25,33.14,32.02,33.13,15683395,22139239.05,39.1751648954199,32.70794572781303,NaN,NaN,-77.83471965921514,-82.96687027195102,-0.12133238631430343,-1.4665159928902014,-1.345183606575898,-44616385,-44070624.2,26.684264635020355,19.153442275897955,NaN,NaN,-28.90596049460512,-26.28341406147141
2011-08-24T09:30:00-04:00,33.00999,33.61,32.82001,33.60001,9513609,21816711.9,41.93537876055231,34.10817851546062,NaN,NaN,-52.313053583775954,-83.83024383800645,-0.01813378083270689,-1.3678508326167815,-1.3497170517840746,-35102776,-48231226.6,25.693905359173527,19.702605681788675,NaN,NaN,-26.944857927798953,-26.377906042375347
2011-08-25T09:30:00-04:00,33.63,33.89,33.06,33.23,11355887,21882203.5,40.381781956571935,35.4150019024927,NaN,NaN,-44.75349317356655,-74.18440417018627,0.03619164748347914,-1.3044774924297258,-1.340669139913205,-46458663,-49355476.8,25.419372832411568,20.442421134928658,NaN,NaN,-25.80440582554977,-26.295977439971693
2011-08-26T09:30:00-04:00,32.99001,34.00999,32.37,33.92999,14517801,21941770.1,44.565845169707,37.448503777233505,NaN,NaN,-36.120512112792085,-61.640910460847934,0.1252388986617876,-1.1841205165859705,-1.3093594152477581,-31940862,-43683693.2,29.511270217695795,21.67039997928564,NaN,NaN,-23.566683744890256,-25.906078340674345
2011-08-29T09:30:00-04:00,34.31,34.98,34.22,34.955,12789336,21854112.9,50.08956395444493,38.76363775998817,NaN,NaN,47.77920445049213,-32.648514815771485,0.2518376839969587,-0.9945623102515597,-1.2463999942485184,-19151526,-35454042.4,35.07725501007015,23.378723141725878,NaN,NaN,-19.88778180719441,-25.046321693034354
2011-08-30T09:30:00-04:00,34.81,35.47,34.71001,35.25,13199059,21474113.05,51.584815693668304,40.42504163495786,NaN,NaN,89.05893666554603,0.7302164491807475,0.3481750041388054,-0.8111812390750117,-1.1593562432138171,-5952467,-27721258.8,39.880931034951566,25.558265343777123,NaN,NaN,-16.4372478311999,-23.816453998486576
2011-08-31T09:30:00-04:00,35.53999,35.91701,35.03,35.34,12371789,21118663.3,52.056722077859604,41.42090505095522,NaN,NaN,120.23849331890956,35.24052582971785,0.40661868030216164,-0.651082892836115,-1.0577015731382766,6419322,-19416839.2,44.6199484307196,28.1197684725846,NaN,NaN,-13.498421144669564,-22.342449305084145
2011-09-01T09:30:00-04:00,35.31,35.71001,34.83,34.86,12620395,19799292.65,49.29692286847273,42.132545261286666,NaN,NaN,97.74862178254725,63.740948820940616,0.40094480586461323,-0.5565205658075101,-0.9574653716721233,-6201073,-11365321.2,48.83140848696685,30.949011723437007,NaN,NaN,-11.75501879780035,-20.829959232615032
2011-09-02T09:30:00-04:00,34.10001,34.39,33.83,33.97,13176527,18807872.6,44.57788384268019,42.288821164017286,NaN,NaN,20.801724565948824,75.1253961566888,0.3283016502668389,-0.5470883088385747,-0.8753899591054136,-19377600,-8852668.8,50.10656090339894,33.19718107774647,NaN,NaN,-11.576641868710471,-19.508056752057236
2011-09-06T09:30:00-04:00,33.00999,33.85001,32.96001,33.78999,13606504,17599580.2,43.667379140180685,42.5385574251855,NaN,NaN,-24.1610837294996,60.73733852069044,0.262053158166317,-0.5478235113975174,-0.8098766695638344,-32984104,-11619184.4,48.6684526824712,35.15091151770503,NaN,NaN,-11.68574072138811,-18.390583033390218
2011-09-07T09:30:00-04:00,34.36,34.75999,34.17,34.75999,12763070,16664188.1,49.63684483482612,43.17209078959265,NaN,NaN,51.88365311612504,53.30228181080624,0.2760792520985943,-0.4647776044405916,-0.7408568565391859,-20221034,-14472897.8,47.16470151341798,36.42095469059592,NaN,NaN,-10.035047065027806,-17.196935037909874
2011-09-08T09:30:00-04:00,34.52,34.85001,34.16,34.3,11595289,15600089.35,47.088536158792735,44.14031076008247,NaN,NaN,37.21656729769455,36.69789660656325,0.24779676881486568,-0.4311108955206038,-0.6789076643354695,-31816323,-22120026.8,43.303485991527374,37.30572693614423,NaN,NaN,-9.377110682071116,-16.079817272790052
2011-09-09T09:30:00-04:00,33.89,33.89,32.97501,33.17,18917520,15168501.35,41.45775804249903,44.81916807426175,NaN,NaN,-48.76593058509217,7.394986133035362,0.15115545159908417,-0.48996334983661427,-0.6411188014356984,-50733843,-31026580.8,39.27098300454058,37.97850591597677,NaN,NaN,-10.511554977580042,-15.284351230617194
2011-09-12T09:30:00-04:00,32.78999,33.32001,32.261,32.94501,13764570,15112498.2,40.42134367220899,45.423995790563175,NaN,NaN,-79.43751942733374,-12.652862665621146,0.07414534922785632,-0.548437114900878,-0.6225824641287343,-64498413,-40050743.4,35.64873749647154,38.56294839991691,NaN,NaN,-11.74523132753621,-14.778762673034196
2011-09-13T09:30:00-04:00,33.03999,33.62,32.761,33.49001,13515207,14395922.55,44.06887584827392,45.773546572909886,NaN,NaN,-40.34882372045169,-15.890410663811569,0.062446679534833516,-0.5445241147101925,-0.606970794245026,-50983206,-43650563.8,34.290010111879354,39.10621593397827,NaN,NaN,-11.733790577334782,-14.343766659362851
2011-09-14T09:30:00-04:00,33.60001,34.42,33.045,34.00999,18004000,14478226.05,47.37898610371086,46.16237566884978,NaN,NaN,4.737254139364915,-25.31969045916359,0.09055816758519497,-0.4937730847635322,-0.5843312523487272,-32979206,-46202198.2,33.32056585798654,39.650977398179194,NaN,NaN,-10.759024341419735,-13.831660613942406
2011-09-15T09:30:00-04:00,34.46001,34.63,34.03,34.59,12980875,14439143.45,50.8716336322299,46.91165078853963,NaN,NaN,55.59438012256306,-21.64412789418993,0.14577281457957958,-0.40211523412425265,-0.5478880487038322,-19998331,-43838599.8,35.14954264330517,40.345989527528744,NaN,NaN,-8.897432008929176,-13.12677081322623
2011-09-16T09:30:00-04:00,34.52,34.8,34.17999,34.52,12406629,13732592.5,50.4365346874192,47.3309857540905,NaN,NaN,56.09040680850753,-0.6728604154699867,0.17326638810195027,-0.33130506357639433,-0.5045714516783446,-32404960,-40172823.2,37.990417390236004,40.9516428969959,NaN,NaN,-7.495587670502421,-12.3223160785514
2011-09-19T09:30:00-04:00,33.8,34.16,33.41,34.00999,11096758,13314312,47.2646723351387,47.129207781282915,NaN,NaN,-5.1299026895962285,14.188662932077516,0.15346835186040247,-0.3127360118528415,-0.466204363713244,-43501718,-35973484.2,41.16977358964446,41.38682279553692,NaN,NaN,-7.166685348878898,-11.5857974028839
2011-09-20T09:30:00-04:00,34.06,34.38,33.59,33.61,14175699,13402695.95,44.88079054696053,46.65034884223236,NaN,NaN,-13.933209735059332,19.47178572915599,0.1117381305399236,-0.32653170053833946,-0.43826983107826306,-57677417,-37312326.4,40.45755524538404,41.42801023913925,NaN,NaN,-7.551645488849323,-11.009489986593247
2011-09-21T09:30:00-04:00,33.52,33.56,32.03999,32.09,27017168,13969384.6,37.201990199738994,45.58929656522374,NaN,NaN,-144.88747756668064,-10.453160612053123,-0.013282287787679814,-0.45487269081286286,-0.44159040302518304,-84694585,-47655402.2,35.36727929254525,40.76710530069822,NaN,NaN,-10.328907425542482,-10.912263906443137
2011-09-22T09:30:00-04:00,30.92999,30.96001,29.83,30.28999,30879344,15037671.35,30.53856512749786,44.24941386943983,NaN,NaN,-292.12613030701544,-79.99726269796882,-0.20179292210990357,-0.6938315556625625,-0.4920386335526589,-115573929,-66770521.8,28.284519778052754,39.29947039291864,NaN,NaN,-15.245496462526683,-11.531297128740785
2011-09-23T09:30:00-04:00,30.11,30.69,29.95,30.24001,23723184,15656036.2,30.375873152068053,43.234984534396105,NaN,NaN,-230.8725722995814,-137.38985851958662,-0.3080732017586181,-0.8771301357509316,-0.5690569339923135,-139297113,-88148952.4,22.787972021102462,37.348142615611756,NaN,NaN,-19.094571791625903,-12.611764937724374
2011-09-26T09:30:00-04:00,30.52,31.21001,29.81,31.21001,18990544,15879673.35,37.351573814036264,42.783855582528645,NaN,NaN,-163.93781536418967,-169.1514410545053,-0.29144679840130794,-0.9333654319939484,-0.6419186335926405,-120306569,-103509922.6,19.809209678799448,35.28676811534949,NaN,NaN,-20.13610193463873,-13.686670222997853
2011-09-27T09:30:00-04:00,32.24001,32.57001,31.64,31.86,20175504,16248981.75,41.575739302949295,42.20806233025173,NaN,NaN,-78.2188412814045,-182.00856736377435,-0.2184144751628747,-0.9149367275462339,-0.6965222523833592,-100131065,-112000652.2,18.37911185666819,33.23065456843879,NaN,NaN,-19.638522914321,-14.536934893186874
2011-09-28T09:30:00-04:00,32.00999,32.00999,30.39999,30.451,22467552,16712406.4,35.921499567167416,41.41041685942135,NaN,NaN,-118.63358548461828,-176.75778894736186,-0.24475861002589538,-1.0024705149157285,-0.7577119048898331,-122598617,-119581458.6,17.18613532021797,31.365129520488118,NaN,NaN,-21.112375928052284,-15.476283612453361
2011-09-29T09:30:00-04:00,31.13,31.17,29.89999,30.48,20068816,17097257.75,36.11407952284503,41.02872553658892,NaN,NaN,-121.79025886415315,-142.6906146587894,-0.23968132555222732,-1.0573135618301173,-0.81763223627789,-102529801,-116972633,19.13150029463621,29.92659504120923,NaN,NaN,-22.193676266361454,-16.435911134440232
2011-09-30T09:30:00-04:00,29.99001,30.19,29.32001,29.355,18118336,17372154.8,32.08554268134691,40.43331118009878,NaN,NaN,-141.9197013609342,-124.90004047105995,-0.2882751656363932,-1.1779761933233814,-0.8897010276869882,-120648137,-113242837.8,21.954247172373044,28.94841716091648,NaN,NaN,-24.449233670516428,-17.58067149673683
2011-10-03T09:30:00-04:00,29.03,29.85001,28.53,28.53,19323568,17679506.85,29.487782730499518,39.391804528829184,NaN,NaN,-144.6726252136511,-121.04700244095223,-0.34815932085636025,-1.3249001787574386,-0.9767408579010783,-139971705,-117175865,21.11718962426164,28.007501411800927,NaN,NaN,-27.190774882916585,-18.953543409048223
2011-10-04T09:30:00-04:00,28.11,29.67,27.77,29.64,25091744,18253768.85,36.89121580797644,38.642678079133866,NaN,NaN,-122.33398701931227,-129.87003158853378,-0.2877000954983908,-1.3363659772740668,-1.048665881775676,-114879961,-120125644.2,20.486308239731713,27.090768724782727,NaN,NaN,-27.083380189196642,-20.11494866335514
2011-10-05T09:30:00-04:00,29.7,30.92,29.48,30.82001,21033760,18667303.35,43.663094421425214,38.127782421219244,NaN,NaN,-62.043025216888104,-118.55191953498775,-0.14985774177301336,-1.2359880589919428,-1.0861303172189294,-93846201,-114375161,25.179127975323368,26.378596248498322,NaN,NaN,-24.687566298972293,-20.76817975415759
2011-10-06T09:30:00-04:00,30.91,31.6501,30.705,31.60001,20876672,19131372.5,47.66104992320872,37.92953350948993,NaN,NaN,-21.390596628819306,-98.47198708792095,0.004074786099657723,-1.0810368345943573,-1.085111620694015,-72969529,-108463106.6,29.768394860035997,25.791308924912606,NaN,NaN,-21.38112632223068,-20.855743549596603
2011-10-07T09:30:00-04:00,31.85001,31.87,30.72,31.12,17670640,19069028.5,45.520184600551175,37.804927242733676,NaN,NaN,-21.144283205234228,-74.31690345678098,0.0796027440881859,-0.9856081905837826,-1.0652109346719685,-90640169,-102461513,34.18185332249942,25.292171762973677,NaN,NaN,-19.39730436021307,-20.647395093970385
2011-10-10T09:30:00-04:00,31.67,32.42999,31.66,32.42999,10698547,18915727.35,51.873654874186634,38.30441755182125,NaN,NaN,20.808134771492796,-41.2207514597522,0.2160811237383411,-0.795109529999042,-1.0111906537373831,-79941622,-90455496.4,42.029994869030915,25.404488878948456,NaN,NaN,-15.54804939700816,-19.918917137261495
2011-10-11T09:30:00-04:00,32.03999,32.73,31.97501,32.47,10102801,18745107.05,52.057554486062564,39.36552928655865,NaN,NaN,33.416752500529576,-10.07060355578384,0.30206797541414665,-0.6336056844696998,-0.9356736598838464,-69838821,-81447268.4,47.124486891464734,26.24428942172842,NaN,NaN,-12.486667544134537,-18.857167195386214
2011-10-12T09:30:00-04:00,32.7,33.21001,32.57001,32.78999,12448023,18467308.2,53.58514675415029,41.01171368846239,NaN,NaN,58.76773843280686,14.091549174155158,0.36907933818533234,-0.474324487152181,-0.8434038253375133,-57390798,-74156187.8,50.8866234333447,27.85872539710642,NaN,NaN,-9.522294147510413,-17.52361390283253
2011-10-13T09:30:00-04:00,32.48,32.735,32,32.62,9244613,18280495.1,52.62583900681485,42.60099696380145,NaN,NaN,48.02394010205819,27.974456520330648,0.3885738003737338,-0.35768657487034616,-0.74626037524408,-66635411,-72889364.2,51.5318985186154,29.91186300407163,NaN,NaN,-7.367622077496966,-16.072757927784593
2011-10-14T09:30:00-04:00,33.19,33.48,32.86,33.48,9448914,18132609.35,56.83596704290405,43.992739337292,NaN,NaN,97.91618073476252,51.786549308329995,0.442109575175308,-0.1936234062749449,-0.6357329814502529,-57186497,-66198629.8,54.90201253148487,32.41849177926345,NaN,NaN,-4.227532104113531,-14.3805828101173
2011-10-17T09:30:00-04:00,33.31,33.33,32.32001,32.34,9616082,18058575.55,50.43720621011218,44.6257012592322,NaN,NaN,72.27317525347706,62.07955740472685,0.3855323666675129,-0.15381752311586183,-0.5393498897833747,-66802579,-63570821.2,56.19044612145381,35.119301369605274,NaN,NaN,-3.379132318066506,-12.808947025538615
2011-10-18T09:30:00-04:00,32.25,33.3501,31.75999,33.17,17306368,18215109,54.45741174411913,45.94969498615733,NaN,NaN,85.22371491394118,72.44094988740918,0.387746435695744,-0.05466684516369469,-0.4424132808594387,-49496211,-59502299.2,58.18245396044521,38.04760984390722,NaN,NaN,-1.409739120464696,-11.180488753385198
2011-10-19T09:30:00-04:00,33.11,33.11,32.07001,32.21001,11207902,17424645.7,49.46026380717792,46.90299386360967,NaN,NaN,68.17311605888105,74.32202541262401,0.31157694073323633,-0.05294210494289331,-0.36451904567612964,-60704113,-60164962.2,57.72208613054663,40.80408026075797,NaN,NaN,-1.287698386629546,-9.76723298670582
2011-10-20T09:30:00-04:00,32.17999,32.66,31.84,32.50999,15064113,16633884.15,50.974174986879454,48.25218188543344,NaN,NaN,54.55207675510478,75.62765274323333,0.26996927220024286,-0.02705745542582605,-0.2970267276260689,-45640000,-55965880,59.88796406339424,43.51363146725948,NaN,NaN,-0.7322541709452968,-8.476521727311459
2011-10-21T09:30:00-04:00,32.97,33.37,32.8801,33.37,12783230,16086886.45,55.12441691649581,50.083370041576025,NaN,NaN,96.29340254608688,75.30309710549821,0.28732992132463014,0.06213567402971876,-0.2251942472949114,-32856770,-51099934.6,62.29830690039561,46.45513984412619,NaN,NaN,1.0175479541787003,-7.120226058527151
2011-10-24T09:30:00-04:00,33.71001,34.17999,33.56,34.17,9960789,15635398.7,58.63256759232699,51.6363237404582,NaN,NaN,126.51926788572183,86.15231563194716,0.3362561146190356,0.19512589597888308,-0.1411302186401525,-22895981,-42318615,66.24082075882944,49.72331930977602,NaN,NaN,3.596176457544887,-5.589311413374003
2011-10-25T09:30:00-04:00,34.02,34.11,33.24001,33.3,13042039,15278725.45,53.71471654251273,52.35429674910732,NaN,NaN,93.62677942259752,87.83292853367843,0.2950602932954687,0.22769514797918333,-0.06736514531628532,-35938020,-39606976.8,67.37534794284491,52.73733502174185,NaN,NaN,4.271787787807465,-4.180582956062365
2011-10-26T09:30:00-04:00,33.83,34.14,33.05,33.89999,12855973,14798146.5,56.42893074485857,52.98057395065373,NaN,NaN,93.3376931391606,92.86584394973434,0.2926761177319047,0.2984800018485956,0.0058038841166908745,-23082047,-32082563.6,70.352722182861,55.636215544800784,NaN,NaN,5.6687820648218015,-2.7735308102217697
2011-10-27T09:30:00-04:00,35.10001,36.08,34.86,35.74001,20813296,14835370.5,63.498256776394136,54.264721963213944,NaN,NaN,177.6250652918934,117.48044165709207,0.3932120618361099,0.4973189614118283,0.10410689957571836,-2268751,-23408313.8,73.36992122138952,58.43536325186436,NaN,NaN,9.323257794702345,-1.0454181523754678
2011-10-28T09:30:00-04:00,35.39,36.14,35.31,35.99001,9937051,14426306.25,64.3447156198603,55.15551201647635,NaN,NaN,179.42770003174346,134.1073011542234,0.4506185110853951,0.6673800384324622,0.21676152734706713,7668300,-15303299.8,75.84367530466521,60.85062614012395,NaN,NaN,12.483110550198427,0.8872288051350887
2011-10-31T09:30:00-04:00,35.32001,35.34,34.41,34.45,14029305,14161593.1,55.76586852678236,55.42039159081348,NaN,NaN,112.3006510406366,131.26357778520634,0.3627215804396998,0.6701635028966919,0.3074419224569921,-6361005,-11996304.6,76.79101282843975,62.969663707050735,NaN,NaN,12.421697475609147,2.53501004377424
2011-11-01T09:30:00-04:00,33.10001,34.22,32.8,33.53,23038832,14058947.5,51.36038780207927,55.26148023709412,NaN,NaN,32.69341847446618,119.07690559558007,0.22709988250805635,0.5913167755920625,0.3642168930840062,-29399837,-10688668,77.17223267763589,64.84720722450011,NaN,NaN,10.899962799507493,3.730003294593276
2011-11-02T09:30:00-04:00,34.17999,34.58,33.8,34.36,13058508,13660184.9,54.827544589121814,55.418744921544615,NaN,NaN,72.97801172984545,115.00496931371701,0.17983804364487205,0.5890144476400963,0.4091764039952242,-16341329,-9340524.4,77.58108611697722,66.70786348152595,NaN,NaN,10.769806804754461,4.735689510330588
2011-11-03T09:30:00-04:00,34.88,35.10001,34.11,35.06,15001738,13366438.2,57.57428239650254,55.47148173251594,NaN,NaN,97.45770494564393,98.97149724446712,0.1817298127452952,0.6363386699268432,0.454608857181548,-1339591,-9154692.4,77.64053376542942,68.33204356966483,NaN,NaN,11.540906707109697,5.707863395584747
2011-11-04T09:30:00-04:00,34.75,35.11,34.28999,34.98,10140918,12989952.1,57.14661059597068,55.950724902934404,NaN,NaN,90.45744821269429,81.1774468806573,0.16413896461024774,0.6597825629443577,0.4956435983341099,-11480509,-12984454.2,73.32524765744026,69.55595796509245,NaN,NaN,12.022666949864593,6.6099781890532965
2011-11-07T09:30:00-05:00,35,35.31,34.57899,35.28,9366641,12923356.8,58.39470277408381,56.23195997650332,NaN,NaN,96.97517782962814,78.1123522384556,0.1591355371082348,0.6945630197194035,0.5354274826111687,-2113868,-12135026.8,73.67473624630712,70.66254955693972,NaN,NaN,12.781574740109015,7.491634839204114
2011-11-08T09:30:00-05:00,35.35001,35.73,34.985,35.7,15181133,13177273.4,60.1447884951359,56.99514031135747,NaN,NaN,111.17001761094852,93.80767206575204,0.1695793665168086,0.7474016907571794,0.5778223242403708,13067265,-3641606.4,76.92957341996737,72.03451293475548,NaN,NaN,13.91944724933825,8.409893754937562
2011-11-09T09:30:00-05:00,34.75999,34.95,33.88,33.96001,22996736,13704709.05,50.641030434802126,56.97134427192337,NaN,NaN,23.76885708798879,83.9658411373807,0.050925733150445796,0.641479490678428,0.5905537575279822,-9929471,-2359234.8,77.38423039830028,73.28424624439162,NaN,NaN,12.002083722077368,8.923063750243248
2011-11-10T09:30:00-05:00,34.49001,34.64999,33.8,34.37,12748301,13879893.45,52.54386456990985,56.78701910431008,NaN,NaN,19.24889386539284,68.3240789213305,-0.005333038515241251,0.5838874593839307,0.589220497899172,2818830,-1527550.6,77.69129645490109,74.38374549828488,NaN,NaN,11.003274804672344,9.220236758018833
2011-11-11T09:30:00-05:00,34.8,35.28999,34.77,35.17,10544891,13934692.3,56.10017030994513,56.606133584139954,NaN,NaN,72.95091218839521,64.8227717164707,0.005366940256702257,0.5959291732200498,0.5905622329633475,13363721,3441295.4,79.48356889233693,75.3296560792497,NaN,NaN,11.228560976444001,9.507140217793857
2011-11-14T09:30:00-05:00,34.84,35.19,34.5728,34.8,9578328,13932804.6,54.08156060100983,56.632336731175464,NaN,NaN,51.19875051351399,55.66748625324787,-0.017204442980844448,0.569056679237292,0.5862611222181364,3785393,4621147.6,79.89657502497447,76.22402944225895,NaN,NaN,10.815800890540345,9.694091742471928
2011-11-15T09:30:00-05:00,34.64999,35.11,34.42,34.87,9116680,13523320.2,54.41574337081385,56.48853763302941,NaN,NaN,41.41063927622936,41.715610586304045,-0.031327457660361824,0.5471018001426842,0.578429257803046,12902073,4588109.2,79.84810253069206,76.90227089567546,NaN,NaN,10.573208385991993,9.819679834403365
2011-11-16T09:30:00-05:00,34.42,34.75,34.02,34.05,11941570,13560003.6,49.83986677978785,55.51293834755753,NaN,NaN,-13.656526627583391,34.23053384318961,-0.09614116601794764,0.45825280028061144,0.5543939662985591,960503,6766104,80.68023333159877,77.4244360464047,NaN,NaN,9.035598947762,9.707668279168884
2011-11-17T09:30:00-05:00,34.00999,34.1066,32.85001,33.08,20005472,13807071.55,45.01736523723745,54.13241332022732,NaN,NaN,-118.48908141813004,6.682938786485034,-0.19868270184727277,0.3060405889894682,0.504723290836741,-19044969,2393344.2,74.0674189816057,77.29756059475758,NaN,NaN,6.225641678765538,9.21023590768269
2011-11-18T09:30:00-05:00,33.39,33.64,33.03,33.25999,13980711,13866945.6,46.060319346114646,53.43915980732248,NaN,NaN,-123.82286368703419,-32.671816388600845,-0.2456533989958169,0.1976565420919698,0.4433099410877867,-5064258,-1292251.6,68.93858857835762,76.73667314832315,NaN,NaN,4.214911852531521,8.496618185518237
2011-11-21T09:30:00-05:00,32.57001,32.89999,32.325,32.67999,15830645,14160438.4,43.21556882405204,52.85738702317768,NaN,NaN,-170.59554434335988,-77.03067535997562,-0.3032719820232815,0.06421996355868487,0.36749194558196635,-20894903,-6228310.8,62.678675845176926,75.7014190888618,NaN,NaN,1.6609933646019444,7.5201003539587665
2011-11-22T09:30:00-05:00,32.7,32.92999,32.31,32.42999,15024824,14259577.65,42.01114737149128,51.941930079061216,NaN,NaN,-161.72713672446213,-117.6582305601139,-0.3427929450508476,-0.06099923573159316,0.28179370931925446,-35919727,-15992670.8,52.51918435971137,73.91128324905709,NaN,NaN,-0.8155842272171143,6.329288270933641
2011-11-23T09:30:00-05:00,32.07001,32.16,31.53999,31.57001,14462590,14339908.5,38.079598855906134,50.54945268330433,NaN,NaN,-197.89162048683048,-154.50524933196334,-0.4070451203982842,-0.2270126911786008,0.18003242921968343,-50382317,-26261234.8,44.37351774224081,71.53506781882935,NaN,NaN,-4.171732912169323,4.829142387633217
2011-11-25T09:30:00-05:00,31.44,31.88,31.41,31.41,4443477,13521417.55,37.378681947077304,49.137457779811946,NaN,NaN,-171.05953966085963,-165.01934098050924,-0.4378319469926203,-0.36725750452109196,0.07057444247152835,-54825794,-33417399.8,39.74686548825848,69.13661194960207,NaN,NaN,-7.151454492377873,3.117628547631633
2011-11-28T09:30:00-05:00,32.61,32.82001,32.3,32.59,12385199,13643824.95,45.36529013134774,48.206785448187944,NaN,NaN,-89.2104639333259,-158.09686102976758,-0.3595152297333498,-0.3788195946951589,-0.01930436496180911,-42440595,-40892667.2,35.57423747284528,66.41514775149766,NaN,NaN,-7.533095143044734,1.5960965918207237
2011-11-29T09:30:00-05:00,32.72,32.95,32.48,32.64999,11599621,13522340.75,45.74414105967947,47.17816777422677,NaN,NaN,-71.96516210023174,-138.37078458114198,-0.28757703032591386,-0.37877565286920145,-0.09119862254328759,-30840974,-42881881.4,34.53525330003181,63.386982028645114,NaN,NaN,-7.736293521405496,0.2628980042169782
2011-11-30T09:30:00-05:00,33.91,34.55,33.86,34.52,20043584,13372578.35,55.98909029056564,47.56017204963846,NaN,NaN,31.311209501934535,-99.76311533586264,-0.1072411875345444,-0.22525010696146808,-0.11800891942692368,-10797390,-37857414,39.35332740549378,60.67048895773037,NaN,NaN,-4.6322938350085305,-0.4364151156723802
2011-12-01T09:30:00-05:00,34.34,34.8,34.11,34.3,12235910,13331448.45,54.680925490471466,47.71281925825,NaN,NaN,36.668945005418486,-52.85100223741283,-0.0015524359479257288,-0.11994946436183085,-0.11839702841390512,-23033300,-32387610.6,44.17053964495992,58.27614918559171,NaN,NaN,-2.5312577765178457,-0.7356783529360181
2011-12-02T09:30:00-05:00,34.67999,34.75999,33.97,34,10497965,13106259.8,52.86696960101515,47.48187635046929,NaN,NaN,28.520935154082967,-12.934907274424301,0.04670671123561425,-0.060013639369387306,-0.10672035060500155,-33531265,-28128704.8,47.6568019289209,56.002808688204865,NaN,NaN,-1.3321801498601265,-0.8208928953537479
2011-12-05T09:30:00-05:00,34.53999,34.77,34.14011,34.39999,10818488,13140138.3,55.00995803076011,47.548190452594305,NaN,NaN,43.11794763353316,13.530775038947485,0.10100554318883569,0.019536578381043057,-0.08146896480779263,-22712777,-24183141.2,50.72656704251394,53.91923668945767,NaN,NaN,0.3034985978547314,-0.660265539181108
2011-12-06T09:30:00-05:00,34.34,35.00999,34.22501,34.72,10735195,13208566,56.705942427893405,47.71177609952856,NaN,NaN,59.893894982654956,39.902586455524826,0.15090914923560683,0.10716747173671592,-0.043741677498890914,-11977582,-20410462.8,53.5327579305132,52.039569218016325,NaN,NaN,2.1644642254267126,-0.25673271566570505
2011-12-07T09:30:00-05:00,34.45,34.87,34.28999,34.75,11918848,13045451.75,56.87008696174779,48.21393468395427,NaN,NaN,63.90671893429858,46.42168834199762,0.17659017018247977,0.17699603522920881,0.0004058650467290356,-58734,-18262731.6,55.100451533782575,50.21244194674375,NaN,NaN,3.741106907886401,0.3143872305560243
2011-12-08T09:30:00-05:00,34.42999,34.49001,33.58,33.67,13764438,12583836.85,49.582061248036624,48.53998439901135,NaN,NaN,14.211679243187417,41.930235189551404,0.11450261094830771,0.14353412873211369,0.029031517783805964,-13823172,-16420706,56.45729610793929,48.95457602719615,NaN,NaN,3.089987621486866,0.7109015721175731
2011-12-09T09:30:00-05:00,33.39,34.28,33.3,34.10001,13673402,12630091.9,52.2082069164477,48.97911922546371,NaN,NaN,14.375112640467155,39.101070686828244,0.09676247439595675,0.14998461077875191,0.05322213638279515,-149770,-9744407,61.051437550310496,48.391208096621355,NaN,NaN,3.2931897166832362,1.0797998784840963
2011-12-12T09:30:00-05:00,33.5,33.55,33.03999,33.28999,17075504,12956622.55,47.21878319825436,49.26506310933531,NaN,NaN,-23.945838757754224,25.68831340857077,0.02839205158447662,0.08871220086339093,0.06032014927891431,-17225274,-8646906.4,61.76559984975959,48.32598838266297,NaN,NaN,1.9828721169660657,1.2088101982672348
2011-12-13T09:30:00-05:00,33.57001,33.89999,32.53,32.73,16845584,13319985.35,44.08228582156395,49.41300157005479,NaN,NaN,-36.84923417230888,6.339687577578,-0.05223674398638337,-0.004975780704064903,0.04726096328231847,-34070858,-13065561.6,57.216778121125,48.66153079419252,NaN,NaN,-0.07850153481699276,1.024908522112345
2011-12-14T09:30:00-05:00,32.56,32.83,32.22,32.33,19470304,13837666.55,41.93931680587681,49.688695709338404,NaN,NaN,-76.79977341828298,-21.801610892938314,-0.12599290928194978,-0.11023017332011875,0.015762735961831024,-53541162,-23762047.2,48.00088946832826,48.92062877462734,NaN,NaN,-2.4480037930919525,0.528778191368874
2011-12-15T09:30:00-05:00,32.82001,32.89,32.32001,32.55,11260676,13803621.85,43.56431527865228,50.130526661593755,NaN,NaN,-60.820469417633284,-36.80804062510246,-0.1517209081119023,-0.17388839917804688,-0.02216749106614456,-42280486,-29453510,43.9449602271945,49.22049268455134,NaN,NaN,-3.9572433472697206,-0.11208202843663939
2011-12-16T09:30:00-05:00,32.71001,32.97,32.32001,32.53,16181156,13612406.05,43.44527187574514,49.993382500479285,NaN,NaN,-53.967294324981516,-50.47652201819219,-0.1609675151259162,-0.2233768849735398,-0.06240936984762361,-58461642,-41115884.4,37.03867798109376,49.325095577997665,NaN,NaN,-5.230864005640198,-0.8433365966085763
2011-12-19T09:30:00-05:00,32.63,32.77,31.86,31.95,12980625,13562401.75,40.02914903288743,49.58516878427985,NaN,NaN,-78.23015125992616,-61.33338451862657,-0.19477019683888963,-0.30587211589623564,-0.11110191905734601,-71442267,-51959283,32.002688261622424,49.14419807525413,NaN,NaN,-7.317055225585785,-1.7681535436053202
2011-12-20T09:30:00-05:00,32.64,33.265,32.50999,33.21001,16250340,13583386.5,49.347200318897656,49.11074807201785,NaN,NaN,-19.04177605879688,-57.77189289592418,-0.124323097733578,-0.2665057912243185,-0.1421826934907405,-55191927,-56183496.8,30.275702568927528,48.495796301213694,NaN,NaN,-6.444590979223435,-2.436216034407908
2011-12-21T09:30:00-05:00,33.14,33.36,32.8499,33.25999,9611277,13312709.15,49.68118170421496,48.75362351585667,NaN,NaN,-9.139304776059298,-44.23979916747943,-0.06916513927022117,-0.22863911757851696,-0.1594739783082958,-45580650,-54591394.4,31.77016967085288,47.61005558877747,NaN,NaN,-5.6435362760683425,-2.8944046403593986
2011-12-22T09:30:00-05:00,33.37,33.675,33.25,33.58501,7612262,12970192.75,51.90215307570617,48.684708049763174,NaN,NaN,12.446591195935495,-29.586387044765683,-0.008771537688746722,-0.1704384004192292,-0.16166686273048247,-37968388,-53728974.8,32.612751790803884,46.53548057891197,NaN,NaN,-4.327818702771417,-3.0991780778468296
2011-12-23T09:30:00-05:00,33.64,33.91,33.57001,33.91,5416270,13018832.4,54.08446473926414,48.6186013860849,NaN,NaN,30.73200025826518,-12.646528128116342,0.05175580875607971,-0.09697210178538285,-0.14872791054146256,-32552118,-48547070,37.59911800377522,45.59780564757349,NaN,NaN,-2.5874076106528165,-3.0260680111048277
2011-12-27T09:30:00-05:00,33.75999,34.03,33.75999,33.89999,2923466,12545745.75,54.00318930288805,48.42554759144166,NaN,NaN,35.2387080450796,10.047243732884805,0.08769716103666014,-0.03910645924563738,-0.12680362028229752,-35475584,-41353733.4,43.81435193971555,44.90363379108794,NaN,NaN,-1.1742966131817685,-2.7615292399729623
2011-12-28T09:30:00-05:00,33.89,33.92,33.08,33.09,6304258,12280977.6,47.7501421213962,47.774122959987984,NaN,NaN,-21.211199120024443,9.613359120639299,0.0550916491379569,-0.0579390588598514,-0.1130307079978083,-41779842,-38671316.4,45.97527789771079,44.251835674225674,NaN,NaN,-1.6505194267720968,-2.602813552372839
2011-12-29T09:30:00-05:00,33.08,33.53999,33.03999,33.52,4276730,11492634.9,50.99423270107184,47.87499234949049,NaN,NaN,-16.840569924901466,8.073106090870862,0.060239225501885735,-0.03773167612045114,-0.09797090162233688,-37503112,-37055808.8,47.290120925743615,43.59703744692598,NaN,NaN,-1.1317949772041687,-2.3926680416344572
2011-12-30T09:30:00-05:00,33.44,33.67,33.44,33.5,3605091,11061093.95,50.836134618471156,47.77698718534931,NaN,NaN,6.70557018454244,6.924901888592254,0.059924615633006065,-0.023065132081079298,-0.08298974771408536,-41108203,-37683771.8,46.81318581281042,42.58001946567598,NaN,NaN,-0.7487823910644991,-2.1578272344101777
2012-01-03T09:30:00-05:00,34.24001,34.59,34.23,34.42999,11213719,11096881.65,57.443185089054914,48.507301606120784,NaN,NaN,106.7000878416305,22.118519405265324,0.11669246775232806,0.0628758369763247,-0.05381663077600335,-29894484,-37152245,47.29768644482945,41.54659707960955,NaN,NaN,1.5638566320346925,-1.626158110632339
2012-01-04T09:30:00-05:00,34.39,34.75,34.25,34.72,8773461,10994630.3,59.280904100332165,49.59291719746137,NaN,NaN,122.4711567992625,39.56500915610191,0.16515464233378768,0.15262667214123127,-0.012527970192556422,-21121023,-34281332.8,49.9497043098861,41.02752037880676,NaN,NaN,4.047126432114564,-0.8156888902399244
2012-01-05T09:30:00-05:00,34.42,34.95,34.32001,34.82001,7783691,10847055.1,59.92361209264226,50.87750971794461,NaN,NaN,135.69950388084342,70.94714975627548,0.1933687349081356,0.2291829484426131,0.03581421353447749,-13337332,-28592830.8,54.802821480937745,41.51337266542173,NaN,NaN,6.282286145892421,0.19830754349326774
2012-01-06T09:30:00-05:00,34.7,34.89,34.55,34.77,7218656,10612045.5,59.41856042414693,52.009955799765656,NaN,NaN,138.4826522159662,102.01179418444902,0.19739804020938007,0.28256176379620257,0.0851637235868225,-20555988,-25203406,57.45024810688338,42.4780360853995,NaN,NaN,8.00844895121708,1.314042030310955
2012-01-09T09:30:00-05:00,34.82001,34.97,34.67999,34.84,9204594,10384053.3,59.92766655558005,53.18726970546816,NaN,NaN,132.36764651331737,127.14420945020399,0.1932664143146337,0.3267467414801146,0.13348032716548092,-11351394,-19252044.2,61.69315961204957,44.23907048761064,NaN,NaN,9.60004003278707,2.4977560306646858
2012-01-10T09:30:00-05:00,35.38,35.64,35.34,35.49001,9962512,10198508.8,64.39454468486844,54.927655109181096,NaN,NaN,167.42339209443122,139.28887030076413,0.22081065144521833,0.40949364147200384,0.1886829900267855,-1388882,-13550923.8,65.26627354560456,46.61504086503794,NaN,NaN,12.315326716124474,3.9002661285875124
2012-01-11T09:30:00-05:00,35.38,35.89,35.32001,35.83501,7065258,9697996.5,66.5272673316303,56.15480275294771,NaN,NaN,153.63060319285123,145.52075957948188,0.2467964936504916,0.4971786070899,0.2503821134394084,5676376,-8191444,68.26322957800977,49.32843565140096,NaN,NaN,15.278971840903957,5.52579551606129
2012-01-12T09:30:00-05:00,36.03,36.35001,35.75,36.34,11153590,9413396.8,69.41510755292738,57.56436888499859,NaN,NaN,159.92869545320283,150.36659789395375,0.28009103222309956,0.6004959037182829,0.3204048714951833,16829966,-2157984.4,71.26870165727877,52.1497593647171,NaN,NaN,18.7496207209578,7.414913402475078
2012-01-13T09:30:00-05:00,36,36.14999,35.67999,36.10001,8419383,8860850.75,66.4797149762152,58.60562330646353,NaN,NaN,128.52790290133555,148.37564803102765,0.26803989804727324,0.6554547440542748,0.3874148460070016,8410583,3635329.8,73.83128351367083,55.093940202064736,NaN,NaN,20.87108101348722,9.337223061191098
2012-01-17T09:30:00-05:00,36.53999,36.638,36.16,36.3,11880570,8891845.45,67.7052995048916,59.57854007543692,NaN,NaN,136.55921899005517,149.21396252637518,0.25566629363139226,0.7069977130462419,0.45133141941484967,20291153,9963839.2,76.31630933111708,57.85945386830344,NaN,NaN,23.012025882880188,11.290766321432397
2012-01-18T09:30:00-05:00,36.3,36.71001,36.13,36.71001,7823246,8473949.95,70.1175511130536,60.72956591902016,NaN,NaN,131.77920799381673,142.08512570625228,0.25655948646204896,0.7720307774924109,0.5154712910303619,28114399,15864495.4,78.37801909508327,60.328287236543986,NaN,NaN,25.580821124937792,13.332202721933168
2012-01-19T09:30:00-05:00,36.75999,36.77,36.46001,36.74001,8192551,8234546.25,70.29240301311032,62.33972741128546,NaN,NaN,128.2757373261602,137.01415253291407,0.24088512674850648,0.816577699465995,0.5756925727174885,36306950,21990610.2,80.2958300506023,62.77975524746481,NaN,NaN,27.753971424093336,15.392455393670335
2012-01-20T09:30:00-05:00,36.61,36.78,36.46001,36.58,5572578,7700658.15,68.00671718445668,63.55490487438437,NaN,NaN,110.37593897569258,127.10360123741202,0.20297320167201538,0.8294090748075078,0.6264358731354924,30734372,24771491.4,81.11470227437745,65.19579677236723,NaN,NaN,29.00635979622367,17.337298879749383
2012-01-23T09:30:00-05:00,36.64,36.83,36.46001,36.56,6993270,7569757.8,67.71034956274895,64.76020594183278,NaN,NaN,98.22998528928052,121.04401771500102,0.16158310132550413,0.8284147497923726,0.6668316484668685,23741102,27837595.2,82.00278300923685,67.70933942925483,NaN,NaN,29.983663620601387,19.143922414156812
2012-01-24T09:30:00-05:00,36.22,36.59,36.10001,36.56,6596383,7518963.85,67.71034956274895,65.49357483281094,NaN,NaN,77.27971330350138,109.18811657769027,0.12109075826078264,0.8181950962928468,0.6971043380320642,23741102,28527585,82.20557604997325,70.20276011533653,NaN,NaN,30.81188050290791,20.81077356969268
2012-01-25T09:30:00-05:00,36.34,37.25,36.16,37.14,8389734,7667637.05,71.83805713112302,66.39051433501028,NaN,NaN,95.0034029381774,101.83295556656239,0.12002204228374314,0.8471318908867431,0.727109848603,32130836,29330872.4,82.45346210754676,72.52445710088372,NaN,NaN,32.70132306007288,22.509423496889852
2012-01-26T09:30:00-05:00,37.38,37.73,36.92,37.13,8619727,7952450.1,71.6679481517551,67.22939548208976,NaN,NaN,111.02386974415286,98.38258205016093,0.10579333969542959,0.859351523222287,0.7535581835268574,23511109,26771704.2,78.69237510624366,74.23085378840558,NaN,NaN,34.24011095350335,24.18523599069178
2012-01-27T09:30:00-05:00,37.05,37.3,36.85001,37.17999,6150422,7944758.3,72.0245775446313,68.12982527641007,NaN,NaN,95.40651422699935,95.38869710042229,0.08764940178343628,0.8631199357561528,0.7754705339727165,29661531,26557136,78.36959756341442,75.72509303530066,NaN,NaN,35.64410426349255,25.82221717252046
2012-01-30T09:30:00-05:00,36.62,37.28,36.53999,37.14,9225641,8192203.85,71.25191722078836,68.93870032392495,NaN,NaN,82.20852037339188,92.18440411724455,0.062060521321420925,0.8530461856244926,0.7909856643030717,20435890,25896093.6,77.31740179459703,76.84111033405405,NaN,NaN,36.660305101981045,27.370515448157686
2012-01-31T09:30:00-05:00,37.44,37.53,36.82001,37.17999,11363750,8580136.8,71.5802489431531,69.45196491380243,NaN,NaN,92.92980191048147,95.31442183864058,0.03810939476949249,0.8386224077649373,0.8005130129954449,31799640,27507801.2,78.08979251137792,77.75707597446645,NaN,NaN,37.618189698763736,28.834468912529978
2012-02-01T09:30:00-05:00,37.48,37.78999,37.46001,37.55,15190164,8778959.05,74.48402348149382,70.02030463879268,NaN,NaN,121.739124066636,100.66156606433229,0.037414584664736905,0.8472812438263659,0.809866659161629,46989804,30479594.8,79.47748099682799,78.55809393295344,NaN,NaN,39.25327888544846,30.32287033723262
2012-02-02T09:30:00-05:00,37.64999,37.77,37.35001,37.37,7593117,8719941.85,70.69957040163891,70.11205198512923,NaN,NaN,108.66909351140369,100.19061081778246,0.01614717757016615,0.8300506311243367,0.8139034535541706,39396687,33656710.4,80.87226841299439,79.24406298693314,NaN,NaN,39.713905201156805,31.664446746364646
2012-02-03T09:30:00-05:00,37.86,37.97,37.619,37.88,9878777,8824696.15,74.63237336332291,70.6943847270655,NaN,NaN,134.055985377429,107.92050504786839,0.027097523212703867,0.8477753575700504,0.8206778343573465,49275464,37579497,82.45757522696172,79.86022668073963,NaN,NaN,41.24182012574308,33.03264294341871
2012-02-06T09:30:00-05:00,37.60001,37.72,37.5,37.67,5685148,8748020.75,70.43980505038174,70.88970655174334,NaN,NaN,107.99884210812614,113.07856939481526,0.011656818210713848,0.8352488571207388,0.823592038910025,43590316,42210382.2,84.12977080786705,80.41833107193607,NaN,NaN,41.369181147835974,34.223576972621174
2012-02-07T09:30:00-05:00,37.64999,37.81,37.3,37.63,11790520,8877317.05,69.63735037229432,70.85540649883198,NaN,NaN,94.29085927505093,113.35078086772914,-0.008693424182527498,0.8127252586818656,0.8214186828643931,31799796,42210413.4,84.12978178415797,80.82917126401283,NaN,NaN,41.25473078938635,35.22802751787334
2012-02-08T09:30:00-05:00,37.7,37.88,37.42,37.67,6044820,8681432.45,70.00533616378667,70.8349017238803,NaN,NaN,95.23999358679048,108.05095477176003,-0.02592884898799863,0.7890076216293949,0.8149364706173935,37844616,40381375.8,80.61001308281901,80.85161290917117,NaN,NaN,41.253153103443985,36.08875974438344
2012-02-09T09:30:00-05:00,37.8,37.85001,37.42,37.71001,7649684,8710653.75,70.39187710545221,71.00527028966569,NaN,NaN,88.41232205844176,103.99960048116766,-0.040248721756663164,0.7646255684215646,0.8048742901782278,45494300,41600898.4,81.17552168426197,80.85595715273435,NaN,NaN,41.34881378111315,36.840196035344825
2012-02-10T09:30:00-05:00,37.19,37.21001,36.84,37.05,11266539,8716301.2,57.27861708040754,70.26014654092701,NaN,NaN,-2.619211624465172,76.66456108078881,-0.09657241764655977,0.6841587681200281,0.7807311857665878,34227761,38591357.8,75.33622439161921,80.37977439433307,NaN,NaN,37.5385088228341,36.93995500498615
2012-02-13T09:30:00-05:00,37.31,37.41,37.08099,37.14999,6425145,8616589.3,58.53876378911759,69.60503327138191,NaN,NaN,16.942536671377454,58.45329999343909,-0.12754918233469303,0.6212947078482216,0.7488438901829146,40652906,38003875.8,74.21394736750841,79.80894377415702,NaN,NaN,34.710552445376955,36.62146892504198
2012-02-14T09:30:00-05:00,37.03,37.03999,36.39999,36.67,11037750,8574448.3,50.79337562698456,68.10184173537203,NaN,NaN,-74.79679788912028,24.63576856060485,-0.1777373866794646,0.5266721568335839,0.7044095435130485,29615156,37566947.8,73.3389019003938,79.15790375936037,NaN,NaN,29.68858499935211,35.63105693565771
2012-02-15T09:30:00-05:00,36.88,36.96001,36.60001,36.7,11055465,8736059.25,51.22773214149806,66.64182630606795,NaN,NaN,-70.28731604765417,-8.469693366284082,-0.20438453078257102,0.4489288800348348,0.6533134108174058,40670621,38132148.8,73.76975103830226,78.80628775450741,NaN,NaN,25.747026911169947,34.21905264644517
2012-02-16T09:30:00-05:00,36.73,37.39,36.56,37.35001,10221922,8837527.8,59.557680182378206,65.75133363733559,NaN,NaN,-12.266716506175296,-28.60550107920749,-0.17484628363413468,0.4347555562747374,0.6096018399088721,50892543,39211797.4,74.61368985896772,78.53800863276122,NaN,NaN,24.671943795669087,32.85517995347716
2012-02-17T09:30:00-05:00,37.44,37.509,37.23,37.37,7447402,8931269,59.78515492460164,64.93227918760797,NaN,NaN,34.20439234913458,-21.240780284487546,-0.15144845997654333,0.4202912649381929,0.5717397249147362,58339945,44034234.2,78.01606899476832,78.58791343277346,NaN,NaN,23.888416535001795,31.574213750837824
2012-02-21T09:30:00-05:00,37.61,37.86,37.42,37.59,8101730,8986692,62.29849024346749,64.26929642334471,NaN,NaN,77.86904060744173,-9.055479497274689,-0.1200165347671096,0.4217190564558493,0.5417355912229589,66441675,49191988,80.95589975802804,78.79263537896274,NaN,NaN,23.983253091090344,30.489790799445327
2012-02-22T09:30:00-05:00,37.58,37.71001,37.34,37.53,5711980,8942471.85,61.175553748620544,63.31869144242519,NaN,NaN,50.53212628445863,16.01030533744109,-0.10279210771902236,0.413245456574181,0.5160375642932034,60729695,55414895.8,83.77504759709623,79.09960442183906,NaN,NaN,23.735471886467554,29.524888097591358
2012-02-23T09:30:00-05:00,37.53999,37.64,37.28,37.57001,4916797,8768825,61.6716881597421,62.67384271086114,NaN,NaN,38.36310310068482,37.74038916710889,-0.08875890963677496,0.40508892724723466,0.49384783688400963,65646492,60410070,85.61576123892557,79.43842533797701,NaN,NaN,23.668643547265106,28.688281733259036
2012-02-24T09:30:00-05:00,37.67999,37.77901,37.47,37.55,4426543,8559165.8,61.250123429667894,61.71796771560007,NaN,NaN,58.22835982212255,51.83940443276846,-0.0810895921513533,0.392485846694818,0.4735754388461713,61219949,62475551.2,86.30749807273659,79.71341982696092,NaN,NaN,23.500506044407935,27.94717092056602
2012-02-27T09:30:00-05:00,37.34,37.7,37.16,37.56,7771539,8640221.65,61.39215718285721,61.07170715363402,NaN,NaN,24.570584523820038,49.91264286770555,-0.07571108235627766,0.37893658590082424,0.4546476682571019,68991488,64605859.8,87.00179213934055,79.91856420778045,NaN,NaN,23.3955780319271,27.296943365046175
2012-02-28T09:30:00-05:00,37.57001,37.81,37.50999,37.67999,8912980,8624588.6,63.138094923554526,60.60747462158118,NaN,NaN,68.2928536821494,47.99740548264708,-0.0648584910974529,0.37357455438528575,0.43843304548273865,77904468,66898418.4,87.7232432435029,80.17524002630509,NaN,NaN,23.7535132764827,26.790739066679965
2012-02-29T09:30:00-05:00,37.71001,37.81,36.89999,36.97,18397936,8976297.9,49.01388393665572,59.10808517678612,NaN,NaN,-49.694394538764506,27.952101318002455,-0.10396332138921549,0.3084788937462193,0.4124422151354348,59506532,66653785.8,87.16726803239985,80.64361537984658,NaN,NaN,19.77202179136946,25.788065170207037
2012-03-01T09:30:00-05:00,37.19,37.52,37.14,37.38,11608578,8797218.6,55.24077904174651,58.025863886521414,NaN,NaN,-14.26010010331201,17.427460677203086,-0.10061845711303441,0.28666914374414176,0.3872876008571762,71115110,67747509.4,87.54726780149994,81.09874010250643,NaN,NaN,18.228204784635448,24.70808511512538
2012-03-02T09:30:00-05:00,37.25999,37.58,37.07001,37.28999,8955992,8865362.35,53.69050423080207,57.769570111549605,NaN,NaN,-20.822591342042628,1.6172704443700525,-0.10252243025008029,0.2591345630445758,0.3616569932946561,62159118,67935343.2,87.61509559865289,81.97580233158025,NaN,NaN,16.50094119707493,23.535635983975318
2012-03-05T09:30:00-05:00,37.14,37.14999,36.48,36.69,11249023,8933874.65,44.68775130923196,56.780212077272054,NaN,NaN,-145.64602060302366,-32.42605058099869,-0.13992852640988418,0.1867463352823009,0.32667486169218507,50910095,64319064.6,78.72459309053816,82.29799131179666,NaN,NaN,11.837684123151023,21.86450000385756
2012-03-06T09:30:00-05:00,36.13,36.13,35.8,35.94,14786594,9388946.95,36.45821779426688,55.75627223207794,NaN,NaN,-264.51172187288995,-98.98696569200656,-0.20688013845156822,0.06807468862772481,0.27495482707929303,36123501,55962871.2,62.85346259360025,81.54903136131142,NaN,NaN,4.508387186231918,19.385055315625326
2012-03-07T09:30:00-05:00,36.13,36.17,35.81,36.03,14333414,9516091.65,37.93527555131412,54.8068110470648,NaN,NaN,-200.23401986310196,-129.09489075687407,-0.2347622340308091,-0.018497965459218335,0.21626426857159076,50456915,54152947.8,60.03049583701046,80.56765598979057,NaN,NaN,-0.5712318477168219,16.53415714943359
2012-03-08T09:30:00-05:00,36.46001,36.7,36.24001,36.63,8240582,9625879.75,46.81186743525764,53.8963958508419,NaN,NaN,-96.75237437472144,-145.59334561115594,-0.20361260890459096,-0.03825149255914795,0.165361116345443,58697497,51669425.2,56.294268118738934,79.25912586548853,NaN,NaN,-1.7635225775970431,13.920202902714928
2012-03-09T09:30:00-05:00,36.73,36.99001,36.52,36.64,7320129,9609402,46.948054596827575,52.97946011314376,NaN,NaN,-57.54839533315331,-152.93850640937808,-0.17428430702622008,-0.0524942674373321,0.12179003958888798,66017626,52441126.8,57.1859575324803,77.77126076103939,NaN,NaN,-2.6199536244555968,11.557323398833425
2012-03-12T09:30:00-04:00,36.63,36.827,36.38,36.44,5579957,9325072.9,44.494249893857656,51.70772865960019,NaN,NaN,-75.50275974645744,-138.90985423806484,-0.160639493533802,-0.07900932732836452,0.08163016620543748,60437669,54346641.6,59.38920997656477,76.2307829195063,NaN,NaN,-4.105481274419918,9.319779874082947
2012-03-13T09:30:00-04:00,36.66,37.08,36.59,37.03999,10333891,9520510.2,52.51282857341004,51.08896257565659,NaN,NaN,-19.38661004365201,-89.88483187221725,-0.10612044761500809,-0.05102039331332264,0.05510005430168545,70771560,61276253.4,66.20102463344023,74.97549556495942,NaN,NaN,-2.6594189505386474,7.6084657562798625
2012-03-14T09:30:00-04:00,37.03999,37.09,36.75,36.897,8107195,9373982.45,50.63541426388372,50.300657297380994,NaN,NaN,-20.132001041973783,-53.864428107991614,-0.0760135810495194,-0.039916922010213796,0.036096659039305604,62664365,63717743.4,68.22339024687176,73.73318335124131,NaN,NaN,-2.121911436144769,6.218411871647772
2012-03-15T09:30:00-04:00,36.95,37.17,36.84,37.17,7055414,9173979.9,54.015645933940355,49.783908904829026,NaN,NaN,0.4802180593081886,-34.41790962118568,-0.0360652869560938,-0.008984949655811647,0.027080337300282153,69719779,65922199.8,69.97055815890371,72.56625907168181,NaN,NaN,-0.5746281401340809,5.247977584250365
2012-03-16T09:30:00-04:00,37.10001,37.31,37.06,37.10001,11643070,9245037.3,53.01339919609917,49.185426191489164,NaN,NaN,15.58475311478376,-19.791279931598275,-0.013849352764684762,0.009768646344426202,0.023617999109110964,58076709,64334016.4,67.10780476051136,71.14525997319402,NaN,NaN,0.3569924488899433,4.549265422056019
2012-03-19T09:30:00-04:00,37.10001,37.53999,37.08,37.33,7705992,9257966.8,55.908524424601126,48.66902829870678,NaN,NaN,41.98437870843877,3.7061477593809684,0.015263274061046266,0.0426970916854188,0.027433817624372532,65782701,65403022.8,68.05520405116097,69.74040003088388,NaN,NaN,2.0290247511311574,4.189231040495324
2012-03-20T09:30:00-04:00,36.9902,37.1675,36.77,37.12,7178938,9211827.2,52.714637229089185,48.93336781959488,NaN,NaN,-1.345316803521113,7.314406407407148,0.019058560222127194,0.05125701790203152,0.03219845767990433,58603763,62969463.4,63.56655934915428,68.05463512493775,NaN,NaN,2.4852179365939757,3.9458005970808454
2012-03-21T09:30:00-04:00,37.17,37.27,36.94501,37.12,6063918,9229424.1,52.714637229089185,48.75292911869078,NaN,NaN,18.931353004916456,15.127077216785214,0.020144743648836214,0.0573793872409496,0.037234643592113384,58603763,62157343,62.09468257245623,66.23659332286321,NaN,NaN,2.8530341040070017,3.7896910980702962
2012-03-22T09:30:00-04:00,36.7,36.78999,36.32001,36.52,12351270,9601147.75,44.324213343116426,48.08390834099895,NaN,NaN,-73.90269740726819,0.2504941234699373,-0.018860537800616417,0.013658971341342863,0.03251950914195928,46252493,57463885.8,54.27325949988898,63.85503360152292,NaN,NaN,0.5946166686538321,3.3332518938679443
2012-03-23T09:30:00-04:00,36.64999,36.99001,36.32001,36.91,9155609,9837601.05,49.90557443785151,48.45660999304321,NaN,NaN,-33.11917351220508,-9.49029120192783,-0.01772717726671815,0.010360537558561589,0.02808771482527974,55408102,56930164.4,53.44878796469161,62.04961894967674,NaN,NaN,0.41693001546869246,2.916634482668051
2012-03-26T09:30:00-04:00,37.25,37.39,37.07001,37.39,5728461,9735447.15,55.781055661486064,49.836812697844586,NaN,NaN,72.97958386396573,-3.2912501708224395,0.01428888738206762,0.04594882405286427,0.03165993667079665,61136563,56000936.8,51.968579859182,61.272127325789725,NaN,NaN,2.215553382398162,2.8164800397723524
2012-03-27T09:30:00-04:00,37.5,37.64999,37.31,37.31,4625949,9521095.6,54.63097986187149,51.02936300574153,NaN,NaN,105.48122266148323,18.07405772217843,0.02821283865715904,0.06692598499224545,0.03871314633508641,56510614,55582307,51.27957535715025,60.64706157722828,NaN,NaN,3.283897083229528,2.8832539031233773
2012-03-28T09:30:00-04:00,37.24001,37.3,36.5,36.78999,11571297,9179763.65,47.74072706015664,51.095710121805745,NaN,NaN,-2.5823102754795952,13.77132506609922,0.0019223742154376167,0.04111611410438343,0.03919373988894581,44939317,52849417.8,46.90738556563924,59.97656996629259,NaN,NaN,1.9745118077195023,2.7534336037799667
2012-03-29T09:30:00-04:00,36.46001,36.87,36.33,36.84,10805859,9139627.7,48.41456139478082,51.200460607373834,NaN,NaN,-34.97549334130237,21.556765879292385,-0.011822554076265222,0.02441554729361428,0.036238101369879504,55745176,54747954.4,50.09096293869389,59.46978463816499,NaN,NaN,1.1476187160679092,2.5240314769639585
2012-03-30T09:30:00-04:00,37.14999,37.17,36.74001,36.97,7249559,9054306.05,50.21172667262431,51.60885180585717,NaN,NaN,30.692064796935153,34.319013541120434,-0.011851930582120147,0.02142318814222932,0.03327511872434947,62994735,56265281,52.54031347834271,58.98057774543484,NaN,NaN,1.0051263507597512,2.3070450303633576
2012-04-02T09:30:00-04:00,36.92,37.63,36.89,37.49001,18220144,9402862.1,56.708745030650945,51.90856012423152,NaN,NaN,103.6531534523746,40.4537274588022,0.02163341503470355,0.0603168875177289,0.03868347248302535,81214879,60280944.2,58.36406653673198,58.42079502424139,NaN,NaN,2.9418149810399727,2.3977264518885884
2012-04-03T09:30:00-04:00,37.3925,37.44,36.92101,37.21001,9342293,9130647.05,52.71951180011488,52.057424233962315,NaN,NaN,67.78655150661002,32.91479322782756,0.02326570588119562,0.06776560483451988,0.044499898953324256,71872586,63353338.6,62.18721464748632,57.989639624285296,NaN,NaN,3.3161278403098815,2.5289266502344874
2012-04-04T09:30:00-04:00,36.78,36.89999,36.48,36.69,7988875,8813420.1,46.217021768257446,51.50037965069925,NaN,NaN,-72.89825474059496,18.851604334804485,-0.010522353032301597,0.03134695766294726,0.04186931069524886,63883711,67142217.4,66.29717434114826,57.727255065874196,NaN,NaN,1.5061651520057564,2.38281786477324
2012-04-05T09:30:00-04:00,36.66,37.08,36.38,36.48,11535195,8978150.75,43.86408800243886,50.84685742258066,NaN,NaN,-89.15294692866688,8.016113617331584,-0.044931878557657665,-0.014295537501823219,0.030636341055834442,52348516,66462885.4,64.93438211194935,57.5720105909769,NaN,NaN,-0.7236484532306978,1.9390369622012489
2012-04-09T09:30:00-04:00,36.00999,36.17,35.82001,35.95,10400438,9132166.2,38.53228852356536,49.60569771536382,NaN,NaN,-233.84809335256278,-44.891918012568,-0.09824636671006803,-0.09217161733175061,0.00607474937831743,41948078,62253554,57.101876098088894,56.789630022900326,NaN,NaN,-4.458403319669112,1.0251169219340546
2012-04-10T09:30:00-04:00,35.85001,35.94,35.097,35.21001,17035728,9704954.75,32.57807056851942,48.16737152532313,NaN,NaN,-288.9855578770123,-123.41966027844538,-0.17379243350230517,-0.21116579249956402,-0.03737335899725886,24912350,50993048.2,42.37614329113371,55.27602887589886,NaN,NaN,-9.909478273243888,-0.5369681059485085
2012-04-11T09:30:00-04:00,35.74001,35.8188,35.48,35.59,11324801,9754500.25,37.88594687730286,47.108179357338386,NaN,NaN,-191.9287986793608,-175.36273031563954,-0.18744195820047926,-0.27167580674785796,-0.08423384854737868,36237151,43865961.2,36.04092836689113,53.4150464326442,NaN,NaN,-12.482630157494198,-2.243491256169321
2012-04-12T09:30:00-04:00,35.67999,36.64999,35.66,36.565,13242742,10011277.6,48.98392345964267,47.441015794233124,NaN,NaN,-73.93526774729081,-175.5701329169787,-0.1231810325234382,-0.23821013920167644,-0.11502910667823824,49479893,40985197.6,33.838835749277465,51.955444736171955,NaN,NaN,-10.582272789296638,-3.434745760901795
2012-04-13T09:30:00-04:00,36.42,36.52,36.10001,36.13,10791777,10198095.75,45.111272652374694,47.098565666699066,NaN,NaN,-72.00683174104408,-172.14090987945414,-0.10315816133041644,-0.2439768083412588,-0.14081864701084235,38688116,38253117.6,31.851203937021438,50.41276016276695,NaN,NaN,-10.493776678941776,-4.443178749193221
2012-04-16T09:30:00-04:00,36.39999,36.48,36,36.24001,13343273,10283105.9,46.2682199877372,46.41907740428843,NaN,NaN,-66.02944935967373,-138.57718108087633,-0.07689609437491374,-0.23693876497948452,-0.16004267060457078,52031389,40269779.8,34.891277750187456,49.19295286926734,NaN,NaN,-10.030094142406416,-5.241309519652249
2012-04-17T09:30:00-04:00,36.5,36.97,36.41,36.73,8112820,10303447.3,51.20192164856412,46.174144674766474,NaN,NaN,8.475819871019919,-79.08490553126988,-0.02367542368362835,-0.1896369502091062,-0.16596152652547785,60144209,47316151.6,44.24947107673704,48.690802563523526,NaN,NaN,-7.952133732785274,-5.628570121528395
2012-04-18T09:30:00-04:00,36.67,36.82001,36.5,36.63,7271598,10308080.3,50.1890644405553,46.34902591622352,NaN,NaN,3.0394435168269216,-40.09125709203234,0.006054639657519928,-0.15839322695357794,-0.16444786661109786,52872611,50643243.6,48.04656260594189,48.77217235211658,NaN,NaN,-6.649050147506051,-5.774352982382346
2012-04-19T09:30:00-04:00,36.75,36.84,36.25999,36.5,8752219,10442495.35,48.836571019783506,46.37916946086658,NaN,NaN,-11.719151321948544,-27.648033806963888,0.0175744166903139,-0.1424798457482055,-0.1600542624385194,44120392,49571343.4,46.93739972840546,48.546917837095975,NaN,NaN,-6.01236665354186,-5.808354935405133
2012-04-20T09:30:00-04:00,36.72,36.78,36.48,36.48,7459406,10197902.15,48.61949699972843,46.26543876994544,NaN,NaN,-4.149293149616903,-14.076526088678449,0.024056340678678984,-0.12998383659017065,-0.15404017726884964,36660986,49165917.4,46.500150262478854,48.11547760739142,NaN,NaN,-5.563724763678006,-5.773407768015543
2012-04-23T09:30:00-04:00,36.03999,36.05,35.5619,36.03,10309336,10255588.5,43.89215726734595,45.34996821542366,NaN,NaN,-106.27963324637369,-22.12656286601846,-0.00045558189621380807,-0.1546096546391169,-0.1541540727429031,26351650,44029969.6,41.25690049131408,46.89353717557585,NaN,NaN,-6.5724344515519535,-5.887554437092174
2012-04-24T09:30:00-04:00,36.03,36.16,35.8,36.03,8200527,10379191.8,43.89215726734595,44.71944289165445,NaN,NaN,-77.72070513149977,-39.3658678665224,-0.014389904479715415,-0.17214145334254738,-0.15775154886283196,26351650,37271457.8,35.572600792807236,44.992493328813055,NaN,NaN,-7.386381257359983,-6.101672554273289
2012-04-25T09:30:00-04:00,36.42,36.82001,36.39999,36.78999,9780289,10636908.8,52.8682034404896,45.19452729681389,NaN,NaN,35.18000769413022,-32.93775503106174,0.02756965173229997,-0.123289484197457,-0.15085913592975697,36131939,33923323.4,33.13687492465088,42.623900513348964,NaN,NaN,-5.375365028749488,-5.997914336341317
2012-04-26T09:30:00-04:00,36.53999,36.88,36.44,36.75,5910316,10353859.75,52.3932348075763,45.80375206860942,NaN,NaN,40.675819983448115,-22.45876076998241,0.051247127543541715,-0.08680022650032981,-0.13804735404387153,30221623,31143569.6,31.225232734489353,40.21610412924467,NaN,NaN,-3.898919942038273,-5.698057994298026
2012-04-27T09:30:00-04:00,36.92999,37.05,36.73,36.92999,5581859,10092659.75,54.37982803825261,46.93571917680136,NaN,NaN,73.37204651587928,-6.954492836883171,0.0761463442518346,-0.04286442372907828,-0.11901076798091288,35803482,30972068.8,31.106003220956566,38.35925606659236,NaN,NaN,-2.084995892504197,-5.181906265470336
2012-04-30T09:30:00-04:00,36.84,36.87,36.49001,36.67,9068285,10183596.05,51.06503181251728,48.2562164085155,NaN,NaN,39.159425579883916,22.13331892836835,0.07225401775363235,-0.028693245788872446,-0.1009472635425048,26735197,31048778.2,31.232485166336616,37.5632804862497,NaN,NaN,-1.473314706402028,-4.652107471317721
2012-05-01T09:30:00-04:00,36.67,37.10001,36.55,36.89,8299730,9687575.35,53.64023191342759,49.38152248252441,NaN,NaN,76.26293070921132,52.930046096510566,0.08098691087916732,0.0002863750564543466,-0.08070053582271297,35034927,32785433.6,34.17869317371846,37.43026368673737,NaN,NaN,-0.21577991879179215,-4.018346392385445
2012-05-02T09:30:00-04:00,36.67,36.74001,36.41,36.71001,6616484,9551284.9,51.26334253431597,49.54433813071536,NaN,NaN,43.241155508997856,54.5422756594841,0.0714642414833679,0.0086297660314969,-0.062834475451871,28418443,31242734.4,32.83300928796899,37.35841893950105,NaN,NaN,0.18554292554550134,-3.417790775538167
2012-05-03T09:30:00-04:00,36.67,36.74001,36.17999,36.28999,9561875,9629934.9,46.12672509546547,49.616870448078984,NaN,NaN,4.555412139655526,47.31819409072558,0.03551749792518329,-0.01843760304539188,-0.053955100970575175,18856568,28969723.4,30.902440235053035,37.290650103646165,NaN,NaN,-0.9594213569577082,-3.0665951443123873
2012-05-04T09:30:00-04:00,36.03,36.12,35.60001,35.67999,12152184,9660784.35,39.877293431528386,49.160375694064065,NaN,NaN,-100.8095021691699,12.481884353715742,-0.027311987036410586,-0.0880950847660884,-0.06078309772967782,6704384,23149903.8,26.591174099206185,36.6977855571475,NaN,NaN,-3.9735225690797065,-3.196156204993433
2012-05-07T09:30:00-04:00,35.50999,35.87,35.44,35.71001,11055227,9693523.8,40.30592550131601,48.38209025497491,NaN,NaN,-116.16215597217135,-18.58243195669531,-0.06279059734223838,-0.1392713444074758,-0.07648074706523741,17759611,21354786.6,25.41344976388315,35.35235546337223,NaN,NaN,-6.257908071606966,-3.6335493287953664
2012-05-08T09:30:00-04:00,35.44,35.57001,34.94,35.5399,12046113,9444043.05,38.625482093906726,47.55612008735716,NaN,NaN,-171.7539612039238,-68.18581033932233,-0.0918950784977276,-0.19134959518739691,-0.09945451668966931,5713498,15490500.8,21.987445395149564,33.49098994831563,NaN,NaN,-8.663651564259693,-4.352135362433128
2012-05-09T09:30:00-04:00,34.96001,35.645,34.89,35.22,14403125,9597959.25,35.61806033516271,46.611940752741376,NaN,NaN,-176.09472001590174,-112.05298544430225,-0.12482847438503136,-0.25549010967095853,-0.13066163528592717,-8689627,8068886.8,18.574632771236466,31.465078022803556,NaN,NaN,-11.64837670302008,-5.39445555394555
2012-05-10T09:30:00-04:00,35.58,35.64999,35.02,35.11,7940027,9332823.5,34.61987977337991,45.61196809371649,NaN,NaN,-145.24258582101157,-142.01258503643567,-0.14475549983689978,-0.3116060100820519,-0.16685051024515213,-16629654,971642.4,16.014679674304375,29.287544409362518,NaN,NaN,-14.414794099798229,-6.683075346210218
2012-05-11T09:30:00-04:00,34.84,35.34,34.82001,35.00999,6102441,9098356.7,33.69530164189642,44.88362126332724,NaN,NaN,-143.95264965514346,-150.64121453363038,-0.1545183111463778,-0.3599983991781244,-0.20548008803174658,-22732095,-4915653.4,14.259121155371986,27.359131599652365,NaN,NaN,-16.991309771508526,-8.155680264109977
2012-05-14T09:30:00-04:00,34.60001,34.84,34.38,34.52499,12873105,9074848.3,29.570861261703868,43.860671548638514,NaN,NaN,-166.45185151645634,-160.69915364248737,-0.18161559115005327,-0.4324995769693132,-0.2508839858192599,-35605200,-15588615.6,11.745392545779268,25.657188153436085,NaN,NaN,-20.582409624126406,-9.930927315540895
2012-05-15T09:30:00-04:00,34.53,34.69,33.95,34.00999,11507527,9244583.65,25.939954730235144,41.93722521219177,NaN,NaN,-173.9018792934904,-161.1287372604007,-0.21965788735810537,-0.5254563450168916,-0.30579845765878627,-47112727,-26153860.6,9.887244952389992,23.996500298274594,NaN,NaN,-24.9597187334183,-12.07789751809481
2012-05-16T09:30:00-04:00,34.14,34.4716,33.62,33.64,12099473,9485977.4,23.689480363887128,39.886957037642546,NaN,NaN,-171.8427818305389,-160.27834962332813,-0.25281122346600743,-0.6218124869912955,-0.3690012635252881,-59212200,-36258375.2,8.50192385334067,22.373406806763974,NaN,NaN,-29.428535277737577,-14.556560055186633
2012-05-17T09:30:00-04:00,33.78999,33.8,32.89999,32.89999,13730730,9734902.95,19.959642881467545,37.42837238358646,NaN,NaN,-192.0117324837616,-169.63217895587815,-0.30419990548504894,-0.7492511453815993,-0.4450512398965504,-72942930,-47521030.4,7.27789668504208,20.6713991970558,NaN,NaN,-34.77506527220756,-17.44491794333248
2012-05-18T09:30:00-04:00,33.08,33.33501,32.64999,32.77,14529039,10088384.6,19.382347879806872,35.16532353125,NaN,NaN,-176.8877863812896,-176.21920630110736,-0.32470088501665917,-0.8509273461673743,-0.5262264611507151,-87471969,-60469005.2,6.176891079729799,18.881713905155316,NaN,NaN,-39.19095800508375,-20.551495095011234
2012-05-21T09:30:00-04:00,32.8,33.78999,32.8,33.73,8574148,10001625.2,34.45897608790976,33.795233829427296,NaN,NaN,-122.19777318715296,-167.3683906352467,-0.254466681418272,-0.8443098129235551,-0.5898431315052831,-78897821,-69127529.4,5.570056957711728,16.83823988972626,NaN,NaN,-37.89077233779255,-23.02853470112285
2012-05-22T09:30:00-04:00,33.82001,34.095,33.31,33.52,8611656,10022181.65,33.00490605081778,32.49105979489172,NaN,NaN,-97.08112917123852,-152.00424061079633,-0.20512990150215282,-0.8462555083829741,-0.6411256068808213,-87509477,-77206879.4,5.069574573229843,14.855137410102037,NaN,NaN,-37.35802262675421,-25.075604404784475
2012-05-23T09:30:00-04:00,33.22,33.98,32.87,33.92,10646250,10065479.7,38.34191995044405,31.93500228453305,NaN,NaN,-88.71851507683458,-135.37938726005547,-0.13208122996025407,-0.8062271443311388,-0.6741459143708848,-76863227,-80737084.8,4.863926611418805,12.995243579842452,NaN,NaN,-35.106572337711874,-26.5085998237741
2012-05-24T09:30:00-04:00,34.14999,34.21001,33.675,34.13,11501520,10345039.9,40.99931647779802,32.01514678783802,NaN,NaN,-57.269780959216135,-108.43099695514636,-0.05982405247742495,-0.748925979967666,-0.689101927490241,-65361707,-79220840.2,6.616107114894419,11.568453080963039,NaN,NaN,-32.430892277201,-27.354641602835088
2012-05-25T09:30:00-04:00,34.10001,34.25,33.87,33.99001,6855719,10408732.9,39.76884446454789,31.9767838566403,NaN,NaN,-49.05627066055796,-82.86469381100002,-0.014050001822796032,-0.7066644297687361,-0.6926144279459401,-72217426,-76169931.6,10.199996429203665,10.481777842771647,NaN,NaN,-30.652415488814416,-27.825752157974993
2012-05-29T09:30:00-04:00,34.39,34.7,34.24001,34.58,9564160,10433526.65,46.98968609839468,32.57422699981801,NaN,NaN,-14.169392547236452,-61.25901768301672,0.05934302765579624,-0.6184356433761948,-0.6777786710319911,-62653266,-72921020.6,13.985699744318296,9.910224581997984,NaN,NaN,-26.72700577084432,-27.668788388384897
2012-05-30T09:30:00-04:00,34.2,34.34,33.92,33.96001,7325621,10384821.2,41.37609422671488,32.98551513492888,NaN,NaN,-38.1147648573988,-49.46574482024879,0.06884636248122733,-0.5917207179304569,-0.6605670804116842,-69978887,-69414902.6,18.00306428065589,9.86939826124223,NaN,NaN,-25.17160514955466,-27.312047925694863
2012-05-31T09:30:00-04:00,33.91,34.05,33.37,33.82001,9935906,10550792.3,40.207997598031845,33.384666408118306,NaN,NaN,-57.30831939283082,-43.18370568344804,0.06828161960161439,-0.5752150559096663,-0.6434966755112806,-79914793,-70025215.8,17.846806370823074,10.00026445385071,NaN,NaN,-24.306201944920947,-26.882641357012876
2012-06-01T09:30:00-04:00,33.23,33.50999,33.08,33.10001,12325547,10688975.9,34.77125482149533,33.461520206661085,NaN,NaN,-95.58662047136815,-50.847073585878434,0.02426613278523826,-0.6131640095297328,-0.6374301423149711,-92240340,-75400942.4,16.489227754430544,10.159557782354893,NaN,NaN,-25.3573411580087,-26.66474132858371
2012-06-04T09:30:00-04:00,33.17999,33.21001,32.59,33.13,13447723,10753752.85,35.164504006358925,33.86106611699359,NaN,NaN,-112.88749712154068,-63.613318878074985,0.0031312282626135834,-0.6335161069867041,-0.6366473352493177,-78792617,-76715980.6,16.165281013970286,10.475264101511396,NaN,NaN,-26.053603645734157,-26.577435945319486
2012-06-05T09:30:00-04:00,33.03,33.49001,32.99001,33.44501,7630629,10582522.95,39.30376773949053,34.81562418908326,NaN,NaN,-76.01098054662111,-75.98163647795191,0.01562752990872951,-0.6171129228634058,-0.6327404527721353,-71161988,-78417725,15.734490021459209,10.892924463587766,NaN,NaN,-25.355378132881256,-26.40285625782831
2012-06-06T09:30:00-04:00,33.73,34.28999,33.73,34.28999,8328438,10396639.2,48.75463427363802,36.605992325494036,NaN,NaN,18.046183945687957,-64.74944671733456,0.08233397224689365,-0.5298229874635183,-0.612156959710412,-62833550,-76988657.6,17.717540125793505,11.55118276876297,NaN,NaN,-21.543985394714333,-25.70873184881203
2012-06-07T09:30:00-04:00,34.7,34.94,34.23,34.35001,9280961,10140531,49.357827519527206,38.70586265678402,NaN,NaN,75.91167742740353,-38.10544735328769,0.12923944944383314,-0.45060764790562047,-0.5798470973494536,-53552589,-71716216.8,24.753358767129896,12.79943006034067,NaN,NaN,-18.366076696598313,-24.6597811127815
2012-06-08T09:30:00-04:00,34.17,34.60001,33.92,34.58,6362691,10061664.2,51.70374625211522,41.01453396909176,NaN,NaN,69.08522875875221,-5.171077507263613,0.17182772814776093,-0.3650624371647524,-0.5368901653125133,-47189898,-62706128.4,34.98454518692081,14.857119639425742,NaN,NaN,-15.02236544109827,-23.28300744539818
2012-06-11T09:30:00-04:00,34.87,35,33.89999,33.94,9883539,10250719.1,45.40110277389175,41.796114446661896,NaN,NaN,67.33857783391032,30.874137483826587,0.1535651630364951,-0.34493371151689445,-0.49849887455338954,-57073437,-58362292.4,39.27160675910167,17.26437319666788,NaN,NaN,-14.055667714942949,-21.96481605533315
2012-06-12T09:30:00-04:00,34.11,34.57001,33.91,34.57001,10427754,10128451.55,51.64931169812383,43.127857707183765,NaN,NaN,81.51701327263906,62.37973624767862,0.17881888689467912,-0.2749752659350406,-0.45379415282971974,-46645683,-53459031.4,43.77815941507095,20.029272113942245,NaN,NaN,-11.146651846609652,-20.419364025515506
2012-06-13T09:30:00-04:00,34.37,34.55009,33.94,34.03999,8664395,9986294.95,46.79729870849503,43.731813332758826,NaN,NaN,55.380151653807786,69.8465297893026,0.15558596672087,-0.2593116944286322,-0.4148976611495022,-55310078,-51954337,45.12396812786256,22.904989365116798,NaN,NaN,-10.308249633601084,-18.974919112384875
2012-06-14T09:30:00-04:00,34.11,34.37,33.925,34.32001,8441563,9803399.45,49.496648072260214,44.33876558950613,NaN,NaN,55.76681849508717,65.81755800283932,0.1545207139851862,-0.22174676866801946,-0.37626748265320564,-46868515,-50617522.2,46.35263540578744,25.7433128144663,NaN,NaN,-8.75698640414134,-17.515214439778656
2012-06-15T09:30:00-04:00,34.3,34.56,34.17999,34.53,10976676,9665696.75,51.48457096600155,45.175603196752824,NaN,NaN,81.98280296078417,68.3970728432457,0.16258423308864345,-0.17303719129240136,-0.3356214243810448,-35891839,-48357910.4,48.453499930380886,28.475705921693244,NaN,NaN,-6.8782724738472645,-15.995651301788458
2012-06-18T09:30:00-04:00,34.41,34.8,34.25999,34.71001,6693074,9273898.5,53.18571251274832,45.618176512063805,NaN,NaN,104.33556028149752,75.79646933276314,0.17366297061556046,-0.1185427111115942,-0.29220568172715466,-29198765,-42782976,53.31142574113224,31.2846863500371,NaN,NaN,-4.8273622475148095,-14.400181436892222
2012-06-19T09:30:00-04:00,34.92999,35.53,34.89999,35.37,8211633,9255772.75,58.87884495144171,46.868372992401426,NaN,NaN,198.67175976857632,99.2274186319506,0.21628621214867455,-0.021847916541311463,-0.238134128689986,-20987132,-37651265.8,57.30057903701059,34.09165168977672,NaN,NaN,-1.1920056164563932,-12.51329917682996
2012-06-20T09:30:00-04:00,35.28999,35.53999,34.92999,35.17,8338621,9242121,56.63130827516134,48.041466612196395,NaN,NaN,166.76620948700122,121.50463019858928,0.22107104418729526,0.038204676544133065,-0.1828663676431622,-29325753,-32454400.8,60.940261077877906,37.169755597423496,NaN,NaN,1.093659089279024,-10.569447995957248
2012-06-21T09:30:00-04:00,35.16,35.17999,33.98,34.02,9901453,9204881.15,45.80434404618012,48.82954441395959,NaN,NaN,33.94192820641992,117.13965214085583,0.1407580191500055,-0.00691884370565532,-0.1476768628556608,-39227206,-30926139,61.9669609208997,40.418165109314145,NaN,NaN,-0.45327418306830586,-9.124280308401685
2012-06-22T09:30:00-04:00,34.21001,34.33,33.83,34.2,8991438,9079377.05,47.49633892102186,49.71038976500694,NaN,NaN,-12.366841606166018,98.26972322746579,0.09587412427983925,-0.02783420750586174,-0.123708331785701,-30235768,-29794924.8,62.74751180335197,43.745467308555696,NaN,NaN,-1.1273301550001056,-7.9818588579157455
2012-06-25T09:30:00-04:00,33.8,33.98,33.58,33.77,6592543,9066218.25,43.96512888158594,50.04334413229947,NaN,NaN,-65.46287940938635,64.310035289289,0.03640211830699028,-0.07820568390196314,-0.11460780220895342,-36828311,-31320834,60.93096426678861,46.9737868975078,NaN,NaN,-2.837651069237134,-7.246972030961658
2012-06-26T09:30:00-04:00,33.88,34.07001,33.58,33.875,5461816,8861101.05,45.039658437221156,49.777988715412555,NaN,NaN,-49.11524964336743,14.752633406900253,0.004963670091014574,-0.1084032145951852,-0.11336688468619978,-31366495,-33396706.6,58.451802558548316,49.883377071276,NaN,NaN,-3.8761741170130435,-6.765429471826141
2012-06-27T09:30:00-04:00,34.06,34.31,33.92,34.25,9155813,8952610.65,48.81478221450116,49.73919976505355,NaN,NaN,1.3376847212615366,-18.333071546247684,0.009963624204424676,-0.10091235443066893,-0.1108759786350936,-22210682,-31973692.4,59.66340261586058,52.376951631899615,NaN,NaN,-3.6090422850918444,-6.314517016578384
2012-06-28T09:30:00-04:00,33.91,34.3,33.73,34.25999,8676973,8889664,48.91544993834278,49.54003574264123,NaN,NaN,-12.376741159032383,-27.596805419338125,0.014223562526990932,-0.09309652547635494,-0.10732008800334587,-13533709,-26834993,63.771885593088236,54.43319023234015,NaN,NaN,-3.365825638097722,-5.893275391081147
2012-06-29T09:30:00-04:00,35.12,35.28999,34.812,35.28999,12637004,8905236.85,58.07155676692779,50.44506817071523,NaN,NaN,148.9459037213876,4.665743646172603,0.0828585971767931,-0.0037468415323544946,-0.0866054387091476,-896705,-20967180.4,67.8044869104822,56.471253100295904,NaN,NaN,-0.1878365274182141,-5.078212696272157
2012-07-02T09:30:00-04:00,35.21001,35.28999,34.72,35.11,17123984,9089049.9,56.17671286923215,50.76845396865154,NaN,NaN,123.70808965113586,42.499937458277046,0.11083714657499816,0.0519409945096001,-0.058896152065398055,-18020689,-17205656,70.10198050471129,58.35152603527022,NaN,NaN,1.7978185885680853,-4.095922512723551
2012-07-03T09:30:00-04:00,35.25,35.7052,35.201,35.61,5883664,9001701.65,60.07407913049303,51.71679542736569,NaN,NaN,175.22219361777653,87.36742611050583,0.15500906981498921,0.13486518520333846,-0.02014388461165075,-12137025,-13359762,72.28003967098364,60.291245431207436,NaN,NaN,4.730421421101264,-2.835016236462863
2012-07-05T09:30:00-04:00,35.45,35.77,35.3,35.56,5769867,8873773.1,59.504179435034274,52.431619096135265,NaN,NaN,149.11085650008422,116.92206046627038,0.17156210872939975,0.19430875130009895,0.022746642570699194,-17906892,-12499004,72.75837093596714,62.17736939764884,NaN,NaN,6.909599634216796,-1.4429282549371976
2012-07-06T09:30:00-04:00,35.13,35.21001,34.92999,35.14999,7332184,8776334.25,54.90449212141256,52.67589917866462,NaN,NaN,72.59625734506044,133.91666016708893,0.14657040646251523,0.20595965064884325,0.05938924418632801,-25239076,-14840077.4,69.25791800789213,63.66339926032822,NaN,NaN,7.416703786451076,-0.17726653473887288
2012-07-09T09:30:00-04:00,35.11,35.17,34.78999,34.92999,14432668,9179833.1,52.556895594104695,52.63098368447579,NaN,NaN,48.3531020345079,113.79809982971298,0.10864130230575558,0.19519087206852248,0.0865495697627669,-39671744,-22595085.2,59.11244917927971,64.07775807733876,NaN,NaN,7.150989539455062,0.8696271901459749
2012-07-10T09:30:00-04:00,35.11,35.24001,34.22,34.41,11557070,9263509.65,47.398258686267496,51.81094180839192,NaN,NaN,-0.3460079158461761,88.98728031631659,0.04519931512583608,0.143048713670062,0.09784939854422592,-51228814,-29236710.2,52.07652028994295,63.704611023976774,NaN,NaN,5.348651327014456,1.5094877811271865
2012-07-11T09:30:00-04:00,34.53,34.53,34.08,34.3,11037102,9293977.05,46.36157604998874,51.077389506593875,NaN,NaN,-44.72793746682681,44.99725409939591,-0.004846333458896443,0.09179148172060536,0.0966378151795018,-62265916,-39262488.4,43.63361189308452,62.46842179649153,NaN,NaN,3.5696420786989007,1.8037955379231456
2012-07-12T09:30:00-04:00,33.89999,34.34,33.67999,34.13,12345957,9478055.15,44.733201383373526,51.0008793163934,NaN,NaN,-78.30441643554511,-0.48580048772996065,-0.0476899550018372,0.0370253714272053,0.0847153264290425,-74611873,-50603484.6,36.43724290153149,60.644870509393805,NaN,NaN,1.6121964665161908,1.7764242420078664
2012-07-13T09:30:00-04:00,34.23,34.83,34.23,34.74001,8608387,9486396.35,51.33798977722184,51.27528294897911,NaN,NaN,-5.271494220508881,-16.05935080084382,-0.03388644107586844,0.04235727508420695,0.07624371616007539,-66003486,-58756366.6,32.311568632378425,58.47087456860998,NaN,NaN,1.796912248959311,1.7793511001437872
2012-07-16T09:30:00-04:00,34.67,34.735,34.33,34.61,4729516,9174038.35,49.96740506630627,51.70401696217342,NaN,NaN,-12.334995268313554,-28.196970261408108,-0.032450316609211674,0.0356808203985608,0.06813113700777247,-70733002,-64968618.2,29.564656141093764,56.230423988203206,NaN,NaN,1.5523132034383245,1.7469171149001497
2012-07-17T09:30:00-04:00,34.81,35.12,34.52,35.05,11490715,9413920.4,54.404042744609754,52.37290155555832,NaN,NaN,33.53538783727114,-21.420691110784645,-0.0023904488888412956,0.06514307589672086,0.06753352478556215,-59242287,-66571312.8,28.88246287803571,54.118328296738014,NaN,NaN,2.6502519349792286,1.875964946340018
2012-07-18T09:30:00-04:00,34.86,35.32001,34.83,35.25999,9007605,9453719,56.3915214772895,52.91409721718606,NaN,NaN,69.36205696450483,1.397307775481687,0.02936118609327247,0.10423500740215275,0.07487382130888028,-50234682,-64165066,31.440326660995908,52.10239429996197,NaN,NaN,4.150700290123821,2.2009271383091327
2012-07-19T09:30:00-04:00,35.41,35.72,35.19,35.64,9604680,9517021.95,59.80595717473548,53.691990591214115,NaN,NaN,117.41562028483327,40.54131511955736,0.07129207396723446,0.16398891376792335,0.0926968398006889,-40630002,-57368691.8,38.20119640223203,50.2759165006151,NaN,NaN,6.466820643505586,2.8103404961943403
2012-07-20T09:30:00-04:00,35.33,35.52,35.24001,35.42,11093301,9576614.35,57.02236523642193,53.61704833903512,NaN,NaN,89.26580915031865,59.448775793722874,0.07895130839433387,0.19138597529360624,0.11243466689927237,-51723303,-54512655.2,40.84131542919118,48.34997568052289,NaN,NaN,7.61234267486926,3.4963408074336146
2012-07-23T09:30:00-04:00,34.77,34.94,34.5,34.86,10632563,9658670.6,50.570195462203,53.216582809961615,NaN,NaN,2.34856784574591,62.385488416534756,0.04285027296820927,0.16599750810953395,0.12314723514132468,-62355866,-52837228,42.3960009390223,46.37097714011652,NaN,NaN,6.674040993898702,3.950297976928627
2012-07-24T09:30:00-04:00,34.87,34.92999,34.10001,34.32001,8709984,9764542.65,45.25291582880739,52.157928288412634,NaN,NaN,-50.707680725542865,45.53687470397196,-0.017607048880268067,0.1011384240409896,0.11874547292125767,-71065850,-55201940.6,40.76754472570157,44.12008464402495,NaN,NaN,4.166501537507336,3.9811841998684425
2012-07-25T09:30:00-04:00,34.58,34.59,34.12,34.32001,9560512,9969477.45,45.25291582880739,51.13998088796786,NaN,NaN,-75.02202798813961,16.660057713443074,-0.055660116175468025,0.049170327701922645,0.10483044387739067,-71065850,-59368174.2,37.99827647951273,41.637220754278204,NaN,NaN,2.175099296920569,3.723172070875889
2012-07-26T09:30:00-04:00,34.72,34.83,34.23,34.48,9485250,9985949.3,47.16196881608904,50.58694350901618,NaN,NaN,-52.71774007608043,-17.366614358739668,-0.06733877739405975,0.020656972134815987,0.08799574952887573,-61580600,-63558293.8,35.39422054881764,39.218385221487175,NaN,NaN,1.0572403445644294,3.3423246814028236
2012-07-27T09:30:00-04:00,34.67,35.21001,34.58,35.11,9260492,10015125.25,53.96875494856643,50.687790605763446,NaN,NaN,17.82072215597912,-31.655631757607573,-0.03172583825596864,0.04833845170891493,0.08006428996488357,-52320108,-63677654.8,35.31996526029377,37.51892208441676,NaN,NaN,2.1136265246719637,3.166796373298415
2012-07-30T09:30:00-04:00,35.07001,35.31,34.92,35.08,9535504,9860050.25,53.61455898700618,51.13181205581621,NaN,NaN,43.38343688438695,-23.44865794987936,-0.01038567783887405,0.06708219266629101,0.07746787050516506,-61855612,-63577604,35.44222582174598,36.33075819383126,NaN,NaN,2.8625492859400152,3.1233325036757864
2012-07-31T09:30:00-04:00,34.94,35.08,34.82001,34.84,5461969,9276949.5,50.74528780494004,51.44493432402702,NaN,NaN,9.601912366723816,-11.386739331426025,-0.012488143427530782,0.061857691220751576,0.07434583464828236,-67317581,-62827950.2,36.412100201478026,35.81493593014509,NaN,NaN,2.6774827590925634,3.0596396830210404
2012-08-01T09:30:00-04:00,35.02,35.3,34.84,34.85001,8063152,9385923.9,50.86340182840466,51.882805784386385,NaN,NaN,32.088996637449135,10.035465593691724,-0.013190260981132157,0.05785800842186717,0.07104826940299933,-59254429,-60465666,39.49672201412983,36.033470152473534,NaN,NaN,2.5580632983343454,2.987985913780084
2012-08-02T09:30:00-04:00,34.53,34.8,34.17,34.44,11155996,9655230.35,45.99780782636852,51.501364216468296,NaN,NaN,-66.20868750588365,7.337276107731083,-0.03975249323705057,0.021357652856686116,0.06111014609373668,-70410425,-62231631,38.01220513956617,36.440658474415514,NaN,NaN,1.064471184964182,2.7131980953778125
2012-08-03T09:30:00-04:00,34.92999,35.25999,34.89999,35.12,10113094,9794275.85,53.87801447357812,51.78069345984485,NaN,NaN,65.67786143008611,16.908703962552483,-0.011478412576767932,0.04676213037277677,0.0582405429495447,-60297331,-63827075.6,36.6711908118664,36.94826809375642,NaN,NaN,2.09869528005679,2.6254119789033807
2012-08-06T09:30:00-04:00,35.24001,35.63,35.19,35.44,8672855,9506285.2,57.05397392382869,51.969974258360494,NaN,NaN,121.1836191616685,32.46874041800879,0.026735635284305045,0.09166008705492601,0.06492445177062096,-51624476,-61780848.4,39.61362088855416,37.71477938022202,NaN,NaN,3.9564590656718384,2.815561562727446
2012-08-07T09:30:00-04:00,35.58,35.96001,35.58,35.85001,9840762,9420469.8,60.78045295233203,52.28346936372067,NaN,NaN,166.85774573945403,63.919907092554844,0.0748599104824176,0.15849933987364295,0.08363942939122536,-41783714,-56674075,46.31734638451225,38.77742364618748,NaN,NaN,6.726302839057922,3.3742388879175143
2012-08-08T09:30:00-04:00,35.72,36.03999,35.6701,35.89,4863090,9111769.2,61.13467827414952,52.37837801367882,NaN,NaN,159.4319165176121,89.38849106858744,0.1028885373104978,0.2122501010293476,0.10936156371884981,-36920624,-52207314,51.399510529214815,39.72016036954339,NaN,NaN,9.053607614176943,4.185577277383147
2012-08-09T09:30:00-04:00,35.89,36.27,35.83,36.09,5355516,8762247.15,62.93758801102363,52.800893926150366,NaN,NaN,169.9811763511323,136.62646383999063,0.12682925472292889,0.2678981321225109,0.14106887739958202,-31565108,-44438250.6,58.71964084832484,40.99718361376723,NaN,NaN,11.541927246640196,5.236484415848439
2012-08-10T09:30:00-04:00,35.86,36.10001,35.78999,36.06,4179117,8540783.65,62.4694698611894,53.65084209750654,NaN,NaN,135.74035138031687,150.63896183003675,0.13198560553818842,0.30605088432231753,0.1740652787841291,-35744225,-39527629.4,62.558353150560215,42.43735162887708,NaN,NaN,13.45367779675649,6.410369184549589
2012-08-13T09:30:00-04:00,35.97,36.11,35.67,35.86,3528726,8480744.15,59.30272233875359,54.65439970535984,NaN,NaN,104.11017760383733,147.22427351847054,0.11394815011181952,0.3165004664239035,0.20255231631208398,-39272951,-37057324.4,64.35412123777787,44.122107094025395,NaN,NaN,14.229993018879805,7.527458303739619
2012-08-14T09:30:00-04:00,35.97,36.07001,35.58,35.7,6637219,8238069.35,56.82113155491631,55.48070082865333,NaN,NaN,79.53998084325531,129.7607205392308,0.08461181516008973,0.30831708526219614,0.22370527010210642,-45910170,-37882615.6,63.262472817381074,45.92669254673028,NaN,NaN,14.21608066784855,8.482975784326609
2012-08-15T09:30:00-04:00,35.56,35.84,35.53999,35.75999,4251680,8000273.1,57.538584735370144,56.22188768003057,NaN,NaN,62.81039598078104,110.43641643186456,0.06357782099298842,0.30317754634334193,0.2395997253503535,-41658490,-38830188.8,61.96281857319764,47.824449548471705,NaN,NaN,14.393264518604951,9.327302746366373
2012-08-16T09:30:00-04:00,35.86,36.36,35.82001,36.28999,7248391,7882458.65,63.334956172665144,56.89090205318047,NaN,NaN,111.49367008853811,98.73891517934574,0.07870024337431591,0.33797502956824843,0.2592747861939325,-34410099,-39399187,61.15042966487333,49.66948272022739,NaN,NaN,16.22339466902224,10.312458735317211
2012-08-17T09:30:00-04:00,36.34,36.41,36.16,36.24001,8417723,7748679.75,62.468930279633625,57.52335714551101,NaN,NaN,111.04551152751075,93.79994720878452,0.07849972237712144,0.35739943916533434,0.2788997167882129,-42827822,-40815906.4,59.07367847832037,51.35744362426841,NaN,NaN,17.497874219307434,11.338946661601529
2012-08-20T09:30:00-04:00,36.19,36.22,35.92999,36.17,4140250,7424064.1,61.206425790285344,58.27058128732138,NaN,NaN,83.2862590810705,89.63516350423113,0.0672484044145995,0.3629602223064623,0.2957118178918628,-46968072,-42354930.6,56.81630093232079,52.814886533614334,NaN,NaN,18.231769546036215,12.323635645092198
2012-08-21T09:30:00-04:00,36.37,36.63,36.08,36.22,5336832,7255406.5,61.80020434964886,59.05178146741025,NaN,NaN,98.48781029273559,93.42472939412718,0.05716595880138631,0.3671692663935957,0.3100033075922094,-41631240,-41499144.6,57.7823705882966,54.12100428891195,NaN,NaN,19.006801241642766,13.278373587456565
2012-08-22T09:30:00-04:00,36.05,36.52,35.88,36.52,8940328,7224397.3,65.23818259807658,60.42609395110368,NaN,NaN,92.28165850229966,99.3189818984309,0.0641688013622187,0.3902143092949828,0.3260455079327641,-32690912,-39705629,59.811523643156065,55.6780984677398,NaN,NaN,20.64286451701005,14.33044372024992
2012-08-23T09:30:00-04:00,36.44,36.44,35.88499,35.91,5175809,7008925.25,54.497912237236164,60.47037236279355,NaN,NaN,58.98143420430572,88.81653472158442,0.023292943222427365,0.3551616869607983,0.33186874373837094,-37866721,-40396953.4,58.64151900194264,57.247407624173825,NaN,NaN,18.95875309178388,14.9916307733262
2012-08-24T09:30:00-04:00,35.78999,35.92999,35.64999,35.84,4139781,6752889.7,53.411239172928425,60.21017702344352,NaN,NaN,15.8442968271983,69.77629178152193,-0.01104112779184624,0.31806733399856313,0.32910846179040937,-42006502,-40232689.4,58.84750801172039,58.621256704399975,NaN,NaN,17.261107941939237,15.315841797413777
2012-08-27T09:30:00-04:00,35.89,35.94,35.58,35.63,4364973,6494363.15,50.17869591425026,59.452908663580544,NaN,NaN,-3.4644848126567513,52.426143002776485,-0.048384392605235305,0.26862797103386526,0.31701236363910057,-46371475,-40113370,59.00722098016545,59.52767631837521,NaN,NaN,14.856004019009974,15.250150686213233
2012-08-28T09:30:00-04:00,35.5594,35.7,35.46249,35.55,3821411,6412335.25,48.962972331804735,58.5835010962702,NaN,NaN,-38.885203287371816,24.951540286755023,-0.07724959203160281,0.22045037359959707,0.2976999656311999,-50192886,-41825699.2,55.66825107193157,59.83258635714069,NaN,NaN,12.50747785740993,14.858340282098476
2012-08-29T09:30:00-04:00,35.60001,35.74001,35.39,35.63,4225258,6220440.55,50.26074734975616,57.67801247760824,NaN,NaN,-46.55766652969369,-2.816324719643646,-0.0889008492123397,0.18657390411577524,0.27547475332811494,-45967628,-44481042.4,50.86187456815369,59.27131733712846,NaN,NaN,10.881785415471876,14.290261015437533
2012-08-30T09:30:00-04:00,35.50999,35.53999,35.295,35.31,8060070,6065644.25,45.29886944071457,56.451541019002896,NaN,NaN,-119.78014726717831,-38.56864101394045,-0.11447640523770378,0.13237924678098523,0.246855652018689,-54027698,-47713237.8,45.69058818326651,58.066476982321774,NaN,NaN,7.9838871895692165,13.389350468884917
2012-08-31T09:30:00-04:00,35.62,35.77,35.33,35.64999,7309332,5925456.15,50.850689825605706,55.84782441092091,NaN,NaN,-81.62231902803707,-58.06196418498753,-0.10505879428519133,0.11553215916219983,0.22059095344739116,-46718366,-48655610.6,44.27709043955816,56.63240335387751,NaN,NaN,7.031706316810794,12.481115590017184
2012-09-04T09:30:00-04:00,35.69,35.69,35.09,35.19,6694969,5826561.85,44.29970137587719,54.953436540989536,NaN,NaN,-151.53119698138755,-87.67530661873369,-0.12501523538670037,0.0643219092140157,0.18933714460071607,-53413335,-50063982.6,42.17706733500766,55.126302962279404,NaN,NaN,4.095729159418225,11.283203242788762
2012-09-05T09:30:00-04:00,35.17,35.41,35.07001,35.35001,7069148,5687981.15,46.864076954904704,54.19097169952773,NaN,NaN,-141.82337696997374,-108.26294135525407,-0.12248472705034222,0.03623123578778831,0.15871596283813053,-46344187,-49294242.8,43.74742524922228,53.82520343913831,NaN,NaN,2.4590714314627595,10.022612984027905
2012-09-06T09:30:00-04:00,35.60001,36.28999,35.57001,36.235,8598625,5874757.9,58.29927387279161,53.83128010667962,NaN,NaN,45.35956484363351,-89.87949508058863,-0.05944679049580978,0.08440747471836829,0.14385426521417807,-37745562,-47649829.6,47.05546963769285,52.81842058005399,NaN,NaN,4.921184714732883,9.293837516985759
2012-09-07T09:30:00-04:00,36.49001,36.98,36.46001,36.95,11445027,6179233.45,64.8760254039326,54.00321547270097,NaN,NaN,196.97738328201703,-26.52798897074956,0.027498603630785656,0.17822751975266016,0.1507289161218745,-26300535,-42104397,56.37286946977281,52.625505650872014,NaN,NaN,9.559645520137838,9.331810088864627
2012-09-10T09:30:00-04:00,36.83,37.24001,36.83,36.89,7800184,6360286.8,63.96435939220514,54.20021072998095,NaN,NaN,192.72981248195768,28.342437331249393,0.07534954342980016,0.2449158454091247,0.16956630197932454,-34100719,-39580867.6,59.836729418824625,52.841250542765145,NaN,NaN,12.740703339406398,9.818794838942022
2012-09-11T09:30:00-04:00,37,37.25,36.88,37.02,6636750,6515688,65.10841979058463,54.43651183290494,NaN,NaN,168.95830389519756,92.44033750656641,0.10814203058176747,0.3047438402065339,0.19660180962476642,-27463969,-34390994.4,65.8431360067105,53.41701950122323,NaN,NaN,15.62744330749622,10.648601763021194
2012-09-12T09:30:00-04:00,37.14999,37.2,36.7516,36.97,7413098,6554481.95,64.26335225557264,54.36688109415466,NaN,NaN,135.99819170061653,148.00465124068447,0.11804347793199682,0.34415615703976243,0.2261126791077656,-34877067,-32097570.4,68.11256955008467,54.009951351718136,NaN,NaN,17.65279314848116,11.649200532372618
2012-09-13T09:30:00-04:00,36.96001,38.07001,36.87,37.88,13155293,6999662.6,71.51087310983071,55.58209258505427,NaN,NaN,189.32997279009584,176.79873282997693,0.17407412707716968,0.44370533795422773,0.26963121087705805,-21721774,-28892812.8,71.01103243827839,54.89348802574211,NaN,NaN,22.14020457894612,13.147915396168832
2012-09-14T09:30:00-04:00,38.17999,38.57001,38.14,38.35001,9494887,7111987.4,74.39880107174062,57.081204149255136,NaN,NaN,220.1595600898086,181.43516819153524,0.22760456297151027,0.5541369145914459,0.3265323516199356,-12226887,-26078083.2,73.30605596906513,55.92624145126673,NaN,NaN,26.901332551425945,15.112689275491277
2012-09-17T09:30:00-04:00,38.10001,38.11,37.64999,37.75999,6048719,6993537.2,65.43192382930403,58.17072042890184,NaN,NaN,138.12932649849049,170.51507099484178,0.20859436471764892,0.5872753075169967,0.37868094279934783,-18275606,-22913060.6,75.64130514744609,57.11439032035821,NaN,NaN,27.697370589937474,16.910500891840734
2012-09-18T09:30:00-04:00,37.67,37.735,37.42,37.66,8700008,7221525.1,64.02364007881451,59.2464824108311,NaN,NaN,100.42120529968524,156.80765127573932,0.17591078937972016,0.598569429523998,0.4226586401442779,-26975614,-22815389.6,75.71191855914509,58.546080855159175,NaN,NaN,27.834980376503115,18.471140818221073
2012-09-19T09:30:00-04:00,37.83,38.02,37.72,37.87,6601348,7284750.9,65.69366228821332,60.34883347786376,NaN,NaN,105.99439621314087,150.8068921782442,0.15575223454384812,0.617348933324088,0.4615966987802399,-20374266,-19914829.4,77.77265175258839,60.46827922547594,NaN,NaN,28.483724054432578,19.901509851965574
2012-09-20T09:30:00-04:00,37.50999,37.85001,37.32001,37.81,5187797,7097124.35,64.76856807975912,61.73952623779551,NaN,NaN,80.13931074875693,128.96875976997643,0.12691510458487948,0.6202405795113393,0.4933254749264598,-25562063,-20682887.2,75.93539638731882,62.62862266862253,NaN,NaN,28.71590472555619,21.160709119621377
2012-09-21T09:30:00-04:00,37.91,38,37.35001,37.44501,9566445,7316656.15,59.298178682552766,62.342918299006,NaN,NaN,68.6079965392375,98.6584470598622,0.07439708739087059,0.586321834165048,0.5119247467741774,-35128508,-25263211.4,65.9324322301235,64.17543279652004,NaN,NaN,27.21771059792707,22.02599504509362
2012-09-24T09:30:00-04:00,37.12,37.47,37.06,37.33501,4999383,7359636.25,57.716031754161484,63.3012276117406,NaN,NaN,42.41441710789624,79.51546518174337,0.02589273018189131,0.5442906595015415,0.5183979293196502,-40127891,-29633668.4,58.071679249019745,65.31076221894948,NaN,NaN,25.523007855588265,22.52556830373571
2012-09-25T09:30:00-04:00,37.5,37.5,36.72,36.74001,7397328,7511254,49.952309437792586,63.52181564623259,NaN,NaN,16.86395814392091,62.80401575059051,-0.04856384587265794,0.45769312197882783,0.5062569678514858,-47525219,-33743589.4,51.81541172643842,65.88704696732206,NaN,NaN,21.507553791781024,22.380137659170757
2012-09-26T09:30:00-04:00,36.59,36.75999,36.31,36.56,5748316,7607599.25,47.8549875596698,62.77579519529532,NaN,NaN,-22.776532064462238,37.04983009506989,-0.10878925403524786,0.370270400307426,0.47905965434267384,-53273535,-40323443.2,43.698593208231735,65.64727007950341,NaN,NaN,17.565203484259307,21.692289919897693
2012-09-27T09:30:00-04:00,36.88,37.08,36.60001,37.00999,4536980,7623185.35,53.150471486911265,61.938255629793794,NaN,NaN,1.2939413710074537,21.28075621952001,-0.1164846455321567,0.33345384742747797,0.4499384929596347,-48736555,-44958341.6,39.057311915349075,64.41044453990172,NaN,NaN,15.78321685914319,20.848136625504193
2012-09-28T09:30:00-04:00,36.78999,36.87199,36.60001,36.8,4669652,7453664.45,50.56962006156093,60.98148853474778,NaN,NaN,-20.20793414051481,3.5175700835695123,-0.13270472481705958,0.2840575869383102,0.41676231175536976,-53406207,-48613881.4,35.82541400450994,62.69535058173638,NaN,NaN,13.515356247456658,19.8005965714974
2012-10-01T09:30:00-04:00,37.03999,37.33,36.81,36.92,5633688,7369882.25,52.00388468425439,60.04545031286705,NaN,NaN,-0.38007455701211945,-5.041328249412159,-0.1320559781038408,0.25169233912556876,0.38374831722940955,-47772519,-50142807,34.53813214343401,60.459278877216626,NaN,NaN,12.08239929557862,18.69799696065186
2012-10-02T09:30:00-04:00,36.99001,37.03999,36.49001,36.72,5475488,7308908.2,49.42960397839353,58.985896864497114,NaN,NaN,-45.35024877848382,-17.484169633893107,-0.14098885656855908,0.2075122465187107,0.3485011030872698,-53248007,-51287364.6,33.565798311922194,57.99165236020503,NaN,NaN,10.120738017440564,17.472674254478818
2012-10-03T09:30:00-04:00,36.67,36.7345,36.38,36.55,8038422,7357371.9,47.286888710059415,57.255612264513445,NaN,NaN,-88.36856981433853,-30.602577183868362,-0.15322316378011236,0.15697214836212936,0.3101953121422417,-61286429,-52889943.4,32.19893682975865,55.219359816739335,NaN,NaN,7.850894189817134,16.098134245241436
2012-10-04T09:30:00-04:00,36.82001,37.14999,36.74001,37.02,5997641,7227322.7,53.312628542837984,55.749457083877545,NaN,NaN,-37.554293887763585,-38.37222423562257,-0.12569286854320055,0.153079226463241,0.27877209500644157,-55288788,-54200390,31.084250826531132,52.203516592272614,NaN,NaN,7.617336308315366,14.886591682823425
2012-10-05T09:30:00-04:00,37.21001,37.52,37.075,37.2,6174484,6963795.55,55.41467815906119,55.033939536003054,NaN,NaN,5.991726163410267,-33.13229217483756,-0.09290271746258705,0.16264369817820779,0.25554641564079483,-49114304,-53342009.4,32.7270952755417,49.138215887136596,NaN,NaN,8.045444141848185,13.909284891255535
2012-10-08T09:30:00-04:00,36.95,37.25,36.89999,37.13,3659324,6756752.55,54.38910726247366,54.345758620550136,NaN,NaN,-23.588742510073317,-37.7740257654498,-0.07427737641131768,0.16269969512664773,0.2369770715379654,-52773628,-54342231.2,31.776522362847246,45.999973301686744,NaN,NaN,8.107797304303164,13.080500950262339
2012-10-09T09:30:00-04:00,37.14999,37.325,36.75,36.78,8593332,6854581.65,49.46019193236925,53.18622502370413,NaN,NaN,-45.98611937519782,-37.901199884792604,-0.08320628772662608,0.1329692118796828,0.21617549960630889,-61366960,-55966021.8,30.240877627933585,42.60484657849712,NaN,NaN,6.726409968052753,12.17277366708954
2012-10-10T09:30:00-04:00,36.72,36.75999,36.28999,36.38,8624277,6915140.6,44.497146823607046,51.73826636255041,NaN,NaN,-114.2171743043812,-43.07092078280114,-0.11193884155550854,0.07625194766192323,0.18819078921743176,-69991237,-57706983.4,28.64264022734271,39.226792567070255,NaN,NaN,3.999390524806973,11.005147503906317
2012-10-11T09:30:00-04:00,36.71001,36.90221,36.53,36.53,6620344,6588393.15,46.65872892975841,50.835448523065104,NaN,NaN,-79.29274501616756,-51.41861100848193,-0.11622288053906851,0.04291218854359613,0.15913506908266464,-63370893,-59323404.4,27.20501450158592,36.46054844360328,NaN,NaN,2.368983833274686,9.771409836673227
2012-10-12T09:30:00-04:00,36.55,36.75999,36.25999,36.37,6098465,6418572.05,44.66072823512018,49.902926843133585,NaN,NaN,-107.26711863581187,-74.07037996832636,-0.12447706799071528,0.0035387340942705237,0.1280158020849858,-69469358,-63394415.2,23.94526062837504,34.02294711355723,NaN,NaN,0.4207123744556272,8.435595913499284
2012-10-15T09:30:00-04:00,36.39,36.71001,36.25999,36.67999,5632355,6397753.85,49.19954565091708,49.8491580012139,NaN,NaN,-87.32342814643891,-86.81731709559948,-0.10450959720725259,-0.002621194424079931,0.10188840278317265,-63837003,-65607090.2,22.375921389515213,31.920126375205566,NaN,NaN,0.05328070052545093,7.2381223116458795
2012-10-16T09:30:00-04:00,36.83,37.59,36.81,37.56,12287863,6577146.6,59.38387370532335,50.67264986876058,NaN,NaN,69.02205059547502,-63.8156831014649,-0.03128452235805372,0.0627827498356055,0.09406727219365922,-51549140,-63643526.2,26.95124879102525,30.723887488262243,NaN,NaN,3.137137623111851,6.652267356141018
2012-10-17T09:30:00-04:00,37.69,37.89999,37.52,37.86501,12138754,6854016.9,62.211582260271,51.31987206685771,NaN,NaN,163.7219982271901,-8.227848595150647,0.03485895458551577,0.13764096542555393,0.10278201084003816,-39410386,-57527356,39.01002785422045,30.72051005532448,NaN,NaN,6.620124185034138,6.647675474554321
2012-10-18T09:30:00-04:00,37.7,38.05,37.62,37.88,6891766,6939215.35,62.35031206141332,52.16135006684716,NaN,NaN,174.43181075050447,42.51706255818376,0.07450862332775007,0.19591778999972576,0.12140916667197568,-32518620,-51356901.4,48.28530313475555,31.61050213605631,NaN,NaN,9.389469667393506,7.039360359245633
2012-10-19T09:30:00-04:00,37.7,37.7,36.97,37.09,9177430,6919764.6,51.59897920112551,52.13242824662367,NaN,NaN,60.75648593181211,76.12178347170855,0.04393158378560852,0.17632364640398634,0.13239206261837783,-41696050,-45802239.8,54.93007848692804,33.06706973202017,NaN,NaN,8.33407304478789,7.224319314323098
2012-10-22T09:30:00-04:00,37,37.32001,36.8,37.25999,8973082,7118449.55,53.45868107557994,52.420219467851275,NaN,NaN,36.24732613812923,100.83593432862219,0.03210489306964176,0.17252317895543,0.14041828588578825,-32722968,-39579432.8,60.97900209698085,35.02515571666722,NaN,NaN,8.095000196056693,7.348702297427897
2012-10-23T09:30:00-04:00,36.37,36.47,35.89,36.1375,15453750,7521270.65,41.9865772234218,52.041625790234306,NaN,NaN,-148.11672297706215,57.40817961411476,-0.049905695263204514,0.0780361668067826,0.12794186206998712,-48176718,-38904948.4,61.58088078218763,37.12386599898358,NaN,NaN,3.6256126031906346,6.816832341108288
2012-10-24T09:30:00-04:00,36.42999,36.48,36.05,36.12,10116277,7739668.7,41.83584239886438,51.22185535137904,NaN,NaN,-128.76024241426634,-1.0882685141765307,-0.1009754348615149,0.0017225684930934904,0.1026980033546084,-58292995,-42681470.2,56.34079570487893,38.92790491886557,NaN,NaN,0.21947376708850888,5.8743525448197484
2012-10-25T09:30:00-04:00,36.38,36.39999,35.8,36.03999,7925387,7909089.05,41.10917973915685,50.20003403567159,NaN,NaN,-131.6094566040762,-62.29652198509266,-0.13373398848234294,-0.06446948224832028,0.06926450623402267,-66218382,-49421422.6,48.42159970579301,40.04894094959781,NaN,NaN,-2.6855682011566344,4.65150672396598
2012-10-26T09:30:00-04:00,35.97,36.2,35.78,36.11,8986887,8124950.8,42.057558044743324,49.31920909154799,NaN,NaN,-122.66452909715417,-98.98072499088592,-0.14341945523007843,-0.11000981280357536,0.03340964242650306,-57231495,-52528511.6,45.26307880956826,41.01226641007788,NaN,NaN,-4.728958850158834,3.311440213376721
2012-10-31T09:30:00-04:00,36.08,36.34,35.7,36.0302,14120266,8549279.7,41.24228290149251,48.73221558934251,NaN,NaN,-109.54458932628407,-128.13910808376858,-0.1473690722216284,-0.15080169785053243,-0.0034326256289040416,-71351761,-60254270.2,38.532611897917285,41.60453314364814,NaN,NaN,-6.635656786612413,1.890426356235416
2012-11-01T09:30:00-04:00,36.11,36.75999,36.03999,36.73,6059832,8578496.9,50.33451581364073,49.14917051720206,NaN,NaN,-36.29339200821002,-105.77444188999816,-0.09742838962120526,-0.1252181126554106,-0.027789723034205356,-65291929,-63677312.4,35.97981737557926,42.12861722566503,NaN,NaN,-5.555179055852985,0.8267684402227873
2012-11-02T09:30:00-04:00,36.99001,37,36.045,36.07001,6676059,8510378.75,43.498160450516046,48.92341562582761,NaN,NaN,-53.676090786400316,-90.75761156442493,-0.10288484644503759,-0.15639578109050234,-0.053510934645464754,-71967988,-66412311,34.0393843981835,42.61678650399343,NaN,NaN,-6.854746482376173,-0.27059083443420695
2012-11-05T09:30:00-05:00,35.97,36.39999,35.92999,36.32001,5297887,8475391.05,46.464286910438204,49.05224124549318,NaN,NaN,-68.77010481026092,-78.1897412056619,-0.08446918928204461,-0.1590974212480205,-0.0746282319659759,-66670101,-66502654.8,33.97420431429404,43.33313962441622,NaN,NaN,-6.950183310033162,-1.2248183309483434
2012-11-06T09:30:00-05:00,36.49001,36.92,36.35001,36.7,5646723,8449003,50.70057756160099,49.15945781054203,NaN,NaN,-4.689315978101485,-54.594698581851354,-0.04356815224233372,-0.12908842226889305,-0.08552027002655933,-61023378,-67261031.4,33.39610783246039,44.1202957989123,NaN,NaN,-5.657294934534337,-1.8580292743177709
2012-11-07T09:30:00-05:00,36.27,36.39,35.75999,36.12,9690602,8750566.9,44.864922793564034,48.1223898882735,NaN,NaN,-81.85149995239071,-49.05608070707268,-0.0518828331139025,-0.15037381141893746,-0.09849097830503496,-70713980,-67133475.2,33.60075958838887,44.59526085586685,NaN,NaN,-6.471514526066338,-2.5170985959961376
2012-11-08T09:30:00-05:00,36.19,36.24001,35.53999,35.63,6932355,8667518.05,40.612032501555674,46.57956490550812,NaN,NaN,-113.80763396553041,-64.55892909853677,-0.0847472619796365,-0.2044250557795806,-0.11967779379994409,-77646335,-69604356.4,31.576725013429808,44.06431065295323,NaN,NaN,-8.585313077236604,-3.38398637903049
2012-11-09T09:30:00-05:00,35.47,36.03999,35.44,35.56,8918004,8682204.4,40.02827725395992,44.98513384783288,NaN,NaN,-118.54232077694189,-77.53217509664509,-0.10427961465734384,-0.2500273121216239,-0.14574769746428004,-86564339,-72523626.6,29.328855679917226,42.71027869189335,NaN,NaN,-10.427500238973215,-4.390202644736593
2012-11-12T09:30:00-05:00,35.73,35.78999,35.50999,35.56,4639219,8583148.15,40.02827725395992,44.15865513732105,NaN,NaN,-113.37463396866625,-86.45308092832616,-0.10972685125994996,-0.2829062615392175,-0.17317941027926753,-86564339,-76502474.2,26.554224315077263,40.68343196533259,NaN,NaN,-11.88795411537211,-5.461309997684524
2012-11-13T09:30:00-05:00,35.36,35.83,35.25,35.5,5745258,8565487.8,39.46437493802838,43.15906184178165,NaN,NaN,-111.28223993797963,-107.77166572030178,-0.1096392269764693,-0.31022844399985416,-0.20058921702338486,-92309597,-82759718,22.88720361699579,37.962589216762225,NaN,NaN,-13.243764698877381,-6.573089240712076
2012-11-14T09:30:00-05:00,35.5,35.59,34.83,34.895,10345430,8801141.55,34.22824496609573,42.60489525197265,NaN,NaN,-143.29663013182312,-120.06069175618828,-0.1406177893319978,-0.37636145368838214,-0.23574366435638433,-102655027,-89147927.4,19.87027901031645,34.983260518771424,NaN,NaN,-16.07623979986582,-7.930682177734039
2012-11-15T09:30:00-05:00,34.89999,35.065,34.515,34.78,8177762,8595636.5,33.323181981341605,41.99684807929244,NaN,NaN,-166.78539418657482,-130.65624380039714,-0.15785293653589183,-0.4330598350262491,-0.2752068984903573,-110832789,-95785218.2,17.316269829157093,32.19579438479129,NaN,NaN,-18.66769538327576,-9.464541207097142
2012-11-16T09:30:00-05:00,34.89999,34.99001,34.44,34.86,8760035,8426700.55,34.618352241482654,41.53321754374429,NaN,NaN,-160.58577647593927,-139.06493494019662,-0.15276625926361137,-0.4661647225698715,-0.31339846330626014,-102072754,-98886901.2,16.264204832786433,29.898837608147968,NaN,NaN,-20.447599308074317,-11.033549507236739
2012-11-19T09:30:00-05:00,35.5,35.89,35.37,35.845,17798272,8972025.85,48.009233147529855,41.958337193943336,NaN,NaN,-38.70171902417951,-124.13035195129928,-0.07585217592192361,-0.4082136832086647,-0.3323615072867411,-84274482,-98428929.8,17.06542063121387,27.884719166836938,NaN,NaN,-17.86817003456477,-12.0099238682836
2012-11-20T09:30:00-05:00,35.73,36.075,35.63,35.88,6753449,8850826.8,48.41353483428054,42.47056947485677,NaN,NaN,-8.347277681218019,-103.54335949994694,-0.018403927501827955,-0.355366416664026,-0.33696248916219806,-77521033,-95471217,22.240244453075405,26.72097863506252,NaN,NaN,-15.703709495858192,-12.537607529365685
2012-11-21T09:30:00-05:00,35.84,35.98,35.75,35.94,4728813,8638613.35,49.14365171890831,42.385507753804454,NaN,NaN,6.062652989443455,-73.67150287569363,0.025469368463337694,-0.3051257785830259,-0.3305951470463636,-72792220,-89498655.6,31.530852692908667,26.403195443443195,NaN,NaN,-13.732295367274885,-12.708277220495571
2012-11-23T09:30:00-05:00,36.14,36.42,36.05,36.39999,3125215,8022186.6,54.46458424406998,43.16882373905831,NaN,NaN,73.25336457331535,-25.66375112371561,0.08400261405638815,-0.22559187947587844,-0.3095944935322666,-69667005,-81265498.8,41.845674516571556,26.960787594756628,NaN,NaN,-10.3580819520722,-12.372535039292233
2012-11-26T09:30:00-05:00,36.31,36.42999,36.08,36.42999,5785641,7805654.8,54.7967613357916,43.764000483726406,NaN,NaN,75.580334023266,21.569470976125444,0.1210236063958009,-0.15831498553751544,-0.27933859193331634,-63881364,-73627220.8,49.453669252815,28.06646366179384,NaN,NaN,-7.528114831918891,-11.68047500966747
2012-11-27T09:30:00-05:00,36.41,36.59,36.25999,36.265,5089594,7663865.15,52.52728140034139,43.894479329350716,NaN,NaN,80.30170330306166,45.37015544157367,0.12990079001738666,-0.11696260441158302,-0.24686339442896968,-68970958,-70566516,52.15475063996834,29.40636671947298,NaN,NaN,-5.761287810395977,-10.834876838342971
2012-11-28T09:30:00-05:00,35.94,36.44,35.73,36.42,8908016,7659921.6,54.43646471067256,44.57816089485847,NaN,NaN,49.41431413930869,56.92247380567901,0.14079756700485213,-0.07086643567290452,-0.21166400267775665,-60062942,-67074897.8,55.102306559332064,30.94219150311178,NaN,NaN,-3.72640641312631,-9.81938106331202
2012-11-29T09:30:00-05:00,36.57001,36.78999,36.491,36.67,6177664,7262791.5,57.411479143149656,45.77812136925803,NaN,NaN,109.02205571701795,77.51435435119393,0.15813073085933463,-0.014000589103588368,-0.172131319962923,-53885278,-63293509.4,58.11199881129102,32.837568202959005,NaN,NaN,-1.1123222537931374,-8.575515519095037
2012-11-30T09:30:00-05:00,36.62,36.81,36.59,36.7,5673363,7243468.05,57.767832589391496,47.045232464646006,NaN,NaN,112.62397202511698,85.38847584155425,0.164189166255506,0.03310513785645952,-0.13108402839904648,-48211915,-59002491.4,61.283655270557794,35.12005388800476,NaN,NaN,1.1543615291160034,-7.185533083636317
2012-12-03T09:30:00-05:00,36.81,36.92999,35.97,36.02,18888048,7854067.5,47.96999154124028,47.612497770880324,NaN,NaN,55.98451698731441,81.46931243436394,0.11717846545474395,0.015389053419383458,-0.10178941203536049,-67099963,-59646211.2,60.543058061023345,37.547827727000914,NaN,NaN,0.4163572226173474,-6.099548754171508
2012-12-04T09:30:00-05:00,36.08,36.39,35.96001,36.08501,7814473,7979896.8,48.86295943335987,48.28382523483257,NaN,NaN,32.965857368454934,72.0021432474426,0.08664716111849902,0.0065195393627632825,-0.08012762175573573,-59285490,-57709117.6,62.030073866402795,40.34374703052998,NaN,NaN,0.06870015531635926,-5.218370338530384
2012-12-05T09:30:00-05:00,35.63,35.94,35.44,35.66,12925590,8343840.15,43.59521781405222,48.952894723972314,NaN,NaN,-30.716737412387978,55.975932937103266,0.03657590662010639,-0.034407738480602745,-0.07098364510070913,-72211080,-60138745.2,59.02535029105982,43.14053783629736,NaN,NaN,-1.83440357310558,-4.73494651489827
2012-12-06T09:30:00-05:00,35.73,35.78,35.46001,35.75,4637473,8091183.7,44.94866282151635,49.78328621255623,NaN,NaN,-30.084871325850724,28.154547528529527,0.00966557896445458,-0.05890167139514091,-0.06856725035959549,-67573607,-62876411,55.74846996961919,45.88569498918751,NaN,NaN,-3.010196050195051,-4.4885535913692385
2012-12-07T09:30:00-05:00,35.95,36.06,35.82001,36.05,6164965,8052814.2,49.314539953754405,50.83301390628993,NaN,NaN,18.17811069679932,9.265375262865991,0.012062434987140186,-0.05348920662567025,-0.06555164161281044,-61408642,-65515756.4,52.71026091205058,48.488984709134954,NaN,NaN,-2.755974893278669,-4.241042348784871
2012-12-10T09:30:00-05:00,36.05,36.36,36,36.28,6841578,7948992.9,52.4293662934448,51.148737702426715,NaN,NaN,50.60553380282126,8.189578625967359,0.028208089615023614,-0.03029152959403092,-0.05849961920905453,-54567064,-63009176.6,55.20695470472836,51.21338000010028,NaN,NaN,-1.6234064870926008,-3.8670943685431185
2012-12-11T09:30:00-05:00,36.39999,36.66,36.37,36.57001,5548965,7994480.2,56.093326913825614,51.697294279537076,NaN,NaN,90.31926656362585,19.660260465001546,0.05589024901869058,0.011363192064308691,-0.04452705695438189,-49018099,-60955698.4,57.20051840369602,53.7105424251446,NaN,NaN,0.45124176116587916,-3.2501892071561187
2012-12-12T09:30:00-05:00,36.75,36.81,36.38,36.48,11818879,8298161.25,54.68550867170528,52.09314120473686,NaN,NaN,85.81402805550788,42.96641355858072,0.06497274779110482,0.03668887778449914,-0.02828387000660568,-60836978,-58680878,59.35842082874685,55.69822586341876,NaN,NaN,1.7627071453425471,-2.5340611567991664
2012-12-13T09:30:00-05:00,36.44,36.69,36.2,36.38,6361711,8098975.3,53.09127325842893,51.995047562905356,NaN,NaN,60.71769737738163,61.12692729922719,0.06113559552499781,0.048135624399641586,-0.012999971125356228,-67198689,-58605894.4,59.43102994201553,56.9543226795219,NaN,NaN,2.4174865208592298,-1.826697202847967
2012-12-14T09:30:00-05:00,36.37,36.81,36.35001,36.64999,6097211,7994947.75,56.75675323995126,52.13504698463105,NaN,NaN,88.95149140532666,75.28160344093266,0.07287436319279222,0.07809298286563404,0.005218619672841825,-61101478,-58544461.6,59.494878222681855,57.67155189165525,NaN,NaN,4.03981189468516,-0.988624474628949
2012-12-17T09:30:00-05:00,36.78,37.03,36.701,37.02,6511695,7882530.75,61.22815913215298,52.75653825118902,NaN,NaN,152.40634418751134,95.64176551787068,0.09997739744126499,0.13019036647442306,0.030212969033158073,-54589783,-58549005.4,59.48742088266281,58.19531405184771,NaN,NaN,6.8262494279948145,0.1277860828887314
2012-12-18T09:30:00-05:00,37.08,37.5,36.99001,37.46001,8343430,7409788.65,65.76201552513139,53.56550616650751,NaN,NaN,212.20839133360133,120.01959047186578,0.13952903824138063,0.20462426683488388,0.06509522859350324,-46246353,-57994656.2,60.14379167442115,58.55542013149693,NaN,NaN,10.742707932604931,1.6442034899910456
2012-12-19T09:30:00-05:00,37.52,37.56,37.28999,37.3,7176844,7430958.4,62.88230360943107,53.95627934267048,NaN,NaN,190.1194511404452,140.88067508885325,0.14619997254589193,0.24784519427586815,0.10164522172997623,-53423197,-56511900,61.920912257826814,58.82748537767805,NaN,NaN,13.106927516632211,3.2817354937969263
2012-12-20T09:30:00-05:00,37.27,37.67999,37.16,37.66,5487387,7468887.1,66.44271960724728,54.57591412966018,NaN,NaN,178.77764893537284,164.49266540045147,0.16476481967584242,0.30760124632477925,0.14283642664893684,-47935810,-52659324.2,66.14480051984448,59.174710038341395,NaN,NaN,16.27891951439998,5.138476068168791
2012-12-21T09:30:00-05:00,36.74001,37.13499,36.7,37,9740320,7799642.35,55.86308307670291,55.13970638219322,NaN,NaN,72.54039857567797,161.21044683452175,0.12434179153133068,0.2982636660631002,0.1739218745317695,-57676130,-51974254.6,66.84899207072228,59.625133896177026,NaN,NaN,15.6084111706108,6.634181082803364
2012-12-24T09:30:00-05:00,37.12,37.3,36.84,37.19,9639422,7992331.4,57.93939779354229,55.788023407920534,NaN,NaN,89.73156645540153,148.67549128809978,0.10302696203141451,0.3027055770710376,0.19967861503962311,-48036708,-50663639.6,68.21126401864802,60.06664747848026,NaN,NaN,15.740164496003317,7.935035856117643
2012-12-26T09:30:00-05:00,37.35001,37.575,37.31,37.42,10183582,8247030.8,60.36979061776544,56.98620717961433,NaN,NaN,123.39271808832889,130.9123566390453,0.09712402710410412,0.3210836489197533,0.22395962181564916,-37853126,-48984994.2,69.91642369446609,60.84458129300928,NaN,NaN,16.62011429953911,9.175761348034996
2012-12-27T09:30:00-05:00,37.50999,37.53999,36.82001,37.28999,8766168,8239938.4,58.31843728433211,57.94119106981545,NaN,NaN,81.01500503956345,109.09146741886893,0.0779940482649773,0.32145218214687077,0.24345813388189347,-46619294,-47624213.6,71.26215933583109,61.95270196202441,NaN,NaN,16.703560777622265,10.251161266547463
2012-12-28T09:30:00-05:00,37.03999,37.19,36.75,36.82001,6640785,8263094.45,51.505121475702765,58.09766117852605,NaN,NaN,34.644487222255854,80.26483507624553,0.029702584273224697,0.2805863642234243,0.2508837799501996,-53260079,-48689067.4,68.67332117479737,63.09292055222061,NaN,NaN,14.583654924262454,10.870088931935319
2012-12-31T09:30:00-05:00,36.75999,37.59,36.71001,37.53999,14333422,8696097.4,59.34171674708702,58.59140049664336,NaN,NaN,77.09921347490122,81.17659805609017,0.04153755371864981,0.30280572209851186,0.26126816837986205,-38926657,-44939172.8,72.46663654595102,64.3257549694508,NaN,NaN,15.351105342288312,11.510234133414318
2013-01-02T09:30:00-05:00,38.41,38.60001,38.19,38.48,12668965,8385143.25,66.86934676585093,59.361116200359454,NaN,NaN,194.8093015785815,102.19214508072616,0.10438532622792585,0.3917498261647694,0.28736449993684354,-26257692,-40583369.6,76.08859571947559,65.67490334914933,NaN,NaN,18.88722388771149,12.564089812599628
2013-01-03T09:30:00-05:00,38.44,38.59,38.08,38.2,7643371,8376588.15,63.12056346711089,59.963620114316996,NaN,NaN,160.10919880043704,109.53544122314779,0.11781624802179536,0.43463480996408776,0.3168185619422924,-33901063,-39792957,76.68788464850957,66.9127221934181,NaN,NaN,20.280610606156564,13.666449925964905
2013-01-04T09:30:00-05:00,38.31,38.72,38.28,38.67,5754344,8018025.85,66.5140802247769,60.9223920404847,NaN,NaN,169.3340631354384,127.19925284232276,0.1471642948389948,0.5007739304910359,0.3536096356520411,-28146719,-36098442,79.29945225224802,68.33189521557756,NaN,NaN,22.62869071771196,14.946770039071627
2013-01-07T09:30:00-05:00,38.49001,38.63,38.36,38.59,5307184,8051511.4,65.41078460968782,61.54053713832303,NaN,NaN,150.0829331607015,150.2869420300119,0.14951528184941532,0.5405037379638102,0.3909884561143949,-33453903,-32137206.8,81.67044095779487,69.91586398237135,NaN,NaN,24.064573115426615,16.249313335693767
2013-01-08T09:30:00-05:00,38.7,38.74001,38.36,38.64999,6000281,8043277.2,65.8679924753338,61.87195380569309,NaN,NaN,138.40449437287165,162.54799820960596,0.14341485135567877,0.5702570203089934,0.4268421689533146,-27453622,-29842599.8,82.89277414919391,71.58767492998071,NaN,NaN,25.336216208787267,17.54744231756427
2013-01-09T09:30:00-05:00,38.75999,38.94,38.7,38.89999,7171715,8059784.05,67.77939644632426,62.01605244292115,NaN,NaN,142.50079953240757,152.0862978003712,0.14413615359437665,0.6070123609462854,0.46287620735190876,-20281907,-28647442.8,83.50961032318409,73.25666197632093,NaN,NaN,26.980622149949525,18.89503943647645
2013-01-10T09:30:00-05:00,39.12,39.17999,38.71001,39.07001,7384008,8151536.2,69.04883683706781,62.456519102038065,NaN,NaN,131.48765238439876,146.36198851716352,0.14366272169366623,0.6424546094689916,0.49879188777532535,-12897899,-24446810,85.4899255610594,74.9401629265518,NaN,NaN,28.716977432403667,20.298173435894622
2013-01-11T09:30:00-05:00,39.06,39.06,38.75,39.00999,4860949,7803639.7,68.02987255440121,62.569887169691924,NaN,NaN,109.72833924082194,134.44084373824023,0.12745721987543035,0.6581134126196133,0.530656192744183,-17758848,-22369235.8,86.36223981254773,76.38426573317348,NaN,NaN,29.8453682877572,21.662058414732133
2013-01-14T09:30:00-05:00,39.08,39.14999,38.95,39.02,7239711,7847539.7,68.11438490148055,63.44498015717603,NaN,NaN,104.84011496342619,125.39228009878518,0.10641933080847743,0.6636803562547797,0.5572610254463023,-10519137,-17782282.6,88.06783178635052,77.89989714143262,NaN,NaN,30.794326559127512,22.96666814964576
2013-01-15T09:30:00-05:00,38.84,39.11,38.83,39.06,9264359,8005897.1,68.47303304272315,64.19738267497466,NaN,NaN,91.33580903410794,115.97854303103243,0.08512677649783817,0.6636694960686,0.5785427195707619,-1254778,-12542513.8,89.65884453717834,79.43186717847051,NaN,NaN,31.683799573111028,24.211972638712226
2013-01-16T09:30:00-05:00,38.82001,39.06,38.72,38.78,7485059,8054565.3,63.12086829851375,64.39388822359955,NaN,NaN,71.56243775857877,101.79087067626668,0.04417512026271375,0.633761619899154,0.5895864996364403,-8739837,-10234099.8,90.27411981672061,80.88598833006013,NaN,NaN,31.038216903094824,25.18715039076688
2013-01-17T09:30:00-05:00,39.10001,39.2298,38.98,39.08,6709602,7972873.9,66.17182718100099,64.95484464479019,NaN,NaN,85.77337822616644,92.64801584462022,0.029961834270130216,0.627038792474103,0.5970769582039728,-2030235,-8060567,90.82750204177279,82.28351280905596,NaN,NaN,31.297500149587236,26.06005749916979
2013-01-18T09:30:00-05:00,39.00999,39.35001,39.00999,39.34,8608293,8044446.35,68.59658994515443,66.17566382117958,NaN,NaN,91.19809735052648,88.94196746656112,0.03063172904166278,0.6353666195060512,0.6047348904643884,6578058,-3193185.8,91.9342638105444,83.9450087116093,NaN,NaN,32.20330632953514,26.93766447493627
2013-01-22T09:30:00-05:00,39.34,39.75,39.34,39.72,8111863,8175670.15,71.78032983556116,67.06413618464202,NaN,NaN,116.35391751979014,91.2447279778339,0.04818329994161885,0.664964015391412,0.6167807154497932,14689921,1848625.8,92.89111412388621,85.40389996717612,NaN,NaN,33.946556846077776,27.93893481367077
2013-01-23T09:30:00-05:00,39.62,39.64999,39.37,39.5,7254523,8051380.3,67.51285461662849,67.11010103112613,NaN,NaN,103.9674157461673,93.7710493202458,0.03699547825963723,0.6630250632743397,0.6260295850147025,7435398,3586661,93.19098938528117,86.62549951473366,NaN,NaN,34.18564244198839,28.831321617716146
2013-01-24T09:30:00-05:00,39.5,39.84,39.47,39.62,11590758,8148947.1,68.6091116996405,67.50214019059254,NaN,NaN,113.013603810344,102.06128253059883,0.02999453170106381,0.6635227496410323,0.6335282179399685,19026156,9139859.6,94.05402982275092,87.8659384557509,NaN,NaN,34.69572184187479,29.669093078310237
2013-01-25T09:30:00-05:00,39.84,39.87,39.5,39.75999,7254711,8002503.55,69.8857654911346,67.74297485247523,NaN,NaN,112.56043653334575,107.41869419203468,0.027192190038402897,0.6675184554879721,0.6403262654495692,26280867,14802080,94.78048016691199,88.97172616394118,NaN,NaN,35.48408595801752,30.49980634683985
2013-01-28T09:30:00-05:00,39.75999,39.78999,39.25,39.38,12437551,8186072.7,62.46015096128459,67.53221530616071,NaN,NaN,83.0401101906771,105.78709676006478,-0.006077529368806234,0.6327293537385614,0.6388068831073677,13843316,16255131.6,94.95095922434554,89.92033461155195,NaN,NaN,34.00799742204296,31.000976500440295
2013-01-29T09:30:00-05:00,39.37,39.66,39.34,39.60001,7978797,8252973.3,64.7927027652521,67.45540889829773,NaN,NaN,89.3137283621139,100.37905892852955,-0.01839510701878755,0.6158129993338832,0.6342081063526708,21822113,17681570,95.11948367538527,90.7936710062799,NaN,NaN,33.42145795300349,31.34675956509218
2013-01-30T09:30:00-05:00,39.58,39.77,39.31,39.38,6313840,7851994.2,60.72902056844772,66.95181062130656,NaN,NaN,75.9508603021554,94.77574783972719,-0.044973702614740985,0.5779909780842445,0.6229646806989855,15508273,19296145,95.31028879691166,91.63657661154616,NaN,NaN,31.721101848163997,31.400237034102442
2013-01-31T09:30:00-05:00,39.03,39.32001,38.95,39.02,6964238,7566757.85,54.685242038334536,65.92583956425418,NaN,NaN,-0.7202271347849054,72.0289816507014,-0.08792886466953909,0.5130535998620616,0.6009824645316006,8544035,17199720.8,90.36998029555842,91.98515194972467,NaN,NaN,28.369837913350278,30.96732287399499
2013-02-01T09:30:00-05:00,39.23,39.55499,39.14,39.5,6604438,7514811.2,60.35111306614178,65.37735674366422,NaN,NaN,50.75070388294757,59.66703512062181,-0.0850895154633774,0.49462057020237893,0.5797100856657563,15148473,14973242,85.31231490102226,91.91015731318713,NaN,NaN,27.161049941841643,30.423569597973085
2013-02-04T09:30:00-05:00,39.23,39.35001,39.09,39.12,5360914,7495139.7,54.53746171166895,64.40757651582054,NaN,NaN,-0.13231031473271476,43.032551019539845,-0.10838515182876207,0.4442286458798037,0.5526137977085658,9787559,14162090.6,83.47927211926377,91.58240305125237,NaN,NaN,24.226866304941183,29.5383262703971
2013-02-05T09:30:00-05:00,39.28,39.505,39.2601,39.32001,4756547,7467607.85,56.8913246646709,63.58031163167394,NaN,NaN,33.25889854897415,31.821585056911896,-0.10957858020312217,0.415640572454663,0.5252191526577852,14544106,12706489.2,80.15117497933983,90.90328379712103,NaN,NaN,22.56262375225412,28.541797339233817
2013-02-06T09:30:00-05:00,39.24001,39.39999,39.17999,39.36,6475719,7491379.75,57.36661792690516,63.169293747987616,NaN,NaN,13.425439255135448,19.316500847507903,-0.10681856212656432,0.3916959499995798,0.4985145121261441,21019825,13808799.6,80.77620738785282,90.22486148077334,NaN,NaN,21.37355998378582,27.517763431312673
2013-02-07T09:30:00-05:00,39.32001,39.38,38.86,39.14999,7886270,7527107.5,53.99948798990908,62.29984094862391,NaN,NaN,-44.67604857419223,10.52533655962644,-0.11743623995798902,0.35171921217865787,0.4691554521366469,13133555,14726703.6,81.30415505095375,89.54462241000054,NaN,NaN,19.362977794325953,26.352794054600285
2013-02-08T09:30:00-05:00,39.25,39.41,39.16,39.38,5725445,7444179.35,56.97789285998273,61.46993401396879,NaN,NaN,6.543376297583279,1.6838710425535823,-0.10753349281988556,0.33473858611178997,0.4422720789316755,18859000,15468809,81.74075887557193,88.81651491464538,NaN,NaN,18.52657060096702,25.234762132652676
2013-02-11T09:30:00-05:00,39.42,39.42,39.19,39.33,3590791,7380671.45,56.127142831459274,60.35184922796151,NaN,NaN,-0.5296647009189993,1.6044001653163253,-0.10291255268972116,0.31363138806952406,0.4165439407592452,15268209,16564939,82.39474119556283,88.06677399119371,NaN,NaN,17.599494935033803,24.14400967584998
2013-02-12T09:30:00-05:00,39.23,39.41,39.14999,39.35001,7031242,7370248,56.40766519295401,59.55862141198476,NaN,NaN,-9.317663298770178,-6.910912204232536,-0.09714195101536638,0.29511650199003725,0.39225845300540363,22299451,18116008,83.30591184851816,87.36069702428208,NaN,NaN,16.910555824508386,23.110659125658323
2013-02-13T09:30:00-05:00,39.48,39.60001,39.36,39.49001,6149148,7214487.45,58.41127348538887,58.830204396681076,NaN,NaN,52.10372537355329,0.8247450194510322,-0.08307438059535438,0.28841547726121064,0.371489857856565,28448599,19601762.8,84.15203119403344,86.6534114079451,NaN,NaN,16.85644058734846,22.2171993344712
2013-02-14T09:30:00-05:00,39.38,39.42999,39.23,39.36,6745480,7177508.5,55.844336365386454,57.827245173413345,NaN,NaN,-16.78398164652136,6.403158404985206,-0.08158594028135313,0.26950743250487363,0.35109337278622677,21703119,21315675.6,85.09078144701883,85.96129007080988,NaN,NaN,16.122061207778966,21.34646531637231
2013-02-15T09:30:00-05:00,39.45,39.495,39.19,39.35001,13362102,7510133.5,55.641990364544576,57.34023370221763,NaN,NaN,-21.879746302278555,0.7185338850128389,-0.08021453464790185,0.2508252044763495,0.33103973912425133,8341017,19212079,78.91232855811553,84.81567359465059,NaN,NaN,15.454900673878583,20.50481322458749
2013-02-19T09:30:00-05:00,39.33,39.48,39.16,39.17999,6001805,7379809.1,52.17691192648616,56.439105785162916,NaN,NaN,-59.38481956991654,-11.05249708878667,-0.08901829102487191,0.21976687534316142,0.3087851663680333,2339212,16626279.6,71.99240985650782,83.16373975044506,NaN,NaN,13.952574352231636,19.568779099965226
2013-02-20T09:30:00-05:00,39.10001,39.12041,38.07001,38.08,11537793,7551105.6,36.38825846400011,54.70047992055952,NaN,NaN,-371.4352398426713,-83.4760123975669,-0.16288375649625159,0.10518047074771886,0.26806422724397044,-9198581,10326673.2,58.5270985927682,80.53636902157767,NaN,NaN,6.848387752237296,17.751580336004093
2013-02-21T09:30:00-05:00,37.98,38.00999,37.5,37.73,13515676,7864163.25,32.96968077696222,53.14936840189007,NaN,NaN,-378.6483369170828,-169.62642485569413,-0.22542263630067105,-0.013714068131868373,0.21170856816880268,-22714257,94102,44.098865606699974,77.23128940094492,NaN,NaN,-0.27560356819979837,15.176268349689252
2013-02-22T09:30:00-05:00,37.92,38.23,37.86,38.23,7234629,7646356.8,41.4344147499272,51.7981756650176,NaN,NaN,-212.1706108414933,-208.7037506946885,-0.22282504219007837,-0.06682273456879528,0.1560023076212831,-15479628,-7342447.4,36.966468842071045,73.7780146824484,NaN,NaN,-3.3941041497379905,12.523357992628217
2013-02-25T09:30:00-05:00,38.42,38.44,37.35001,37.35001,13320176,7949630.05,33.43236062038923,50.29066844421191,NaN,NaN,-210.94539323628953,-246.5168800814907,-0.2670972128560642,-0.17786920844879717,0.08922800440726704,-28799804,-14770611.6,31.48812175635038,70.06436108509743,NaN,NaN,-9.311381414010816,9.404109505965499
2013-02-26T09:30:00-05:00,37.66,37.82001,37.39,37.75,12023535,7928929.25,39.181853452548985,49.02570621477463,NaN,NaN,-168.38093613767123,-268.31610339504164,-0.25613152181352294,-0.2309363978596366,0.025195123953886317,-16776269,-18593707.8,29.097984207015315,66.41770460135999,NaN,NaN,-11.79143163653095,6.376175057037435
2013-02-27T09:30:00-05:00,37.64999,38.56,37.64,38.42,12913199,8175649.35,47.38019434448751,48.31239024460194,NaN,NaN,-83.58090355594888,-210.74523613769716,-0.19330346587598296,-0.2164342083910924,-0.02313074251510943,-3863070,-17526605.6,30.67964158172684,62.83937847235099,NaN,NaN,-10.661440598088506,3.9422299634480154
2013-02-28T09:30:00-05:00,38.39999,38.71001,38.35001,38.49001,9707555,8345335.1,48.16646769450552,47.8957459377874,NaN,NaN,-40.58388015948908,-143.1323447861784,-0.13911201728787828,-0.19702076412495728,-0.057908746837079,5844485,-11814857.2,38.57781759993426,59.787497225849584,NaN,NaN,-9.540497744390066,2.0161260051854324
2013-03-01T09:30:00-05:00,38.24001,38.645,38.005,38.50999,10553766,8524811.5,48.40342238055498,47.28328376068543,NaN,NaN,-50.02488361075788,-110.70319934003132,-0.09605036544355106,-0.17797170364151782,-0.08192133819796676,16398251,-5439281.4,45.976940076900846,57.232938740230225,NaN,NaN,-8.607340060640098,0.4984879957817854
2013-03-04T09:30:00-05:00,38.35001,38.57001,38.2,38.56,9029824,8646080.8,49.03148440603295,46.77645101601212,NaN,NaN,-38.442479117669166,-76.20261651630724,-0.06008665486763656,-0.15702965678251246,-0.0969430019148759,25428075,5406294.4,55.74365295984988,55.32928958053645,NaN,NaN,-7.675129039581528,-0.669171580698688
2013-03-05T09:30:00-05:00,38.86,39.11,38.73,38.82001,8955391,8825804.65,52.28360852647189,46.481875539834824,NaN,NaN,14.515633731269466,-39.62330254251913,-0.016918414461955605,-0.11809101999232041,-0.1011726055303648,34383466,15638241.4,62.611193004010154,53.851095377357304,NaN,NaN,-5.889056003029612,-1.4148693553173914
2013-03-06T09:30:00-05:00,39.07001,39.28,39,39.16,8258469,9000900.75,56.217533947077506,46.32517985852687,NaN,NaN,47.14411237907753,-13.478299355513826,0.03364523241282262,-0.05911606501433653,-0.09276129742715915,42641935,24939242.4,67.54185690212472,52.664654356506674,NaN,NaN,-3.1296070471005413,-1.6598318827149843
2013-03-07T09:30:00-05:00,39.25,39.3701,39.205,39.27,4464785,8900354.05,57.4400945837806,46.43916258841217,NaN,NaN,63.643177067223306,7.36711208982865,0.07143943807612872,-0.0034619998319982415,-0.07490143790812696,47106720,33191689.4,71.17417053576136,51.67061071998828,NaN,NaN,-0.5083840040169726,-1.4953393286152683
2013-03-08T09:30:00-05:00,39.42,39.64999,39.355,39.59,5921230,8802102.05,60.86375962450058,46.81214610698046,NaN,NaN,88.33175873888028,35.03844055975628,0.1124876551320673,0.06570813100695716,-0.046779524125110133,53027950,40517629.2,73.96006610560451,51.316877687666064,NaN,NaN,2.8009284837163424,-0.8815867839964668
2013-03-11T09:30:00-04:00,39.52,39.85001,39.42,39.81,8000410,8915850.3,63.06365448020573,47.58977057510328,NaN,NaN,101.90881575680878,63.108699534651876,0.1467854596194597,0.1367023003992145,-0.010083159220245205,61028360,47637686.2,76.35216542069557,51.62828879939376,NaN,NaN,6.256506597166444,0.13814084188394893
2013-03-12T09:30:00-04:00,39.82001,40.03909,39.71989,39.84,5988141,9035717.8,63.3660599960865,49.516756398823745,NaN,NaN,113.52171399145116,82.90991558668821,0.16259437882097916,0.19315981430597873,0.030565435484999584,67016501,54164293.2,78.31833359796315,53.041948442621965,NaN,NaN,9.154657184968698,1.4262146051817701
2013-03-13T09:30:00-04:00,39.8,39.87,39.64,39.74001,5602047,8964258.05,61.55707988865734,51.55871347823054,NaN,NaN,95.40217398500063,92.56152790787283,0.1573198496485494,0.22721524754568634,0.06989539789713695,61414454,57918797,79.38041771946675,55.562059307819595,NaN,NaN,11.096722840517224,2.8077157816582634
2013-03-14T09:30:00-04:00,39.86,40.02,39.77,39.98,6192457,8966423.5,64.19885171396604,53.18474468994759,NaN,NaN,107.9039709911655,101.41368669266127,0.1604452886094104,0.27045200865889996,0.11000672004948955,67606911,62018835.2,80.50357671908048,58.67185272760599,NaN,NaN,13.541083267750533,4.341053993957159
2013-03-15T09:30:00-04:00,39.71001,39.96001,39.71001,39.85001,8059586,9032128.8,61.724628369468334,55.205620957738965,NaN,NaN,93.67876353727866,102.48308765234094,0.14469487766016947,0.2908753171247014,0.1461804394645319,59547325,63322710.2,80.86062090203826,62.19845980944084,NaN,NaN,14.945223045043132,5.855935286969441
2013-03-18T09:30:00-04:00,39.46001,39.7,39.37,39.57001,5047973,8616422.35,56.65921423068665,56.454003870463076,NaN,NaN,62.92565752184475,94.68645600534815,0.10803603559730113,0.2812254839611583,0.1731894483638572,54499352,62016908.6,79.29446210046225,65.78392251611562,NaN,NaN,14.76469667030057,7.128615484588173
2013-03-19T09:30:00-04:00,39.64,39.64,39.05,39.39999,7608734,8696768.8,53.773511844056436,56.91066940614657,NaN,NaN,44.446218859808766,80.87135697901967,0.06696634174093657,0.2568973755400279,0.18993103379909132,46890618,57991732,74.5040691146563,68.91423876846773,NaN,NaN,13.797525950838027,8.081316979766724
2013-03-20T09:30:00-04:00,39.62,39.765,39.53999,39.7,4347242,8337241.25,57.85267785714206,57.602541560620615,NaN,NaN,67.00417347304888,75.19175687662933,0.055128539334697135,0.25884170796746275,0.20371316863276562,51237860,55956413.2,72.13114790980225,71.3109052191726,NaN,NaN,14.109886552703285,8.942541204471947
2013-03-21T09:30:00-04:00,39.34,39.45,39.02,39.02,6592719,7991093.4,47.59984489391157,57.54514316871751,NaN,NaN,13.510743159508639,56.31311131029794,-0.0004343204737257411,0.20317026804060845,0.2036045885143342,44645141,51364059.2,66.94982822486648,72.80896865831299,NaN,NaN,11.089364875770698,9.249230300371769
2013-03-22T09:30:00-04:00,39.11,39.23,38.95,39.07001,4816246,7870174.25,48.32516899105678,57.49469206764779,NaN,NaN,0.011561318667160793,37.57967086657563,-0.03390197957453128,0.16122711404617007,0.19512909362070135,49461387,49346871.6,64.74968565274139,73.45225670780523,NaN,NaN,8.903597633280466,9.199854205073011
2013-03-25T09:30:00-04:00,39.16,39.21001,38.58,38.77,6093191,7508825,44.35838275747185,56.92860451271922,NaN,NaN,-37.563124080700064,17.48191454606668,-0.07402655415456344,0.10259590092749704,0.17662245508206048,43368196,47120640.4,62.31575674202566,73.43115411766348,NaN,NaN,5.792517633891923,8.713091837761427
2013-03-26T09:30:00-04:00,38.88,39.07001,38.825,39.03999,5492527,7182274.6,48.458699616171295,56.37440206051162,NaN,NaN,-34.569855102113365,1.6786997536822512,-0.0796753680218781,0.07702824505471284,0.15670361307659095,48860723,47514661.4,62.583836036806424,73.07700977014075,NaN,NaN,4.405317272864338,8.097695471347556
2013-03-27T09:30:00-04:00,38.81,39.06,38.63,39.03,4126582,6742943.75,48.316820486828014,55.722739625015016,NaN,NaN,-55.11647574699927,-22.745430090327382,-0.0811053960590615,0.05532186800276406,0.13642726406182556,44734141,46213917.6,61.04009047702163,72.3531469088022,NaN,NaN,3.252626602859516,7.405542775849265
2013-03-28T09:30:00-04:00,38.96001,39.28,38.96001,39.17999,7510539,6633092.95,50.652911678501724,54.99339334315795,NaN,NaN,-23.657204545772803,-30.179019631383674,-0.06942180097555839,0.04965001284237758,0.11907181381793597,52244680,47733825.4,62.21300420647405,71.5140710588643,NaN,NaN,2.9456038395250026,6.768408642088657
2013-04-01T09:30:00-04:00,39.14999,39.22,38.75,38.84,6335637,6422186.5,45.61932088973399,53.74736951526711,NaN,NaN,-69.60068441745301,-44.1014687786077,-0.08124246692398485,0.01751873016295491,0.09876119708693976,45909043,47023356.6,61.28423175139723,70.43779008248586,NaN,NaN,1.1776144605292516,5.969723759008742
2013-04-02T09:30:00-04:00,38.91,38.99001,38.38,38.46001,9508516,6446121.1,40.74575774346848,52.1316336400801,NaN,NaN,-136.69021291297005,-63.92688654506171,-0.10954302802919891,-0.03816758794955888,0.07137544007964003,36400527,45629822.8,59.41074623357637,69.0872481278868,NaN,NaN,-1.899387625049195,4.845564989857609
2013-04-03T09:30:00-04:00,38.46001,38.64,37.96001,38.14,14870703,6741886.7,37.1466601763765,50.38803223206004,NaN,NaN,-185.5602894897397,-94.12497342258698,-0.14261185177752936,-0.10688937464227166,0.03572247713525769,21529824,40163643,52.61603781735042,67.17550670630706,NaN,NaN,-5.684311007508632,3.34129699023386
2013-04-04T09:30:00-04:00,38.2,38.64,38.19,38.47,9158125,6786869.5,42.76146664813386,48.85679044164346,NaN,NaN,-132.70619325479822,-109.64291692414676,-0.13512864687370893,-0.13318833145687847,0.001940315416830457,30687949,37354404.6,49.483776273994856,64.95980667451524,NaN,NaN,-7.1513848367453505,1.8423424435225442
2013-04-05T09:30:00-04:00,37.95,38.3372,37.95,38.31,7646301,6945945.3,40.85578346540197,47.36615866278157,NaN,NaN,-146.22277341659859,-134.1560306983119,-0.13358316775125353,-0.16503864427223647,-0.031455476520982927,23041648,31513798.2,43.66386835384744,62.302895778215884,NaN,NaN,-8.943977328931824,0.3014396188862061
2013-04-08T09:30:00-04:00,38.39999,38.45,38.13,38.42999,4117371,6855752.35,42.9105556549787,46.38411162165958,NaN,NaN,-112.44742714027493,-142.7253792428763,-0.11766758593236018,-0.17853995893643315,-0.06087237300407297,27159019,27763793.4,40.380052990916965,59.52329512753408,NaN,NaN,-9.804025931286073,-1.142198316852691
2013-04-09T09:30:00-04:00,38.49001,39.02,38.49001,38.88,9114879,6911475.8,49.93550263668675,46.109968106847454,NaN,NaN,-42.06567636070497,-123.80047193242328,-0.072250129593545,-0.15118503499600422,-0.07893490540245922,36273898,27738467.6,40.357977927875154,57.084288614192566,NaN,NaN,-8.35695423474179,-2.1728777336939906
2013-04-10T09:30:00-04:00,38.99001,39.17,38.84,39.14999,6206414,6922389.45,53.622751193525275,45.80783048801768,NaN,NaN,1.9229406880718756,-86.30382589686097,-0.022046111142404234,-0.10649254433046451,-0.08444643318806028,42480312,31928565.2,45.65176159162439,55.19290387717985,NaN,NaN,-5.965847549972944,-2.714730564590984
2013-04-11T09:30:00-04:00,39.11,39.50101,39.08501,39.32001,7442445,7014409.35,55.828962812514646,46.395624625060755,NaN,NaN,48.453695486479475,-50.07184814860544,0.022196649799108265,-0.05670062093917494,-0.0788972707382832,49922757,35775526.8,50.036512908299436,53.984809925996494,NaN,NaN,-3.3066023841484493,-2.799283681670622
2013-04-12T09:30:00-04:00,39.09,39.23,38.56,38.74001,12492164,7329394.7,47.52350926805628,46.33836321627501,NaN,NaN,-23.263318170819655,-25.479957099449653,0.01246861651475395,-0.06331150009484077,-0.07578011660959472,37430593,38653315.8,53.08574248109277,53.1516711280216,NaN,NaN,-3.6051610556995946,-2.9144090208176183
2013-04-15T09:30:00-04:00,38.35001,38.44,37.25999,37.31,20628544,7957842.6,34.066977039535345,45.603262807850975,NaN,NaN,-212.6499450509331,-45.52046068158127,-0.08485137634358901,-0.18184433703908098,-0.09699296069549197,16802049,36581921.8,50.687850024947906,52.32110636251605,NaN,NaN,-9.334177098537666,-3.8315187462061964
2013-04-16T09:30:00-04:00,37.63,38.00999,37.63,37.99001,9606688,8185778.35,42.41686867410551,45.17170345484628,NaN,NaN,-147.95623725569814,-66.6985728605799,-0.09712069722646341,-0.21839383222857123,-0.12127313500210782,26408737,34608889.6,48.44323885540188,51.31106370670143,NaN,NaN,-10.563726058994002,-4.793262648033026
2013-04-17T09:30:00-04:00,37.64999,37.73,37.23,37.42999,9843785,8297530.9,38.13374840698603,44.444341163428994,NaN,NaN,-176.4805088829405,-102.37926277478238,-0.13435318649500078,-0.2892146181208588,-0.15486143162585803,16564952,29425817.6,43.05001652757706,50.02605842459825,NaN,NaN,-13.219522635360681,-5.997014074794119
2013-04-18T09:30:00-04:00,37.57001,37.67,37.10001,37.32001,17338016,8947069.6,37.33639849736215,43.49316165049045,NaN,NaN,-162.74837893588685,-144.61967765925564,-0.15625359796613555,-0.3501784290835275,-0.19392483111739192,-773064,19286653.4,34.87133459511068,48.07308202378658,NaN,NaN,-15.47267688002444,-7.350680189827022
2013-04-19T09:30:00-04:00,37.53999,37.77,37.45,37.75999,10762434,9155555.35,42.5148402803221,43.27141303553246,NaN,NaN,-107.35319746466558,-161.43765351802483,-0.13194280839774766,-0.3588533416145765,-0.22691053321682883,9989370,13798408.8,31.394532271036,45.93810348947506,NaN,NaN,-15.444372895770375,-8.506922004961787
2013-04-22T09:30:00-04:00,37.95,38.25999,37.56,38.12,7175586,9273522.35,46.41676585778258,43.67648504369775,NaN,NaN,-59.18744299954235,-130.7451531077467,-0.08474491926425165,-0.3328416822971434,-0.24809676303289174,17164956,13870990.2,31.491813817334076,43.94389403117204,NaN,NaN,-14.065785038572862,-9.301045295477655
2013-04-23T09:30:00-04:00,38.22,38.5,38.06,38.45,9095586,9423642.1,49.78164725546257,44.57898412077533,NaN,NaN,-9.454256221372523,-103.04475690088154,-0.027398048137370234,-0.28234432320460456,-0.25494627506723433,26260542,13841351.2,31.47218827958335,42.43361906418868,NaN,NaN,-11.81413004648258,-9.660057402764073
2013-04-24T09:30:00-04:00,38.60001,39.11,38.55,39.03,7065113,9502271.4,55.11654232132049,45.46148952600294,NaN,NaN,67.32037007769316,-54.284581108754836,0.04932065218701007,-0.19329545983347174,-0.2426161120204818,33325655,17193491.8,36.306786768891236,41.49240552810985,NaN,NaN,-8.069515708796317,-9.43283716076868
2013-04-25T09:30:00-04:00,39.37,39.77,39.25,39.46001,6358930,9613888.8,58.62589693967115,46.7307833455936,NaN,NaN,136.43792136116036,5.552678950654604,0.12447509557615327,-0.08702224255029023,-0.2114973381264435,39684585,25285021.6,46.177537932321485,41.671953355143714,NaN,NaN,-3.7976813825506683,-8.627814906737536
2013-04-26T09:30:00-04:00,39.42999,39.42999,38.75999,38.89999,7768898,9626806.75,52.832277707347345,47.43947777790565,NaN,NaN,78.41836300531803,42.70699104465133,0.13124426728274563,-0.047442004023011464,-0.1786862713057571,31915687,29670285,50.6419546633852,42.40494633174859,NaN,NaN,-2.17489853717978,-7.705969711086428
2013-04-29T09:30:00-04:00,39.00999,39.53,38.88,39.49001,6944156,9657232.7,57.58780893167306,47.98607108469039,NaN,NaN,107.11129178991277,75.96673800254234,0.1678897582389423,0.03117592649292078,-0.13671383174602153,38859843,34009262.4,54.650188416252306,43.42581850948982,NaN,NaN,0.8268633815432571,-6.486993554996473
2013-04-30T09:30:00-04:00,39.42,39.57001,39.13,39.55,10680961,9715854.95,58.05090758057001,48.3023679694793,NaN,NaN,107.69511094225876,99.3966114352686,0.18713219903767125,0.09720141705106755,-0.0899307819866037,49540804,38665314.8,58.54090880467163,44.346471881850334,NaN,NaN,3.300555928788799,-5.0887722001700055
2013-05-01T09:30:00-04:00,39.34,39.42999,38.82001,38.85001,10340785,9489359.05,51.046854227544365,47.96078878483856,NaN,NaN,57.30246235484105,97.39302989069817,0.14553136432481426,0.09198342341941412,-0.05354794090540014,39200019,39840187.6,59.48545493652736,45.02139631243805,NaN,NaN,3.1346295664995862,-3.9140005192172067
2013-05-02T09:30:00-04:00,39.03999,39.22,38.67,39.13,6173473,9340126.45,53.46538662743312,48.38520859622263,NaN,NaN,49.67272240189103,80.0399900988443,0.13018426651994755,0.1091823922445343,-0.02100187427541325,45373492,40977969,60.42575972129186,45.545683258166555,NaN,NaN,3.777289552720433,-2.815244794654687
2013-05-03T09:30:00-04:00,39.69,40.005,39.53,39.82001,5830355,9249329.15,58.85970147330368,50.15611748434894,NaN,NaN,120.6355001626674,88.48341753031418,0.1579668248579596,0.17645665679703626,0.018489831939076655,51203847,44835601,63.5174075694555,46.46208022563138,NaN,NaN,6.128903020760477,-1.5375093924525205
2013-05-06T09:30:00-04:00,39.92999,39.985,39.73,39.92999,4656199,9276270.55,59.66232893530945,51.38793607443494,NaN,NaN,118.11989043502024,90.68513725933568,0.17394961059805056,0.23592684518663987,0.0619772345885893,55860046,48235641.6,66.03592637562805,47.71870076279039,NaN,NaN,8.23822828465431,-0.1409754385801163
2013-05-07T09:30:00-04:00,40.03999,40.37,39.89999,40.31,6082445,9124648.85,62.3924834386128,53.12070286240827,NaN,NaN,132.68478954523047,95.68307297993002,0.19853490084628891,0.31014586064645044,0.11161095980016153,61942491,50715979,67.78317072493496,49.48535463403025,NaN,NaN,10.860659555493356,1.4306867034303798
2013-05-08T09:30:00-04:00,40.27,40.67,40.21001,40.66,5135992,9071127.75,64.75835048482072,55.07941371865531,NaN,NaN,145.2337899510629,113.26933849917438,0.2248556034322734,0.3926804640905033,0.16782486065822988,67078483,56291671.8,71.35108790690398,52.09105129915834,NaN,NaN,13.78983395470772,3.196279167898571
2013-05-09T09:30:00-04:00,40.69,40.81,40.49001,40.61,5959340,8996972.5,64.13760288733438,56.62389676201333,NaN,NaN,139.97219724849327,131.32923346849483,0.2248446971976752,0.44888073215532387,0.22403603495764868,61119143,59440802,73.1591162835806,55.07423587148296,NaN,NaN,15.965295768002171,5.0204243964848
2013-05-10T09:30:00-04:00,40.58,40.66,40.27,40.57001,4879156,8616322.1,63.612399965497595,57.85215634113583,NaN,NaN,113.91183594824275,129.98450062560988,0.2084565686737111,0.4846067457997876,0.2761501771260765,56239987,60448030,73.73016905338469,58.09126124548657,NaN,NaN,17.599081727635593,6.817375443792056
2013-05-13T09:30:00-04:00,40.53,40.56,40.17,40.28,4455965,7807693.15,59.788733388961816,58.56694820781435,NaN,NaN,92.01591624340925,124.7637057872877,0.16623180028148027,0.4839399274779268,0.31770812719644653,51784022,59632825.2,72.38781062301318,61.013805698588705,NaN,NaN,17.95059716875525,8.40783569021537
2013-05-14T09:30:00-04:00,40.2,40.785,40.2,40.78,5063996,7580558.55,63.82590844862252,59.189045788335925,NaN,NaN,101.3514119016123,118.49703025856407,0.16006433538547093,0.5177885464282852,0.35772421104281427,56848018,58613930.6,70.65631474238275,63.46734341098095,NaN,NaN,19.43194074242671,9.982707840531276
2013-05-15T09:30:00-04:00,40.63,41.149,40.59,41.005,5300223,7353380.45,65.5042952209057,59.68035995128117,NaN,NaN,116.63716088081596,112.77770444451468,0.1589055219280569,0.5563561134528854,0.3974505915248285,62148241,57627882.2,68.9377465879962,65.093072600672,NaN,NaN,21.164664236873612,11.580130182865895
2013-05-16T09:30:00-04:00,40.83,41.155,40.73,40.82001,4587215,6715840.4,62.919477400579915,60.4008742150835,NaN,NaN,106.13618850966375,106.01050269674877,0.13441999925858128,0.5654755905980551,0.4310555913394738,57561026,56916258.8,67.65872967207144,66.30855652986388,NaN,NaN,21.90217883355302,13.054708561535485
2013-05-17T09:30:00-04:00,40.89999,41.32001,40.89999,41.25999,7047207,6530079.05,66.32324403700338,61.02483386546424,NaN,NaN,118.5616366953333,106.94046284616688,0.13617507371462684,0.6012744334827573,0.4650993597681305,64608233,58589908,69.11027992286652,67.34142020890775,NaN,NaN,23.54067702422119,14.55270405620487
2013-05-20T09:30:00-04:00,41.19,41.5,41.10001,41.3,5254023,6434000.9,66.62328313057864,61.637146404750574,NaN,NaN,120.08509960154396,112.55429951779381,0.12844972064546156,0.6256615105749574,0.4972117899294959,69862256,62205554.8,72.03080668102285,68.30498434293284,NaN,NaN,24.968153995226427,16.04062547606509
2013-05-21T09:30:00-04:00,41.41,41.48,41.17999,41.25,4543773,6206410.25,65.83390812973812,62.69336454062155,NaN,NaN,111.41925755655959,114.56786864878327,0.1091502042270337,0.633649545213288,0.5244993409862543,65318483,63899647.8,73.30437778502082,69.29205026068237,NaN,NaN,25.948808978980527,17.45608026219587
2013-05-22T09:30:00-04:00,41.25999,41.61,40.53999,40.69,12295637,6467936.45,57.602048231088595,62.98884036945408,NaN,NaN,72.35331853395424,105.71110017941093,0.05081215505043035,0.5880145347992922,0.5372023797488619,53022846,62074568.8,69.62610076614013,69.94921747817153,NaN,NaN,24.499124765051246,18.462229476889494
2013-05-23T09:30:00-04:00,40.25,40.8,40.05499,40.71001,6901137,6495046.8,57.805074532202795,62.91350987366116,NaN,NaN,26.639321920735966,89.81172686162537,0.007962758791234537,0.547155828237905,0.5391930694466704,59923983,62547160.2,70.04525035632028,70.41549196294758,NaN,NaN,23.36258369709772,19.162280079776384
2013-05-24T09:30:00-04:00,40.53,40.6225,40.27,40.57001,5782527,6395728.25,55.7920665169341,62.63706255806293,NaN,NaN,17.561096709480076,69.61161886445471,-0.03316202685266689,0.4977405358808369,0.5309025627335038,54141456,60453804.8,65.71909689594847,70.3928612858276,NaN,NaN,21.846240187373603,19.545702952290274
2013-05-28T09:30:00-04:00,41.05,41.10001,40.8,40.94,5603270,6328683.95,59.778499278043185,62.450349403736524,NaN,NaN,66.69526811329638,58.9336525668052,-0.03842807741767318,0.4828674659614123,0.5212955433790855,59744726,58430298.8,61.7490149094908,69.96185015615303,NaN,NaN,21.579511803238965,19.836247073854373
2013-05-29T09:30:00-04:00,40.75,40.89999,40.42,40.81,6207609,6105016.35,57.8060951094484,61.95375973406708,NaN,NaN,32.3989131926728,43.12958369402784,-0.05276312083257395,0.45534164233836805,0.508104763170942,53537117,56074025.6,57.400607677136044,68.96538728259817,NaN,NaN,20.812010740272164,19.97564188334263
2013-05-30T09:30:00-04:00,40.88499,41.095,40.73,40.94,4929879,5834471.05,59.25393732668253,61.6049264797348,NaN,NaN,57.68820531367433,40.19656104997186,-0.05531811618900029,0.4389571179346916,0.4942752341236919,58466996,57162855.6,58.84293455003761,67.94280287305939,NaN,NaN,20.543046510248296,20.056699687186295
2013-05-31T09:30:00-04:00,40.67,40.98,40.28,40.3,7776734,5914634.1,50.1334079001286,60.642141332208446,NaN,NaN,-27.59615909576291,29.349464846672095,-0.09936918852441812,0.37006374846816925,0.46943293699258737,50690262,55316111.4,55.41584390575464,66.63463679108581,NaN,NaN,17.56559616602583,19.700827755591945
2013-06-03T09:30:00-04:00,40.41,40.52,40.03,40.5,6264395,5936336.1,52.58932486936432,60.127897866522915,NaN,NaN,-74.46795513769852,10.94365447723637,-0.1132866479070952,0.3278246271087184,0.4411112750158136,56954657,55878751.6,56.25183151892629,65.48206685507962,NaN,NaN,15.76621409042519,19.138740089139553
2013-06-04T09:30:00-04:00,40.5,40.73,40.22,40.45,6326840,6019868.15,51.901139280880685,59.27612864025564,NaN,NaN,-60.156025797879835,-14.426604304998872,-0.12328357902603643,0.28700680123326805,0.4102903802593045,50627817,54055369.8,52.79675206691846,64.20638380683216,NaN,NaN,14.092454971836526,18.41784221523912
2013-06-05T09:30:00-04:00,40.34,40.34,39.55,39.55,8710199,6151255.85,41.39943893398029,57.55435319118954,NaN,NaN,-203.580742890393,-61.62253552161203,-0.1842631693648341,0.17996141855326186,0.364224587918096,41917618,51731470,48.69185598983844,62.760248764106606,NaN,NaN,9.021564328405704,17.075516802834347
2013-06-06T09:30:00-04:00,39.53999,39.83,39.36,39.81,7222504,6255581.45,44.869898921317194,56.26509758552792,NaN,NaN,-201.12258807459125,-113.38469419926514,-0.1995525888507596,0.11478385185464646,0.31433644070540606,49140122,49866095.2,45.62541125238931,61.18644030555789,NaN,NaN,5.9208389909707195,15.481991401139544
2013-06-07T09:30:00-04:00,39.92,40.23,39.77,40.17999,9937617,6454495.3,49.457090007775484,55.06037229772593,NaN,NaN,-106.27781281236072,-129.1210249425847,-0.17792867221915765,0.09192560043145903,0.2698542726506167,59077739,51543590.6,48.751083368618794,59.732211980254476,NaN,NaN,4.747810044062575,13.94853692155712
2013-06-10T09:30:00-04:00,40.32001,40.48,40.21001,40.37,4633500,6442212.5,51.68065700042861,53.99304185985807,NaN,NaN,-48.38683423456363,-123.90480076195772,-0.1453821207795424,0.08812662167618868,0.23350874245573108,63711239,52894907,51.18540264225796,58.24325454891413,NaN,NaN,4.476760961787827,12.595426070161507
2013-06-11T09:30:00-04:00,39.91,40.22,39.69,39.81,6061465,6522487.5,45.34853223445523,52.52980072448072,NaN,NaN,-120.94975407192396,-136.06354641676654,-0.15522814823481632,0.03947355716221068,0.194701705397027,57649774,54299298.4,53.64952804708559,56.83933671049018,NaN,NaN,2.1836717858368724,11.108032600972273
2013-06-12T09:30:00-04:00,40.11,40.23,39.58,39.61,7729512,6655763.3,43.30767350499212,51.50877395833097,NaN,NaN,-120.48160348994975,-119.44371853667789,-0.1678007225080625,-0.015049197738051134,0.15275152477001136,49920262,55899827.2,56.35361931902297,55.891302321410386,NaN,NaN,-0.3299492242407654,9.47403519737041
2013-06-13T09:30:00-04:00,39.50999,40.41,39.46001,40.34,9385555,6860029.9,51.82909523982577,51.08191829458975,NaN,NaN,-71.20450336202363,-93.46010159416437,-0.12169028924660705,0.0006386632117525437,0.12232895245835959,59305817,57932966.2,59.57956073270116,55.14375306258046,NaN,NaN,0.2730426542859994,8.159607691215495
2013-06-14T09:30:00-04:00,40.21001,40.53,39.95,40.05,5028941,6882116.2,48.697576942715145,50.575169039288404,NaN,NaN,-48.71982439316151,-81.94850391032453,-0.10603232915603858,-0.010211458986688626,0.09582087016934995,54276876,56972793.6,57.42108794798029,54.55103813772559,NaN,NaN,-0.26338537216540164,6.956322967875367
2013-06-17T09:30:00-04:00,40.39,40.47,40.14,40.39,4488543,6754183,52.33385401214616,50.043408663152896,NaN,NaN,-17.521545314245166,-75.77544612626085,-0.06983540809662421,0.008526610048569694,0.0783620181451939,58765419,55983629.6,55.202327838766614,54.08341763267386,NaN,NaN,0.480773835814599,6.031244520438114
2013-06-18T09:30:00-04:00,40.36,40.63,40.3,40.57001,4159660,6699464.85,54.185362643936905,49.784784915616356,NaN,NaN,21.011477476475708,-47.383199816580905,-0.032713585635128925,0.037470036101282744,0.07018362173641167,62925079,57038690.6,57.10615644011723,54.062385401458236,NaN,NaN,1.6677537821584019,5.40788870068387
2013-06-19T09:30:00-04:00,40.49001,40.74001,40.25999,40.25999,8422746,6893413.5,50.54400671272059,49.16264701461908,NaN,NaN,16.03098567294621,-20.08068198400171,-0.028156049089090987,0.03498856037504794,0.06314460946413893,54502333,57955104.8,58.746126995927774,54.05547057616468,NaN,NaN,1.5364516695060544,4.854826267658468
2013-06-20T09:30:00-04:00,39.64999,39.85001,39.08,39.22,13191977,6938230.5,40.67025544445353,48.486707553499436,NaN,NaN,-180.23194606169199,-41.88617052393535,-0.0907688964022497,-0.050316511038673184,0.0404523853635765,41310356,54356012.6,50.56882891282484,53.70925521952683,NaN,NaN,-2.0414611343277347,3.8696423530890103
2013-06-21T09:30:00-04:00,39.27,39.28999,38.375,38.785,11069309,7146639.1,37.38092616564218,47.40039336037643,NaN,NaN,-229.90697760874235,-78.12360116705152,-0.1533846409841805,-0.15127841586664914,0.00210622511753137,30241047,49548846.8,42.132902543868084,52.70076029273696,NaN,NaN,-6.108390605862393,2.44420907323881
2013-06-24T09:30:00-04:00,38.22,38.46001,37.78,38.17,12424492,7478737.35,33.28250152975478,46.07049066386743,NaN,NaN,-259.92543207244745,-126.60437851869199,-0.22385736558330377,-0.27771548186159833,-0.05385811627829458,17816555,41359074,32.25935886302288,51.233803635315844,NaN,NaN,-10.979388845706426,0.526552227675205
2013-06-25T09:30:00-04:00,38.61,38.61,38.16,38.39999,5336168,7465382.25,36.1038710154874,45.692235812546514,NaN,NaN,-184.51216125064715,-167.70910626411654,-0.24112489240091928,-0.35526423177944366,-0.1141393393785244,23152723,33404602.8,25.90866882781627,49.60643312374283,NaN,NaN,-13.88356427196694,-1.532035843702244
2013-06-26T09:30:00-04:00,38.56,38.675,38.21001,38.58,5108332,7410418.4,38.30302893159005,45.223173670423144,NaN,NaN,-145.79564052659904,-200.0744315040256,-0.22677927414931726,-0.39761343206517097,-0.1708341579158537,28261055,28156347.2,22.729308472109608,47.97099721086572,NaN,NaN,-15.49902358455045,-3.527319806680559
2013-06-27T09:30:00-04:00,38.83,38.83,38.53,38.56,4673910,7397619.95,38.14593904521307,44.41523431595441,NaN,NaN,-110.54127397703562,-186.13629708709433,-0.20561846513213183,-0.4278572393310185,-0.22223877419888666,23587145,24611705,20.866822203377794,45.979264270491356,NaN,NaN,-16.824755132325254,-5.426953424629801
2013-06-28T09:30:00-04:00,38.41,38.66,38.25,38.345,8137809,7415673.7,36.416875569723935,43.32496421376122,NaN,NaN,-113.54923437993189,-162.86474844133224,-0.19327110952059923,-0.4638276610996357,-0.27055655157903646,15449336,21653362.8,19.43542063210299,43.71140841262315,NaN,NaN,-18.439913240527016,-7.2859476840436885
2013-07-01T09:30:00-04:00,38.77,38.97,38.49561,38.57001,11203520,7662629.95,39.507269604179506,42.90773116874152,NaN,NaN,-77.86316666625574,-126.4522953600939,-0.15857421033322028,-0.46877431449556184,-0.31020010416234156,26652856,23420623,22.840530871058974,41.510765757192665,NaN,NaN,-18.90797471932727,-8.946237260512772
2013-07-02T09:30:00-04:00,38.42,38.75999,38.24001,38.45,4235492,7558062.55,38.43429075176928,42.559632400654166,NaN,NaN,-84.92437444325721,-106.53473799861592,-0.13334486667318357,-0.476881187503821,-0.34353632083063745,22417364,23273551.2,22.754339288205912,39.11081718356287,NaN,NaN,-19.59706370221702,-10.46778389504195
2013-07-03T09:30:00-04:00,38.22,38.53999,38.19,38.46001,3311106,7288107.9,38.58411984514249,41.61356272960536,NaN,NaN,-82.4626619089664,-93.8681422750894,-0.10677067471120799,-0.47699966421964746,-0.37022898950843947,25728470,22767034.2,22.440262460142222,36.458010164094375,NaN,NaN,-20.124985423537893,-11.847384113398514
2013-07-05T09:30:00-04:00,38.72,38.74001,38.38,38.72,3525473,7103256.35,42.49833703008749,41.17075987870339,NaN,NaN,-57.70854221362396,-83.30159592240707,-0.06455012937574423,-0.45091665122811975,-0.3863665218523755,29253943,23900393.8,24.93690585060847,34.13771144285353,NaN,NaN,-19.52457023049018,-12.94412498726875
2013-07-08T09:30:00-04:00,38.89,39.03999,38.78,38.94,3922859,6802518.45,45.654631382547606,40.69367254801778,NaN,NaN,-28.16468403150229,-66.22468585272114,-0.017140969192716515,-0.40779273334327115,-0.39065176415055464,33176802,27445887,32.28078788994901,32.50045858936656,NaN,NaN,-18.136980412600007,-13.685961476601788
2013-07-09T09:30:00-04:00,39.21001,39.63,39.21001,39.53999,4798906,6810788.75,53.19952871577021,40.62325583886302,NaN,NaN,23.765805374241605,-45.89889144462167,0.055324189549998126,-0.321496527213057,-0.3768207167630551,37975708,29710457.4,36.55070904987097,31.03221234720611,NaN,NaN,-14.584992772836127,-13.81439451892098
2013-07-10T09:30:00-04:00,39.5,39.67999,39.31,39.53,3786720,6697051.5,53.067421984992095,40.80349978688241,NaN,NaN,30.842105523922278,-22.745595451185768,0.10064162581586411,-0.25101868449322495,-0.35166031030908906,34188988,32064782.2,40.734546526993704,29.74567088513939,NaN,NaN,-11.735288302561878,-13.517379345155394
2013-07-11T09:30:00-04:00,40.03999,40.25,39.97,40.17,5320414,6576596.6,59.93200201672392,42.179338827758876,NaN,NaN,86.32167111560331,11.011271153728174,0.16781924136136273,-0.14188625860738568,-0.3097054999687484,39509402,34820968.6,45.28332340884244,29.368134777712076,NaN,NaN,-6.947301517278327,-12.578796798315814
2013-07-12T09:30:00-04:00,40.24001,40.25,39.862,40.03,3787858,6296711.75,57.93573412556083,43.64753939632449,NaN,NaN,78.906021976078,38.33418399166857,0.1950165603894548,-0.06593479948192993,-0.26095135987138474,35721544,36114488.8,47.32662957258078,29.739115279762977,NaN,NaN,-3.5784342090612653,-11.293030714136593
2013-07-15T09:30:00-04:00,40.03,40.2,39.965,40.13,7371938,6413861.6,58.9865886007396,45.48354561568055,NaN,NaN,84.50849289864642,60.86881937769831,0.21060103282991927,0.0022999311660143462,-0.20830110166390492,43093482,38097824.8,50.38595803208123,31.033872363267147,NaN,NaN,-0.4861667853425315,-9.749193010023156
2013-07-16T09:30:00-04:00,40.16,40.22,39.66,39.83,5863027,6482585.8,54.581255769499634,46.80335881239571,NaN,NaN,70.65202288360703,70.24606287957138,0.19208276632893906,0.031802356247268904,-0.16028041008167015,37230455,37948774.2,50.15021983575698,32.765411720977205,NaN,NaN,0.9482506905203459,-8.22098676708837
2013-07-17T09:30:00-04:00,40.03999,40.31,39.94,40.2,6976602,6623432.9,58.68000079707216,48.25885680278729,NaN,NaN,98.91405549921474,83.86045287462989,0.19548036114828876,0.08407004135369078,-0.11141031979459796,44207057,39952388,53.312402346095126,34.94991842626188,NaN,NaN,3.43187400900943,-6.55629237050297
2013-07-18T09:30:00-04:00,40.14,40.44,40.125,40.22,3759411,6390266.15,58.89593107837685,49.74099909087041,NaN,NaN,112.24669151098935,89.04545695370709,0.1896545641068974,0.12565788533902378,-0.06399667876787361,47966468,41643801.2,55.85803499120179,37.449290768249305,NaN,NaN,5.512677079639043,-4.832153877625539
2013-07-19T09:30:00-04:00,40.17999,40.48,40.12,40.48,6055418,6033438.2,61.69814381688488,51.54680396566763,NaN,NaN,108.435990511412,94.95145066077389,0.19323709984303308,0.17754969603591775,-0.015687403807115335,54021886,45303869.6,60.834511124028076,40.40636866052967,NaN,NaN,8.125914905551914,-2.9810011943144747
2013-07-22T09:30:00-04:00,40.46001,40.7,40.46001,40.52,4927031,5726324.3,62.12593276497137,53.162422762867045,NaN,NaN,111.27358706546858,100.30446949413833,0.18804848137301192,0.21937319790914955,0.031324716536137644,58948917,48474956.6,64.56220774647338,43.38648843734499,NaN,NaN,10.40722990406048,-1.0683967516894812
2013-07-23T09:30:00-04:00,40.88,41.08,40.56,40.64,4846980,5347448.7,63.44498690416196,54.948901059466515,NaN,NaN,116.73283041745883,109.52063100090868,0.18231108190411405,0.2592135689162802,0.07690248701216616,63795897,53788045,69.75615545913531,46.7437610209828,NaN,NaN,12.713583657103072,0.9004575924237406
2013-07-24T09:30:00-04:00,40.81,40.81,40.09,40.25999,5741086,5367694.6,56.709417379150324,56.24356516903851,NaN,NaN,77.37877423596073,105.21357474825788,0.14420548717866666,0.2571593459854995,0.11295385880683283,58054811,56557595.8,72.05535414532933,50.28769614135331,NaN,NaN,12.913148163406257,2.616556245421243
2013-07-25T09:30:00-04:00,40.10001,40.69,39.96001,40.64,4030562,5313806.1,61.151034818303714,57.57590072533967,NaN,NaN,74.10535081268937,97.58530660859789,0.13598372036422576,0.282933509262115,0.14694978889788926,62085373,59381376.8,74.20826671886711,53.80707906051464,NaN,NaN,14.396113176447825,4.299350092710755
2013-07-26T09:30:00-04:00,40.39999,40.53999,40.14999,40.49001,4201234,5290172.3,58.595600677152575,58.50025567495431,NaN,NaN,65.2443014028751,88.9469687868905,0.11279026031193895,0.28793761428781295,0.175147353975874,57884139,60153827.4,74.78064886540261,56.84278341590419,NaN,NaN,14.899374605289587,5.813639308793445
2013-07-29T09:30:00-04:00,40.33,40.77,40.27,40.72,7354848,5251024.25,61.268349908061175,59.07660004583223,NaN,NaN,78.99891716099692,82.49203480599616,0.10542103656844642,0.30692364968643204,0.20150261311798562,65238987,61411841.4,75.72548303180879,59.64098155747117,NaN,NaN,16.1055096109575,7.283906494816882
2013-07-30T09:30:00-04:00,40.33,40.7,40.16,40.62,4822523,4931974.4,59.47075870532966,59.53398124014206,NaN,NaN,66.23126352084539,72.39172142667347,0.08705697771259416,0.3103238352587283,0.22326685754613415,60416464,60735954.8,74.11882571373549,62.02557292795273,NaN,NaN,16.603916827116297,8.615336542288226
2013-07-31T09:30:00-04:00,40.64999,40.86,40.42,40.48,5837645,5012082.05,56.95150073194895,59.321088291229565,NaN,NaN,74.74188236741708,71.86434305296476,0.06001311650932889,0.29828325318279525,0.23827013667346636,54578819,60040756.4,72.41689944455709,63.963685501932346,NaN,NaN,16.322577258514166,9.716370930320503
2013-08-01T09:30:00-04:00,40.75,40.99001,40.67999,40.78,4596980,5076375.75,60.785031357704455,59.524609522096966,NaN,NaN,107.18018036780448,78.47930896398778,0.05688959729039661,0.30938213328646214,0.2524925359960655,59175799,59458841.6,70.94834582448394,65.65095094849686,NaN,NaN,17.166205398997565,10.780632997274369
2013-08-02T09:30:00-04:00,40.72,41.03999,40.60001,41.00999,2841463,5042175.25,63.470712815600194,59.84490410887272,NaN,NaN,117.20894545201152,88.87223777381504,0.06432508750835664,0.3328988953815113,0.26857380787315466,62017262,60285466.2,71.82249591964771,67.18213222618017,NaN,NaN,18.673427296618687,11.908175040037843
2013-08-05T09:30:00-04:00,40.89999,41.05,40.83,40.89999,2538978,4972981.2,61.30805128047351,60.32538950251371,NaN,NaN,125.22951007337771,98.11835635629122,0.05614500218813301,0.33875506060832095,0.28261005842018794,59478284,59133325.6,68.71884523868464,68.50846261210357,NaN,NaN,19.325014418728784,12.967723522707978
2013-08-06T09:30:00-04:00,40.89999,40.92999,40.41701,40.522,3371302,4901601,54.44320000743686,60.02276087468262,NaN,NaN,55.950573349871625,96.06221832209646,0.021375728690544715,0.30932971928336883,0.2879539905928241,56106982,58271429.2,66.40699118233096,69.44379038612043,NaN,NaN,17.858828541627805,13.666452811125096
2013-08-07T09:30:00-04:00,40.38,40.66991,40.38,40.53999,2944628,4859496.4,54.703166277231546,59.72327767460081,NaN,NaN,24.207649086740126,85.95537166596107,-0.0030146711592340947,0.2841856516437815,0.2872003228030156,59051610,59165987.4,67.62441124339736,70.28424583270582,NaN,NaN,16.739052706463855,14.105395653316346
2013-08-08T09:30:00-04:00,40.89,41.28999,40.8,41.14,4199301,4803440.75,62.40811722547677,59.7739900609288,NaN,NaN,161.07939389375613,96.73521437115143,0.0175288187251178,0.30911134620941283,0.29158252748429503,63250911,59981009.8,68.7360928734677,70.84864452909436,NaN,NaN,18.076763722925797,14.67273394897484
2013-08-09T09:30:00-04:00,41.03,41.50999,41.03,41.38,7383207,4983208.2,64.97451311054621,59.9774600856127,NaN,NaN,195.32827921116314,112.35908112298175,0.042144127619894334,0.34426268700916296,0.3021185593892686,70634118,61704381,71.00336827619104,71.3087274240742,NaN,NaN,20.005990473688776,15.434627738219687
2013-08-12T09:30:00-04:00,41.3,41.44099,41.21001,41.32001,4046600,4816941.3,63.802004079023106,60.00296131238849,NaN,NaN,169.65231582319362,121.24364227294491,0.04878048265863605,0.3630941627125637,0.3143136800539276,66587518,63126227.8,72.7586556082948,71.52319172044274,NaN,NaN,21.21502854236928,16.260399281669628
2013-08-13T09:30:00-04:00,41.42999,41.59,41.2,41.47,3971693,4722374.6,65.47934122326795,60.629384444111174,NaN,NaN,163.3675333761687,142.72703427820434,0.05708934149462308,0.38567535692220645,0.32858601542758337,70559211,66016673.6,75.94636091000302,71.80112077506229,NaN,NaN,22.722274785832834,17.183524353692942
2013-08-14T09:30:00-04:00,41.49001,41.67999,41.36,41.38,3957573,4571423.15,63.575671165567634,60.80257275463003,NaN,NaN,151.09499993627966,168.10450444811224,0.05056520990216801,0.3917925278052934,0.3412273179031254,66601638,67526679.2,77.43208920923405,72.03139381008849,NaN,NaN,23.43567450221955,18.076688660625315
2013-08-15T09:30:00-04:00,41,41.14999,40.73,41.08,5601047,4663504.95,57.56767688719695,60.729149626776056,NaN,NaN,41.6641264378659,144.2214509569342,0.021569095287271023,0.3681886870122142,0.34661959172494317,61000591,67076615.2,75.92675189240308,72.11325831201711,NaN,NaN,22.295823046815183,18.679422144366725
2013-08-16T09:30:00-04:00,41.02,41.03,40.64999,40.75999,7070453,4714256.7,51.930191147269106,60.062138286719474,NaN,NaN,-1.289102173894937,104.89797467992257,-0.021318150473648156,0.31997190363288297,0.3412900541065311,53930138,63735819.2,65.71423736395784,71.39816933574204,NaN,NaN,19.562439435170507,18.805567471624407
2013-08-19T09:30:00-04:00,40.72,40.8399,40.405,40.44,4644461,4700128.2,46.97633466948421,59.16967942701623,NaN,NaN,-60.27335087098769,58.91284134108632,-0.07061400309994603,0.2530225502315986,0.3236365533315446,49285677,60275451,57.14103616463884,70.18547008223513,NaN,NaN,15.618786164407044,18.350312999164785
2013-08-20T09:30:00-04:00,40.44,40.78999,40.36,40.67,3271052,4621331.8,50.622440208930485,58.717603675372054,NaN,NaN,-46.79592348286766,16.880149969279053,-0.08608245578201235,0.2160334836040292,0.30211593938604153,52556729,56674954.6,49.85315995197866,68.57377440419381,NaN,NaN,13.40653623769411,17.644059176097546
2013-08-21T09:30:00-04:00,40.55,40.74699,40.28999,40.36,4850660,4576810.5,46.02831230385875,57.663552314383075,NaN,NaN,-80.99820582028609,-29.5384911820341,-0.11380300680680194,0.15986218087753912,0.27366518768434106,47706069,52895840.8,43.571585497149016,66.6182915236699,NaN,NaN,10.039444868821557,16.55768570362955
2013-08-22T09:30:00-04:00,40.52,40.89999,40.46001,40.84,4617258,4606145.3,53.12230138347259,56.9243800692311,NaN,NaN,-23.487036781083308,-42.56872382582395,-0.09707444413101371,0.15232213252057392,0.24939657665158763,52323327,51160388,41.015743906356995,64.41780923700627,NaN,NaN,9.391779220066542,15.533984777406262
2013-08-23T09:30:00-04:00,40.91,41.25,40.72501,41.17,4462840,4619225.6,57.27965227604532,56.636637283200514,NaN,NaN,46.12206311371427,-33.08649076830212,-0.06271437428657395,0.17100360879337018,0.23371798307994412,56786167,51731593.8,42.21716133674325,62.52483181543902,NaN,NaN,10.236408642323724,14.777188186680185
2013-08-26T09:30:00-04:00,41.28,41.57001,41.13,41.17,5689043,4535935.35,57.27965227604532,56.839241016672545,NaN,NaN,94.36356342427919,-2.159107909248719,-0.04002131928146119,0.18369133397811765,0.22371265325957884,56786167,53231691.8,45.36450667319064,61.02179720764328,NaN,NaN,10.894018362543964,14.222449640375011
2013-08-27T09:30:00-04:00,40.84,40.96001,40.36,40.44501,5896809,4589649.65,46.72216035091215,56.26916916479259,NaN,NaN,-76.99569755904504,-8.199062724484197,-0.07200648200091284,0.1337045507584378,0.20571103275935063,50889358,52898217.6,44.780574405111636,59.39009457633716,NaN,NaN,7.875478619927037,13.315739494596729
2013-08-28T09:30:00-04:00,40.39999,40.575,40.3,40.37,3494956,4472515.2,45.78194686830176,55.08158556785152,NaN,NaN,-114.07296921255704,-14.814015402938386,-0.09494185474818326,0.08703371432412155,0.1819755690723048,47394402,52835884.2,44.664841902618676,57.6707195069908,NaN,NaN,5.209583645782728,12.157717230480444
2013-08-29T09:30:00-04:00,40.23,40.73599,40.17999,40.5,4085558,4446944.1,47.74460023590513,53.85087750537715,NaN,NaN,-91.16680409302501,-28.34996886532673,-0.0977030333751468,0.059846777353371294,0.1575498107285181,51479960,52667210.8,44.33096731995832,55.76554801011704,NaN,NaN,3.659007442627004,10.943615832215666
2013-08-30T09:30:00-04:00,40.53,40.62,40.34,40.42999,5600348,4584888.35,46.76284767270831,52.6337949049261,NaN,NaN,-83.25309252048645,-54.224999992166865,-0.10021615838415382,0.0322796127483258,0.13249577113247962,45879612,50485899.8,40.15102867436323,53.4364318005505,NaN,NaN,2.1103630291001574,9.681722574627736
2013-09-03T09:30:00-04:00,41.03,41.14,40.50999,40.672,4361297,4676004.3,50.54829307394493,51.56729146568874,NaN,NaN,-15.851475361271639,-76.26800774927703,-0.0823012656643161,0.029619189052084494,0.1119204547164006,50240909,49176848.2,37.844848020949804,50.71489516561813,NaN,NaN,1.9100352733733312,8.571481531591393
2013-09-04T09:30:00-04:00,40.58,41.10001,40.47501,41.05,4319137,4723396.05,55.83106942978452,51.014105627418516,NaN,NaN,3.0227126804160838,-60.26432570138481,-0.043655470132992175,0.05735111705016038,0.10100658718315256,54560046,49910985.8,39.92871018905809,48.0360823784627,NaN,NaN,3.3756259341856136,7.8292164462477105
2013-09-05T09:30:00-04:00,41.07001,41.25,41.00999,41.12,5504523,4851390.8,56.752438204958814,50.95587429297293,NaN,NaN,51.79903098347427,-27.08992566217855,-0.013598163613467912,0.08400888266631767,0.09760704627978559,60064569,52445019.2,46.5855781124712,45.94028425132471,NaN,NaN,4.840233824281681,7.402218928823992
2013-09-06T09:30:00-04:00,41.42999,41.46001,40.89999,41.07001,4987398,4890795.65,55.856333392352525,51.236313024764605,NaN,NaN,54.077426207928475,1.9589203980121468,0.0018739021890594038,0.09994942401610984,0.09807552182705044,55077171,53164461.4,48.33606445327452,44.698986186275896,NaN,NaN,5.789412243807022,7.171817973821568
2013-09-09T09:30:00-04:00,41.2,41.74001,41.19,41.69,5438199,4793545.25,63.54451154185839,52.41975422993419,NaN,NaN,132.16872705322945,45.043284312755326,0.05014543781991718,0.1607573191019469,0.11061188128202973,60515370,56091613,54.823156600621,44.53342336027463,NaN,NaN,9.148173206534,7.45415443563763
2013-09-10T09:30:00-04:00,41.99001,42.21001,41.83,42.065,7251641,4953797.3,67.25884044405615,53.60806853244316,NaN,NaN,203.0999921041932,88.8335778058483,0.10069559099028663,0.236481370019888,0.13578577902960137,67767011,59596833.4,61.11901108881112,45.338127012905524,NaN,NaN,13.268021487571739,8.284706871628217
2013-09-11T09:30:00-04:00,42.08,42.3499,41.89,42.32001,6173855,5063905.4,69.53220501545982,55.286918011843234,NaN,NaN,200.58106476198472,128.345248222162,0.14213702782893356,0.3134570638157683,0.17132003598683476,73940866,63472997.4,66.65331454759269,46.986821945080074,NaN,NaN,17.437695717797208,9.592276706795214
2013-09-12T09:30:00-04:00,42.13,42.25,41.815,41.88,5960816,5164067.55,61.58620610437689,55.89148263476498,NaN,NaN,151.05349507602395,148.19614104067196,0.13101835739386997,0.3350929827291722,0.20407462533530224,67980050,65056093.6,68.6180132029248,48.95841260912063,NaN,NaN,18.435732034609558,10.85562746791155
2013-09-13T09:30:00-04:00,42,42.23,41.87,42.16,7414422,5254736.3,64.37607881301528,56.39837024454858,NaN,NaN,139.4287830972429,165.26641241853483,0.13318962784163646,0.3705616601373478,0.23737203229571135,75394472,69119553.8,73.01311919620801,51.15812388479668,NaN,NaN,20.17714945641574,12.187273466269291
2013-09-16T09:30:00-04:00,42.77,42.83,42.49001,42.63,8439367,5323182,68.51027064497963,57.20055727090103,NaN,NaN,175.0373856755827,173.8401441430055,0.15539874420310174,0.4316204625495885,0.2762217183464868,83833839,73783247.6,76.9953251599612,53.41746806242315,NaN,NaN,23.08142928502925,13.743581440377856
2013-09-17T09:30:00-04:00,42.57001,42.7,42.42999,42.50999,4650379,5323477.9,66.39158652554217,58.605516283374605,NaN,NaN,136.9472575001773,160.60959722220232,0.15099571060617123,0.4649663566042008,0.3139706459980296,79183460,76066537.4,78.65592168451755,55.83713572523785,NaN,NaN,24.705641654269655,15.309590042362398
2013-09-18T09:30:00-04:00,42.57001,43.55,42.4084,43.49001,10134480,5666649.3,73.57756032752103,60.59091724474741,NaN,NaN,165.17415148758258,153.52821456732187,0.20000070623673594,0.5639715287939495,0.3639708225572136,89317940,79141952.2,80.67896743740722,58.40957326343704,NaN,NaN,28.886337126304674,17.24912534006844
2013-09-19T09:30:00-04:00,43.66,43.78,43.24001,43.33501,6204086,5734320.6,70.9921505140799,62.251456550331326,NaN,NaN,162.819868600311,155.8814892721793,0.2070217302019387,0.6227479853096369,0.41572625510769823,83113854,82168713,82.44274568806134,61.131843146872974,NaN,NaN,31.22536610574171,19.24573116373605
2013-09-20T09:30:00-04:00,43.23,43.23,42.57001,42.62,10990422,6052978.8,60.44139437265283,63.228495600327356,NaN,NaN,95.41540069312968,147.07881279135663,0.15114958610018447,0.6046632377329288,0.4535136516327444,72123432,81514505,80.7273791385793,64.03015389431697,NaN,NaN,29.428504550310446,20.70041307610382
2013-09-23T09:30:00-04:00,42.5,42.63,42.28,42.3,6556340,6157653.8,56.40135726395311,63.64657161389937,NaN,NaN,56.51662351021774,123.37466035828363,0.08365024771883534,0.5580764612812885,0.4744262135624532,65567092,77861155.6,71.74932258193077,66.45190207724418,NaN,NaN,26.568697088086026,21.53873936352985
2013-09-24T09:30:00-04:00,42.28999,42.60001,42.17999,42.28,3488392,6047621.25,56.14874430361936,63.669262676316144,NaN,NaN,47.83644786825779,105.55249843189975,0.03135627938457841,0.5136215627931762,0.48226528340859776,62078700,74440203.6,64.51402981564239,68.20799633628592,NaN,NaN,24.298882177370913,21.93304547979286
2013-09-25T09:30:00-04:00,42.39,42.67,42.23,42.39,4258961,5965728.85,57.28199096761583,63.70708787364879,NaN,NaN,49.11612902377705,82.34089393913864,-0.00044109235650174883,0.4817139179629706,0.48215501031947233,66337661,69844147.8,56.29977850544497,68.90186779292691,NaN,NaN,22.827853965959406,22.06087526353094
2013-09-26T09:30:00-04:00,42.57001,42.85001,42.45,42.67,5845164,6083239.25,60.10802861841098,64.01078038979583,NaN,NaN,63.91607006674172,62.56013423242479,-0.006874715481005711,0.4735616159682152,0.48043633144922093,72182825,67657942,52.85254909599657,69.22447383883562,NaN,NaN,22.450577374009388,22.11654699359929
2013-09-27T09:30:00-04:00,42.36,42.49001,42.12,42.16,3796334,6068778.05,53.203923025816806,63.27216692436428,NaN,NaN,21.86681430519696,47.850416954838245,-0.047473856743620424,0.4210940105196954,0.46856786726331584,68386491,66910553.8,51.687382782887575,69.0004899947118,NaN,NaN,19.90609076803091,21.800767532803807
2013-09-30T09:30:00-04:00,41.75,42.16,41.63,42.00999,5672645,6072392.9,51.33611325410585,62.13482926793926,NaN,NaN,-22.22981635082862,32.101128982628964,-0.08427708548702406,0.36322151040453576,0.4474985958915598,62713846,66339904.6,50.7671193568728,68.26106915671622,NaN,NaN,17.262654860613058,21.15246572249084
2013-10-01T09:30:00-04:00,42.00999,42.22,41.78999,42.19,5019906,6105323.35,53.44808285184685,60.985963399109764,NaN,NaN,-16.067340119916153,19.32037138499417,-0.0955186337988268,0.32810030364302634,0.42361893744185314,67733752,67470915,52.56958347456756,67.25508836578585,NaN,NaN,15.702045563394924,20.373834271191424
2013-10-02T09:30:00-04:00,41.95,42.31,41.81,42.3,4278254,6103279.2,54.740698627348436,60.49699857932201,NaN,NaN,-16.88975490092263,6.119194600054237,-0.09439948384586627,0.30561958263452027,0.40001906648038654,72012006,68605784,54.37460280292896,66.23770190864329,NaN,NaN,14.787953179314853,19.575851258066198
2013-10-03T09:30:00-04:00,42.24001,42.24001,41.63499,41.94,7084336,6182269.85,49.86105768646602,59.46021135599706,NaN,NaN,-60.39621412171741,-18.743262237637587,-0.11537070185248455,0.25580568916478086,0.3711763910172654,64927670,67154753,51.66718452946617,64.7129922895903,NaN,NaN,12.535366457286715,18.5700677150977
2013-10-04T09:30:00-04:00,41.95,42.565,41.86,42.55,5167039,6191251.9,56.87578441212974,58.62917662507921,NaN,NaN,-4.387770742793095,-23.9941792472356,-0.08692230156366387,0.2625235140626856,0.34944581562634947,70094709,67496396.6,52.269791117469616,62.94688271512662,NaN,NaN,12.70043837091705,17.73154923735761
2013-10-07T09:30:00-04:00,42.06,42.41901,42,42.03,5994570,6219070.45,50.40222036179009,57.48707904195407,NaN,NaN,-49.358427439123915,-29.419901464894657,-0.10090580070239213,0.22331356474835928,0.3242193654507514,64100139,67773655.2,52.784278620578505,61.09890821055954,NaN,NaN,10.718451796465711,16.729678174373053
2013-10-08T09:30:00-04:00,42.05,42.05,41.33,41.36,8603180,6286647.4,43.52776138646301,55.34066483187849,NaN,NaN,-158.531082118191,-57.91264986454961,-0.15009441907002363,0.1366013416132219,0.28669576068324554,55496959,65326296.6,47.87838369116763,58.75600937154242,NaN,NaN,6.596386984652066,15.282065147270055
2013-10-09T09:30:00-04:00,41.48,41.6499,41.08,41.42,6203531,6288131.2,44.26093973155761,53.431292633126894,NaN,NaN,-171.09331050021095,-88.75336098440728,-0.17184138534972915,0.0718940289960841,0.24373541434581325,61700490,63263993.4,44.15424611730421,56.021116545059776,NaN,NaN,3.6341680501472378,13.61807984768108
2013-10-10T09:30:00-04:00,41.99001,42.37,41.89,42.3,5424734,6261327.1,53.74599876423052,52.95305008966817,NaN,NaN,-26.101063885111127,-81.89433093708601,-0.12252629821869582,0.09057754157244347,0.21310383979113928,67125224,63703504.2,45.133721350597796,53.478712417346806,NaN,NaN,4.25134575775522,12.279974977691673
2013-10-11T09:30:00-04:00,42.31,42.56,42.16,42.55,5060309,6143621.45,56.03491716937972,52.92687579719864,NaN,NaN,15.779338887345684,-77.86090901105825,-0.07118193705425227,0.12412641847332395,0.19530835552757622,72185533,64121669,46.1023027308573,51.64678242798442,NaN,NaN,5.516315687548452,11.31373793624264
2013-10-14T09:30:00-04:00,42.21001,42.75,42.21001,42.7,6160277,6029666.95,57.39716291060405,53.016048554840395,NaN,NaN,42.3841279872208,-59.51239792578931,-0.027476750842603898,0.16096241697432134,0.18843916781692524,78345810,66970803.2,52.283206476346535,50.77315218946329,NaN,NaN,6.959880047539313,10.691758237856451
2013-10-15T09:30:00-04:00,42.56,42.75999,42.3439,42.44,5367539,6065524.95,54.25892734956008,52.800115439264985,NaN,NaN,35.290321048199274,-20.74811729251126,-0.01695336666866873,0.16724745948108932,0.18420082614975805,72978271,70467065.6,58.56300637409376,50.934811322938195,NaN,NaN,7.172366860949629,10.188988041155476
2013-10-16T09:30:00-04:00,42.7,42.99899,42.53999,42.87,4270809,5772341.4,58.317971288543255,52.67225420141729,NaN,NaN,100.29031117583484,33.5286070426979,0.016293481825037065,0.2045676784310544,0.18827419660601732,77249080,73576783.6,63.20177863992587,51.67404200464743,NaN,NaN,8.64500184055483,9.968418583926812
2013-10-17T09:30:00-04:00,42.73,43.47,42.73,43.425,4640965,5694185.35,62.894769382033935,53.36445751257566,NaN,NaN,193.1435246895971,77.37752475763952,0.06998017462815881,0.27574941489121585,0.20576924026305704,81890045,76529747.8,66.9817672854389,52.76649804054396,NaN,NaN,11.42817106376677,10.176954652475377
2013-10-18T09:30:00-04:00,43.71001,43.71001,43.355,43.55901,7404848,5514906.65,63.92480098217185,54.26364949315181,NaN,NaN,230.7641033068135,120.37447764153308,0.10663772344493236,0.3390663945692225,0.23242867112429014,89294893,79951619.8,70.73344507602395,54.19266416334046,NaN,NaN,13.980245799448607,10.720281959185838
2013-10-21T09:30:00-04:00,43.59,43.64,43.39,43.55,3899206,5382049.95,63.796572345121746,55.00282731410001,NaN,NaN,184.76072115300133,148.8497962746892,0.12132983421616844,0.3840909638945007,0.26276112967833226,85395687,81361595.2,72.13823933667742,55.59042529634831,NaN,NaN,15.977484016444166,11.471310824508457
2013-10-22T09:30:00-04:00,43.78,44.28,43.75,44.17999,5519117,5483586.2,68.5473664114637,55.98901787010824,NaN,NaN,211.4541145971482,184.08255498447897,0.16198720118233545,0.46524513115625155,0.3032579299739161,90914804,84948901.8,75.37663670810237,57.09057057528927,NaN,NaN,19.283158305820855,12.587289036124513
2013-10-23T09:30:00-04:00,44,44.03,43.83,43.89,5391070,5540191.65,64.36067316132514,57.024704689741036,NaN,NaN,155.77064401890152,195.1786215530923,0.1577075853842877,0.5003924117042757,0.34268482631998803,85523734,86603832.6,76.72089839958942,58.880121566012356,NaN,NaN,20.76897207949773,13.756100899463544
2013-10-24T09:30:00-04:00,43.94,44.14,43.7,44.11,3241332,5410000.05,66.05456653595638,57.68033198430008,NaN,NaN,135.6779306327895,183.68550274173077,0.15767360677783182,0.5397768347922778,0.38210322801444596,88765066,87978836.8,77.80507255116692,60.704070239847866,NaN,NaN,22.5146589612264,15.00732347971538
2013-10-25T09:30:00-04:00,44.2,44.24001,43.82001,44.24001,5771406,5508753.65,67.05119882948489,58.86954473199256,NaN,NaN,124.37927136018523,162.40853635240512,0.1542001709152127,0.5748534416584619,0.42065327074324915,94536472,89027152.6,78.62252414999749,62.54965920623494,NaN,NaN,24.24449106573636,16.32691884914695
2013-10-28T09:30:00-04:00,44.21,44.29,43.89,44.02,6316869,5540964.85,63.64575749988327,60.306544454379726,NaN,NaN,105.9219260599126,146.64077733378738,0.12606412105482911,0.5782334220617855,0.4521693010069564,88219603,89591935.8,79.06978040641006,64.77761611446655,NaN,NaN,24.734444009330726,17.527993872030347
2013-10-29T09:30:00-04:00,44.02,44.12,43.83,44.109,4283206,5504129.85,64.4327124479701,61.7473853626949,NaN,NaN,89.94895140563496,122.33974469548475,0.10337793142544272,0.5813917152887598,0.47801378386331705,92502809,89909536.8,79.33165327955494,67.29028805462733,NaN,NaN,25.359636724463225,18.64679999380647
2013-10-30T09:30:00-04:00,44.08,44.36,43.57,43.84,5499568,5565195.55,60.191619817382495,62.20778686649147,NaN,NaN,73.75665833269966,105.93694755824436,0.062214513291378004,0.5557819254775396,0.49356741218616157,87003241,90205438.2,79.58789763528716,69.75130064639085,NaN,NaN,24.713659011938166,19.513494139253858
2013-10-31T09:30:00-04:00,43.83,44.065,43.74,43.77,5575738,5489765.65,59.10143578032028,62.42682391013009,NaN,NaN,62.319391467113775,91.26523972510921,0.02418569633112333,0.5237995326000657,0.4996138362689424,81427503,88737925.6,74.64513687187085,71.79007451360609,NaN,NaN,23.877118771774814,20.136869086756853
2013-11-01T09:30:00-04:00,43.82,43.91,43.43,43.67,5167501,5489788.75,57.499250939823504,62.43411591221719,NaN,NaN,42.41477045296948,74.87233954366607,-0.011854533924742061,0.48479566886301484,0.4966502027877569,76260002,85082631.6,63.98577617205554,72.62597234901388,NaN,NaN,22.738601954347654,20.508545210698397
2013-11-04T09:30:00-05:00,43.86,43.87,43.632,43.845,5569678,5468544.15,59.565077848379694,62.81312666213288,NaN,NaN,47.510986824946585,63.19015169667286,-0.027182191705357073,0.4626724631560606,0.48985465486141766,81829680,83804647,60.72097764797878,72.78011315429139,NaN,NaN,22.290011069210543,20.76304033334299
2013-11-05T09:30:00-05:00,43.68,43.76,43.49,43.66,2970705,5186920.4,56.4417594994199,62.679111534338354,NaN,NaN,28.825704358080376,50.965502287161954,-0.051636514440156045,0.4253090118112226,0.47694552625137865,78858975,81075880.2,54.34485236779987,72.14747556342523,NaN,NaN,21.062703691721683,20.805849384539947
2013-11-06T09:30:00-05:00,43.93,44.06,43.76,43.96,3972984,5075393.05,60.09583083489298,62.47918735239972,NaN,NaN,56.29378670081141,47.4729279607843,-0.049460060935770045,0.4151204500816661,0.46458051101743614,82831959,80241623.8,52.52877976599039,71.11511931203606,NaN,NaN,20.95994835384361,20.8278635230119
2013-11-07T09:30:00-05:00,44.04,44.06,43.34,43.38,5934512,5100881.95,51.16011013144881,61.56742372020522,NaN,NaN,5.778803506738451,36.164810368709226,-0.08675286077358779,0.3561394350504514,0.4428922958240392,76897447,79335612.6,50.552991699843425,69.67365835659459,NaN,NaN,18.163806377106802,20.447283930739744
2013-11-08T09:30:00-05:00,43.27,44.19,43.27,44.185,5310798,5113406.4,60.040932059087105,61.29916369977417,NaN,NaN,46.04770045576016,36.8913963692674,-0.05824408206339743,0.37008719324479245,0.4283312753081899,82208245,80525261.2,53.050155434572396,68.31022379215851,NaN,NaN,18.484223867823207,20.166846778894524
2013-11-11T09:30:00-05:00,44.18,44.2,44.02,44.17,2495780,4930181.55,59.822646918397595,60.67596945026945,NaN,NaN,88.90769104577838,45.17073721343375,-0.0421843602821364,0.3756008249555194,0.4177851852376558,79712465,80101818.2,52.04269563517339,66.64351371552074,NaN,NaN,18.66547837168832,19.952365577865066
2013-11-12T09:30:00-05:00,43.95,44.15,43.905,44.029,4284779,4876043.55,57.699116682513726,60.2001439874972,NaN,NaN,65.12986243304546,52.43156882842677,-0.042714222309746974,0.36439240735047207,0.40710662966021904,75427686,79415560.4,50.37307967614481,64.76152666384613,NaN,NaN,18.172142857194913,19.69804804634076
2013-11-13T09:30:00-05:00,43.87,44.279,43.81,44.27,4691174,4897061.8,60.293516269632995,59.78864039704553,NaN,NaN,90.84688512284121,59.34218851283274,-0.029138635900880616,0.3706833347841183,0.3998219706849989,80118860,78872940.6,49.03357753719527,62.706419877133854,NaN,NaN,18.532725942265422,19.53157346004428
2013-11-14T09:30:00-05:00,44.4,44.66,44.26,44.64,5179686,4923997.85,63.949223582939375,59.567070736577996,NaN,NaN,220.81759450653078,102.3499467127912,0.0008652091257128625,0.40090348209214,0.40003827296642713,85298546,80553160.4,53.18489595001098,60.88944643427767,NaN,NaN,19.972773503614867,19.59460203769722
2013-11-15T09:30:00-05:00,44.67,44.96,44.67,44.925,4564023,4781956.6,66.50716020540403,59.771456644115176,NaN,NaN,278.41265429287904,148.822937480215,0.03416664383922774,0.4427465777654618,0.40857993392623404,89862569,82084025.2,56.649483900046405,59.28799668382313,NaN,NaN,21.986370421955915,19.936283235448464
2013-11-18T09:30:00-05:00,45.03,45.07,44.5149,44.65,5689854,4871489,61.9402680604782,59.59342490215147,NaN,NaN,206.3573320948604,172.31286569003137,0.0319734632174854,0.4485467629480908,0.4165732997306054,84172715,82976075.2,58.573382233909605,57.805263037705615,NaN,NaN,22.296474112654536,20.273453360763618
2013-11-19T09:30:00-05:00,44.54,44.7,44.367,44.51,3584055,4774735.9,59.692995499233064,59.55780887942651,NaN,NaN,120.84826157178112,183.45654551777852,0.01619042612596988,0.4368113323880678,0.4206209062620979,80588660,84008270,60.74432061541461,56.459293250571854,NaN,NaN,21.88347952925016,20.503457099118837
2013-11-20T09:30:00-05:00,44.46,44.59,44.05,44.15,4709718,4740668.3,54.243121166313266,59.210786406997435,NaN,NaN,46.591128447466325,174.60539418270352,-0.0213598841329799,0.39392105109587305,0.41528093522885295,75878942,83160286.4,58.052776603771726,55.27412465999334,NaN,NaN,19.85862142500143,20.411337717102064
2013-11-21T09:30:00-05:00,44.48,44.54,44.24,44.51,3326895,4744946.45,58.339260945791374,59.270787121709425,NaN,NaN,78.94070052526462,146.2300153864503,-0.024587648753080282,0.3845463742875026,0.4091340230405829,79205837,81941744.6,54.32754283379408,54.584250850117535,NaN,NaN,19.368441057577503,20.262352480027126
2013-11-22T09:30:00-05:00,44.57,44.76,44.365,44.74,2381732,4575462.75,60.7563769282906,59.35587991313164,NaN,NaN,107.54311145696511,112.05610681926751,-0.014373758021153704,0.3911668255141407,0.40554058353529443,81587569,80286744.6,49.66597753092469,53.79460798461366,NaN,NaN,19.697109760696524,20.181603520122753
2013-11-25T09:30:00-05:00,44.6,44.79,44.36,44.46,5652282,4542233.4,56.461618671479684,59.35729842542162,NaN,NaN,78.21802776797055,86.42824595388956,-0.028784574997510082,0.36955986478840686,0.39834443978591694,75935287,78639259,45.48226261286016,53.161565859260826,NaN,NaN,18.661533243545602,19.964450623468874
2013-11-26T09:30:00-05:00,44.51,44.51,44.21,44.35,2073501,4431748.15,54.822079864310176,58.98060192752285,NaN,NaN,37.47297597791654,69.75318883511662,-0.046959634148954266,0.3396448970997241,0.3866045312486784,73861786,77293884.2,42.3452642764335,52.43417189572106,NaN,NaN,17.32635349733429,19.587579605449648
2013-11-27T09:30:00-05:00,44.37,44.52,44.32,44.38,2833134,4298426.45,55.204129342674904,59.26946044261042,NaN,NaN,42.72459309232645,68.97988176408865,-0.057499777297027266,0.3147298096273943,0.37222958692442154,76694920,77457079.8,42.86009162171084,51.884679032997305,NaN,NaN,16.342924710568678,19.124057477609508
2013-11-29T09:30:00-05:00,44.44,44.6,44.25,44.34,3672141,4203246.6,54.54184178373488,58.87666828008526,NaN,NaN,36.326903156591314,60.45712229035398,-0.06703815413026931,0.2884318942615849,0.3554700483918542,73022779,76220468.2,39.94908613584625,50.94888836880257,NaN,NaN,15.345904845630004,18.58432138732672
2013-12-02T09:30:00-05:00,44.48,44.585,44.2,44.23,5190496,4204396.35,52.67047197172873,58.365798641037486,NaN,NaN,19.016099069327744,42.751719812826515,-0.07976306872335193,0.2557662124876643,0.3355292812110162,67832283,73469411,34.35830327373428,49.68571748584264,NaN,NaN,13.992237429018223,17.92830939328265
2013-12-03T09:30:00-05:00,44.08,44.1,43.51,43.71,5822344,4217029.65,44.838421504611645,57.44717755690162,NaN,NaN,-108.89026299855661,5.330061659521087,-0.11980162839811881,0.18577724571336773,0.30557887411148654,62009939,70684341.4,29.810004969365693,48.21692643535842,NaN,NaN,10.400472176409531,16.85290407658649
2013-12-04T09:30:00-05:00,43.62,44.11,43.58,43.92,9835278,4560258.3,48.18908028760024,56.58257498675643,NaN,NaN,-94.03319352049857,-20.971172240161934,-0.12800101746671871,0.14557760227808814,0.27357861974480685,71845217,70281027.6,29.207034003089973,46.800744754350895,NaN,NaN,8.300382182014388,15.631115234504762
2013-12-05T09:30:00-05:00,43.81,43.88,43.58,43.67,4696602,4596439.2,44.70747853730085,55.20816462635368,NaN,NaN,-123.8448811131037,-54.28506708124796,-0.14487879084816463,0.09248013118460108,0.2373589220327657,67148615,68371766.6,26.476760798883348,44.89302081498464,NaN,NaN,5.454373026242378,14.177294919038708
2013-12-06T09:30:00-05:00,44.15,44.36,44,44.27,4903869,4544907.05,53.40787254781934,54.27250122224048,NaN,NaN,-19.529800574655127,-65.45640782749726,-0.11173602430348847,0.09768889165340511,0.20942491595689358,72052484,68177707.6,26.208587559518037,42.718671076375465,NaN,NaN,5.60239539319443,12.952309272489526
2013-12-09T09:30:00-05:00,44.39,44.5399,44.3,44.5,3685641,4463649.2,56.249805223316955,53.86603959101468,NaN,NaN,36.726605491030675,-61.91430654315667,-0.07233661759137736,0.1190041439676719,0.19134076155904925,75738125,69758876,32.23151184685497,40.83710890587156,NaN,NaN,6.63170947723632,12.04936644459621
2013-12-10T09:30:00-05:00,44.5,44.7666,44.5,44.63,3618855,4519802.95,57.816011929764,53.73196933605261,NaN,NaN,81.40848304390664,-23.854557334664023,-0.03729794863593999,0.14471832576412424,0.18201627440006424,79356980,73228284.2,43.18868194227322,39.58313471493288,NaN,NaN,7.954703119407953,11.464414540997888
2013-12-11T09:30:00-05:00,44.66,44.69,43.8,43.87,5545358,4582831.9,47.18193576054111,53.22759894992602,NaN,NaN,-63.598561091092876,-17.767630848782883,-0.06354200177834302,0.10258877217713547,0.16613077395547848,73811622,73621565.2,44.28831838001227,38.599959127521494,NaN,NaN,5.591977842161942,10.625495012592753
2013-12-12T09:30:00-05:00,43.8,43.925,43.64,43.78,3742321,4535389.25,46.10057263533827,52.353406927750804,NaN,NaN,-142.0016306457334,-21.398980755308823,-0.08391846142297243,0.06123269717676294,0.14515115859973537,70069301,74205702.4,45.96139178031254,38.002376909415666,NaN,NaN,3.384293732231125,9.591037686826805
2013-12-13T09:30:00-05:00,43.94,44.1,43.8499,43.99,2982745,4425542.2,49.03567687788331,51.51621406700742,NaN,NaN,-79.2618806291051,-33.34539676619882,-0.08021249315845366,0.04488554215166829,0.12509803531012195,73052046,74405614.8,46.552956096051744,37.780018235496165,NaN,NaN,2.4869780115936666,8.576172018936358
2013-12-16T09:30:00-05:00,44.26,44.39,44.07,44.17,4387791,4416730.6,51.47485820040584,51.16001689050215,NaN,NaN,-15.446848243967187,-43.78008751319839,-0.06333810803219364,0.0459254002698799,0.10926350830207354,77439837,74745957.2,47.60456029207169,37.931610926868416,NaN,NaN,2.496473325777674,7.707643634199403
2013-12-17T09:30:00-05:00,43.98,44.49,43.96,44.46,8588635,4561669.65,55.195434945108204,51.18668511055915,NaN,NaN,16.649207508105608,-56.73194262035859,-0.03193029410341727,0.06935064067280194,0.10128093477621922,86028472,76080255.6,51.62327072727239,38.5943256733569,NaN,NaN,3.6584031209347194,7.12918070373302
2013-12-18T09:30:00-05:00,44.57,45,44.02,45,13636611,5064297.45,61.16624535973151,51.6125505403489,NaN,NaN,118.26958520806802,-20.358313360526406,0.022967533487895445,0.12999035163608852,0.10702281814819307,99665083,81250947.8,63.35349245792184,40.05814001880054,NaN,NaN,6.666861897406423,7.063135159972077
2013-12-19T09:30:00-05:00,45.08,45.14,44.7,45.07,7573088,5207465.95,61.875503126958144,52.13638349343628,NaN,NaN,171.36059945581337,42.31413265978294,0.05966396208002203,0.18160277074822062,0.12193880866819859,107238171,88684721.8,73.356093897576,42.4443548589241,NaN,NaN,9.281924259130225,7.380105031280384
2013-12-20T09:30:00-05:00,44.91,45.091,44.79,44.93,7839196,5433081,59.53358642762088,52.626605954571424,NaN,NaN,145.03322404727146,87.17315359505827,0.06949072333431919,0.20880221283609757,0.13931148950177838,99398975,93954107.6,77.95036924324944,45.55807385674662,NaN,NaN,10.739164137677465,7.859970617908538
2013-12-23T09:30:00-05:00,45.15,45.21,44.98,45.15,4111467,5519567.75,61.969511536939756,53.85025524259487,NaN,NaN,167.41531328853634,123.74558590155895,0.08477693814966794,0.2452826621888633,0.16050572403919536,103510442,99168228.6,81.3730518176157,49.24114863162162,NaN,NaN,12.704867759008359,8.552098780922798
2013-12-24T09:30:00-05:00,45.18,45.64,45.12,45.64,1887105,5331308.9,66.76780037195641,55.177306677191766,NaN,NaN,201.50112480369148,160.71596936067613,0.11972124949011945,0.31015728590184466,0.1904360364117252,105397547,103042043.6,83.43087194868576,53.114279913449884,NaN,NaN,15.998535194051245,9.615875411369718
2013-12-26T09:30:00-05:00,45.7,45.93,45.66,45.89,1996337,5327450.7,68.92223292622711,56.906931990686495,NaN,NaN,206.80479580498604,178.42301148005976,0.14956592808773622,0.3773934465213955,0.22782751843365928,107393884,104587803.8,84.18182041512279,57.23606988603842,NaN,NaN,19.43667393804428,11.018846629466083
2013-12-27T09:30:00-05:00,46.1,46.1,45.89,46.03,1838905,5277739.25,70.09157109329321,58.098624743934636,NaN,NaN,184.0227822253795,180.95544803397297,0.167288914286238,0.43693866129145675,0.26964974700521877,109232789,104986727.4,84.37859225246675,61.391070221249045,NaN,NaN,22.616981213486593,12.67572299861187
2013-12-30T09:30:00-05:00,46.04,46.13,45.9501,46.06,2100500,5199157.2,70.34902953277387,59.10571219461013,NaN,NaN,156.20978847969673,183.19076092045802,0.16908396200813558,0.48100469951538827,0.3119207375072527,111333289,107373590.2,85.5378047861,65.19866257405226,NaN,NaN,25.268667120359726,14.47471501600442
2013-12-31T09:30:00-05:00,46.13,46.22,45.985,46.22,3178541,5098559.45,71.74596830612572,60.100709078635965,NaN,NaN,139.83300021338815,177.6742983054284,0.16871250684529687,0.5228113710638738,0.3540988642185769,114511830,109573867.8,86.53010229733695,68.29447831369967,NaN,NaN,27.922734216263645,16.395860616041453
2014-01-02T09:30:00-05:00,45.94,46.1299,45.73,45.85,6941858,5154535.15,64.21204203743775,61.31714524127144,NaN,NaN,102.60904926306854,157.8958831973038,0.13279471018638656,0.5200922519515601,0.3872975417651735,107569972,110008352.8,86.72381714159265,71.32558536809827,NaN,NaN,28.079552009988785,18.06495938660536
2014-01-03T09:30:00-05:00,45.91,45.95,45.72,45.74,4342658,4879904.15,62.12344322150904,62.46163599742649,NaN,NaN,83.79958816904563,133.29484167011572,0.09276995216348916,0.5032599819695349,0.41049002980604576,103227314,109175038.8,84.22207180580035,74.05849108420455,NaN,NaN,27.60686824325576,19.4280892232697
2014-01-06T09:30:00-05:00,45.84,45.85,45.38,45.49,4428099,4866479,57.542457299690305,63.06926317041272,NaN,NaN,55.363715514229575,107.56302832788575,0.04312327985515135,0.46439412962498494,0.4212708497698336,98799215,107088324,78.14304386871183,76.31492592510884,NaN,NaN,25.85419804717462,20.34610476954183
2014-01-07T09:30:00-05:00,45.5,45.78,45.28,45.41,3883089,4815440,56.116429055893214,63.40080394580467,NaN,NaN,41.920676001058084,84.70520583215799,0.0007990548510742324,0.4222696683336764,0.4214706134826022,94916126,103804891.4,69.62704009989586,77.88796019709628,NaN,NaN,23.992163899982994,20.866970359604856
2014-01-08T09:30:00-05:00,45.48,45.74,45.3,45.68,4120325,4837174.2,59.742566548908954,63.72559906036186,NaN,NaN,45.327231509138045,65.804052091308,-0.012382535101350345,0.4059924446059142,0.41837497970726456,99036451,100709815.6,62.69147466244896,78.67854619246603,NaN,NaN,23.384011833136096,21.22654771296646
2014-01-09T09:30:00-05:00,45.7,45.85,45.32,45.5,4418963,4877179.6,56.39683956869698,63.3849272181451,NaN,NaN,39.40891855167898,53.16402594903006,-0.03529681167893689,0.37425396510859343,0.4095507767875303,94617488,98119318.8,57.52649835680777,78.26233232810075,NaN,NaN,21.898287114341457,21.32251048459146
2014-01-10T09:30:00-05:00,45.59,45.6859,45.37,45.64,3099813,4754902.35,58.35053243338427,63.13314359717554,NaN,NaN,35.46356962256622,43.49682223973418,-0.042608042442171756,0.35629072373481563,0.3988987661769874,97717301,97017316.2,55.43420807484139,76.98219762647685,NaN,NaN,21.186358899120798,21.303060258095652
2014-01-13T09:30:00-05:00,45.47,45.61,44.955,45.02,5033914,4819482,48.076917703556695,62.31481011688525,NaN,NaN,-15.75744558066029,29.2725900207562,-0.08816063172633604,0.28869797651906737,0.3768586082454034,92683387,95794150.6,53.124606598861,75.20892886616339,NaN,NaN,17.22740658610954,20.720824019240492
2014-01-14T09:30:00-05:00,45.15,45.7,45.1,45.65,3811988,4860944.15,56.46480342857082,61.92161668057317,NaN,NaN,14.032337255173289,23.694922271579237,-0.07532120598599235,0.28270710076291294,0.3580283067489053,96495375,96110000.4,53.66149161288673,73.22953170868274,NaN,NaN,16.480971741059804,20.11513083664325
2014-01-15T09:30:00-05:00,45.67,46.0194,45.67,45.93,3528072,4817958.2,59.58937029322706,61.40887167494965,NaN,NaN,72.36086107536676,29.101648184824978,-0.048720370454878204,0.29712784368030754,0.34584821413518574,100023447,96307399.6,54.01597250315868,71.12846746257367,NaN,NaN,16.92764098285128,19.659775143244396
2014-01-16T09:30:00-05:00,45.85,46.045,45.81,46.04,4922911,4634672,60.78026484103503,60.827302526007365,NaN,NaN,86.41699287189543,38.50326304886828,-0.02562656889367465,0.3138150030180924,0.33944157191176705,104946358,98373173.6,57.66573731872676,69.2344615271168,NaN,NaN,17.665318703988408,19.374852794779255
2014-01-17T09:30:00-05:00,46.06,46.13,45.86,45.93,7343038,4319993.35,58.91063314232586,60.02866410093827,NaN,NaN,79.63890751098168,47.33833062655137,-0.019923001426460307,0.3145378201286917,0.334460821555152,97603320,98350377.4,57.611395945703435,67.32251893377658,NaN,NaN,17.687345641698546,19.133780344339154
2014-01-21T09:30:00-05:00,46.4,46.565,45.979,46.21,7369857,4309831.8,62.10595405299703,59.439872995239924,NaN,NaN,128.84751924924547,76.25932359253252,-0.00048398877671979035,0.33385583558425225,0.33433982436097204,104973177,100808335.4,61.792214393684205,65.62640533431829,NaN,NaN,18.695753591785795,19.07120509397439
2014-01-22T09:30:00-05:00,46.16,46.25,45.63,45.76,5594651,4197604.55,54.738505170361385,58.225054199828186,NaN,NaN,37.43747617488631,80.94035137647512,-0.020040681829486373,0.3092889720741141,0.32932965390360047,99378526,101384965.6,62.72114311439451,63.92576539267956,NaN,NaN,17.20976863634352,18.805285600027123
2014-01-23T09:30:00-05:00,45.59,45.64,44.771,45.08,6498731,4316967.75,45.88123186619448,56.91571061616795,NaN,NaN,-148.99444248430487,36.6692906645408,-0.07764631948885592,0.23227175454253057,0.3099180740313865,92879795,99956235.2,58.90008181098092,61.93835572620729,NaN,NaN,12.760756870268006,17.94178149577582
2014-01-24T09:30:00-05:00,44.69,44.72,43.85,43.87,10100218,4727623.4,35.021807403339594,54.979879486298714,NaN,NaN,-308.772878719059,-42.36868365365009,-0.18972690593719188,0.07275944160989667,0.26248634754708855,82779577,95522879,48.93736766550664,59.418019716186315,NaN,NaN,4.161393990411067,15.973154709295143
2014-01-27T09:30:00-05:00,43.93,44.08,43.37,43.69,5952156,4925414.35,33.74236972279911,53.27987323080648,NaN,NaN,-293.38871834113286,-116.974208824073,-0.2639112656566792,-0.06740273452376044,0.19650853113291875,76827421,91367699.2,41.800816067991,56.82214630184911,NaN,NaN,-2.7258835428744836,13.301863530413767
2014-01-28T09:30:00-05:00,43.96,44.04,43.78,43.94,4846543,5075796.25,37.17528657577437,51.926934482226564,NaN,NaN,-198.85650620867526,-182.51501391565714,-0.28241103531431555,-0.1565052630099757,0.12590577230433986,81673964,86707856.6,35.541220769485335,54.3874449211055,NaN,NaN,-6.876582453455858,10.419228389860963
2014-01-29T09:30:00-05:00,43.6,44.56,43.6,44.12,10316086,5486575.55,39.60172406450095,50.48830287619743,NaN,NaN,-142.347286488043,-218.471966448243,-0.26886255880796517,-0.2101724262056166,0.058690132602348566,91990050,85230161.4,33.81207495841758,52.32463065653183,NaN,NaN,-9.319251993576232,7.599445477941364
2014-01-30T09:30:00-05:00,44.35,44.505,43.98,44.33,8043621,5729829.55,42.39694156635673,49.48831016174455,NaN,NaN,-104.21802717856761,-209.51668338709555,-0.2334097739386305,-0.23307208482093955,0.00033768911769094245,100033671,86660936.6,37.00771506100864,50.85900327826046,NaN,NaN,-10.37951832931887,5.031022076904188
2014-01-31T09:30:00-05:00,43.77,44.4,43.67,44.04,6237680,5694620.65,39.66682087422003,48.15375933608997,NaN,NaN,-110.28719297706904,-169.81954623869757,-0.21746313033022915,-0.2714912237950955,-0.054028093464866346,93795991,88864219.4,41.67751863172143,49.87638260375189,NaN,NaN,-12.12385523919262,2.580325317461787
2014-02-03T09:30:00-05:00,43.97,44.23,42.96,43.01,19839772,6469476.35,31.827567869633356,46.99309149080973,NaN,NaN,-141.34066496262295,-139.40993556299557,-0.26130793633874305,-0.38066301388829515,-0.1193550775495521,73956219,88289979,40.82799112494488,48.998052927043595,NaN,NaN,-16.55947712757481,-0.15393217468629805
2014-02-04T09:30:00-05:00,43.25,43.67,43.04,43.39,7413369,6618739.85,36.790736926446826,45.5878010263723,NaN,NaN,-122.15242842203817,-124.06912000566815,-0.24975196780621128,-0.4315450373073162,-0.1817930695011049,81369588,88229103.8,40.73320266003338,48.07460371612549,NaN,NaN,-18.39359958488696,-2.759598947572107
2014-02-05T09:30:00-05:00,43.23,43.55,42.775,43.44,7898453,6819508.05,37.43616041319846,44.005428892084545,NaN,NaN,-113.15102760213838,-118.22986822848722,-0.2245682438540934,-0.4625033743187217,-0.23793513046462827,89268041,87684702,39.84234924113355,47.062202054552266,NaN,NaN,-19.59672067299057,-5.164902051203316
2014-02-06T09:30:00-05:00,43.53,44.15,43.5,44.09,8890709,7058027.25,45.261212656749926,42.89692516463561,NaN,NaN,-59.45246580794199,-109.27675595436213,-0.1533606444983373,-0.4296359360875499,-0.2762752915892126,98158750,87309717.8,39.20629868419705,45.743670723514434,NaN,NaN,-17.99582174302338,-6.997890578606182
2014-02-07T09:30:00-05:00,44.25,44.77,44.12,44.7,5181572,7096157.7,51.404000707038996,42.360737133543694,NaN,NaN,-12.508961781215268,-89.72110971519136,-0.05924215831565982,-0.3503279894837874,-0.2910858311681276,103340322,89218584,44.09863510288744,44.778473520456146,NaN,NaN,-14.497358227017415,-8.069243099807785
2014-02-10T09:30:00-05:00,44.7,44.9943,44.5734,44.92,15249931,7703663.6,53.433645898626814,41.741286551088685,NaN,NaN,12.813981515015548,-58.89018041966366,0.019548717276747563,-0.2666499345721931,-0.28619865184894067,118590253,98145390.8,60.22068759506942,44.66622160626938,NaN,NaN,-11.04289657938641,-8.494050739747589
2014-02-11T09:30:00-05:00,45.03,45.59,44.955,45.44,6980697,7801002.75,57.9085044337828,41.9677150699045,NaN,NaN,50.35380460602377,-24.388933814051274,0.10370293926636043,-0.15656997776599013,-0.26027291703235056,125570950,106985663.2,69.57781457787365,45.15598385366074,NaN,NaN,-6.61388235963394,-8.225455256874211
2014-02-12T09:30:00-05:00,45.39,45.65,45.26,45.36,3772108,7799008.75,57.00097507033681,42.76198244162895,NaN,NaN,58.065858298807775,9.854443366137959,0.1482803412313654,-0.07492249049314381,-0.22320283172450922,121798842,113491823.4,74.358335779561,46.26014485141646,NaN,NaN,-3.4095749505086386,-7.5374723559648436
2014-02-13T09:30:00-05:00,45.06,45.9,45.01,45.75,6714115,7958310.9,60.26984680520444,44.56541382747644,NaN,NaN,70.70101607098636,35.88513974192363,0.19537127916630284,0.021011267233369324,-0.17436001193293352,128512957,119562664.8,77.85510717088053,48.32569767322889,NaN,NaN,0.33527531093542606,-6.412794117836234
2014-02-14T09:30:00-05:00,45.83,46.17,45.67,46.12,5121687,7968249.7,63.13333211562123,46.66476828410659,NaN,NaN,104.41232728837123,59.26939755584093,0.23984742403015435,0.12544926810475943,-0.11439815592539493,133634644,125621529.2,80.68598214581547,51.103209535930645,NaN,NaN,4.396198709135532,-4.868652285411696
2014-02-18T09:30:00-05:00,46.1,46.26,45.91,46.15,5690050,7885600.3,63.36389438399123,48.53538312755065,NaN,NaN,112.31081495825441,79.1687642444887,0.2581084877533855,0.20823745376633696,-0.04987103398704855,139324694,129768417.4,82.34912349172399,54.44663115894769,NaN,NaN,7.708412896737466,-3.0719286879618157
2014-02-19T09:30:00-05:00,46.12,46.52,45.79,45.83,7892253,7911720.1,59.11692078186884,49.92932575021979,NaN,NaN,109.8902941086493,91.07606214501381,0.23605670756309344,0.24519985046681825,0.009143142903724817,131432441,130940715.6,82.80002815046538,57.94577067266539,NaN,NaN,9.303237421904148,-1.304047815123821
2014-02-20T09:30:00-05:00,45.96,46.37,45.69,46.31,6716249,7967800,63.11094897102348,51.40889770769599,NaN,NaN,113.17343076612086,102.09757663847643,0.24040971862201518,0.3096552911812438,0.06924557255922861,138148690,134210685.2,84.02584776251096,61.30420872277271,NaN,NaN,11.92103888521331,0.5852502849243404
2014-02-21T09:30:00-05:00,46.39,46.52,46.19,46.19,3986853,7842206.1,61.493533226693046,52.967948590015496,NaN,NaN,114.16540605697082,110.79045463567331,0.22224600858819224,0.34705308329446893,0.1248070747062767,134161837,135340461.2,84.43849943999226,64.35856449479205,NaN,NaN,13.595226429992998,2.443818305648434
2014-02-24T09:30:00-05:00,46.03,46.45,46.01,46.03,14709720,8072681.2,59.310928464709185,54.931045775378045,NaN,NaN,92.64640475276161,108.43727012855138,0.18786217552687295,0.3596347941148679,0.17177261858799492,119452117,132503955.8,78.92584239185463,67.0798395852856,NaN,NaN,14.374984004224947,4.1482705483022215
2014-02-25T09:30:00-05:00,46.06,46.405,45.91,46.2,6392789,8094712.85,60.898919450122136,56.65305881278342,NaN,NaN,83.77514154483168,102.73013544586686,0.16574599409477098,0.37895511120645864,0.21320911711168766,125844906,129807998.2,73.98204220009625,69.4547566952901,NaN,NaN,15.477116223537932,5.766677073335894
2014-02-26T09:30:00-05:00,46.28,46.69,46.2,46.55,6753007,8190036.05,64.01293308938548,58.551399718225355,NaN,NaN,94.7824124849636,99.70855912112971,0.16358771665555932,0.4176937629311368,0.2541060462755775,132597913,130041092.6,74.13290867611542,71.90408236921736,NaN,NaN,17.335749253178694,7.419401670456294
2014-02-27T09:30:00-05:00,46.47,46.92,46.44,46.92,4848835,7916673.5,67.00453857215416,60.10449442646852,NaN,NaN,103.68324958781633,97.81052288546881,0.17495531103969297,0.4728001850751937,0.29784487403550075,137446748,129900704.2,73.85513932084059,74.37899955754905,NaN,NaN,19.841499601812735,9.1939870892215
2014-02-28T09:30:00-05:00,46.89,47.25,46.81,47.08,5892533,7809119.1,68.23429556763872,61.30665834508278,NaN,NaN,112.92748107691853,97.56293788945835,0.18040428381594087,0.5233502288054268,0.34294594498948594,143339281,131736193,75.16533680923679,76.59804967943114,NaN,NaN,22.2944977146385,11.065488607138214
2014-03-03T09:30:00-05:00,46.7,47.18,46.6,46.97,10187765,8006623.35,66.40196669930816,62.23296697370288,NaN,NaN,97.04797664990565,98.44325226888716,0.1642159879885825,0.5482159299752141,0.38399994198663157,133151516,134476072.8,77.01684063665532,77.79777489668729,NaN,NaN,23.84137726594026,12.890615558395648
2014-03-04T09:30:00-05:00,47.68,47.79,47.36,47.71,7665518,7397910.65,71.87382776103152,63.23049006850636,NaN,NaN,136.90034432238025,109.06829282439688,0.18918522139209593,0.6204814687267515,0.43129624733465555,140817034,137470498.4,78.87086233402675,78.4615640221268,NaN,NaN,26.994060850878977,14.905393457321837
2014-03-05T09:30:00-05:00,47.73,47.88,47.55,47.82,4077798,7231132.1,72.58848836152876,64.34388387502007,NaN,NaN,142.6643747018973,118.6446852677836,0.19800594869604565,0.6788036832047126,0.480797734508667,144894832,139929882.2,80.27805115479542,78.88440083464354,NaN,NaN,29.781547279990185,17.0305582891316
2014-03-06T09:30:00-05:00,47.98,48.26,47.97,48,6285171,7150468,73.76328622688119,65.30770097656843,NaN,NaN,165.79117951551166,131.06627125332267,0.20025864898218737,0.7311210457364012,0.5308623967542139,151180003,142676533.2,81.74062675817852,79.16193794802197,NaN,NaN,32.463338602607784,19.23524119105677
2014-03-07T09:30:00-05:00,48.11,48.12,47.64,47.79,9034575,7157661.3,69.99430197582942,65.79777025229758,NaN,NaN,130.02187774521065,134.4851505869811,0.17293122804789685,0.7470264318140849,0.5740952037661881,142145428,142437762.6,81.17703615688924,79.19701323452725,NaN,NaN,33.66486342692057,21.29661579618017
2014-03-10T09:30:00-04:00,47.65,47.78,47.33,47.75,4857918,7141478.6,69.2682897884546,66.21951278118782,NaN,NaN,97.84717249888203,134.64498975677637,0.13895096635651183,0.7477839117118279,0.6088329453553161,137287510,143264961.4,81.6490959072778,79.14701126420967,NaN,NaN,34.456384370438755,23.17658273535997
2014-03-11T09:30:00-04:00,47.87,47.87,47.235,47.26,6647382,6711351.15,60.93073985411563,66.34907128634829,NaN,NaN,74.07407407407047,122.07973570711442,0.07354748835593428,0.7007673058002339,0.6272198174442997,130640128,141229580.2,76.56119972388592,78.70138066231111,NaN,NaN,32.73493931552233,24.542062246811735
2014-03-12T09:30:00-04:00,47.17,47.35,47.03,47.24,5345241,6629578.35,60.61006321832211,66.17043658972678,NaN,NaN,45.299553855956326,102.60677153792622,0.021703777923749668,0.6543495398489867,0.632645761925237,125294887,137309591.2,67.7986288321159,77.54229359585433,NaN,NaN,31.238278229263695,25.49866453001916
2014-03-13T09:30:00-04:00,47.42,47.59,46.74,46.9,7924212,6837183.55,55.283355500733784,65.72685246644396,NaN,NaN,26.938284339004287,74.83619250262474,-0.03939431964616147,0.5834028623675351,0.6227971820136966,117370675,130547725.6,55.91119848165622,75.50462924168747,NaN,NaN,28.36450002436215,25.908069600639585
2014-03-14T09:30:00-04:00,46.9,47.17,46.82,46.9,6277251,6815340.35,55.283355500733784,65.43916868330287,NaN,NaN,8.834561413526865,50.598729236288,-0.08130223123115865,0.5211693929747483,0.6024716242059069,117370675,125592775,49.11537600147621,73.3753102138033,NaN,NaN,26.011176559321942,25.922799166165635
2014-03-17T09:30:00-04:00,47.19,47.57,47.07,47.28,5263807,6822446.35,59.85639116807601,65.36470237744243,NaN,NaN,42.99250459623489,39.62779565575856,-0.08454920756023154,0.4967851147556175,0.581334322315849,122634482,122662169.4,45.586154536025084,71.3470325235125,NaN,NaN,25.16095640381763,25.813964485830205
2014-03-18T09:30:00-04:00,47.36,47.59,47.27,47.55,4799291,6777908.4,62.7697637249868,65.27590456569968,NaN,NaN,57.051058477860586,36.223192536516585,-0.0702212850664995,0.4935577159827247,0.5637790010492242,127433773,122020898.4,44.82710341747476,69.25376071932388,NaN,NaN,25.25528410443779,25.734153002774146
2014-03-19T09:30:00-04:00,47.46,47.63,46.86,47.13,7890548,6777823.15,55.965652643750005,64.4874127136708,NaN,NaN,17.921896792186047,30.747661123762533,-0.08950298936710877,0.45190026434033825,0.541403253707447,119543225,120870566,43.430106662473214,67.08054410086906,NaN,NaN,23.280336800193503,25.38360783097691
2014-03-20T09:30:00-04:00,46.9,47.76,46.9,47.76,5805681,6732294.75,62.52728641664317,64.0797692028854,NaN,NaN,49.28059357296221,35.21612297055411,-0.06162723538888326,0.46436920947134297,0.5259964448602262,125348906,122466212.2,45.94648863422372,64.99348351693956,NaN,NaN,23.592324044388757,25.127710147178604
2014-03-21T09:30:00-04:00,47.6,47.68,47.275,47.37,8769994,6971451.8,56.87705464572242,63.399418341915,NaN,NaN,39.38944302475143,41.327099292799026,-0.07060894939796192,0.4377352581127738,0.5083442075107357,116578912,122307859.6,45.729089884173746,62.7586441774766,NaN,NaN,21.99631005601117,24.68036727701183
2014-03-24T09:30:00-04:00,47.55,47.65,46.8305,47,4825589,6477245.25,52.069726393728224,61.98483967282191,NaN,NaN,-17.4185493180116,29.24488850994973,-0.10078408864898514,0.38236409669950433,0.48314818534848947,111753323,120131627.8,42.736364111621484,60.17760859016193,NaN,NaN,19.065058861495217,23.878180360509457
2014-03-25T09:30:00-04:00,47.26,47.5,47.08,47.26,5382257,6426718.65,54.95114741336292,60.72502960509577,NaN,NaN,-6.25620664655246,16.58343548506712,-0.10222619006550471,0.3553654477666086,0.4575916378321133,117135580,118071989.2,40.06397925741866,57.30517488320645,NaN,NaN,17.579760648569362,22.978406115946587
2014-03-26T09:30:00-04:00,47.5,47.51,46.57,46.58,6048360,6391486.3,46.99396758628524,58.81293541648178,NaN,NaN,-105.10096938943295,-8.021137751256676,-0.14533899250280635,0.2759178972036054,0.42125688970641173,111087220,116380788.2,37.964699650223025,54.17832294692391,NaN,NaN,13.516789558819294,21.626746607785545
2014-03-27T09:30:00-04:00,46.7,46.71,46.26,46.45,4988635,6398476.3,45.633508787044946,57.072878760140036,NaN,NaN,-191.2412453685467,-56.12550553955846,-0.176879166637325,0.20015793140975546,0.37703709804708047,106098585,112530724,33.64287859422538,50.78302597816222,NaN,NaN,9.866639738516566,19.94673134074712
2014-03-28T09:30:00-04:00,46.6,47,46.47,46.77,6682113,6437955.3,49.50835201489273,55.66145463345704,NaN,NaN,-119.81705939243511,-87.96680602299577,-0.17039136138722966,0.1640478963130434,0.33443925770027305,112780698,111771081.2,32.84831967165903,47.2972562470466,NaN,NaN,8.066589680113847,18.249568246370938
2014-03-31T09:30:00-04:00,47.15,47.34,46.94,47.28,4857327,6171433.4,55.01170361570272,55.23866633071326,NaN,NaN,-28.4958669576512,-90.18226955092368,-0.12789474435046327,0.17457082726219397,0.30246557161265725,117638025,112948021.6,35.394178637329034,44.356754740863956,NaN,NaN,8.332599715156991,16.832858456197517
2014-04-01T09:30:00-04:00,47.5,47.59,47.2401,47.54,5783207,6077317.85,57.55182567343291,55.0202207917926,NaN,NaN,35.556644651366916,-81.8196992913398,-0.08071916254141331,0.20156661843589063,0.28228578097730395,123421232,114205152,38.093914889831346,42.23498945927221,NaN,NaN,9.373757908113497,15.767272663614087
2014-04-02T09:30:00-04:00,47.65,47.999,47.43,47.89,4332322,6090044.05,60.76345336814167,55.4116563537503,NaN,NaN,108.66814654687525,-39.06587610407817,-0.027156353169260572,0.2483403395157282,0.2754966926849888,127753554,117538418.8,44.69327815711421,41.43370943609063,NaN,NaN,11.285813722495398,15.127064243454274
2014-04-03T09:30:00-04:00,48.07,48.26,47.77,47.95,4642272,6007899.1,61.3039594646184,55.841699494027786,NaN,NaN,163.22259305995667,31.826891581622505,0.009156768037564766,0.28694265273194475,0.27778588469438,132395826,122797867,53.17528512720871,41.72370294507153,NaN,NaN,12.97483468667445,14.819602878200014
2014-04-04T09:30:00-04:00,48.27,48.34,47.22,47.34,9381344,6025237.55,53.269579655584074,55.371212957421214,NaN,NaN,84.08814981052154,72.60793342221385,-0.010024179818309387,0.26525565992149325,0.27527983973980263,123014482,124844623.8,56.00311562355021,42.46777159418046,NaN,NaN,11.922155137093132,14.405681772327602
2014-04-07T09:30:00-04:00,47.19,47.38,46.48,46.65,7403037,6152493.5,45.9359281593029,54.16879613130094,NaN,NaN,-99.80624119962802,58.34585857381846,-0.06806480405421117,0.19019883467203869,0.25826363872624986,115611445,124439307.8,55.291009142819135,43.21519343170507,NaN,NaN,8.49504028485257,13.561304416974027
2014-04-08T09:30:00-04:00,46.71,47.022,46.5,46.83,4811094,6060679.1,47.94908434414456,53.59618410990055,NaN,NaN,-100.82987278590726,31.06855508636363,-0.09174283420015414,0.14358509597605718,0.23532793017621131,120422539,123839569.2,54.19294319385225,43.983967469660705,NaN,NaN,6.414757446675691,12.540369135502836
2014-04-09T09:30:00-04:00,47.05,47.654,46.76,47.54,4112924,5999063.25,55.057834345136534,53.062651819078646,NaN,NaN,21.666018143383877,13.668129405665358,-0.05860935231806924,0.16206623977862478,0.22067559209669402,124535463,123195951,52.977002788580116,44.48614705211474,NaN,NaN,7.002109177766472,11.749189141540498
2014-04-10T09:30:00-04:00,47.53,47.57,46.5,46.59,5472209,5876463.1,46.00438568413679,52.28603260753682,NaN,NaN,-72.52220301163894,-33.48082980865375,-0.09740816655738391,0.09891538389996413,0.19632355045734803,119063254,120529436.6,48.15617279273708,44.65951011701212,NaN,NaN,4.218408534772071,10.67336334057358
2014-04-11T09:30:00-04:00,46.41,46.63,46.03,46.03,5218299,5823515.5,41.656058649344004,51.54219919722366,NaN,NaN,-185.00013997752103,-87.29848776626227,-0.15414795068689197,0.003638612098733063,0.15778656278562503,113844955,118695531.2,45.11544622309843,44.82944455354618,NaN,NaN,0.3755565889291646,9.202248090338664
2014-04-14T09:30:00-04:00,46.45,46.58,46.09,46.4,4958629,5808256.6,45.33268176953715,50.85516593695039,NaN,NaN,-134.31692128053677,-94.20062378244403,-0.15945663221614342,-0.041534227484554265,0.11792240473158916,118803584,119333959,46.38465781777365,45.28092159357154,NaN,NaN,-1.3865727787931272,7.689559394748408
2014-04-15T09:30:00-04:00,46.43,46.71,45.92,46.68,4863194,5811451.75,48.00305618685265,50.92724369413378,NaN,NaN,-105.18765507625493,-95.07218024051357,-0.13763116098764558,-0.05411654650296782,0.08351461448467776,123666778,119982806.8,47.70818640905171,45.97688493348788,NaN,NaN,-1.888077145749036,6.3213256032487735
2014-04-16T09:30:00-04:00,46.93,47.41,46.87,47.37,5811160,5707482.35,53.97011139213419,51.52271530878301,NaN,NaN,22.63421847997338,-94.87854017319566,-0.07346372433211765,-0.008315040930469308,0.06514868340164834,129477938,120971301.8,49.74359673387722,47.126936229177296,NaN,NaN,-0.2544877382650846,5.381923697318222
2014-04-17T09:30:00-04:00,47.35,47.6,47.315,47.52,4721583,5653277.45,55.174412483126304,51.92743391365684,NaN,NaN,65.42595752158938,-67.28890806655001,-0.020415026881854793,0.03962989979932985,0.06004492668118464,134199521,123998555.2,55.46122036573142,48.74214342161104,NaN,NaN,1.4207190160309655,4.816037314277185
2014-04-21T09:30:00-04:00,47.6,47.75,47.38,47.53,3319001,5380727.8,55.25845509794981,51.945059019531634,NaN,NaN,75.85600637915239,-15.11767879521532,0.013995816902486538,0.07753969780929282,0.06354388090680628,137518522,128733268.6,62.623515519129064,50.687096056025325,NaN,NaN,2.7618503620772406,4.522582035391479
2014-04-22T09:30:00-04:00,47.6,47.865,47.43,47.7,4999131,5389404.9,56.74323211552141,51.88730233682367,NaN,NaN,85.14198314604768,28.774102090101564,0.045099868704903665,0.11991871678793586,0.0748188480830322,142517653,133476082.4,68.14893139328817,52.833882949129375,NaN,NaN,4.306086885195289,4.491654156792023
2014-04-23T09:30:00-04:00,47.73,47.85,47.63,47.71,3975951,5319089.6,56.833978231948066,51.60662554138127,NaN,NaN,87.57903648631685,67.32744040261592,0.06218714362939409,0.15255277761977482,0.09036563399038072,146493604,138041447.6,72.38138789678175,54.81160507339134,NaN,NaN,5.586226182129956,4.648021588983156
2014-04-24T09:30:00-04:00,47.84,47.95,47.41,47.5,3459961,5189669.65,54.25970077013123,51.10346420606076,NaN,NaN,65.40759895366425,75.8821164973541,0.0554116080505819,0.1596301440536081,0.10421853600302619,143033643,140752588.6,74.5446485801963,56.33798817717617,NaN,NaN,5.978439578181896,4.8380813017258335
2014-04-25T09:30:00-04:00,47.41,47.445,47.01,47.16,3500663,5115271.05,50.288174207063385,50.89050667402356,NaN,NaN,-0.053441620418236566,62.786236668952576,0.02561191935919152,0.13623343520201558,0.11062151584282406,139532980,141819280.4,75.36231915069428,57.72078842911504,NaN,NaN,5.214433301947059,4.891845873186009
2014-04-28T09:30:00-04:00,47.36,47.37,46.61,46.96,9573532,5259842,48.05975255457294,51.04220841654285,NaN,NaN,-39.00282919377538,39.81446955436703,-0.008180615338853753,0.10039574666925688,0.10857636200811063,129959448,140307465.6,71.84014527727278,58.90286958157602,NaN,NaN,3.9441323978486493,4.756458233852101
2014-04-29T09:30:00-04:00,47.05,47.42,47.05,47.29,4977314,5265841.35,51.85104264864465,51.32091972400714,NaN,NaN,5.430910325511346,23.872254990259766,-0.008862320950705382,0.0974984608197289,0.10636078177043429,134936762,138791287.4,68.38812322906209,59.91681101266244,NaN,NaN,3.8920404711984524,4.632969982044437
2014-04-30T09:30:00-04:00,47.15,47.7,47.13,47.67,6018263,5277594.15,55.84764732360522,51.377334936754906,NaN,NaN,45.452684165261466,15.44698452604869,0.014456017992938094,0.12443080426160691,0.10997478626866881,140955025,137683571.6,65.89678124612281,60.839652331058346,NaN,NaN,4.999440380101587,4.685322896052601
2014-05-01T09:30:00-04:00,47.62,47.62,47.27,47.37,4170357,5269495.9,52.16622171258996,51.81746608164441,NaN,NaN,36.559514352343264,9.677367605784495,0.008165774461523015,0.12018200434557258,0.11201622988404956,136784668,136433776.6,63.103582782681414,61.90732447319723,NaN,NaN,4.892830936914954,4.71496690189008
2014-05-02T09:30:00-04:00,47.44,47.82,47.34,47.55,4983168,5286540.7,54.120410875390455,52.70777695493344,NaN,NaN,68.2215854991905,23.33237302970624,0.01426105718906473,0.12984255137038048,0.11558149418131575,141767836,136880747.8,63.696254855928586,63.234525089827955,NaN,NaN,5.3586497382059495,4.806921592792348
2014-05-05T09:30:00-04:00,47.39,47.84,47.31,47.81,2399034,4937425.2,56.861852078768926,53.53128911987857,NaN,NaN,82.60806338601924,47.654551545665164,0.03287273230701353,0.15667240956508266,0.12379967725806913,144166870,139722232.2,67.29308752788374,64.72798435483581,NaN,NaN,6.542215157998708,5.054820673536113
2014-05-06T09:30:00-04:00,47.67,47.83,47.41,47.57,3428317,4738689.2,53.67366883217911,53.93633288025904,NaN,NaN,68.73979551875883,60.31632858431466,0.02637002941321004,0.15676221402458168,0.13039218461137164,140738553,140882590.4,68.65866932557503,66.22444742030176,NaN,NaN,6.656940993609961,5.283695004975234
2014-05-07T09:30:00-04:00,47.73,47.98,47.42,47.94,4292474,4712758.2,57.61887680493454,54.196958981173346,NaN,NaN,93.46761759086498,69.91931526943536,0.043335675656523465,0.184561779182026,0.14122610352550252,145031027,141697790.8,69.61839234858263,67.64407567849501,NaN,NaN,7.907069996421345,5.658462860896107
2014-05-08T09:30:00-04:00,47.86,48.22,47.55,47.75,4844587,4749341.35,55.02734174636606,54.18645392854762,NaN,NaN,94.27360106861343,81.4621326126894,0.03828479876241456,0.1890821019785207,0.15079730321610615,140186440,142378145.2,70.43216575582912,68.71342892064484,NaN,NaN,8.223230277083909,6.024858206065793
2014-05-09T09:30:00-04:00,47.55,47.81,47.45,47.75,3977414,4674601.6,55.027341746366055,54.169945832005915,NaN,NaN,59.99533051657533,79.81688161616636,0.0317372643344265,0.19046888363413927,0.15873161929971277,140186440,142061866,69.50020220351183,69.20462082667218,NaN,NaN,8.482030419830563,6.3758828080321885
2014-05-12T09:30:00-04:00,48.03,48.4,48.01,48.36,4435740,4635473.65,61.47854320015922,54.50818233805148,NaN,NaN,169.85788885713274,97.26684671038906,0.06345132581684718,0.23804577657077175,0.17459445075392457,144622180,142152928,69.62482511936571,69.31004180710629,NaN,NaN,10.641180333085266,6.985211025896914
2014-05-13T09:30:00-04:00,48.31,48.59,48.31,48.4,3410785,4558081.45,61.86484999223727,54.867530320929276,NaN,NaN,207.769218798628,125.0727313663629,0.08096382407522157,0.27579923084795155,0.19483540677272998,148032965,143611810.4,71.62515761394457,69.25602535833221,NaN,NaN,12.514381011191187,7.775092452367524
2014-05-14T09:30:00-04:00,48.4,48.6699,48.3,48.41,4829538,4556398.65,61.96753541671313,55.418089938542266,NaN,NaN,202.22725175365983,146.82465819892187,0.08655796069113716,0.30303285763665144,0.21647489694551428,152862503,145178105.6,73.63279602937233,69.19089303327335,NaN,NaN,14.085926402945997,8.67664015959302
2014-05-15T09:30:00-04:00,48.28,48.31,47.445,47.73,6543982,4593039.75,51.760975443342424,55.52329002684792,NaN,NaN,39.2666520271806,135.8232683906353,0.0401571741058368,0.26667136457781027,0.22651419047197346,146318521,146404521.8,75.1173552393324,69.17339561103321,NaN,NaN,12.537713211446059,9.228222024143454
2014-05-16T09:30:00-04:00,47.76,47.92,47.3659,47.9,4376408,4575781,53.80928027524101,55.93397057832421,NaN,NaN,10.721623679342796,125.96852702318878,0.017752870795795184,0.24870527896671746,0.23095240817092227,150694929,148506219.6,77.45950161580339,69.57477820664255,NaN,NaN,11.842703457257779,9.601719371731214
2014-05-19T09:30:00-04:00,47.81,48.35,47.79,48.1,2740725,4546867.2,56.167365019903315,56.24227931912839,NaN,NaN,89.99779605928121,109.99650846361848,0.013437636445376405,0.2477494537276428,0.23431181728226638,153435654,150268914.4,79.2256848091858,70.34888974807996,NaN,NaN,11.937014849331385,9.935333011388382
2014-05-20T09:30:00-04:00,48.05,48.2,47.72,47.84,4680583,4530939.8,52.42077515698913,55.997502735798676,NaN,NaN,46.19745448608877,77.68215560111065,-0.008700260657165615,0.22343649146080935,0.23213675211797496,148755071,150413335.6,79.36832608280345,71.31114295069999,NaN,NaN,10.921648993395616,10.076235294532273
2014-05-21T09:30:00-04:00,47.97,48.18,47.8899,48.06,2514023,4457843.4,55.14709435791454,56.21042221046472,NaN,NaN,67.77292058650832,50.791289367680335,-0.010196244056721537,0.21939144704707303,0.22958769110379457,151269094,150094653.8,78.09409647613649,72.38189392880393,NaN,NaN,10.84457913615011,10.185998700477677
2014-05-22T09:30:00-04:00,48.08,48.32,48,48.17,3223630,4446026.85,56.489572963819086,56.37964807392391,NaN,NaN,84.42072664340489,59.82210429092519,-0.005672557643026321,0.22249699405001166,0.228169551693038,154492724,151729494.4,79.87876642069679,73.53778761200167,NaN,NaN,11.159455841341256,10.325064006315332
2014-05-23T09:30:00-04:00,48.23,48.6,48.17,48.58,2244514,4383219.4,61.15630803848393,56.68639492818926,NaN,NaN,130.3859232560604,83.75496420626871,0.021545230124005776,0.2551010893480452,0.23355585922403943,156737238,152937956.2,81.10423826811561,74.52429837916108,NaN,NaN,12.826733468690362,10.682445358083193
2014-05-27T09:30:00-04:00,48.68,48.78,48.52,48.58,2171804,4013133,61.15630803848393,57.22086915721103,NaN,NaN,148.13825516538273,95.383056027489,0.03534609144864548,0.27773847353484626,0.24239238208620079,156737238,153598273,81.75800842249362,75.45996545751241,NaN,NaN,14.17864019985162,11.18190176405011
2014-05-28T09:30:00-04:00,48.54,48.77,48.5,48.6,3986506,3963592.6,61.390584434712615,57.49027684505232,NaN,NaN,129.69492802642813,112.08255073555688,0.0412098116369356,0.29390464663237026,0.25269483499543466,160723744,155992007.6,83.92879646886676,76.48213718038984,NaN,NaN,15.362576164918432,11.779140964174156
2014-05-29T09:30:00-04:00,48.64,49.12,48.469,49.09,2756938,3800526.35,66.69111029431966,58.3234031699061,NaN,NaN,159.39254897183503,130.40647641262223,0.07169167612502453,0.34230943015171533,0.2706177540266908,163480682,158434325.2,85.78718341917195,77.5789241563429,NaN,NaN,18.025805231679833,12.671521573817824
2014-05-30T09:30:00-04:00,48.89,49.1,48.84,49.08,3423773,3763197.15,66.49049045892195,59.14219950651724,NaN,NaN,156.44079705995532,144.8104904959323,0.0839335750817019,0.3755347228788182,0.29160114779711627,160056909,159547162.2,86.55033916727045,78.79679108232565,NaN,NaN,20.147364042117804,13.739499069289248
2014-06-02T09:30:00-04:00,49.16,49.3901,49.03,49.28,3420520,3685064.75,68.52952198521696,59.64584084830708,NaN,NaN,167.64515581358688,152.2623370074376,0.09731168424413605,0.41324075310228636,0.3159290688581503,163477429,160895200.4,87.43077338021548,80.06864452952922,NaN,NaN,22.566616897875186,15.000515901944382
2014-06-03T09:30:00-04:00,49.07,49.31,49.02,49.17,2637717,3696998.9,66.14553555392015,59.951604102713,NaN,NaN,136.50008164531766,149.9347023034246,0.09069537656692123,0.4292982895668018,0.3386029129998806,160839712,161715695.2,87.94791110618618,81.23455549326074,NaN,NaN,23.973585068531186,16.282382925742496
2014-06-04T09:30:00-04:00,49.08,49.4,48.925,49.25,2871127,3669139.4,67.04347987931067,60.31417156432711,NaN,NaN,124.8966690979761,148.9750505177342,0.08381243656857673,0.4433684587106015,0.35955602214202476,163710839,162313114.2,88.32457857294209,82.28396853208717,NaN,NaN,25.408616372431307,17.586130560983754
2014-06-05T09:30:00-04:00,49.36,49.569,48.9,49.48,4861636,3697597.5,69.54452417660481,61.58442504527442,NaN,NaN,128.79661782453147,142.8558642882735,0.08650481576130875,0.4676870418436607,0.38118222608235197,168572475,163331472.8,88.95807885760246,83.2725916476779,NaN,NaN,27.373775183064343,18.984365506995267
2014-06-06T09:30:00-04:00,49.57,49.7499,49.48,49.72,2925899,3601663.1,71.93768365523584,62.879311000988345,NaN,NaN,152.21987459594604,142.01167979547162,0.0954986952169462,0.5005555951035348,0.40505689988658855,171498374,165619765.8,90.23963043891057,84.18545799218555,NaN,NaN,29.791024015618543,20.52817386537002
2014-06-09T09:30:00-04:00,49.63,49.79,49.5,49.59,7319763,3768780.55,68.78474738731008,63.78055259866024,NaN,NaN,132.09954322815432,134.90255727838513,0.08414056247794965,0.5102326029840256,0.42609204050607596,164178611,165760002.2,90.31382593189139,84.9774680723788,NaN,NaN,30.980764220755407,22.021401058996506
2014-06-10T09:30:00-04:00,49.48,49.67,49.3,49.66,2658451,3679916.1,69.55843403710381,65.004671090097,NaN,NaN,105.48784088313143,128.7001091259479,0.07319335426771084,0.5175837333407145,0.44439037907300366,166837062,166959472.2,90.94767345010536,85.80456431290035,NaN,NaN,32.1938652575454,23.474610230217777
2014-06-11T09:30:00-04:00,49.5,49.6,49.29,49.38,2347535,3626753.6,62.8482265232778,65.55475195905153,NaN,NaN,80.83385506690261,119.88754631973318,0.04057457153890226,0.4951085934966315,0.45453402195772924,164489527,167115209.8,91.02975126413006,86.7285396548999,NaN,NaN,31.38598758038788,24.60480699452779
2014-06-12T09:30:00-04:00,49.38,49.47,48.845,48.96,3401267,3555340.05,54.3747881517919,65.40369590104959,NaN,NaN,37.33777200557994,101.59577715594287,-0.012944554349754278,0.43835332902053636,0.45129788337029064,161088260,165618366.8,83.21961307998882,86.96717155913505,NaN,NaN,28.033880386956778,25.094674622017646
2014-06-13T09:30:00-04:00,48.98,49.21,48.86,49.15,2446924,3350487.15,57.18689834122326,65.12016663695954,NaN,NaN,30.13505078441777,77.1788123936372,-0.03779977122227052,0.40404816934245247,0.441847940564723,163535184,164025728.8,75.77055537334131,86.58619420950832,NaN,NaN,26.033814683376868,25.228837487926107
2014-06-16T09:30:00-04:00,49.02,49.1399,48.8,49.04,7960917,3529712.6,55.070627572444245,64.68547517509957,NaN,NaN,13.118724178955075,53.38264858379735,-0.062445199516493854,0.36379144116910567,0.4262366406855995,155574267,162304860,68.62295247412567,85.64797592748202,NaN,NaN,23.742740951273987,25.01653798269009
2014-06-17T09:30:00-04:00,48.72,49.24,48.7,49.14,6116136,3698483.15,56.64150007522269,64.34625486370743,NaN,NaN,12.404102389361913,34.76590088504346,-0.0721231476755218,0.3360827060911973,0.4082058537667191,161690403,161275528.2,64.69195696704244,84.273915963066,NaN,NaN,22.272447373828662,24.62452503856703
2014-06-18T09:30:00-04:00,49.18,49.7,49.12,49.67,8043825,3866645.25,63.85463080433555,64.14364918585142,NaN,NaN,89.50191364259838,36.499512600182605,-0.04430645653537996,0.35282278309749415,0.3971292396328741,169734228,162324468.4,66.78033184820421,82.91628370799688,NaN,NaN,23.15930753422513,24.41520825223247
2014-06-19T09:30:00-04:00,49.73,49.75,49.475,49.57,5766388,4029263.5,61.766715505168925,63.80623668915477,NaN,NaN,103.4381047643662,49.71957915193986,-0.03455119361727205,0.35394024761128406,0.3884914412285561,163967840,162900384.4,67.90285252417236,81.58432037634702,NaN,NaN,23.24183075315485,24.24758289522138
2014-06-20T09:30:00-04:00,49.4,49.67,49.33,49.64,4217946,4078979.3,62.68646508027839,63.388875481659156,NaN,NaN,86.41006513910796,60.974582022877904,-0.025700118994447574,0.35636629248549667,0.38206641147994425,168185786,163830504.8,69.68452606478738,80.31673128238788,NaN,NaN,23.57949687836042,24.152142035669815
2014-06-23T09:30:00-04:00,49.7,49.86,49.49,49.71,2952681,4114387.65,63.628726011277784,63.20910337147041,NaN,NaN,109.24036444345954,80.1989100757788,-0.01782118426571977,0.35978993114779456,0.37761111541351433,171138467,166943344.8,74.7384044063591,79.37319508954309,NaN,NaN,24.127601360609944,24.148636224946976
2014-06-24T09:30:00-04:00,49.59,49.867,49.24,49.24,4374850,4224539.95,53.80431739283962,62.263448908151055,NaN,NaN,44.24813116373012,86.56771583065243,-0.04538551514467537,0.3208792214826701,0.3662647366273455,166763617,167957987.6,76.13497647124306,78.50250922513602,NaN,NaN,21.577706328224885,23.78136052541525
2014-06-25T09:30:00-04:00,49.33,49.87,49.33,49.63,6716798,4361054.55,59.40541032069723,61.53922648987194,NaN,NaN,80.16012764212765,84.6993586305583,-0.03873339683105037,0.3178479905885325,0.3565813874195829,173480415,168707225,77.13998564214212,77.65835970974601,NaN,NaN,21.134562764366922,23.403246559551203
2014-06-26T09:30:00-04:00,49.73,49.83,49.345,49.62,5451884,4495801.85,59.20718192953692,60.629904938036304,NaN,NaN,70.3301891203183,78.07777550174872,-0.03642257036111829,0.31105317446818503,0.3474757448293033,168028531,169519363.2,78.21110657412125,76.79917943368962,NaN,NaN,20.724910516648944,23.02062712485088
2014-06-27T09:30:00-04:00,49.26,49.49,49.155,49.465,6352572,4642241.8,56.083332793438736,59.72266103847407,NaN,NaN,-4.870043671387222,59.82175373964967,-0.04612446570420159,0.2898201626990513,0.3359446284032529,161675959,168217397.8,72.35779653628664,75.51660590543213,NaN,NaN,19.44150889034118,22.509324519920924
2014-06-30T09:30:00-04:00,49.46,49.72,49.29,49.64,13123531,5127392.35,58.730812350661026,58.94925948944244,NaN,NaN,50.51828784310325,48.077338419578425,-0.04168215692189847,0.28384193225087984,0.3255240891727783,174799490,168949602.4,73.55638902215253,74.2743713034355,NaN,NaN,19.139733331948815,22.02795435021062
2014-07-01T09:30:00-04:00,49.7,49.96,49.59,49.76,6992863,5345149.65,60.48971298726942,58.78079423687041,NaN,NaN,115.53330088174488,62.334372363181366,-0.03202237762242044,0.28549611714475276,0.3175184947671732,181792353,171955349.6,77.81002553679225,73.33010518005423,NaN,NaN,19.401216908850667,21.652706144302055
2014-07-02T09:30:00-04:00,49.8,49.95,49.72,49.82,3872493,5395217.95,61.37610561327278,59.28088834126191,NaN,NaN,125.22077706712011,71.34650224817986,-0.023354844827885635,0.2883249387323161,0.31167978356020176,185664846,174392235.8,80.54270978467628,73.1388978018176,NaN,NaN,19.86867264192947,21.397844215391686
2014-07-03T09:30:00-04:00,49.93,50.19,49.92,50.14,2809706,5292621.45,65.78487598746229,59.89502960170755,NaN,NaN,186.42559715273885,94.56558385466397,0.0008822236970101871,0.31278256318146447,0.3119003394844543,188474552,178481440,84.08462232406622,73.7327597268694,NaN,NaN,21.6092837084927,21.42804985726326
2014-07-07T09:30:00-04:00,50.07,50.11,49.63,49.72,4985587,5395605.85,56.645603566199554,60.00752788697579,NaN,NaN,96.27823941631183,114.79524047220377,-0.013619653587603753,0.29487577249994956,0.3084954260875533,183488965,182844041.2,86.83749133012962,75.03379821658396,NaN,NaN,20.28999103778491,21.26547002590921
2014-07-08T09:30:00-04:00,49.69,49.72,49.45,49.59,4276627,5243449.05,54.13850964479809,59.828742856231166,NaN,NaN,24.762966455670774,109.64417619471729,-0.03310397478441579,0.2671154576070336,0.3002194323914494,179212338,183726610.8,87.31549396403703,76.64976514494073,NaN,NaN,18.42766210003082,20.860068893640868
2014-07-09T09:30:00-04:00,49.75,49.825,49.62,49.76,4180922,5319572.6,56.82932260629382,59.326935127799615,NaN,NaN,65.72909350510126,99.68333471938857,-0.03546904518589594,0.25588312590907947,0.2913521710949754,183393260,184046792.2,87.49294498326391,78.12923751173071,NaN,NaN,17.685844406412798,20.406608252608287
2014-07-10T09:30:00-04:00,49.32,49.745,49.271,49.54,4031260,5403758.85,52.53364824458073,58.66743032347188,NaN,NaN,-0.9432804291896321,74.45052322012661,-0.051788167705573374,0.2266169614630087,0.27840512916858207,179362000,182786223,82.59393449361924,79.17860050954833,NaN,NaN,15.728246826462119,19.738270906015977
2014-07-11T09:30:00-04:00,49.52,49.675,49.42,49.63,3487903,5408090.65,54.0634043356469,58.051497413141064,NaN,NaN,10.251824259622923,39.21576864150344,-0.056096432896134196,0.20828458804841432,0.2643810209445485,182849903,181661293.2,78.37635008903362,79.79944508270877,NaN,NaN,14.571910545148977,19.00021942589212
2014-07-14T09:30:00-04:00,49.88,49.88,49.58,49.6,2515314,5411510.15,53.44509244407588,57.32409501548379,NaN,NaN,44.14529173567846,28.789179105376764,-0.060180943561824296,0.18915484149226813,0.24933578505409243,180334589,181030418,76.03151665087319,79.8918102430312,NaN,NaN,13.451335844039258,18.20752177134171
2014-07-15T09:30:00-04:00,49.63,49.95,49.3602,49.5,2823963,5154662.45,51.3374267137361,57.14788853840496,NaN,NaN,-1.7839761181828062,23.47979059060604,-0.06824116435125177,0.16403432961502773,0.2322754939662795,177510626,180690075.6,74.73256161606591,79.7916377533757,NaN,NaN,11.91155819693564,17.308098403569414
2014-07-16T09:30:00-04:00,49.66,49.88,49.64,49.84,3845118,5041111.55,57.47753381326684,57.0101830735885,NaN,NaN,76.26494907169993,25.586961703925777,-0.05013544563416486,0.16960618692357343,0.2197416325577383,181355744,180282572.4,73.12174296838884,79.50462041953618,NaN,NaN,12.321550105782,16.595734361028356
2014-07-17T09:30:00-04:00,49.67,49.92,49.535,49.63,5507153,4914277.95,53.02708613326454,56.56874765956905,NaN,NaN,22.264802645277072,30.228578318819114,-0.051564000924068154,0.15528663140265309,0.20685063232672124,175848591,179579890.6,70.30756722392806,78.94008189452238,NaN,NaN,11.338131086556972,15.844648178961016
2014-07-18T09:30:00-04:00,49.67,50.025,49.63,49.94,4866161,4869266.6,58.17539405787266,56.718180607028614,NaN,NaN,102.82373646285328,48.742960759465184,-0.03185866351729011,0.1670273029301086,0.1988859664473987,180714752,179152860.4,68.58018711466723,78.670252650121,NaN,NaN,12.08254520570597,15.307204897067438
2014-07-21T09:30:00-04:00,49.77,49.88,49.6,49.8,4929571,4904847.85,55.23128955476269,56.46821469303587,NaN,NaN,43.22764264505954,48.5594309413414,-0.02858533432761265,0.16315429853788288,0.19173963286549553,175785181,178242978.8,64.92022303586151,78.05338365110022,NaN,NaN,11.799674266493962,14.806129092699798
2014-07-22T09:30:00-04:00,49.95,50.02,49.845,49.87,2818684,4898148,56.41888071283613,56.17744095914778,NaN,NaN,108.99575068495011,70.71537630196798,-0.022316001711689876,0.16384463072588318,0.18616063243757305,178603865,178461626.6,65.39810751135008,77.16681807785434,NaN,NaN,11.919224875324618,14.393714204503343
2014-07-23T09:30:00-04:00,49.88,50.18,49.75,50.08,2269940,4792902.5,59.85909480553321,56.069083044309245,NaN,NaN,137.3122599372661,82.92483847508122,-0.005512145349305414,0.17927045075094128,0.1847825961002467,180873805,178365238.8,64.9778715448634,76.0550439178677,NaN,NaN,13.055658030762963,14.202563322540431
2014-07-24T09:30:00-04:00,50.08,50.19,49.9233,50.02,2500449,4582085.05,58.43967289113836,55.54442568028611,NaN,NaN,137.48576197401448,105.96903034082871,-0.0002045454443688477,0.18452691429478563,0.18473145973915447,178373356,178870191.8,66.2031038196327,74.77779259612245,NaN,NaN,13.584621890364886,14.114285975086782
2014-07-25T09:30:00-04:00,49.9,50.28,49.9,50.11,2389177,4428949.7,59.97291679730677,55.782090911079486,NaN,NaN,141.43446797483693,113.69117664322543,0.007192306248214236,0.19372184254942226,0.18652953630120803,180762533,178879748,66.22718413226494,73.30562779627498,NaN,NaN,14.464750098051187,14.164352278367412
2014-07-28T09:30:00-04:00,50.11,50.365,49.95,50.24,10673659,4645004.05,62.145305625014316,56.35400490966636,NaN,NaN,159.04199894227474,136.85404790266847,0.018047219129226744,0.20908856021274147,0.19104134108351473,191436192,182009950.2,73.0106241602632,72.2838513817197,NaN,NaN,15.837093123618706,14.403315256260454
2014-07-29T09:30:00-04:00,50.3,50.34,49.863,49.88,3892526,4183453.8,53.48798184361151,56.11533771233191,NaN,NaN,83.51437173098391,131.75777211187523,-0.0008112432343716502,0.19002728704055016,0.1908385302749218,187543666,183797910.4,75.97854409948266,71.46139417573532,NaN,NaN,14.485922351913027,14.415116269925107
2014-07-30T09:30:00-04:00,50.01,50.13,49.52,49.62,5282593,4097940.3,48.25908639081128,55.81001186563409,NaN,NaN,-30.13200438095046,98.26891924823192,-0.030921266429127847,0.152186947238512,0.18310821366763985,182261073,184075364,76.4120222877554,71.01982901817362,NaN,NaN,11.666189299587511,14.022412417019737
2014-07-31T09:30:00-04:00,49.25,49.4,48.65,48.65,6458782,4227254.75,34.64975060823366,54.423322313676,NaN,NaN,-293.5222391383486,12.067319025759309,-0.11174519829318896,0.04342671580115365,0.1551719140943426,175802291,183561151,73.7555812255804,70.68977409935555,NaN,NaN,3.4634609846735684,12.513990783827428
2014-08-01T09:30:00-04:00,48.55,48.86,48.38,48.69,5622042,4367871.55,35.45805111146953,53.13853364706126,NaN,NaN,-287.72410134688033,-73.76439483858414,-0.15540817118948952,-0.039088299892519274,0.11631987129697023,181424333,183693511,74.00608174446282,70.54510017746908,NaN,NaN,-2.3546021571755804,10.389906077969854
2014-08-04T09:30:00-04:00,48.83,49.315,48.57,49.27,4966328,4366908.6,45.90592626087404,52.75056932899968,NaN,NaN,-146.42508839731352,-134.85781230650178,-0.13867474462381665,-0.05702355948280058,0.08165118514101607,186390661,182684404.8,68.62788041216785,70.10905152004779,NaN,NaN,-3.543032502806397,8.399486280716104
2014-08-05T09:30:00-04:00,48.85,49.18,48.622,48.76,5137635,4409959,39.804334679005585,51.48819796226673,NaN,NaN,-157.82989992381573,-183.1266666374617,-0.15420840458656632,-0.11110932059219181,0.043099083994374496,181253026,181426276.8,62.52677778769972,69.35226829285571,NaN,NaN,-6.8671376604432055,6.2185400034076315
2014-08-06T09:30:00-04:00,48.64,49.185,48.54,49.12,6358717,4518848.75,45.328334915564014,50.93828716100241,NaN,NaN,-117.31338617640034,-200.5629429965517,-0.13327930947600966,-0.12350005285063759,0.009779256625372074,187611743,182496410.8,65.3485813780967,68.99805501815347,NaN,NaN,-7.428186716969543,4.269007614782321
2014-08-07T09:30:00-04:00,49.34,49.49,48.56,48.69,5083681,4571469.8,40.54257964488017,49.67880041721723,NaN,NaN,-106.50153871701943,-163.15880291228586,-0.14070538754587042,-0.16610247780696596,-0.025397090261095538,182528062,183841565,68.5540334268024,68.99618689759168,NaN,NaN,-9.669852953358102,2.2777418193336896
2014-08-08T09:30:00-04:00,48.8,49.23,48.62,49.2,4269097,4610529.5,47.6079153695293,49.13427368970056,NaN,NaN,-78.28775827589371,-121.27153429808853,-0.10520535152219197,-0.1569037796638355,-0.051698428141643535,186797159,184916130.2,70.87208476705732,69.4213198783914,NaN,NaN,-8.83303514212656,0.6904879676965112
2014-08-11T09:30:00-04:00,49.33,49.52,49.13,49.15,5491698,4759348.7,47.01801919354208,48.46278358117956,NaN,NaN,-36.700358960052604,-99.32658841063635,-0.08015913681202097,-0.15189734915666975,-0.07173821234464878,181305461,183899090.2,65.91918141701967,69.45853944308207,NaN,NaN,-8.410680500768665,-0.6096789563699423
2014-08-12T09:30:00-04:00,49.14,49.365,49.04,49.305,7297181,4983009.6,49.12260975753252,47.695891792036655,NaN,NaN,-37.466203028889446,-75.25384903165109,-0.049712818769051786,-0.1338792358059635,-0.08416641703691172,188602642,185369013.4,69.26261608022767,69.76459262417951,NaN,NaN,-7.377210620771156,-1.5764691941415443
2014-08-13T09:30:00-04:00,49.53,49.63,49.27,49.58,4308844,5006195.9,52.711657218341614,47.28674781540831,NaN,NaN,1.4543370249637302,-51.50030439137828,-0.00970644164847248,-0.09629946909750231,-0.08659302744902983,192911486,186428962,71.43851376682362,70.1385504775503,NaN,NaN,-5.344980498111556,-2.114827951851546
2014-08-14T09:30:00-04:00,49.66,49.685,49.53,49.58,3607294,4911202.95,52.71165721834162,46.7680864169108,NaN,NaN,17.823379607303686,-26.63532072651365,0.016667060290827942,-0.0657592020854949,-0.08242626237632285,192911486,188505646.8,75.15015294947362,70.7759053930652,NaN,NaN,-3.75443691877177,-2.3490578042687207
2014-08-15T09:30:00-04:00,49.76,49.95,49.33,49.73,4439497,4889869.75,54.73177091092723,46.23854822304744,NaN,NaN,30.54554917348527,-4.868659236637856,0.04264785959823568,-0.029116437878528245,-0.07176429747676392,197350983,190616411.6,78.24474289721586,71.14977101713325,NaN,NaN,-1.8306103559402038,-2.2749938830789325
2014-08-18T09:30:00-04:00,49.93,50.22,49.93,50.22,5348105,4910796.45,60.64602321033498,46.74983689209911,NaN,NaN,93.16967926285936,21.10534840794454,0.08862136667215939,0.03901241086343532,-0.04960895580872407,202699088,194895137,82.89487169602208,71.64379441688607,NaN,NaN,1.7862697929544784,-1.6948133579313023
2014-08-19T09:30:00-04:00,50.3,50.45,50.24,50.37,3144591,4927091.8,62.271051430034035,47.750691537757874,NaN,NaN,118.05148177021552,52.20888536776554,0.12281591672367702,0.1039109400958722,-0.018904976627804812,205843679,198343344.4,85.57148714529002,72.29804190670997,NaN,NaN,5.254107398576631,-0.7021103927158834
2014-08-20T09:30:00-04:00,50.3,50.495,50.25,50.44,4800426,5053616.1,63.03809164188503,49.77843018301869,NaN,NaN,116.35979802524275,75.18997756782134,0.14244977446962495,0.15915724145922638,0.016707466989601433,210644105,201889868.2,87.70285378383412,73.29427566087095,NaN,NaN,8.30454573296833,0.5845547680961471
2014-08-21T09:30:00-04:00,50.51,50.53,50.2323,50.37,1362867,4996737,61.68749627063031,51.651961980101596,NaN,NaN,108.13614353835159,93.25253035403092,0.14266888831435803,0.19504357738254896,0.05237468906819094,209281238,205163818.6,89.2775112367415,74.38509205317656,NaN,NaN,10.449893331330886,1.9938888485582527
2014-08-22T09:30:00-04:00,50.36,50.36,50.07,50.17,1807199,4967638.1,57.872360190633714,52.50670726079873,NaN,NaN,83.56348422610753,103.85611736455537,0.12208626294638265,0.20498251775116927,0.08289625480478661,207474039,207188429.8,90.12005149214019,75.92024713031745,NaN,NaN,11.234524572262405,3.3139796662302743
2014-08-25T09:30:00-04:00,50.46,50.46,50.265,50.36,1563104,4512110.35,60.379296826347726,53.9763474141803,NaN,NaN,101.49755046918335,105.52169160582017,0.11415511526961973,0.22559014889181128,0.11143503362219155,209037143,208456040.8,90.61716785115351,77.92670356342128,NaN,NaN,12.61972103432141,4.6433712902432935
2014-08-26T09:30:00-04:00,50.39,50.53,50.37,50.41,1909215,4412944.8,61.03640420603404,55.09835236349959,NaN,NaN,104.34917629005686,102.78123050978843,0.10537477704329054,0.24315350492630472,0.13777872788301418,210946358,209476576.6,91.0093790501947,79.75961768285686,NaN,NaN,13.95172835653148,5.97313658542732
2014-08-27T09:30:00-04:00,50.49,50.53,50.305,50.41,3299558,4313793.05,61.03640420603404,56.56219697501058,NaN,NaN,91.9320333547842,97.89567757569674,0.09309140884780837,0.25414298894277465,0.16105158009496628,210946358,209537027.2,91.03328886855302,81.36527878583904,NaN,NaN,15.057524213760583,7.270906246617787
2014-08-28T09:30:00-04:00,50.32,50.51,50.14,50.45,1836557,4082681.8,61.6268780347799,57.56355145109991,NaN,NaN,77.50166326327057,91.76878152068053,0.08159685619222334,0.26304765033524546,0.18145079414302212,212782915,210237362.6,91.32125002740474,82.82593344729243,NaN,NaN,16.148932122040133,8.539195657392408
2014-08-29T09:30:00-04:00,50.55,50.599,50.39,50.53,2667143,3934936.85,62.839804016011165,58.693678938419126,NaN,NaN,84.4023722671816,91.93655912889535,0.07356601209130761,0.27340830925715665,0.19984229716584903,215450058,211832566.4,91.955004880881,84.68563512328252,NaN,NaN,17.402973746312206,9.805449670095236
2014-09-02T09:30:00-04:00,50.52,50.61,50.26,50.36,6617805,4017510.7,58.60088647498743,59.370698703951625,NaN,NaN,66.68686720887818,84.97442247683432,0.052005055750528995,0.2648486168540103,0.2128435611034813,208832253,211791588.4,91.76961658830845,86.29327801671687,NaN,NaN,17.440914001225806,10.896230288828175
2014-09-03T09:30:00-04:00,50.56,50.66,50.41,50.44,3135606,3917409.25,59.96936618278698,59.8891064871263,NaN,NaN,72.255610437604,78.55570930634374,0.03892983405163056,0.2615058536680195,0.22257601961638893,211967859,211995888.6,91.85775271042348,87.75179508411686,NaN,NaN,17.82072176609252,11.885443357008796
2014-09-04T09:30:00-04:00,50.48,50.755,50.321,50.44,5777028,3888324.8,59.96936618278698,60.407514270300965,NaN,NaN,68.33564891781259,73.83643241894943,0.026664589085596657,0.25590675597338475,0.2292421668877881,211967859,212200188.8,91.95058157907354,88.95182570051686,NaN,NaN,18.14242120317429,12.779297335032439
2014-09-05T09:30:00-04:00,50.4,50.67,50.26,50.66,3076804,3787980.95,63.78715599444034,61.054327490551906,NaN,NaN,69.31969260763378,72.20003828782207,0.02952909829999592,0.266153539762783,0.23662444146278708,215044663,212652538.4,92.16361351708672,89.94603074479335,NaN,NaN,19.42749300656397,13.729039573822657
2014-09-08T09:30:00-04:00,50.57,50.74,50.37,50.46,2303773,3689714.75,58.33990640955071,60.88960486192446,NaN,NaN,66.73568214783569,68.66670026395289,0.014855760424689002,0.2551941419936483,0.24033838156895931,212740890,212110704.8,89.12106854963861,90.39075909148025,NaN,NaN,19.123379781171305,14.499659603443893
2014-09-09T09:30:00-04:00,50.4,50.41,49.94,50.05,3160475,3573153.6,49.08572892767553,59.947796111756,NaN,NaN,-16.394881596143975,52.05035050294846,-0.02347632830865104,0.21099297118314553,0.23446929949179657,209580415,212260337.2,89.22683916895261,90.651855664599,NaN,NaN,16.04565643754453,14.720516294029698
2014-09-10T09:30:00-04:00,49.96,50.079,49.61,50.05,6364045,3526496.8,49.08572892767553,58.95119877502675,NaN,NaN,-85.5554417212137,20.488140071184922,-0.04840908283522727,0.17395794594776248,0.22236702878298975,209580415,211782848.4,86.34199012621505,90.55465111762622,NaN,NaN,13.556310766904616,14.554201218726115
2014-09-11T09:30:00-04:00,49.82,50.09,49.79,49.98,4262712,3524190.2,47.59093980971892,57.94430188496165,NaN,NaN,-91.77499671729524,-11.533989055836642,-0.06799328045284997,0.13737542821692728,0.20536870866977724,205317703,210452817.2,78.70834947078174,89.79971099148624,NaN,NaN,11.037770896614115,14.051854029852972
2014-09-12T09:30:00-04:00,49.93,50.07,49.555,49.75,3883011,3537976.05,42.96159471951917,56.87924720845347,NaN,NaN,-150.83162380253785,-55.56425233787097,-0.09325432598928116,0.08880080118317579,0.18205512717245695,201434692,207730823,65.87251883941212,88.06774437343422,NaN,NaN,7.424807806858882,13.105133140853816
2014-09-15T09:30:00-04:00,49.79,49.945,49.57,49.82,3191047,3475553.55,44.72392522142087,55.761006379530116,NaN,NaN,-162.06097232916065,-101.32358323327023,-0.10139143945584361,0.05531582785265243,0.15670726730849605,204625739,206107792.8,59.62827951399564,85.85425234935153,NaN,NaN,4.87923482736654,11.930004810355634
2014-09-16T09:30:00-04:00,49.7,50.26,49.66,50.05,3317535,3374025.05,50.17160262372108,54.984949123650615,NaN,NaN,-87.67758461365703,-115.58012383677286,-0.08792712530212005,0.046798360680845974,0.13472548598296602,207943274,205780364.6,58.42504986592382,83.52680026476074,NaN,NaN,4.176854374673324,10.822411890972447
2014-09-17T09:30:00-04:00,50.32,50.62,50.15,50.35,5159894,3474790.2,56.23087104776734,54.64169675520299,NaN,NaN,31.014462008471927,-92.26614309083573,-0.05696163623023601,0.06352344069517102,0.12048507692540703,213103168,206484915.2,60.282262130662296,81.3302983549114,NaN,NaN,5.41439776504562,10.04983844441147
2014-09-18T09:30:00-04:00,50.55,50.77,50.5,50.69,4484899,3459013.85,61.8874474189607,54.66030885407305,NaN,NaN,109.14464140513229,-52.08221546635026,-0.01396747823510662,0.10302572913152375,0.11699320736663037,217588067,208938988,65.98249051941198,79.52038696148337,NaN,NaN,8.37838307829434,9.811059106394737
2014-09-19T09:30:00-04:00,50.66,50.83,50.35,50.44,6075521,3694646.55,56.14205338535784,54.181898094740674,NaN,NaN,71.23774740695855,-7.668341224450981,-0.003308395343706333,0.11285771318699744,0.11616610853070378,211512546,210954558.8,69.81430309154631,77.93890826224516,NaN,NaN,9.013375601315975,9.697104319954914
2014-09-22T09:30:00-04:00,50.71,50.86,50.38,50.42,3837224,3796147.8,55.69658133794137,53.97444772780881,NaN,NaN,69.62548544622143,38.66895033062544,0.001210525348979613,0.11767926521692829,0.11646873986794867,207675322,211564475.4,70.88312081537227,76.44701570703543,NaN,NaN,9.376298879209566,9.651274971277006
2014-09-23T09:30:00-04:00,50.37,50.46,50.14,50.16,2965467,3866265.95,50.128046035851874,53.27149628874202,NaN,NaN,-15.191899559117473,53.166087341533355,-0.01367497630801695,0.09937501948292748,0.11304999579094444,204709855,210917791.6,68.12864841912742,74.75207968622856,NaN,NaN,7.928167031194714,9.405116694122393
2014-09-24T09:30:00-04:00,50.19,50.73,50.13,50.68,4279073,3984758.85,58.96464778893161,53.19973068918092,NaN,NaN,57.368382631702275,58.436871466179426,0.009866474441259238,0.12538308884251848,0.11551661440125924,208988928,210094943.6,64.68430211063995,72.80448829562617,NaN,NaN,9.664659885411165,9.442194292877932
2014-09-25T09:30:00-04:00,50.49,50.51,49.9099,49.91,4704977,4055029.8,45.97440936752439,51.92739164440121,NaN,NaN,-50.624077513071285,26.483127682538708,-0.026088161259492246,0.08290641282689393,0.10899457408638617,204283951,207434120.4,55.000900929671204,70.15000882509648,NaN,NaN,6.167725961542886,8.974413102687212
2014-09-26T09:30:00-04:00,49.95,50.45,49.91,50.4,4727476,4199575.75,53.0611692601945,51.55033899087577,NaN,NaN,-9.901363856945277,10.255305429757943,-0.016979273293865782,0.08777048246905395,0.10474975576291973,209011427,206933896.6,53.38295264759627,67.59728626066489,NaN,NaN,6.140592190016268,8.56958154373422
2014-09-29T09:30:00-04:00,50.17,50.33,49.86,50.19,9104047,4521420.95,50.0321287953055,51.61793898142077,NaN,NaN,-39.91041454098849,-11.651874567684043,-0.024736610152549285,0.07382899307223312,0.0985656032247824,199907380,205380308.2,48.60108953833327,64.69544700133494,NaN,NaN,4.979041359604501,8.056647231715688
2014-09-30T09:30:00-04:00,50.14,50.225,49.5,49.59,7832937,4582177.55,42.557040646642356,51.15160410420412,NaN,NaN,-120.69765302339732,-32.753025260540014,-0.06749122671215385,0.014201569834590089,0.08169279654674394,192074443,202853225.8,42.009237329563085,61.528821801574075,NaN,NaN,1.074724370593746,7.0592296801268395
2014-10-01T09:30:00-04:00,49.5,49.5,48.3,48.42,11288135,4989804,32.393509310346104,50.06607335424891,NaN,NaN,-294.2466744209957,-103.0760366710796,-0.1661624347479321,-0.1260102468881712,0.04015218785976091,180786308,197212701.8,31.680661733113737,58.16970124888352,NaN,NaN,-6.935512656531535,5.0599807748899295
2014-10-02T09:30:00-04:00,48.31,48.43,47.63,48.3,9073452,5154625.2,31.56097210762246,49.251743167684864,NaN,NaN,-304.0298896875279,-153.75719910597093,-0.22732130645636653,-0.24399944521069727,-0.01667813875433074,171712856,190698482.8,24.26168273656741,55.19749867010891,NaN,NaN,-12.936513077946172,2.4890530816276293
2014-10-03T09:30:00-04:00,48.58,48.69,48.36,48.44,5443115,5272940.75,33.7017861812717,48.46444752195992,NaN,NaN,-195.15031692895062,-190.80698972037197,-0.24465141954196856,-0.32249241318179145,-0.07784099363982289,177155971,184327391.6,19.46145932765343,52.328440085370175,NaN,NaN,-16.621346271754387,-0.24100396885551545
2014-10-06T09:30:00-04:00,48.63,48.75,48.27,48.43,4787381,5397121.15,33.62088759331586,47.282253591216694,NaN,NaN,-159.71905540967907,-214.76871789411013,-0.24261708216194658,-0.3811123463422561,-0.13849526418030952,172368590,178819633.6,16.434287206378713,49.329099895402656,NaN,NaN,-19.416015740729645,-2.9802913648375338
2014-10-07T09:30:00-04:00,48.29,48.29,47.57,47.58,6060716,5542133.2,27.564178839335383,45.23463271918583,NaN,NaN,-183.29074319293144,-227.28733592801694,-0.28160598990906244,-0.4905027515666376,-0.20889676165757515,166307874,173666319.8,14.207512936584038,46.03804638153993,NaN,NaN,-24.166503716400044,-6.006893129346464
2014-10-08T09:30:00-04:00,47.58,48.27,47.05,48.2,10523393,5750100.6,36.543818286910195,43.42437349546794,NaN,NaN,-144.54510529732815,-197.34702210328345,-0.2498098071533223,-0.521159020599228,-0.27134921344590573,176831267,172875311.6,13.896267797729237,42.317601901419735,NaN,NaN,-24.780308169873198,-8.688809563707427
2014-10-09T09:30:00-04:00,48.2,48.22,46.87,47.02,14628192,6268374.6,29.13980548603844,41.49564150265942,NaN,NaN,-148.17749385707245,-166.17654293719235,-0.2896161372361998,-0.6333693849911555,-0.3437532477549557,162203075,170973355.4,13.150292999742206,38.27017260914801,NaN,NaN,-28.323502623244696,-11.493765715069893
2014-10-10T09:30:00-04:00,47.03,47.2,46.29,46.3,15178702,6833159.15,25.716120051276647,39.35417998218337,NaN,NaN,-163.63117772443007,-159.87271509628823,-0.34219860247913936,-0.7715015008538799,-0.42930289837474056,147024373,164947035.8,11.114426202709325,34.00098013681494,NaN,NaN,-32.503370709640365,-14.495137857151388
2014-10-13T09:30:00-04:00,46.25,46.64,45.04,45.11,16575259,7502369.75,21.26836840101457,37.29277443683784,NaN,NaN,-181.11840290930974,-164.15258459621435,-0.42924680416868677,-0.965861403585599,-0.5366145994169123,130449114,156563140.6,9.021824131090469,29.779064116240875,NaN,NaN,-37.86398323514975,-17.833544339722582
2014-10-14T09:30:00-04:00,45.41,45.9,44.95,45.25,11001255,7886555.75,22.95661619805304,34.72077218034652,NaN,NaN,-163.01336003871384,-160.09710796537084,-0.44747841800589927,-1.0959626219242864,-0.6484842039183871,141450369,151591639.6,8.053520129865518,25.734008260471274,NaN,NaN,-41.06575577269141,-21.152431687289557
2014-10-15T09:30:00-04:00,44.43,45.75,44.09,45.56,18955406,8576331.35,26.704471065235808,33.34434801589734,NaN,NaN,-151.28952128004366,-161.44599116191392,-0.4097524997732469,-1.1606748286349458,-0.7509223288616989,160405775,148306541.2,7.482062254710883,22.33980549797411,NaN,NaN,-42.16579314625128,-24.154340467141232
2014-10-16T09:30:00-04:00,44.76,46.27,44.68,46.01,20220499,9363111.35,31.884463225187773,31.831726156254,NaN,NaN,-114.41617650836677,-154.69372769217279,-0.3290627577237665,-1.162250776016407,-0.8331880182926404,180626274,151991181,14.785747544323954,19.5828622763118,NaN,NaN,-41.224601205768394,-26.592949144087967
2014-10-17T09:30:00-04:00,46.5,46.97,46.4,46.62,11148683,9616769.45,38.25472598018948,30.990483098031422,NaN,NaN,-64.61197989403581,-134.88988812609395,-0.21471318606696,-1.1015795008763405,-0.8868663148093805,191774957,160941297.8,29.37109914888694,18.20929153420849,NaN,NaN,-38.213166705721555,-28.252980224321337
2014-10-20T09:30:00-04:00,46.52,47.36,46.33,47.33,17191335,10284475,44.733413070009654,31.145938271129086,NaN,NaN,-44.19732640181229,-107.50567282459447,-0.07838953764667256,-0.9848532368677212,-0.9064636992210486,208966292,176644733.4,46.63118292896768,18.539430505594535,NaN,NaN,-33.40663842116978,-28.9892171095854
2014-10-21T09:30:00-04:00,47.61,48.42,47.6,48.35,7131807,10492792,52.45206487984866,32.57869224037927,NaN,NaN,11.28436683037322,-72.64612745077704,0.084522866862357,-0.8008101156431024,-0.8853329825054594,216098099,191574279.4,57.311968317869585,20.370238118791377,NaN,NaN,-26.435527816247667,-28.624404353394297
2014-10-22T09:30:00-04:00,48.7,48.8,47.93,47.96,9213151,10739495.9,49.59968824210123,33.86717196427061,NaN,NaN,23.69007339689322,-37.650208515389686,0.16538490043995413,-0.6786018569555168,-0.8439867573954709,206884948,200870114,62.362764037824405,23.09174392602402,NaN,NaN,-21.964381900787266,-27.672972574450437
2014-10-23T09:30:00-04:00,48.31,48.45,47.79,47.92,29946809,12001587.5,49.30354454661965,34.981583276081174,NaN,NaN,21.20984633635324,-10.52500394644567,0.2125396663734087,-0.5783121744287101,-0.7908518408021188,176938139,200132487,61.738536242310076,26.111535134213785,NaN,NaN,-18.63587017559675,-26.381957946042768
2014-10-24T09:30:00-04:00,48.01,48.33,47.57,48.28,6706803,12100553.85,52.076840272410976,36.29986561030226,NaN,NaN,29.86440271194362,8.370272574750205,0.2611380838510564,-0.4644292359882982,-0.7255673198393546,183644942,198506484,60.30554281350207,29.24519624900831,NaN,NaN,-15.025379490518265,-24.75958959525355
2014-10-27T09:30:00-04:00,47.85,47.95,47.08,47.27,35143392,13402521.1,44.69038256860619,37.52316587667874,NaN,NaN,0.3820344163154307,17.286144738375754,0.22006835885307918,-0.45048187127300565,-0.6705502301260848,148501550,186413535.6,50.85205774886108,31.862663735599533,NaN,NaN,-14.257734563628288,-23.259324590735655
2014-10-28T09:30:00-04:00,47.57,47.78,47.38,47.74,7599604,13390854.45,48.36093259400503,38.36724547004267,NaN,NaN,22.588257958866702,19.54692296407445,0.21889788430593382,-0.39692787474366753,-0.6158257590496014,156101154,174414146.6,43.55591288495156,33.98120981325827,NaN,NaN,-12.424086968397214,-21.711433501830165
2014-10-29T09:30:00-04:00,47.73,47.8,46.83,47.15,23906901,14021792.75,44.379395953646075,39.45578764630035,NaN,NaN,1.0205383339680787,15.013015951489422,0.17465120897076813,-0.3975117478361412,-0.5721629568069093,132194253,159476007.6,36.529268980569,35.65113666903161,NaN,NaN,-12.195483579047197,-20.35201208428974
2014-10-30T09:30:00-04:00,46.97,47.76,46.97,47.51,6691400,13902690.15,47.23399699472261,40.9927788565465,NaN,NaN,15.913029777844507,13.953652639787668,0.16595340453482343,-0.36472120113838,-0.5306746056732035,138885653,151865510.4,33.558904032943644,37.25431365690549,NaN,NaN,-11.101839858955515,-19.030558909241993
2014-10-31T09:30:00-04:00,47.91,48.42,47.74,48.4,8402636,14050666.2,53.577259481513515,43.30055679086785,NaN,NaN,79.06899418121186,23.794570933641317,0.21343801740891166,-0.2638770839120639,-0.47731510132097554,147288289,144594179.8,30.967910786975267,38.82189127518298,NaN,NaN,-8.046830925639856,-17.461454911584546
2014-11-03T09:30:00-05:00,48.42,48.6,47.89,48.06,20828242,14852709.25,51.052338899614995,45.3073941266937,NaN,NaN,81.01828467521825,39.92182098542188,0.2146652642357026,-0.20898352102634732,-0.4236487852620499,126460047,140185879.2,29.481789202066267,40.35248192319732,NaN,NaN,-6.379908727764678,-15.878376885324565
2014-11-04T09:30:00-05:00,47.93,48.04,47.34,47.56,13038132,15201580.05,47.506674488181595,46.79326579976125,NaN,NaN,38.59327839386673,43.12282507242189,0.17613486410121254,-0.20348020513553422,-0.37961506923674676,113421915,131650031.4,26.79992850771241,41.732329512697426,NaN,NaN,-6.111352436205191,-14.483087678307513
2014-11-05T09:30:00-05:00,47.66,48.11,47.63,48.02,6115876,14981204.2,50.886216771642765,48.15053391022233,NaN,NaN,60.30864072354018,54.98044555033631,0.1755684786097827,-0.1601544709745184,-0.3357229495843011,119537791,129118739,26.04334058403333,42.53644330124809,NaN,NaN,-4.8322272200222764,-13.104393327123908
2014-11-06T09:30:00-05:00,47.86,48.505,47.86,48.41,3826528,14441121,53.61294620662085,49.24754964068171,NaN,NaN,81.08222528340197,68.0142846514478,0.19395950033096454,-0.09327357417059545,-0.28723307450156,123364319,126014472.2,25.107232445171306,42.231881393839835,NaN,NaN,-2.931527713556834,-11.65112681090004
2014-11-07T09:30:00-05:00,48.46,48.72,48.43,48.64,5102519,13937311.85,55.19286141658065,49.99465309400821,NaN,NaN,99.28305300738236,72.0570964166819,0.21261567073260812,-0.021463486085799843,-0.23407915681840796,128466838,122250182,23.981551418650398,40.614050571674305,NaN,NaN,-0.9012633394773472,-10.115432029268227
2014-11-10T09:30:00-05:00,48.62,48.8,48.5,48.77,3642964,13290697.1,56.10292712789795,50.25542896886888,NaN,NaN,102.8121119765186,76.41586187694196,0.22359368340696442,0.04541294744029756,-0.17818073596666686,132109802,123380133,25.067595291929848,38.31088106982147,NaN,NaN,1.0250425886505086,-8.523935655279836
2014-11-11T09:30:00-05:00,48.75,49.045,48.69,49.01,3610219,12921145.3,57.806737363669875,50.84164676326663,NaN,NaN,119.61518411449396,92.62024302106741,0.2356940177909027,0.11643678627196152,-0.11925723151894119,135720021,127839754.2,29.357219024381862,35.95334214028986,NaN,NaN,3.1289346370839555,-6.859239899227866
2014-11-12T09:30:00-05:00,48.97,49.25,48.9,49.13,3854020,12166076,58.670511857234736,51.510715856881994,NaN,NaN,135.8186655005259,107.72224797646454,0.23966816815550737,0.18032797867544303,-0.05934018948006434,139574041,131847004.2,33.06517695824165,33.90524504857069,NaN,NaN,5.123457294488979,-5.147426014411174
2014-11-13T09:30:00-05:00,49.18,49.53,48.87,49.14,4119254,11361013.75,58.74630389242865,51.987106115454694,NaN,NaN,146.5937513247682,120.82455318473781,0.23077445702299149,0.22912788179867505,-0.0016465752243164516,143693295,135912799.4,36.69581676694712,32.21883604524534,NaN,NaN,6.802728751915628,-3.4402610477930597
2014-11-14T09:30:00-05:00,49.2,49.39,49.08,49.29,3168742,10962016.7,59.93323035872957,53.075880957606365,NaN,NaN,145.6658917303183,130.101120929325,0.2226901338957612,0.27671609214538506,0.05402595824962385,146862037,139591839.2,39.87391726530655,31.434683153562872,NaN,NaN,8.552652151227832,-1.7269877336472181
2014-11-17T09:30:00-05:00,49.25,49.335,49.1,49.28,2627052,10233802.55,59.809685155132534,53.8936489976869,NaN,NaN,127.09176180258147,134.95705089453756,0.20481853099527214,0.31004912199371404,0.10523059099844188,144234985,142016875.8,41.94291004491109,31.319468664988555,NaN,NaN,10.003876794048324,-0.05114994397642647
2014-11-18T09:30:00-05:00,49.29,49.91,49.29,49.87,5018118,10128118.1,64.4640727846219,55.328268771328005,NaN,NaN,152.2268812329961,141.479390318238,0.21957308512742488,0.379696947407723,0.1601238622802981,149253103,144723492.2,44.24882448330002,31.870865486612196,NaN,NaN,12.603872400392218,1.7567103909333799
2014-11-19T09:30:00-05:00,49.83,49.96,49.625,49.8,4840909,9909506,63.524110463023646,56.49184830477808,NaN,NaN,137.8269617706203,141.88104957225687,0.21138351470984504,0.4243532556676044,0.21296974095775936,144412194,145691122.8,45.08851392162039,32.69440905008911,NaN,NaN,14.565656298857565,3.5865598063511204
2014-11-20T09:30:00-05:00,49.55,50.06,49.4,50.06,3858498,8605090.45,65.53431220873095,57.345923499579335,NaN,NaN,123.63410274345,137.28911985599322,0.20982036561129075,0.4752451979718728,0.26542483236058206,148270692,146606602.2,45.91843647397211,33.76230374201746,NaN,NaN,16.822097311342983,5.477350878492815
2014-11-21T09:30:00-05:00,50.7,51.01,50.48,50.67,9559167,8747708.65,69.74686460237284,58.68124676406204,NaN,NaN,173.9909059111552,142.9541226921606,0.2343504311597695,0.5583628713102939,0.32401244015052444,157829859,148800166.6,47.948430206188696,35.0813495280262,NaN,NaN,20.111286342774896,7.5679130876759695
2014-11-24T09:30:00-05:00,50.75,50.75,50.36,50.44,2141861,7097632.1,66.4490240290383,60.03427173126608,NaN,NaN,138.99243652079744,145.3342576358038,0.21980834192570542,0.5987728675576562,0.3789645256319508,155687998,151090769.2,50.056609407575515,36.74254102087357,NaN,NaN,22.0190836413107,9.632366023909503
2014-11-25T09:30:00-05:00,50.45,50.6,50.22,50.26,2406421,6837972.95,63.90247524171617,60.96400447912846,NaN,NaN,114.11568037445412,137.7120174640954,0.1842287988916662,0.6092505242465336,0.4250217253548674,153281577,151896464,50.81125823403651,38.5116779958738,NaN,NaN,22.948843196300174,11.534719905679598
2014-11-26T09:30:00-05:00,50.11,50.33,49.915,50.3,1881019,5736678.85,64.23053129320382,61.722403413884386,NaN,NaN,92.10954134021215,128.56853337801377,0.15094851715881497,0.6137073718033861,0.4627588546445711,155162596,154046544.4,52.858364315445115,40.49390170089335,NaN,NaN,23.812340432375155,13.288665695207534
2014-11-28T09:30:00-05:00,49.81,49.86,49.05,49.16,4867728,5645495.25,50.221960329522155,61.36733905052307,NaN,NaN,16.39242229742565,107.1201972888089,0.04520508971775,0.5192652167917586,0.47406012707400863,150294868,154451379.6,53.25285610335285,42.5847091783721,NaN,NaN,20.29817240639929,14.290023796806356
2014-12-01T09:30:00-05:00,49.01,49.23,48.39,48.65,12012309,5825978.9,45.44662409082286,60.60617454787485,NaN,NaN,-44.04197560877075,63.51362098482373,-0.060311491747993384,0.3986707623890169,0.45898225413701027,138282559,150541919.6,48.98942858552606,44.29341155648611,NaN,NaN,15.716062700857814,14.493743640242279
2014-12-02T09:30:00-05:00,48.65,49.05,48.54,48.94,5930479,5081090.75,48.44831301417443,59.93771566576804,NaN,NaN,-40.760071974581535,27.563119285747938,-0.10896294384925043,0.3227785743254472,0.43174151817469764,144213038,148246927.6,46.629360544318914,45.52713595076733,NaN,NaN,12.84239291806005,14.257836394216246
2014-12-03T09:30:00-05:00,49.05,49.73,48.925,49.66,7347152,4796541.75,55.0597878823634,59.67980681042008,NaN,NaN,11.978299908796219,7.135643192616348,-0.0917321009820406,0.3170763919471469,0.4088084929291875,151560190,147902650.2,46.26925757461985,46.47028456622292,NaN,NaN,12.43780699914952,13.997832194921
2014-12-04T09:30:00-05:00,49.53,49.93,49.49,49.81,5854027,4783449.3,56.3167265614146,59.50626557249051,NaN,NaN,38.96499238964718,-3.4932665974966475,-0.07027777359889859,0.3209612759305642,0.3912390495294628,157414217,148352974.4,46.84747687424176,47.19540314531539,NaN,NaN,12.50592437555441,13.784702506440057
2014-12-05T09:30:00-05:00,49.8,50.105,49.675,49.77,3361077,4760176.75,55.867985920953465,59.21589096979221,NaN,NaN,44.75246460901697,2.1787418648216246,-0.05926609810027439,0.3171564269041198,0.3764225250043942,154053140,149104628.8,47.85614997016222,47.76556262423365,NaN,NaN,12.427643337331444,13.590836910853113
2014-12-08T09:30:00-05:00,49.71,49.72,48.905,48.98,5501851,4780143.35,47.77178539551273,58.356040986962235,NaN,NaN,-45.11892204566674,1.9633525774424256,-0.10310509315803013,0.24754115855685654,0.35064625171488667,148551289,151158374.8,50.61383742642503,48.384914580056076,NaN,NaN,9.767656780679253,13.044668320828276
2014-12-09T09:30:00-05:00,48.72,49.14,48.52,49.11,6023388,4899164.55,49.07949668563059,57.25714269417714,NaN,NaN,-86.44250495497462,-7.173134018636192,-0.12007806524944314,0.20054867015308275,0.3206267354025259,154574677,153230702.6,53.29779555408205,49.03126965654051,NaN,NaN,8.01492470147561,12.326133518063608
2014-12-10T09:30:00-05:00,48.91,48.96,47.98,48.1,7580578,5097682.5,40.57857217310858,55.61817567346891,NaN,NaN,-154.4555762787417,-40.459909256143774,-0.19180063793551094,0.08087593798313719,0.27267657591864813,146994099,152317484.4,51.95774393388472,49.52192894313082,NaN,NaN,3.50195588702407,11.065536713629388
2014-12-11T09:30:00-05:00,48.25,48.66,48.04,48.14,3921756,5101069.3,41.014320717869744,53.86674770983598,NaN,NaN,-147.21679311777876,-77.69626635762896,-0.22663368436245976,-0.010615529534426571,0.2160181548280332,150915855,151017812,50.02983988228296,49.815600615153016,NaN,NaN,0.11229962868655147,9.500788558637554
2014-12-12T09:30:00-05:00,47.65,47.92,46.77,46.8,8668860,5328549.6,32.433697776321466,51.20152150797516,NaN,NaN,-230.8843359867776,-132.82362647678787,-0.32407091660493714,-0.1890704909281382,0.1350004256767989,142246995,148656583,46.64361186178482,49.722399304838454,NaN,NaN,-6.226489099256698,7.254034607509803
2014-12-15T09:30:00-05:00,46.97,47.11,46.36,46.55,8994964,5619860.7,31.12536667601026,48.678403125616015,NaN,NaN,-220.2577795852572,-167.85139798470595,-0.3853395422174163,-0.34667400209497146,0.038665540122444816,133252031,145596731.4,42.61804072786827,49.19107297057366,NaN,NaN,-11.646246950777506,4.55399438489733
2014-12-16T09:30:00-05:00,46.38,47.34,46.175,46.19,9522036,5964609.9,29.2929212111962,46.206292123436015,NaN,NaN,-181.50631993246165,-186.86416098020337,-0.42686825955740937,-0.49491978432431694,-0.06805152476690754,123729995,139427795,35.892415921046194,48.12544137678863,NaN,NaN,-16.656572655748857,1.5239133790907324
2014-12-17T09:30:00-05:00,46.36,47.58,46.36,47.45,10608031,6244105.55,42.133788557040866,44.62795335656723,NaN,NaN,-121.5044868697306,-180.27394309840116,-0.34948984633714436,-0.504913832688338,-0.15542398635119364,134338026,136896580.4,33.55266546636895,46.74646288756891,NaN,NaN,-16.598674541678747,-1.0650277524477647
2014-12-18T09:30:00-05:00,48.19,48.56,47.76,48.53,7015149,6352817.55,50.44160006139091,44.64364190884357,NaN,NaN,-41.14657851892114,-159.05990017862962,-0.21232967301126124,-0.4208360776152702,-0.20850640460400896,141353175,134984044.4,31.862563533839108,45.21858484688936,NaN,NaN,-13.401308840288772,-2.827353622139337
2014-12-19T09:30:00-05:00,48.65,48.99,48.44,48.82,5386255,6429205.4,52.41707552969961,45.141531297334765,NaN,NaN,-7.135122813017166,-114.31005754387755,-0.09482162568979777,-0.3270334367162562,-0.2322118110264584,146739430,135882531.4,33.55584637582193,44.11618611762477,NaN,NaN,-10.243369226280421,-3.88678442273092
2014-12-22T09:30:00-05:00,48.97,48.97,48.57,48.85,3306661,6116580.1,52.62744808655514,45.44004094536195,NaN,NaN,2.8930510416851,-69.67989141848908,-0.012167591163587205,-0.24742129998094242,-0.23525370881735522,150046091,139241343.4,39.598782353403365,43.6140019611308,NaN,NaN,-7.764216465023549,-4.440703285915581
2014-12-23T09:30:00-05:00,49.05,49.37,48.945,49.23,7095634,6364268.75,55.32195405878777,45.45876710082083,NaN,NaN,38.93229037413392,-25.59216935716998,0.06667167704550397,-0.15191411251047526,-0.21858578955597924,157141725,145923689.4,49.44905865828646,43.84113060996413,NaN,NaN,-4.8624718211535995,-4.500955933806726
2014-12-24T09:30:00-05:00,49.05,49.24,48.979,49.06,1878830,6337889.2,53.8463870158932,45.28231427614073,NaN,NaN,38.980928745499504,6.504913765876047,0.10373536557810784,-0.08891658258334445,-0.19265194816145229,155262895,150108663.2,54.45818017872709,44.384752274570225,NaN,NaN,-2.9680372444417182,-4.281967549611725
2014-12-26T09:30:00-05:00,49.36,49.39,49.16,49.23,1296969,6308686.7,55.1350902452272,45.229964585017434,NaN,NaN,59.24997032476655,26.584223534613574,0.13413356211557723,-0.024984995516980746,-0.15911855763255797,156559864,153150001,57.73582098067868,45.090443061035685,NaN,NaN,-1.0342112821683835,-3.8180023685483904
2014-12-29T09:30:00-05:00,49.11,49.3699,49.11,49.23,2173227,6173961.65,55.1350902452272,45.75591493142561,NaN,NaN,58.05218063454498,39.621684224126014,0.1476057133399065,0.025388584042325135,-0.12221712929758136,156559864,155114087.8,59.750439490129715,45.74305749415745,NaN,NaN,0.534686186911341,-3.1961897177684286
2014-12-30T09:30:00-05:00,49.12,49.28,49.04,49.06,2167575,5681724.95,53.40565685168796,46.06492637185828,NaN,NaN,45.9788635548264,48.238846726754275,0.13857728871782896,0.05100448159970483,-0.08757280711812412,154392289,155983327.4,60.64454511842635,46.26782532018204,NaN,NaN,1.3965278223006834,-2.54008721204427
2014-12-31T09:30:00-05:00,49.17,49.17,48.57,48.58,2984435,5534422.75,48.75541434407217,46.648986526927104,NaN,NaN,15.804706974583835,43.61333004684426,0.09581990254550521,0.03220207106375739,-0.06361783148174782,151407854,154836553.2,58.78910215986543,46.75577947918066,NaN,NaN,0.8663580600321874,-2.0534521731762045
2015-01-02T09:30:00-05:00,48.58,48.87,48.355,48.65,5234797,5428805,49.446734220037314,47.25130177708193,NaN,NaN,6.721833674104725,37.1615110325653,0.0690445917078745,0.022687908153095293,-0.0463566835547792,156642651,155112504.4,59.113275459584756,47.40459630613079,NaN,NaN,0.6110971320405054,-1.6728022724309604
2015-01-05T09:30:00-05:00,48.28,48.42,47.2035,47.41,5438843,5408045.8,39.325867651878674,47.74359962533601,NaN,NaN,-68.80061203272899,11.551394561066195,-0.03006836408792786,-0.08394213866468903,-0.053873774576761166,151203808,154041293.2,57.231248305728755,48.160856052126796,NaN,NaN,-2.82565434769862,-1.837495426040626
2015-01-06T09:30:00-05:00,47.55,47.7,46.74,46.99,5054469,5492715.4,36.593750620059495,48.13419847848238,NaN,NaN,-102.83863044171603,-20.626767654186004,-0.1169264731968014,-0.2000318660727629,-0.08310539287596151,146149339,151959188.2,53.65549713359299,48.94924579539285,NaN,NaN,-6.581719322185798,-2.515241696918508
2015-01-07T09:30:00-05:00,47.34,47.66,47.16,47.52,3560313,5395638.5,42.0636965122413,49.04639671427132,NaN,NaN,-66.73566695099683,-43.16967375535065,-0.13065695650144227,-0.24642658850276433,-0.11576963200132206,149709652,151022660.8,52.079330928419715,50.10545401020523,NaN,NaN,-8.079175772972597,-3.310089422069092
2015-01-08T09:30:00-05:00,48,48.78,47.88,48.65,7640540,5476496.1,51.64233063457422,49.72557829123799,NaN,NaN,20.808251318893973,-42.16896488648863,-0.05924429412249496,-0.18982499965444077,-0.1305807055319458,157350192,152211128.4,53.92888917978264,51.56089856116335,NaN,NaN,-6.161178364343856,-3.7173878423940585
2015-01-09T09:30:00-05:00,48.87,48.978,48.18,48.4,6850771,5440005.75,49.68517277934429,49.6715477710918,NaN,NaN,27.09150069228742,-38.09503148285209,-0.026142473629830992,-0.16325879756923456,-0.13711632393940357,150499421,150982482.4,51.707018660621216,52.978359641647785,NaN,NaN,-5.27702865956422,-3.940193673418367
2015-01-12T09:30:00-05:00,48.17,48.49,47.75,48.29,4658117,5476823.8,48.80866790382896,49.4138043692439,NaN,NaN,-2.3041267034252226,-24.795734416991333,-0.009794341835582865,-0.14935925123388216,-0.1395649093982993,145841304,149909981.6,49.77905238120849,54.13716007060397,NaN,NaN,-4.845413568749377,-4.069510801322797
2015-01-13T09:30:00-05:00,48.56,48.7,47.37,47.75,5855035,5336132.55,44.644912003738554,48.84362322047129,NaN,NaN,-28.036781464034842,-9.835364621455096,-0.03222336578263846,-0.17984411662659738,-0.14762075084395893,139986269,148677367.6,47.58312945947365,54.70747057818041,NaN,NaN,-5.776244955409819,-4.313329966192371
2015-01-14T09:30:00-05:00,46.91,47.255,46.44,47.19,6784255,5225597.1,40.76146778921218,47.803588486930174,NaN,NaN,-123.19275665844985,-21.126782562945703,-0.07898430292010264,-0.24635112949408722,-0.16736682657398458,133202014,145375840,42.21185412360871,54.19052739713201,NaN,NaN,-7.803761573923176,-4.811963053011057
2015-01-15T09:30:00-05:00,47.4,47.83,47.1,47.1,5855375,5042264.05,40.15690076816832,46.825768040664116,NaN,NaN,-96.82690427878602,-44.6538136824817,-0.10837040306675844,-0.3028298304074326,-0.19445942734067417,127346639,139375129.4,34.5729179301606,52.7701515222344,NaN,NaN,-9.611035592979396,-5.497544844435105
2015-01-16T09:30:00-05:00,47.17,47.925,47.03,47.85,5460192,4784872.1,47.186677985407684,46.25802430781987,NaN,NaN,-75.95136050890954,-65.2623859227211,-0.07147198838968119,-0.28379941282777565,-0.21232742443809446,132806831,135836611.4,31.009280192550975,50.86111289451099,NaN,NaN,-9.019037992019657,-6.000615294090041
2015-01-20T09:30:00-05:00,48.18,48.24,47.47,47.93,4061644,4637196.85,47.889852615038805,45.74050733423498,NaN,NaN,-42.8223485782574,-73.36603029768753,-0.03755693547364497,-0.2592735937801507,-0.22171665830650572,136868475,134042045.6,29.356610416986996,48.690125103572214,NaN,NaN,-8.333981144820662,-6.333953272765844
2015-01-21T09:30:00-05:00,47.83,48.45,47.71,48.4,4711580,4603463.1,51.938496808072436,45.63571018826245,NaN,NaN,-8.790739291300635,-69.51682186314068,0.01768480971388775,-0.19961064616414603,-0.21729545587803378,141580055,134360802.8,30.069539103111666,46.50619610247832,NaN,NaN,-6.521569886785785,-6.360755646197264
2015-01-22T09:30:00-05:00,48.64,49.09,48.31,49.01,5778313,4727045.7,56.6464157694855,46.19935314722055,NaN,NaN,55.93199871893675,-33.69187078766337,0.09229201456098207,-0.10193043767680621,-0.19422245223778828,147358368,137192073.6,36.22591186733096,44.89453965301157,NaN,NaN,-3.4704737483049533,-5.947858232212648
2015-01-23T09:30:00-05:00,48.91,48.91,48.215,48.25,5036670,4624097.5,50.066138872150844,46.24359633665722,NaN,NaN,24.922659510698153,-9.34195802976653,0.08748552979060933,-0.08486553999952662,-0.17235106979013595,142321698,140187085.4,42.03886972822349,43.67493924362862,NaN,NaN,-2.8847531682285323,-5.510271794500632
2015-01-26T09:30:00-05:00,48.22,48.515,48.01,48.46,3101057,4685208.85,51.7345329230208,47.12992957031023,NaN,NaN,15.707684347623879,8.989850941540158,0.09485978342508236,-0.053776340508782994,-0.14863612393386536,145422755,142710270.2,46.46595777635205,42.90598992010172,NaN,NaN,-1.89460662974946,-4.993748199536179
2015-01-27T09:30:00-05:00,47.79,48.475,47.58,48.13,4516406,4846180.7,48.96583257509705,48.013649709955764,NaN,NaN,-9.629262437691315,15.62846816965337,0.07480437425457731,-0.05513065611564372,-0.12993503037022103,140906349,143517845,47.83919011366084,42.490539418678,NaN,NaN,-1.9078607867035995,-4.552907140560096
2015-01-28T09:30:00-05:00,48.2,48.29,47.18,47.26,5778455,5026442.1,42.50710525769028,48.04532176320212,NaN,NaN,-64.73633492732851,4.439349042447792,0.003975888765655633,-0.1249651694131515,-0.12894105817880713,135127894,142227412.8,45.81675129484133,42.043212301993826,NaN,NaN,-4.002379635503604,-4.474260354123454
2015-01-29T09:30:00-05:00,47.32,47.96,47.01,47.88,5958365,5215981.6,47.79212863522772,47.77030733467736,NaN,NaN,-52.452092674280046,-17.23746923619557,0.00011602615973366204,-0.12879602547914004,-0.1289120516388737,141086259,140972991,43.87496495666177,41.3250748574852,NaN,NaN,-4.069720779178031,-4.416468986274108
2015-01-30T09:30:00-05:00,47.48,48.26,47.35,47.69,7808673,5457193.5,46.38492738333149,47.534575520676455,NaN,NaN,-25.169016931032356,-27.255804524541666,-0.013259432784420655,-0.14548634261939952,-0.13222690983497887,133277586,139164168.6,41.165710577489946,40.57212428011868,NaN,NaN,-4.561582748577186,-4.437199523745976
2015-02-02T09:30:00-05:00,47.74,48.25,47.415,48.12,6625456,5526726.45,49.97487073936146,47.61787572321448,NaN,NaN,6.073256796378881,-29.18269003479067,0.007699252990484767,-0.1226028435968729,-0.13030209658735767,139903042,138060226,39.56015183515898,39.84220281254371,NaN,NaN,-3.8670621183464355,-4.355751322974613
2015-02-03T09:30:00-05:00,48.45,49.21,48.375,49.18,6126111,5561089.85,57.52502644017386,48.53788389724558,NaN,NaN,149.93363652459513,2.729889757666618,0.08926680662163491,-0.018718588310314033,-0.10798539493194895,146029153,139084786.8,41.82783178895229,39.43111012179219,NaN,NaN,-0.7163196436965361,-3.8358325116491736
2015-02-04T09:30:00-05:00,48.88,49.225,48.75,48.86,5683608,5592546.8,54.83442258925804,49.54309495439171,NaN,NaN,136.74161855565447,43.02548045426322,0.11627508531336536,0.03735846170975776,-0.0789166236036076,140345545,140128317,44.127211591026665,39.5679213694649,NaN,NaN,0.9709466125917211,-3.1491497796147603
2015-02-05T09:30:00-05:00,49.02,50.09,49.02,50.04,5864473,5707754.8,61.90943298657881,51.09684725570675,NaN,NaN,211.65444172778916,95.84678733467706,0.20313233015081963,0.17499878908491695,-0.028133541065902684,146210018,141153068.8,46.36907475656795,40.41050399992257,NaN,NaN,4.947707530302292,-1.9924558781980386
2015-02-06T09:30:00-05:00,50.06,50.14,49.78,49.92,5610138,5606234.7,60.86525889900468,52.0738887495351,NaN,NaN,197.96795894305964,140.47418250949545,0.23952260456926877,0.2712697146456833,0.031747110076414516,140599880,142617527.6,49.48828075758024,41.73043261171038,NaN,NaN,7.705262511041521,-0.6070675368781016
2015-02-09T09:30:00-05:00,49.65,50.15,49.65,49.86,3705561,5448974.2,60.31746917171595,52.961575646440615,NaN,NaN,160.32517034338332,171.32456521889634,0.24565666068248956,0.33881793592952647,0.0931612752470369,136894319,142015783,48.24658534476556,43.079716535123126,NaN,NaN,9.722351660528549,0.8685637770371342
2015-02-10T09:30:00-05:00,50.18,50.28,49.71,50.23,3245460,5378341.35,62.55550748011457,53.71993355158647,NaN,NaN,147.530402382313,170.8439183904399,0.25938684218550995,0.41739482797892435,0.1580079857934144,140139779,140837908.2,45.8229495239103,44.20496013660874,NaN,NaN,12.091698136058719,2.471868685468789
2015-02-11T09:30:00-05:00,50.1,50.33,49.8639,50.15,3223932,5246786.2,61.744657545035544,54.08409367841148,NaN,NaN,128.27630914818775,169.15085650894656,0.24784922531916043,0.46781951744236494,0.2199702921232045,136915847,140151968.6,44.423413328052725,44.79049595523172,NaN,NaN,13.78976843619012,4.088711507000408
2015-02-12T09:30:00-05:00,50.45,51.16,50.45,51.01,4900597,5152603.3,66.73625170537224,55.27481602364158,NaN,NaN,161.45258273321792,159.11048471003232,0.2805027683639958,0.5705987525781993,0.29009598421420346,141816444,139273253.8,42.62729232792773,44.83252614092488,NaN,NaN,16.870100579855567,5.914624231694002
2015-02-13T09:30:00-05:00,51.15,51.53,51.05,51.44,2901355,5004902.3,68.91990741475189,56.50234277305095,NaN,NaN,167.50133377886976,153.01715967719434,0.31106180364171293,0.6789232387663446,0.3678614351246317,144717799,140096837.6,44.8768753751205,44.71902025512262,NaN,NaN,20.144130324309902,7.947410816353416
2015-02-17T09:30:00-05:00,51.21,51.7,51.12,51.5,3271206,4895453,69.22350590226841,57.949319439277474,NaN,NaN,146.96539010627467,150.34520362977264,0.31438457851832535,0.7608421582725384,0.4464575797542131,147989005,142315774.8,50.5075162892921,44.909614981953425,NaN,NaN,22.88060789184508,10.080724684280796
2015-02-18T09:30:00-05:00,51.35,51.64,51.14,51.64,2974246,4841083.1,69.96084370263584,59.91030075677359,NaN,NaN,128.58399016293143,146.55592118589632,0.3048508747374258,0.8275211731759953,0.5226702984385695,150963251,144480469.2,55.30405939302443,45.58727984610936,NaN,NaN,25.364371061917566,12.264102738228905
2015-02-19T09:30:00-05:00,51.51,51.895,51.28,51.78,3005719,4755790.05,70.71638248589144,61.54774746039243,NaN,NaN,121.97162314556601,145.29498398537197,0.2870639349027557,0.8815002170670141,0.5944362821642584,153968970,147891093.8,61.61598052461428,46.854495243820246,NaN,NaN,27.660061471094284,14.46352541435253
2015-02-20T09:30:00-05:00,51.68,52.01,51.27,51.93,3572946,4645521.7,71.54226314883087,63.34470001507095,NaN,NaN,112.25528254416449,135.4555239475613,0.26502034724246193,0.9257117162173358,0.6606913689748739,157541916,151036188.2,66.3369519129889,48.65244105349875,NaN,NaN,29.832543402780193,16.659099412699337
2015-02-23T09:30:00-05:00,51.76,51.97,51.53,51.87,2765060,4531941.2,70.68353537371317,64.82389034609608,NaN,NaN,104.35080293121669,122.82541777803067,0.2274585920993102,0.9450146090990117,0.7175560169997015,154776856,153047999.6,68.9663259739414,50.752882063411775,NaN,NaN,31.44649761060409,18.771584869542874
2015-02-24T09:30:00-05:00,52.01,52.16,51.8,52.09,2306822,4492229.45,72.0101638222293,65.8585430162429,NaN,NaN,105.69570927401712,114.57148161157916,0.19948992121464337,0.9669184185180058,0.7674284973033624,157083678,154866934.2,71.15970242669395,52.84801568039332,NaN,NaN,33.201076059868385,20.83294075387509
2015-02-25T09:30:00-05:00,52.06,52.22,51.85,51.94,1957615,4364289.9,69.6944279175798,66.91997196826587,NaN,NaN,95.09316200138551,107.87331597926996,0.1549329601424243,0.9610946974813928,0.8061617373389685,155126063,155699496.6,72.1306401364359,54.848260576493985,NaN,NaN,34.12967060375138,22.7324735895717
2015-02-26T09:30:00-05:00,51.93,52.04,51.46,51.61,2728013,4211767.8,64.76028899897356,67.12360454057979,NaN,NaN,72.00275388116238,97.87954212638924,0.0904742266324714,0.9192545206295577,0.8287802939970863,152398050,155385312.6,71.1570823854901,56.618832549988426,NaN,NaN,33.6643465887127,24.294169732306127
2015-02-27T09:30:00-05:00,51.55,51.76,51.47,51.49,3360629,4081881,63.01327119736736,67.27703399046284,NaN,NaN,59.0655761725308,87.2416008520625,0.030115981381708012,0.8664252707242213,0.8363092893425133,149037421,153684413.6,65.96618498261296,57.79582570891933,NaN,NaN,32.809727300616316,25.510677956350438
2015-03-02T09:30:00-05:00,51.51,51.845,51.27,51.83,3282289,3855561.8,65.8262325552866,67.67051708928932,NaN,NaN,58.39214711569941,78.04986968895905,0.004779406628184768,0.8422835476277442,0.8375041409995594,152319710,153192984.4,64.50210330826135,58.956934134883326,NaN,NaN,32.773842132865944,26.548272838709796
2015-03-03T09:30:00-05:00,51.64,51.815,51.38,51.55,3208255,3684701.75,61.66680926826672,67.6070386455859,NaN,NaN,49.44623997957678,66.79997583007098,-0.03685592322632636,0.7914342369666514,0.8282901601929777,149111455,151598539.8,59.8600098508011,59.959581301089806,NaN,NaN,31.612846057265813,27.27178329850351
2015-03-04T09:30:00-05:00,51.26,51.49,51.015,51.37,3293144,3543053.4,59.08222829576323,67.41686512778072,NaN,NaN,21.68908079736517,52.11915958926691,-0.08005863574269356,0.7282168655146108,0.8082755012573044,145818311,149736989.4,54.89287417936837,60.70739993332664,NaN,NaN,29.910282586246247,27.648711768181045
2015-03-05T09:30:00-05:00,51.5,51.5,50.97,51.15,1937438,3355744.9,55.99328813281035,66.64951058688345,NaN,NaN,5.628739203627515,38.84435665375994,-0.12434923249470997,0.6528389606389169,0.7771881931336269,143880873,148033554,50.7434769463616,61.28712740607192,NaN,NaN,27.58296725162027,27.63931969438665
2015-03-06T09:30:00-05:00,50.92,50.93,50.36,50.46,4394986,3282270.55,47.589503793521686,65.12591032822415,NaN,NaN,-71.71200703950393,12.688840011352989,-0.1967107926815187,0.5312997022817285,0.7280104949632472,139485887,146123247.2,46.49854670121098,61.40296107222124,NaN,NaN,22.84529794210787,26.95445944406111
2015-03-09T09:30:00-04:00,50.5,50.6851,50.42,50.53,2523686,3127947.95,48.4350304913687,63.641019227445604,NaN,NaN,-85.68055568649909,-16.12570054908671,-0.2339236081790692,0.4356059847394107,0.6695295929184799,142009573,144061219.8,42.377550795800566,60.82224925125756,NaN,NaN,19.183477427939042,25.844319156043674
2015-03-10T09:30:00-04:00,50.13,50.13,49.69,49.76,5152614,3200300.6,40.66373100331414,61.548368320351194,NaN,NaN,-171.06391064976117,-60.227730674954294,-0.3002287925560043,0.29424360222347445,0.5944723947794788,136856959,141610320.6,38.05991219951933,59.59052445172148,NaN,NaN,13.250276507598471,24.045170206265787
2015-03-11T09:30:00-04:00,49.85,49.9399,49.62,49.7,2535234,3164789.3,40.12350173969854,59.363162552765985,NaN,NaN,-175.56399805507323,-99.67834644544197,-0.3352978593457172,0.17535007059733232,0.5106479299430495,134321725,139311003.4,34.50780628389434,57.65422629167006,NaN,NaN,8.305594007951482,21.796659320792315
2015-03-12T09:30:00-04:00,49.75,50.355,49.75,50.32,3100598,3158622.6,47.83556390088268,57.669826892198266,NaN,NaN,-129.30930204427617,-126.66595469502272,-0.30479013130467525,0.12966026581220547,0.4344503971168807,137422323,138019293.4,32.66350556757112,55.24898012414021,NaN,NaN,6.240936200072479,19.57441316068948
2015-03-13T09:30:00-04:00,50.1,50.14,49.52,49.84,4192217,3123203.6,43.19682251370664,55.70649025934066,NaN,NaN,-141.70141487580145,-140.66383626228222,-0.30428415605036674,0.054095202053922264,0.358379358104289,133230106,136768137.2,30.938671810914002,52.5327191124954,NaN,NaN,2.965217156559142,17.201670874385147
2015-03-16T09:30:00-04:00,50.06,50.06,49.541,49.76,4012642,3178767.95,42.45782924567167,53.59560921815797,NaN,NaN,-122.13263741907916,-147.9542526087982,-0.2963886316021063,-0.012106431398343886,0.28428220020376244,129217464,134209715.4,27.71570603044404,49.42957651276327,NaN,NaN,0.11720250817686688,14.761032536355394
2015-03-17T09:30:00-04:00,49.41,49.53,49,49.21,7882985,3409356.9,37.68462260297056,51.309194552828735,NaN,NaN,-143.35685648660166,-142.41284177616632,-0.3135941496663693,-0.10771048687919915,0.20588366278717013,121334479,131105219.4,24.39481113931427,46.019874441540296,NaN,NaN,-3.918710693135931,12.092497789285204
2015-03-18T09:30:00-04:00,48.97,50.26,48.71,49.96,6489176,3585103.4,46.5147983083617,50.00594521778503,NaN,NaN,-96.69748458289708,-126.6395390817311,-0.26195286573815013,-0.12155741938551756,0.14039544635263257,127823655,129805605.4,23.144590552987722,42.59041073921869,NaN,NaN,-4.554741538213242,9.714320742499712
2015-03-19T09:30:00-04:00,49.71,49.78,49.05,49.1,3956799,3632657.4,39.587633395983346,48.33268537482903,NaN,NaN,-108.52881119577833,-122.48344091203153,-0.2720162567197389,-0.19962487454704103,0.07239138217269785,123866856,127094512,20.75498414839325,39.36103925106014,NaN,NaN,-7.57902645966642,7.243842570761693
2015-03-20T09:30:00-04:00,49.04,49.545,48.88,49.23,4767513,3692385.75,41.017569506707396,46.56063801421623,NaN,NaN,-104.11112395512562,-114.96538272789635,-0.2564279356805921,-0.2481435374280423,0.008284398252549813,128634369,126175364.6,20.00101383175307,36.182390002738124,NaN,NaN,-9.439271405831658,4.8605405741054994
2015-03-23T09:30:00-04:00,49.17,49.43,49.101,49.23,3370629,3722664.2,41.017569506707396,45.085692316962,NaN,NaN,-92.51902063519724,-109.04265937111995,-0.233290629211286,-0.28332888826155767,-0.05003825905027168,128634369,126058745.6,19.90222625445388,33.32826260299904,NaN,NaN,-10.885828239302437,2.611059315047223
2015-03-24T09:30:00-04:00,49.13,49.3,48.9,49.07,2230064,3718826.3,39.67704098790216,43.69960750925764,NaN,NaN,-95.80221284533616,-99.53173064286686,-0.2163137704372247,-0.32043047209680253,-0.10411670165957784,126404305,127072710.8,23.442808894322482,31.081829368352903,NaN,NaN,-12.470846246115961,0.456501377738197
2015-03-25T09:30:00-04:00,49.16,49.35,48.52,48.52,3682123,3805051.7,35.39478342956659,42.22828574474022,NaN,NaN,-110.24597069668933,-102.2414278656253,-0.22848398197098735,-0.389721679123312,-0.16123769715232467,122722182,126052416.2,22.371212991591392,29.055239085869314,NaN,NaN,-15.199652140443648,-1.7800919820020664
2015-03-26T09:30:00-04:00,48.45,48.81,48.39,48.63,4072368,3872269.45,36.86247810811631,41.46206962435412,NaN,NaN,-117.22336971356306,-103.98033956918225,-0.21564461057005704,-0.43079346036489596,-0.21514884979483892,126794550,126637955,24.504060303628748,27.48420434318487,NaN,NaN,-16.978323664149713,-3.9512679365945873
2015-03-27T09:30:00-04:00,48.74,48.9,48.54,48.61,3684551,3888465.55,36.69923040336663,40.62379818949683,NaN,NaN,-106.13047969667198,-104.38421071749153,-0.19560757677507834,-0.45965832076368685,-0.2640507439886085,123109999,125533081,23.20830739396669,26.114972671625306,NaN,NaN,-18.468057553781854,-6.025095024764196
2015-03-30T09:30:00-04:00,48.91,49.43,48.91,49.27,2795103,3864106.25,45.30703924152447,40.955463063654705,NaN,NaN,-56.787112529824,-97.23782909641687,-0.12826772142373966,-0.42438539576828305,-0.2961176743445434,125905102,124987227.6,22.573231220155677,25.008781173099333,NaN,NaN,-17.220831513974755,-7.624485951794276
2015-03-31T09:30:00-04:00,49.04,49.15,48.78,48.78,3464016,3876894.3,40.864173672071125,41.00836820168133,NaN,NaN,-80.46852629247616,-94.17109178584488,-0.10790740572746255,-0.43100193150387156,-0.323094525776409,122441086,124194583.8,21.64690308524483,24.090145230338653,NaN,NaN,-17.500370292447553,-9.035326571887602
2015-04-01T09:30:00-04:00,48.88,49,48.48,48.92,4207951,3922634.65,42.59620109402588,40.63412800119155,NaN,NaN,-85.47452866135346,-89.2168033787777,-0.07760920572446489,-0.4201060329319901,-0.3424968272075252,126649037,124979954.8,24.933879396435515,23.538029075257537,NaN,NaN,-17.20588960655659,-10.2025498625546
2015-04-02T09:30:00-04:00,48.7,49.11,48.7,48.97,2470374,3949281.45,43.23565082465308,40.63690145197345,NaN,NaN,-66.07044290256879,-78.98621801657885,-0.048237116741410846,-0.4027932231342888,-0.35455610639287793,129119411,125444927,26.88937881789721,23.248793861470624,NaN,NaN,-16.782236539669935,-11.142505102142504
2015-04-06T09:30:00-04:00,48.91,49.5,48.59,49.36,2690866,3864075.45,48.09271021874771,41.039392950050306,NaN,NaN,-29.812675215953423,-63.72265712043513,0.0008227182009596379,-0.3535277086416784,-0.354350426842638,131810277,127184982.6,33.83574925130773,23.685939805818034,NaN,NaN,-14.977397023806684,-11.690346805237388
2015-04-07T09:30:00-04:00,49.2,49.69,49.2,49.28,1836772,3829729.75,47.200525765938444,41.71910031883373,NaN,NaN,21.07654201731776,-48.14992621100678,0.029654476144891473,-0.31728233166152364,-0.3469368078064151,129973505,127998663.2,36.85694307658848,24.576092087051908,NaN,NaN,-13.73482022786171,-11.982414437040863
2015-04-08T09:30:00-04:00,49.51,49.61,49.17,49.42,2125636,3678380.85,48.98414957770881,41.89548255235852,NaN,NaN,29.762933262821182,-26.103634299947306,0.05826855640580114,-0.2741011122991637,-0.3323696687049648,132099141,129930274.2,43.45750009831782,26.027014197432628,NaN,NaN,-12.187017407370652,-12.011643432802261
2015-04-09T09:30:00-04:00,49.35,49.68,49.3,49.56,1905283,3646883.3,50.77493935650484,42.69457583525291,NaN,NaN,58.28807299586386,2.6488860314961187,0.08511339731574147,-0.225977922060288,-0.31109131937602946,134004424,131401351.6,47.92235033930314,27.967540353926193,NaN,NaN,-10.376920371880939,-11.778111566956358
2015-04-10T09:30:00-04:00,49.61,49.71,49.4654,49.7,1670040,3575355.4,52.56800246180427,43.519606760616966,NaN,NaN,96.29155201315051,35.12128501463998,0.10924807170771128,-0.17453122974139035,-0.28377930144910163,135674464,132712362.2,51.59105594236488,30.223971933255605,NaN,NaN,-8.339140231614014,-11.286829947621738
2015-04-13T09:30:00-04:00,49.52,49.743,49.475,49.5,1504586,3440973.85,49.778433005929124,44.14538272484709,NaN,NaN,90.75346140575257,59.234512338981176,0.10847188256653939,-0.1481894482409274,-0.2566613308074668,134169878,133184282.4,52.87792091120768,32.57937869445231,NaN,NaN,-7.301573442856006,-10.717507589798062
2015-04-14T09:30:00-04:00,49.4,49.79,49.375,49.71,2175318,3349107.65,52.62140057350867,45.06997983810469,NaN,NaN,108.4428955585746,76.70778304723254,0.11804074868705836,-0.10911039494864383,-0.22715114363570219,136345196,134458620.6,56.25930038700348,34.92341380107238,NaN,NaN,-5.620028134163737,-9.989296238993159
2015-04-15T09:30:00-04:00,49.82,50.38,49.82,50.19,3117195,3110818.15,58.41589595241611,46.71434501830823,NaN,NaN,194.6372585560424,109.6826481058768,0.15055380974206442,-0.03895888145812165,-0.18951269120018607,139462391,135931270.6,59.8452631523068,37.60013166969491,NaN,NaN,-2.372533213986696,-8.901187235420807
2015-04-16T09:30:00-04:00,50.2,50.348,49.92,50.08,2167456,2894732.15,56.70436015108913,48.131622307092,NaN,NaN,172.30283216893525,132.48559994049106,0.1577478950545643,0.007672177618019305,-0.150075717436545,137294935,136589372.8,61.36942034444253,40.23337167261018,NaN,NaN,-0.13275820494736784,-7.648554516781744
2015-04-17T09:30:00-04:00,49.8,49.96,49.44,49.62,3827872,2888285.8,50.09446569884119,49.08842482819733,NaN,NaN,74.3826181550392,128.1038131688688,0.12599968934385541,0.007423894243274276,-0.11857579510058114,133467063,136147892.6,59.7314772747605,42.842169521238304,NaN,NaN,-0.053792543938937384,-6.563588520661344
2015-04-20T09:30:00-04:00,49.7,50.05,49.7,49.98,2150722,2757446.25,54.5588047380101,49.74926522080345,NaN,NaN,104.5971624055526,130.87255336882882,0.12355080901348173,0.035862716166271014,-0.08768809284721071,135617785,136437474,60.47662927866127,45.54955509684585,NaN,NaN,1.3732570120039633,-5.4297534445663
2015-04-21T09:30:00-04:00,50.11,50.11,49.42,49.61,3971908,2787510.2,49.64345560636479,50.37635678753871,NaN,NaN,63.36224799105376,121.85642385532465,0.09272606069034872,0.02821948301572519,-0.06450657767462353,131645877,135497610.2,56.8027293503612,48.06068554435416,NaN,NaN,1.0854138942191,-4.499015253311243
2015-04-22T09:30:00-04:00,49.73,49.76,49.31,49.71,2712380,2811626,50.93018408005628,50.97164128654089,NaN,NaN,39.12088519290523,90.7531491826972,0.07551471282929123,0.029886813361990505,-0.045627899467300725,134358257,134476783.4,53.03423492405706,50.06785379632713,NaN,NaN,1.2330898806709323,-3.6801430913137896
2015-04-23T09:30:00-04:00,49.77,50.0501,49.59,49.84,4832823,2869161,52.624946180911444,51.64230524055934,NaN,NaN,73.63370645223878,71.01932403935791,0.06948064454667993,0.04122290621604918,-0.028257738330630743,139191080,134856012.4,54.24856718777492,52.02208153703268,NaN,NaN,1.8466606421849643,-2.8905997008139677
2015-04-24T09:30:00-04:00,50.09,50.28,49.995,50.26,3094579,2820271.55,57.70714801561361,52.32905079747833,NaN,NaN,129.21382038303966,81.98556448495802,0.08911735645785968,0.08313895724169384,-0.005978399216165824,142285659,136619731.6,59.49407215411134,53.85481888723293,NaN,NaN,3.9337117995648674,-1.9156980579027056
2015-04-27T09:30:00-04:00,50.41,50.92,50.39,50.7,3617946,2816941.3,62.27319418429994,53.40566997021843,NaN,NaN,204.12439713952395,101.89101143175228,0.12488786397674198,0.15013143075476165,0.025243566778019675,145903605,138676895.6,64.59317471512023,55.8359782899852,NaN,NaN,7.216132752754182,-0.6111507992374363
2015-04-28T09:30:00-04:00,50.69,50.84,50.41,50.77,3184489,2836410.6,62.95835673552561,54.4038276243482,NaN,NaN,173.13122210316033,123.84480625417359,0.1449983925901137,0.20649155751566184,0.06149316492554811,149088094,142165339,71.21141995102118,57.81840113660687,NaN,NaN,10.072864268181766,0.9151370675367352
2015-04-29T09:30:00-04:00,50.5,50.915,50.35,50.74,3444258,2835422.7,62.435021776595306,55.23669065435467,NaN,NaN,147.68006054953523,145.55664132549958,0.14752707562008371,0.24590200945065277,0.09837493383056904,145643836,144422454.8,74.52891414021038,59.71886997952881,NaN,NaN,12.250241509520645,2.534437702105865
2015-04-30T09:30:00-04:00,50.56,50.8,50.23,50.42,4446665,2847358.4,56.99298842073634,55.55276107999267,NaN,NaN,104.4492755983226,151.71975515471635,0.1200598741583356,0.24844977652848854,0.12838990237015294,141197171,144823673,75.07867339715494,61.39655694058525,NaN,NaN,12.588087501834128,3.970673387781331
2015-05-01T09:30:00-04:00,50.73,51.38,50.64,51.25,6749902,3061334.8,65.41371623296165,56.669567024780704,NaN,NaN,172.37915929448317,160.35282293700507,0.14834838215354523,0.3138253800620845,0.16547699790853926,147947073,145955955.8,76.6128036068413,63.091905704559075,NaN,NaN,15.699289593060971,5.646189988535565
2015-05-04T09:30:00-04:00,51.4,51.49,51.09,51.11,4150209,3134301.95,63.16706484838259,57.42282875870028,NaN,NaN,164.95552792794194,152.51904909468868,0.1478593084612801,0.35030113348513936,0.20244182502385927,143796864,145534607.6,74.76830008788212,64.4139771117647,NaN,NaN,17.482255983295243,7.337056559215519
2015-05-05T09:30:00-04:00,51,51.39,50.41,50.53,3761331,3230529.9,54.773909756527516,57.16268688756538,NaN,NaN,90.93361035561773,136.07952674518015,0.1009418687801841,0.3286191609990894,0.2276772922189053,140035533,143724095.4,67.27338977576164,64.9445575848686,NaN,NaN,16.247438235543036,8.609968227262307
2015-05-06T09:30:00-04:00,50.82,50.92,50.355,50.54,5015558,3375026,54.88521359615471,57.032747847927205,NaN,NaN,59.417029818396514,118.42692059895242,0.06480587319472425,0.3086846337123106,0.24387876051758633,145051091,143605546.4,66.80120243877136,65.33254202017781,NaN,NaN,15.3194930297543,9.56847177047545
2015-05-07T09:30:00-04:00,50.26,50.81,50.12,50.76,6230445,3591284.1,57.37083668486689,57.552488632643325,NaN,NaN,47.06117881317614,106.94930124192311,0.0505757902054334,0.3070984982743781,0.25652270806894467,151281536,145622419.4,70.58405311095918,66.10772600847771,NaN,NaN,15.300539323196755,10.38733856372135
2015-05-08T09:30:00-04:00,51.35,51.78,51.34,51.57,4630967,3739330.45,65.01377674183179,58.29927234720201,NaN,NaN,164.28333761769247,105.33013690656496,0.08835902250388411,0.3669714861987998,0.2786124636949157,155912503,147215505.4,73.18329998258429,67.01534534447221,NaN,NaN,17.868708197413618,11.456105654248816
2015-05-11T09:30:00-04:00,51.54,51.615,51.25,51.33,4117226,3869962.45,61.49566941556162,59.145859047858934,NaN,NaN,128.48672579700101,98.03637648037679,0.08955259859438092,0.39055321193789183,0.3010006133435109,151795277,148815188,75.52222313049678,68.35245204305333,NaN,NaN,18.785600595003455,12.503176360070906
2015-05-12T09:30:00-04:00,51.14,51.14,50.76,50.79,3774840,3949938.55,54.367032157250364,59.39134819622994,NaN,NaN,57.15243286303754,91.28014098186074,0.048400510170086175,0.36150125105611863,0.31310074088603246,148020437,150412168.8,77.62071540459297,70.10862922023448,NaN,NaN,17.149092112290447,13.166878610387984
2015-05-13T09:30:00-04:00,50.65,50.945,50.54,50.73,3814005,3984779.05,53.62323051817464,59.46265422032017,NaN,NaN,31.51542158673321,85.69981933552809,0.013386404154962506,0.3298337460797356,0.3164473419247731,144206432,150243237,76.86997713827971,71.7244442166991,NaN,NaN,15.631539291663637,13.518972993427363
2015-05-14T09:30:00-04:00,50.98,51.3,50.98,51.26,3159475,4034380,58.963912900405866,59.55242314066247,NaN,NaN,87.58621285343344,93.80482614357955,0.0216768752263633,0.3435434359577272,0.3218665607313639,147365907,149460111.2,73.32924610233721,72.71267092728667,NaN,NaN,16.053437502479,13.881039351863311
2015-05-15T09:30:00-04:00,51.21,51.51,51.09,51.51,3129890,3999480.9,61.23179648004717,59.4780375903587,NaN,NaN,108.66223946000248,82.68060651204155,0.03875686422124547,0.3703126410079207,0.33155577678667525,150495797,148376770,68.62046751624574,73.00033469879563,NaN,NaN,17.12520785917736,14.344491995765319
2015-05-18T09:30:00-04:00,51.29,51.45,51.17,51.28,2690510,4026470.3,58.05307446969774,59.12766028565671,NaN,NaN,89.33419957543487,74.85010126772832,0.02972977815710215,0.36871799948305295,0.3389882213259508,147805287,147578772,65.29442076350776,72.57769189968752,NaN,NaN,17.010613470292235,14.725366492126307
2015-05-19T09:30:00-04:00,51.21,51.3,50.88,51.03,2714466,3963598.2,54.72741816766721,58.577117170733274,NaN,NaN,46.570330825542136,72.73368086022923,0.0034683845376016764,0.3433237019979529,0.33985531746035125,145090821,146992848.8,62.88429102811685,71.74593310596656,NaN,NaN,15.886367540819446,14.891223784796756
2015-05-20T09:30:00-04:00,51.12,51.17,50.87,51,2203738,3938166.1,54.32523886825993,58.386563631270676,NaN,NaN,28.59415569315098,72.14942768151278,-0.018186492635206164,0.31712220166634353,0.3353086943015497,142887083,146728979,61.77834409793516,70.79590958459372,NaN,NaN,14.864929985486464,14.887467527752428
2015-05-21T09:30:00-04:00,51.02,51.285,50.8701,51.18,1909403,3791995.1,56.395758820387194,57.742423816086784,NaN,NaN,40.109183447583064,62.654021800342704,-0.022375750000722894,0.3073390068006461,0.32971475680136897,144796486,146215094.8,59.58069697785163,69.57933053966589,NaN,NaN,14.592583453306496,14.845341231403008
2015-05-22T09:30:00-04:00,51.15,51.22,51.03,51.12,1754534,3724992.85,55.49272786538604,57.194256888729896,NaN,NaN,36.1655701100535,48.15468793035291,-0.030663527898624754,0.29138534692808804,0.3220488748267128,143041952,144724325.8,53.621466852014684,68.06884245138964,NaN,NaN,14.117337567023988,14.74134070792029
2015-05-26T09:30:00-04:00,50.86,50.87,50.29,50.48,3787583,3733474.7,46.8713435891625,56.62978787677525,NaN,NaN,-101.5721126176681,9.973425491732316,-0.07803007668395012,0.22451127897177514,0.30254135565572526,139254369,143014142.2,47.72432663102707,66.67248079819431,NaN,NaN,11.039358363641455,14.212486087309028
2015-05-27T09:30:00-04:00,50.48,50.89,50.42,50.81,2792950,3713897.75,51.09074305155659,56.35875426644681,NaN,NaN,-64.01245065528676,-12.143130804433458,-0.08532642899131576,0.19588331941658055,0.2812097484078963,142047319,142405441.8,45.793888788656005,65.17195839461463,NaN,NaN,9.680224300058269,13.565020117701776
2015-05-28T09:30:00-04:00,50.73,50.97,50.63,50.94,1742063,3628788,52.6849163058334,56.024045667944414,NaN,NaN,-33.550553775469325,-24.57207269815752,-0.07969412816249827,0.18159208820477346,0.26128621636727173,143789382,142585901.6,46.48500812634325,63.450598038570654,NaN,NaN,9.033170419420369,12.91761301794729
2015-05-29T09:30:00-04:00,50.92,50.93,50.48,50.61,3251153,3569012.4,48.3745273671571,54.83552785546765,NaN,NaN,-82.56776134611938,-49.10746165689801,-0.09542813885151769,0.14200104280287462,0.2374291816543923,140538229,141734250.2,43.656118586270786,61.34151365311969,NaN,NaN,7.1730453698619066,12.096960496792235
2015-06-01T09:30:00-04:00,50.73,50.77,50.28,50.63,4367948,3449914.7,48.648736577109005,53.917889795578176,NaN,NaN,-98.81661270943061,-76.10389822079483,-0.10117565445838234,0.11095961358141437,0.2121352680397967,144906177,142107095.2,45.227623718901604,59.1776136951486,NaN,NaN,5.745271355187595,11.189576333705858
2015-06-02T09:30:00-04:00,50.56,51.02,50.45,50.79,3655845,3425196.5,50.89578009414604,53.66994321964216,NaN,NaN,-46.540741604911986,-65.09762401824362,-0.09119746143617405,0.09813844124457916,0.1893359026807532,148562022,143968625.8,52.3704782106518,57.374025324152804,NaN,NaN,5.1613712123696285,10.328404173514969
2015-06-03T09:30:00-04:00,50.96,51.15,50.75,50.84,2630240,3368641.95,51.60841146049349,53.52602757266494,NaN,NaN,-8.514627291892047,-53.99805934556467,-0.07869785782724545,0.09096358039669639,0.16966143822394184,151192262,145797614.4,58.14578341106736,56.036582915066205,NaN,NaN,4.867839173667716,9.548323459251076
2015-06-04T09:30:00-04:00,50.54,50.54,50,50.24,3772663,3306497.2,43.45796446071055,52.41845982697241,NaN,NaN,-161.38719107629512,-79.56538680572983,-0.10657524593075446,0.036442380810498776,0.14301762674125323,147419599,146523657.8,60.2084355867994,55.09938216395636,NaN,NaN,2.145093236482137,8.490719141712656
2015-06-05T09:30:00-04:00,50.07,50.25,49.8,50.01,2962205,3143085.2,40.79808484019785,50.9589089955546,NaN,NaN,-194.7027418699315,-101.99238291049225,-0.13444332930174469,-0.025036534885927608,0.10940679441581706,144457394,147307490.8,62.36482112950605,54.65255027918924,NaN,NaN,-0.9658178835269087,7.139785280964147
2015-06-08T09:30:00-04:00,50.01,50.11,49.82,49.83,3924501,3107761.9,38.796760760460835,49.58345801632339,NaN,NaN,-187.37532260641933,-119.70412488989,-0.15734738293307837,-0.08727743425053092,0.07006994868254746,140532893,146432834,58.551756698959,54.17093141743577,NaN,NaN,-4.177079711641358,5.523090282020503
2015-06-09T09:30:00-04:00,49.8,50.13,49.8,49.86,2608783,3032339.75,39.330929438432015,48.483708821378016,NaN,NaN,-161.79587774662562,-142.75515211823273,-0.162179074638797,-0.1326538946159488,0.029525180022848208,143141676,145348764.8,54.13393605379385,53.545906062126974,NaN,NaN,-6.6556243862871245,3.783273900833699
2015-06-10T09:30:00-04:00,50.16,50.557,50.13,50.38,2727218,2979958.65,47.83033967924117,48.01978745073382,NaN,NaN,-69.24041202882289,-154.90030906561887,-0.12378978055896006,-0.12521204567585187,-0.0014222651168918077,145868894,144284091.2,50.13321842422629,52.71411137114777,NaN,NaN,-6.389919554001223,2.329960550142996
2015-06-11T09:30:00-04:00,50.43,50.6,50.36,50.5,1858238,2882170.3,49.58558868715083,47.53334672693122,NaN,NaN,-40.68069343104992,-130.75900953656983,-0.08556776372641509,-0.10838196977491066,-0.02281420604849558,147727132,144345597.8,50.36145082179867,52.05559378857256,NaN,NaN,-5.651026775320149,1.1898195036482608
2015-06-12T09:30:00-04:00,50.42,50.44,50.1001,50.2,2373480,2842870.55,45.46705829061885,46.81722747159072,NaN,NaN,-76.23222938775197,-107.06490704013395,-0.0760626468743385,-0.1178925146414187,-0.041829867767080205,145353652,144524849.4,51.06438874536876,51.87294535238357,NaN,NaN,-6.231075245968448,0.12969168227444539
2015-06-15T09:30:00-04:00,49.82,50.075,49.63,49.89,3355902,2854171.15,41.62011973433001,46.44214005338839,NaN,NaN,-131.1514820379735,-95.82013892644477,-0.0855198150031108,-0.1487296365209687,-0.06320982151785791,141997750,144817820.8,52.25447231956613,52.19652718727922,NaN,NaN,-7.90135123457668,-1.0176001629900011
2015-06-16T09:30:00-04:00,49.79,50.18,49.76,50.15,2145197,2826905.5,45.76484383052789,46.06171868045777,NaN,NaN,-91.53537076275272,-81.7680375296702,-0.06979543028349502,-0.1504541093722267,-0.08065867908873167,144142947,145018075,53.094165072203694,52.71797549324691,NaN,NaN,-8.06102675721258,-2.0238039621646555
2015-06-17T09:30:00-04:00,50.25,50.47,49.88,50.36,3539583,2868161.35,48.919268524484494,45.79274383893285,NaN,NaN,-46.93645514201033,-77.30724615230767,-0.04214383960367904,-0.13333847859333048,-0.09119463898965144,147682530,145380802.2,54.64994685206346,53.30118540222692,NaN,NaN,-7.239550287233998,-2.7689105800317044
2015-06-18T09:30:00-04:00,50.54,50.91,50.51,50.78,3665612,2941255.05,54.605879908782754,46.237840449048974,NaN,NaN,53.536817825045866,-58.463743901088534,0.005031714365079612,-0.08490499603330193,-0.08993671039838154,151348142,146105004.2,57.668830383405094,54.30209338773652,NaN,NaN,-4.712870234516634,-3.04661910210098
2015-06-19T09:30:00-04:00,50.47,50.64,50.21,50.21,3697537,3030661.75,46.964430359744874,46.11753286209439,NaN,NaN,-16.259021251976968,-46.469102273933544,-0.0012194656859678132,-0.0914610425058413,-0.09024157681987349,147650605,146564394.8,59.51012004629739,55.32227169683622,NaN,NaN,-4.979091707357933,-3.322686617137687
2015-06-22T09:30:00-04:00,50.48,50.48,50.25,50.4,1981282,3041999.15,49.501198864293805,46.017919917104955,NaN,NaN,-3.460708872032321,-20.930947640745316,0.007874413525475937,-0.08039855991302858,-0.08827297343850452,149631887,148091222.2,64.96468803778674,56.22185811306013,NaN,NaN,-4.373587215941567,-3.4728152741096703
2015-06-23T09:30:00-04:00,50.42,50.48,50.16,50.26,2251578,2965198.9,47.69106883548887,45.738109729604616,NaN,NaN,-19.7422229387872,-6.572318075952206,0.005031785983173373,-0.0819832409595378,-0.08701502694271117,147380309,148738694.6,66.99520626381397,56.853959745399166,NaN,NaN,-4.443012030504009,-3.611414810737433
2015-06-24T09:30:00-04:00,50.15,50.18,49.61,49.62,3141321,2982617.45,40.41533418441105,45.52077899558323,NaN,NaN,-129.85457166955987,-23.155941381462117,-0.03706369787773631,-0.13334464928988154,-0.09628095141214524,144238988,148049986.2,62.82432760487868,57.04080917526198,NaN,NaN,-6.94006821206496,-4.086936725212794
2015-06-25T09:30:00-04:00,49.64,49.82,49.43,49.58,2448051,3017916.85,40.00454983921504,45.464097924084456,NaN,NaN,-157.9207930642736,-65.44746355932601,-0.06318032284620079,-0.17525635496989622,-0.11207603212369543,141790937,146138545.2,52.96814404008635,56.369617954589145,NaN,NaN,-9.025930889076676,-4.7925073200504915
2015-06-26T09:30:00-04:00,49.68,49.77,49.32,49.39,2906020,3000660.2,38.02738679039474,45.40914264050831,NaN,NaN,-158.34566563604184,-93.86479243613898,-0.08734128082311968,-0.22125263315259502,-0.13391135232947535,138884917,144385407.6,45.861437421471706,55.46316657762576,NaN,NaN,-11.361047635803223,-5.730870222300881
2015-06-29T09:30:00-04:00,49.01,49.17,48.19,48.24,6202663,3092395.95,28.761716833634694,44.65419888302279,NaN,NaN,-277.2044785715293,-148.61354637603839,-0.1700757960946887,-0.3465060974478362,-0.17643030135314752,132682254,140995481,35.8462995051283,54.15690682414965,NaN,NaN,-17.07688546976583,-7.351729543367302
2015-06-30T09:30:00-04:00,48.66,48.8,48.275,48.39,6299199,3224563.65,31.119242140357088,43.460549058816774,NaN,NaN,-231.92290397157726,-191.0496825825964,-0.20183540221227297,-0.42872455411848875,-0.22688915190621578,138981453,139315709.8,32.10496922309865,52.86917473835482,NaN,NaN,-20.697305326103663,-9.258240369472496
2015-07-01T09:30:00-04:00,48.87,48.889,48.53,48.66,5416286,3363865.95,35.27160183624281,42.438121426609065,NaN,NaN,-168.5740245127012,-198.79357315122465,-0.19186188842043472,-0.46671651243175916,-0.27485462401132443,144397739,139347460,32.24890840654571,51.575421708693895,NaN,NaN,-22.24913865999282,-11.114082982403971
2015-07-02T09:30:00-04:00,48.73,48.84,48.33,48.51,5138327,3432149.15,34.043748207068504,41.62217070635547,NaN,NaN,-152.38449944972407,-197.68631442831474,-0.18261981839770652,-0.5031293970084576,-0.3205095786107511,139259412,138841155,31.116049223890855,50.1505403143026,NaN,NaN,-23.881004607107727,-12.937928928790221
2015-07-06T09:30:00-04:00,48.11,48.57,47.84,48.11,6435337,3605805.75,30.949672808468122,40.859995925936765,NaN,NaN,-159.64361782607378,-197.94590486632114,-0.18985887618952313,-0.557833173847655,-0.36797429765813183,132824075,137628986.6,28.531848492808393,48.45606718381992,NaN,NaN,-26.266533505949756,-14.842015296955868
2015-07-07T09:30:00-04:00,48,48.1099,47.13,47.95,6859147,3752538.05,29.78362656133548,39.71848040670874,NaN,NaN,-165.5958827583868,-175.62418570369263,-0.19129953613199102,-0.6070987178231206,-0.4157991816911296,125964928,136285521.4,25.958656704982985,46.51781658616129,NaN,NaN,-28.564553543673487,-16.802377903629814
2015-07-08T09:30:00-04:00,47.55,47.69,46.855,46.9,7490816,3996639.7,23.520852187429327,37.904307811204795,NaN,NaN,-173.22903459998852,-163.88541182937487,-0.245392061320318,-0.7225392583415271,-0.4771471970212091,118474112,132184053.2,20.02194328367125,44.04438775984756,NaN,NaN,-32.99128689357641,-19.1150791879079
2015-07-09T09:30:00-04:00,47.59,47.65,47.03,47.04,4903810,4105469.3,25.76234250687196,35.84405513963975,NaN,NaN,-139.4246079301805,-158.05552851287075,-0.25314781796610186,-0.7935819694788364,-0.5404341515127346,123377922,127980089.8,15.98627537920332,41.067062402404574,NaN,NaN,-35.690795653715256,-21.483038683023235
2015-07-10T09:30:00-04:00,47.57,47.795,47.45,47.7,3804160,4202765.4,35.37791944297666,35.01644721701345,NaN,NaN,-98.48894899356353,-147.27641842163865,-0.19769185593378302,-0.7875489714299633,-0.5898571154961803,127182082,125564623.8,14.213560963412007,37.83159389648419,NaN,NaN,-34.688605124756194,-23.36954817469937
2015-07-13T09:30:00-04:00,48,48.27,47.92,48.22,2899932,4229088,41.77663069652679,34.46469234788724,NaN,NaN,-60.04662779749243,-127.35702041592239,-0.11400699962073857,-0.7323658650221034,-0.6183588654013649,130082014,125016211.6,13.838357452791485,34.1797131404131,NaN,NaN,-31.606261015181968,-24.546221437625455
2015-07-14T09:30:00-04:00,48.08,48.59,48.08,48.49,2444527,4183519.25,44.8312015647513,34.26041611426312,NaN,NaN,-39.476357178502454,-102.13311529994553,-0.0327102886487215,-0.6592467262122668,-0.6265364375635453,132526541,126328534.2,19.326354427518737,30.7747951521063,NaN,NaN,-28.110212792177098,-25.055363059704263
2015-07-15T09:30:00-04:00,48.5,48.52,47.99,48.11,3065938,4229556.3,41.528962793890614,34.339961014940236,NaN,NaN,-46.82149174722848,-76.85160672939352,0.0014209430469528384,-0.6247602587548542,-0.626181201801807,129460603,128525832.4,27.637253546520043,28.261432719366393,NaN,NaN,-26.312285744361724,-25.23492344322676
2015-07-16T09:30:00-04:00,47.99,48.135,47.83,47.99,4581718,4281663.05,40.51407882005265,34.37635594214292,NaN,NaN,-57.544016608285744,-60.47548846501458,0.020789904490687294,-0.6001938211884479,-0.6209837256791352,124878885,128826025,28.717676595369056,26.52925647331516,NaN,NaN,-25.20094166228098,-25.23006890309165
2015-07-17T09:30:00-04:00,47.84,47.97,47.41,47.66,7248481,4460806.5,37.77980268099212,34.35867136289988,NaN,NaN,-76.65791975322274,-56.109282616946416,0.016441714169226795,-0.6004315829676017,-0.6168732971368285,117630404,126915689.4,26.051962250153153,25.114293961078122,NaN,NaN,-25.11620577060486,-25.213802741307823
2015-07-20T09:30:00-04:00,47.67,47.67,47.17,47.26,4447721,4498315.7,34.72094885492541,34.78433079299207,NaN,NaN,-98.04929705302499,-63.70981646805292,-0.00704869853903356,-0.6256841703106204,-0.6186354717715868,113182683,123535823.2,22.13677006497251,24.135041858209856,NaN,NaN,-26.001025221078066,-25.326263095560716
2015-07-21T09:30:00-04:00,47.22,47.6,46.83,46.97,3459342,4572218.7,32.65655706081043,34.89413900159588,NaN,NaN,-112.20590664529458,-78.25572636141135,-0.03426967071290765,-0.6614725601627214,-0.6272028894498137,109723341,118975183.2,18.168938956363377,23.139611124871625,NaN,NaN,-27.377254285169727,-25.619261836933433
2015-07-22T09:30:00-04:00,46.87,47.01,46.66,46.77,5892544,4754267,31.27546997383307,34.60870101142376,NaN,NaN,-135.52845175867287,-95.99711836370024,-0.05658021968981619,-0.697928164062084,-0.6413479443722678,103830797,113849222,14.92981507306537,21.902533029623026,NaN,NaN,-28.929942221164197,-26.09221617753783
2015-07-23T09:30:00-04:00,46.88,47,45.97,46.09,4857571,4840079.5,27.08182052109332,34.11142046242553,NaN,NaN,-163.010697467194,-117.09045453548188,-0.10514697556057173,-0.7727816638229825,-0.6676346882624108,98973226,108668090.2,12.503423247914625,20.57305974562473,NaN,NaN,-31.677861117901525,-26.890165454732642
2015-07-24T09:30:00-04:00,46.08,46.1,44.785,45.08,7262228,5080788.35,22.29912034400307,33.49352385782088,NaN,NaN,-228.09794026672066,-147.37845863818148,-0.1884448414831179,-0.9031907401163082,-0.7147458986331903,91710998,103484209,10.64017632013396,19.29508316186227,NaN,NaN,-35.89775345079973,-28.176963739885085
2015-07-27T09:30:00-04:00,44.61,45.12,44.47,44.58,9276929,5399333.8,20.38028032329609,32.8218562693895,NaN,NaN,-231.9009121371214,-174.14878165500076,-0.25616837009862903,-1.0349563612564765,-0.7787879911578475,82434069,97334486.2,8.938452752217444,18.079354308093308,NaN,NaN,-40.028397725184455,-29.870025737784996
2015-07-28T09:30:00-04:00,44.65,45.63,44.43,45.51,14388236,5808612.45,32.086226570574325,33.433668725328424,NaN,NaN,-162.30146140842365,-184.16789260762658,-0.21873690774504073,-1.0522091258391484,-0.8334722180941077,96822305,94754279,8.336053520902524,17.24464789646697,NaN,NaN,-39.33877919172938,-31.222704802634194
2015-07-29T09:30:00-04:00,45.58,45.98,45.36,45.84,9585414,5972923.2,35.69883111387264,34.14341791154276,NaN,NaN,-106.65984897593324,-178.39417205107867,-0.15515060598378982,-1.027410475573845,-0.8722598695900551,106407719,95269663.4,9.64593239630534,16.791766254831398,NaN,NaN,-37.53051153646182,-32.12382005032386
2015-07-30T09:30:00-04:00,45.85,46.14,45.8,46.07,5595813,5981899.55,38.167582564184166,34.34267956305759,NaN,NaN,-76.07768467759637,-161.0075694931591,-0.08453240336195733,-0.9779253737925018,-0.8933929704305444,112003532,97875724.6,16.169325807873562,16.93146374372151,NaN,NaN,-35.280986377482805,-32.57484381134656
2015-07-31T09:30:00-04:00,46.39,46.39,45.855,45.95,4698040,5959885.2,37.36160651549049,34.027320692983565,NaN,NaN,-62.771376528901285,-127.94225674559524,-0.0353521802735165,-0.9375831957724401,-0.9022310154989236,107305492,100994623.4,23.305890809193897,17.60771612632168,NaN,NaN,-33.75131145823313,-32.74291061804464
2015-08-03T09:30:00-04:00,45.91,46.12,45.345,45.59,5704167,5923326.7,34.97546129358267,33.32333924504295,NaN,NaN,-79.62541029135218,-97.4871563764414,-0.017422640541079115,-0.9240093161752725,-0.9065866756341934,101601325,104828074.6,31.07283239029296,18.446750266519835,NaN,NaN,-33.206375083334514,-32.80911982737177
2015-08-04T09:30:00-04:00,45.62,46.05,45.61,45.79,6597844,5910261.55,37.36864116646057,33.02617341451223,NaN,NaN,-62.88486764849139,-77.60383762445495,0.015757281650154553,-0.8868900735715002,-0.9026473552216547,108199169,107103447.4,35.26351212391651,18.99148302204815,NaN,NaN,-32.03885251943247,-32.699081640523296
2015-08-05T09:30:00-04:00,46.12,46.51,45.87,46.02,5836737,5827557.6,40.09896952002685,32.99652275022468,NaN,NaN,-37.28044039612973,-63.72795590849425,0.05863511765134177,-0.8293534581574775,-0.8879885758088193,114035906,108629084.8,37.98600767156038,19.653506670347532,NaN,NaN,-30.259851100413137,-32.350620134793274
2015-08-06T09:30:00-04:00,46.01,46.18,45.79,45.86,6113368,5888035.5,38.830803104346714,33.071594209035716,NaN,NaN,-45.69141453169373,-57.65070187931373,0.08032116095067177,-0.7875871246204795,-0.8679082855711513,107922538,107812886,37.08739268859427,20.441751701664753,NaN,NaN,-29.138513022336127,-31.89174769015654
2015-08-07T09:30:00-04:00,45.56,45.845,45.07,45.22,5851493,5990402.15,34.17498463915828,33.03259676505235,NaN,NaN,-77.34429651036133,-60.565285875605674,0.05677223410790244,-0.7969429929362732,-0.8537152270441757,102071045,106765996.6,35.91384316998261,21.42582835202262,NaN,NaN,-29.51929174499198,-31.552825412275887
2015-08-10T09:30:00-04:00,45.65,46.36,45.37,46.33,5311542,6110982.65,46.21911162076778,34.00135066219216,NaN,NaN,-28.543366146519357,-50.34887704663911,0.11765689426045967,-0.7066441092186011,-0.8243010034790608,107382587,107922249,38.238348495517755,22.859357604819362,NaN,NaN,-25.825121857885037,-30.73458204736291
2015-08-11T09:30:00-04:00,45.6,45.83,45.28,45.47,5851927,6281352.65,40.0975484785533,34.63149912681503,NaN,NaN,-62.42374148856659,-50.25665181465415,0.10228225491659093,-0.6964481848333222,-0.7987304397499131,101530660,106588547.2,36.58974406564993,24.406495390003975,NaN,NaN,-24.753885986251774,-29.880196895775605
2015-08-12T09:30:00-04:00,45.1,45.7,44.97,45.64,6642250,6460168.25,41.74019794912822,35.67852608596038,NaN,NaN,-67.91552479988717,-56.38366869540564,0.10541479981996194,-0.6669619399749607,-0.7723767397949226,108172910,105415948,35.1546649690834,26.024441227230316,NaN,NaN,-23.375071320812236,-28.95089324220941
2015-08-13T09:30:00-04:00,45.5,45.71,45.345,45.51,3028035,6382484.1,40.81840071468361,37.00133182672328,NaN,NaN,-55.5744316251318,-58.360272114093256,0.10059751528833161,-0.6466298456845081,-0.7472273609728397,105144875,104860415.4,34.46499809756136,27.72621421133227,NaN,NaN,-22.568016691971028,-28.0390537350325
2015-08-14T09:30:00-04:00,45.56,45.76,45.44,45.72,2137764,6126948.25,43.00795522295724,38.61759431955621,NaN,NaN,-34.5492981273821,-49.8012724374974,0.11251868530784748,-0.6065790043380304,-0.7190976896458778,107282639,105902734.2,36.96374633644526,29.728020895919972,NaN,NaN,-21.2450830699994,-27.06848649717063
2015-08-17T09:30:00-04:00,45.61,46,45.41,45.98,2547882,6031956.3,45.68718589416924,39.58909141409871,NaN,NaN,-2.471359457140938,-44.58687109962172,0.13724069727791743,-0.547546818048481,-0.6847875153263985,109830521,106392321,38.15651697006794,31.858053999431792,NaN,NaN,-19.345121730328817,-25.965148673336085
2015-08-18T09:30:00-04:00,45.89,45.97,45.625,45.68,2853958,6001687.1,43.165641290665604,40.122434998155356,NaN,NaN,3.187521193623796,-31.46461856318364,0.13263936922249964,-0.5189883037982739,-0.6516276730207735,106976563,107481501.6,40.83852702990074,34.086096473260035,NaN,NaN,-18.47389718713009,-24.89496988959237
2015-08-19T09:30:00-04:00,45.45,45.4688,44.93,45.12,4286604,5921390.1,38.854743301573265,40.171517907968855,NaN,NaN,-107.14664944282626,-39.31084349177146,0.09300504440135793,-0.5353713675190761,-0.628376411920434,102689959,106384911.4,39.00448148329254,35.71717902150424,NaN,NaN,-19.012515661994335,-24.054619285649796
2015-08-20T09:30:00-04:00,44.84,44.97,44.27,44.27,5808673,5968945.2,33.401972481999934,39.88868690557668,NaN,NaN,-212.61907424269316,-70.71977201528372,0.014771312892838062,-0.6099122708043865,-0.6246835836972245,96881286,104732193.6,36.35453178354466,36.649224805386446,NaN,NaN,-21.2779612714456,-23.657953855049197
2015-08-21T09:30:00-04:00,44.01,44.09,43.19,43.19,12550160,6233341.8,28.021149957304587,39.39195038155681,NaN,NaN,-298.1925638614393,-123.44842516209516,-0.09826636693984647,-0.7475165423720327,-0.6492501754321862,84331126,100141891,30.214556297163455,36.58791937016291,NaN,NaN,-25.22520368904989,-23.881846688477868
2015-08-24T09:30:00-04:00,40.64,42.86,39.35,41.38,27681098,7153550.25,21.709241329751677,38.27342182179189,NaN,NaN,-393.72820683805156,-201.6997946382773,-0.2735557910142463,-0.9911949141999941,-0.7176391231857477,56650028,89505792.4,21.256329151428318,35.58740630069946,NaN,NaN,-31.4496872259435,-24.962966765258674
2015-08-25T09:30:00-04:00,42.04,42.94,40.66,40.73,13339511,7101114,19.9695857656628,36.83560869648018,NaN,NaN,-249.16606574511957,-252.17051202602596,-0.4040224620897733,-1.2226672007979644,-0.8186447387081911,43310517,76772583.2,15.378078253841949,33.972554199433866,NaN,NaN,-36.95261981003078,-26.675774343083262
2015-08-26T09:30:00-04:00,41.58,41.92,40.89,41.83,24487891,7846237.85,30.16809155880003,36.21684358608398,NaN,NaN,-181.38144627881633,-267.01747139322396,-0.3869540608655565,-1.3023373147901367,-0.9153832539245802,67798408,69794273,13.22033660196125,32.267764478960075,NaN,NaN,-37.527983440935145,-28.226089928490673
2015-08-27T09:30:00-04:00,42.5,43.56,42.445,43.35,11637653,8148329.85,41.299688530153404,36.72575100686935,NaN,NaN,-82.52234532569989,-240.9981256098253,-0.2506229229686491,-1.2286619076353915,-0.9780389846667424,79436061,66305228,12.291691020667102,30.58046789686611,NaN,NaN,-33.514539609880245,-28.981582740117755
2015-08-28T09:30:00-04:00,43.24,43.76,43.1,43.6,6370261,8231940.9,42.9115687866916,36.489497947292485,NaN,NaN,-55.957647362266194,-192.55114230999072,-0.12716412846473024,-1.1369941452476553,-1.009830016782925,85806322,66600267.2,12.849180649694489,28.76695590787873,NaN,NaN,-29.95853605430932,-29.12114749928798
2015-08-31T09:30:00-04:00,43.44,43.68,42.88,43.36,8999365,8396700.8,41.726986304797926,36.60588636345282,NaN,NaN,-57.37629731619559,-125.28076040561953,-0.04922620593391347,-1.071362774200317,-1.0221365682664034,76806957,70631653,20.303290188834495,27.603637773820484,NaN,NaN,-27.65114184613422,-28.911146691694583
2015-09-01T09:30:00-04:00,42.22,42.76,41.78,42.04,8989213,8516269.25,35.86309335402346,36.186093178088186,NaN,NaN,-95.86402371326272,-94.62035199924816,-0.07271639919768025,-1.1130320672635037,-1.0403156680658234,67817744,75533098.4,28.32964480496061,27.116136333526004,NaN,NaN,-27.761385592657827,-28.746895106117904
2015-09-02T09:30:00-04:00,42.55,42.69,41.99,42.64,7376502,8593257.5,39.99115598156895,36.127004268579995,NaN,NaN,-75.35836503118901,-73.41573574972267,-0.03585272579306831,-1.0851315753071589,-1.0492788495140906,75194246,77012266,30.601121589240307,26.84014515436021,NaN,NaN,-26.409549950408863,-28.41298865530233
2015-09-03T09:30:00-04:00,42.75,43.38,42.71,42.9,4859450,8530561.6,41.74103417679893,36.03650990814012,NaN,NaN,-45.23162484990254,-65.95759165456319,0.015290837232722065,-1.030165302973188,-1.0454561402059102,80053696,77135793,30.798370339286137,26.39976115456313,NaN,NaN,-24.77621337354564,-27.893449329337088
2015-09-04T09:30:00-04:00,42.23,42.44,41.98,42.05,7268024,8601388.15,37.8546798187964,35.477045188470626,NaN,NaN,-75.52115684617932,-69.87029355134582,0.0018312705924099504,-1.0431670519653977,-1.0449983225578077,72785672,74531663,28.9314836327042,25.74083020189429,NaN,NaN,-24.682867446579234,-27.434794774657394
2015-09-08T09:30:00-04:00,42.81,43.14,42.5761,43.1,6574802,8664551.15,44.703726319156054,35.58690840479137,NaN,NaN,-35.75188736274237,-65.54541156065517,0.06983467398960519,-0.9577049800708011,-1.0275396540604063,79360474,75042366.4,29.82980898608622,24.954493198764684,NaN,NaN,-22.282495143334906,-26.69875197018275
2015-09-09T09:30:00-04:00,43.36,43.73,42.7001,42.77,6834377,8713673.65,43.09615755398173,35.889866565677686,NaN,NaN,-25.50731824486164,-51.47407046697496,0.0971050946134493,-0.9061582857935946,-1.0032633804070439,72526097,75984037,31.547946168832738,24.421883533446128,NaN,NaN,-20.892515790962225,-25.869289658865533
2015-09-10T09:30:00-04:00,42.53,43.16,42.53,42.87,5473672,8655244.75,43.75619904966137,36.6294541776535,NaN,NaN,-32.3295149454095,-42.868300449819074,0.12463558354125637,-0.8474689009804734,-0.9721044845217298,77999769,76545141.6,32.60683539390239,24.154190934185966,NaN,NaN,-19.590541994259276,-24.972325706778925
2015-09-11T09:30:00-04:00,42.49,42.83,42.43,42.81,2899502,8648818.1,43.430690563635736,37.7301356495343,NaN,NaN,-36.89656657377238,-41.201288794593054,0.1403909886051513,-0.7966157487652907,-0.937006737370442,75100267,75554455.8,31.67517035758719,24.258520509930516,NaN,NaN,-18.634416589303463,-24.066910118568146
2015-09-14T09:30:00-04:00,42.75,42.76,42.2,42.3,3342914,8709075.6,40.66175735862626,39.08388679445391,NaN,NaN,-49.15040022468796,-35.92713747029478,0.11890214667725141,-0.7883790540238778,-0.9072812007011292,71757353,75348792,31.47411701272503,24.988362500023136,NaN,NaN,-18.60841140760547,-23.287124588430622
2015-09-15T09:30:00-04:00,42.38,42.73,42.275,42.61,3562004,8759781.7,43.03897918704199,40.731700610266714,NaN,NaN,-34.72588886091081,-35.721937769928466,0.1272552951651288,-0.7482120817447182,-0.875467376909847,75319357,74540568.6,30.650753261665557,26.079267857724822,NaN,NaN,-17.91659356228818,-22.519905870410273
2015-09-16T09:30:00-04:00,42.65,43.26,42.6,43.22,4363540,8835260.8,47.49633661419453,41.96943239993774,NaN,NaN,19.246314643527,-26.771211192250735,0.17273019785004717,-0.6595546295972881,-0.8322848274473352,79682897,75971928.6,33.94637229238775,27.559698978469573,NaN,NaN,-16.028976081208228,-21.59263018623855
2015-09-17T09:30:00-04:00,43.14,43.74,42.93,43.02,9138014,9077831.3,46.21928696472671,42.32083228812155,NaN,NaN,55.656439815876965,-9.174020239993444,0.18700243260239247,-0.5985317866943447,-0.7855342192967372,70544883,74480951.4,32.228307411206956,28.983743006365273,NaN,NaN,-14.809308397481535,-20.62358421641612
2015-09-18T09:30:00-04:00,42.09,42.35,41.74,41.88,10128610,9293828.15,39.671612739421086,42.08940685617365,NaN,NaN,-74.27489192485477,-16.64968531020992,0.12055444510205127,-0.634841162919173,-0.7553956080212243,60416273,71544152.6,29.103785680883618,30.144786222878782,NaN,NaN,-15.650877702056928,-19.913197571507663
2015-09-21T09:30:00-04:00,42.18,42.35,41.87,42.02,6017342,8967187.25,40.781124339758335,42.02184528724225,NaN,NaN,-56.74280509768945,-18.16816628481022,0.08840774112973104,-0.6448859316090605,-0.7332936727387915,66433615,70479405,28.042293636380776,30.697572183417805,NaN,NaN,-16.01797030141136,-19.356736532922476
2015-09-22T09:30:00-04:00,41.39,41.43,40.88,41.24,6594791,7912871.9,36.72826278004101,42.083643103386365,NaN,NaN,-168.02290620746658,-44.82756975412136,0.02053185065128882,-0.7076288594246805,-0.7281607100759693,59838824,67383298.4,25.167769815248946,30.471723969866968,NaN,NaN,-17.56189296682688,-19.100330309194533
2015-09-23T09:30:00-04:00,41.3,41.32,40.3,40.36,6928079,7592300.3,32.77124283836102,41.56793502172866,NaN,NaN,-211.23100518710268,-90.9230337202473,-0.07260879802391806,-0.8189217076058668,-0.7463129095819487,52910745,62028868,21.133180783363898,29.795442483732938,NaN,NaN,-20.166369433405798,-19.252621612653286
2015-09-24T09:30:00-04:00,40.01,40.38,39.46,40.25,9294513,6832631.4,32.302750969566915,40.893771935497796,NaN,NaN,-239.6683525113217,-149.987992185687,-0.1273972296884297,-0.9055594466924859,-0.7781622170040562,43616232,56643137.8,18.00639982378007,28.881730304053928,NaN,NaN,-22.40538195042744,-19.703015946621022
2015-09-25T09:30:00-04:00,40.63,40.63,39.96,40.2,7317050,6616601.25,32.07826868749427,40.48117114040479,NaN,NaN,-175.21919217577698,-170.17685223587145,-0.15115571072977574,-0.9671068554162758,-0.8159511446865001,36299182,51819719.6,15.75775011357679,27.940749338401975,NaN,NaN,-24.293562665834013,-20.35880833508002
2015-09-28T09:30:00-04:00,40.02,40.03,38.85,38.95,12341760,6915176.2,27.022445267855517,39.218222493883324,NaN,NaN,-206.7207085202118,-200.1724329203759,-0.2304564431761329,-1.1040216986566662,-0.8735652554805333,23957422,43324481,12.740076302671582,26.7200541467295,NaN,NaN,-27.651152925537797,-21.40057184800256
2015-09-29T09:30:00-04:00,39.14,39.45,38.83,39.1,13472105,7138813.2,28.479176436904027,38.17415241409206,NaN,NaN,-171.6517368037162,-200.89819903962587,-0.2505429211425696,-1.1867439069087453,-0.9362009857661757,37429527,38842621.6,11.489924918911726,25.287338343163714,NaN,NaN,-29.95051031786734,-22.621991629411813
2015-09-30T09:30:00-04:00,39.58,39.999,39.4,39.92,7652233,7071964.2,36.00018527235103,37.620151429998465,NaN,NaN,-110.52954385724055,-180.75790677365345,-0.18913321245066328,-1.1726175013295048,-0.9834842888788415,45081760,37276824.6,11.080829368391079,23.74976648419862,NaN,NaN,-29.694696275881068,-23.63237800747885
2015-10-01T09:30:00-04:00,40.08,40.37,39.56,40.37,9613097,7183793.95,39.744916314941946,37.356881840806054,NaN,NaN,-80.76300325778887,-148.97683692294686,-0.10304393397282174,-1.1122892063448688,-1.009245272372047,54694857,39492549.6,15.65719474693121,22.605625369151763,NaN,NaN,-28.343298202156074,-24.30536660671845
2015-10-02T09:30:00-04:00,39.69,41.36,39.69,41.36,23138028,8097722.85,47.08095000947143,37.815395601580704,NaN,NaN,-38.082500383561744,-121.54949856450382,0.028697474921243638,-0.9733734287204925,-1.0020709036417361,77832885,47799290.2,30.167660545121876,22.512307050037254,NaN,NaN,-24.793256390244395,-24.375065147222156
2015-10-05T09:30:00-04:00,41.8,42.45,41.44,42.44,13911977,8429920.5,53.70301684559302,38.577112577191485,NaN,NaN,32.48146356601817,-73.70906414725783,0.18782483477821665,-0.7672898601689653,-0.9551146949471819,91744862,61356778.2,46.381367206768026,23.635922331830283,NaN,NaN,-19.4468138621125,-23.67102924934935
2015-10-06T09:30:00-04:00,42.7,43.32,42.65,42.99,14076648,8805012.8,56.67626417214382,39.23282168847358,NaN,NaN,79.51476690695006,-23.475763405124574,0.32152400638062584,-0.5532096869713996,-0.8747336933520254,105821510,75035174.8,57.18286478793049,25.295671795797624,NaN,NaN,-14.074469815876109,-22.3000921874246
2015-10-07T09:30:00-04:00,43.11,43.69,42.885,43.56,15933032,9259945.55,59.57385789928152,40.18671961237035,NaN,NaN,98.65375320717179,18.360896007757894,0.4328200857363341,-0.3337085861816078,-0.7665286719179419,121754542,90369731.2,65.5593260901485,27.676458844293446,NaN,NaN,-8.679835342995428,-20.354341209649004
2015-10-08T09:30:00-04:00,43.38,44.3,43.38,44.17,13994886,9686006.25,62.466967653810094,41.81495924911242,NaN,NaN,121.39370781085948,58.79223822148756,0.5258062385307618,-0.10927087375448963,-0.6350771122852514,135749428,106580645.4,71.83279450391336,30.728530903081285,NaN,NaN,-3.236666776570338,-17.908959147780624
2015-10-09T09:30:00-04:00,44.53,44.56,43.99,44.15,9076572,9994859.75,62.3095179504413,43.352701649875485,NaN,NaN,125.27072431903946,91.4628831620078,0.5610380493145778,0.06622044935797078,-0.494817599956607,126672856,116348639.6,74.81023297144466,34.06909799844299,NaN,NaN,1.0228096601457977,-15.204420746648278
2015-10-12T09:30:00-04:00,44.24,44.24,43.555,43.77,7412814,10198354.75,59.25358154128339,44.961652989964236,NaN,NaN,98.72608999283044,104.71180844737026,0.533970569499515,0.17264561191778682,-0.3613249575817282,119260042,121851675.6,76.32836299575314,37.72342608276472,NaN,NaN,3.7067830126012744,-12.502820209612628
2015-10-13T09:30:00-04:00,43.47,43.92,43.27,43.6,8663546,10453431.85,57.88581467349579,46.75555097818815,NaN,NaN,81.56082179041715,105.12101942406366,0.4814587057563748,0.24049842461374027,-0.2409602811426345,110596496,122806672.8,76.59201632050522,41.68477147827481,NaN,NaN,5.537533497787886,-9.925626822841126
2015-10-14T09:30:00-04:00,43.61,44.18,43.52,43.95,6692997,10569904.7,59.936280547234965,48.729374519450154,NaN,NaN,90.17935298828503,103.4261393802863,0.4478393971815824,0.3188389653343435,-0.1290004318472389,117289493,121913663,75.74247740854773,45.80877702004393,NaN,NaN,7.675728477449752,-7.411147494228144
2015-10-15T09:30:00-04:00,43.99,44.292,43.5049,44.07,4576519,10341829.95,60.64379487996874,50.769769247484035,NaN,NaN,89.82963293700054,97.11332440551453,0.4121251766326228,0.38615603894353967,-0.025969137689083183,121866012,119136979.8,73.03006181425863,49.89965642723549,NaN,NaN,9.652030009482628,-4.973550707983748
2015-10-16T09:30:00-04:00,44.28,44.39,43.78,44.09,7240531,10197426,60.768147866713385,53.18017657597388,NaN,NaN,85.7474039074413,89.20866032319489,0.3696490212759116,0.43609213890580634,0.06644311762989472,129106543,119623717.2,73.21116397795753,54.21901983261306,NaN,NaN,11.33163581588158,-2.644238347431559
2015-10-19T09:30:00-04:00,43.79,43.96,43.56,43.78,3904967,10091807.25,57.72366666386472,55.2690687350425,NaN,NaN,66.33916632697724,82.73127559002425,0.3032589524828382,0.4455168082334424,0.14225785575060426,125201576,120812024,73.67590991753669,58.66087590394341,NaN,NaN,12.007787715680848,-0.5510917669869295
2015-10-20T09:30:00-04:00,43.73,44.23,43.65,43.85,3809202,9952527.8,58.232524600067634,56.85709297273655,NaN,NaN,65.46943303319334,79.51299783857951,0.24891990690288934,0.45340773937921597,0.20448783247632663,129010778,124494880.4,75.11673108338708,63.23486888358599,NaN,NaN,12.709763624822184,1.3433161461286578
2015-10-21T09:30:00-04:00,43.85,43.99,43.38,43.46,5516505,9881949.1,54.310298049311065,57.897477382334344,NaN,NaN,49.441740834996914,71.36547540792188,0.17505928759084508,0.423311941964883,0.2482526543740379,123494273,125735836.4,75.60132639688082,67.5165925728681,NaN,NaN,12.314121414423498,2.9105740415993493
2015-10-22T09:30:00-04:00,43.98,44.69,43.8683,44.65,7258997,9780173.3,62.59011081255387,59.00527458255452,NaN,NaN,75.08203844968942,68.41595651045967,0.19326773307712175,0.48983732072044006,0.2965695876433183,130753270,127513288,76.31288397448799,70.81267996067996,NaN,NaN,14.346896449993954,4.544334385655722
2015-10-23T09:30:00-04:00,45.07,45.2,44.775,45.02,6506542,9739647.9,64.73025928691192,59.792934756934436,NaN,NaN,94.66246664791856,70.1989690585551,0.21545778731616033,0.5658918217885187,0.3504340344723584,137259812,129143941.8,76.97627276483175,72.99803035768453,NaN,NaN,16.70288070409561,6.281269574004277
2015-10-26T09:30:00-04:00,44.95,45.0832,44.635,44.65,3994551,9322287.45,60.97374507540438,60.099897678595916,NaN,NaN,85.14761683399522,73.96065915995871,0.1912640543693263,0.5895141024340163,0.39825004806468994,133265261,130756678.8,77.64316062884104,74.4594800606067,NaN,NaN,17.607451484901663,7.899295561275332
2015-10-27T09:30:00-04:00,44.39,44.67,44.085,44.46,6166721,8957018.25,59.077745806089595,60.064461100510776,NaN,NaN,65.91513264228169,74.04979908177637,0.15031738769551956,0.5861467826840894,0.4358293949885698,127098540,130374231.2,77.073032194351,75.28188763947831,NaN,NaN,17.818965144344084,9.31639121599944
2015-10-28T09:30:00-04:00,44.39,45.22,44.39,45.13,7645518,8956682.5,63.39975042692916,60.13108844144785,NaN,NaN,103.37549701256734,84.83655031729046,0.15555738579865025,0.6302761272368826,0.4747187414382324,134744058,132624188.2,78.0922213666228,75.72898955824327,NaN,NaN,19.282675379786674,10.740146096540473
2015-10-29T09:30:00-04:00,44.91,45.32,44.88,45.22,5368124,8744433.85,63.950528909863024,60.24830350997797,NaN,NaN,131.05692579904542,96.03152778716165,0.15210280947783195,0.6648472532855223,0.5127444438076904,140112182,134495970.6,78.93131687419418,76.02335269415394,NaN,NaN,20.638267858847765,12.1541634911558
2015-10-30T09:30:00-04:00,45.2,45.655,45.15,45.28,6425067,7908785.8,64.33584599785092,60.6113223997328,NaN,NaN,150.65264016708377,107.22956249099471,0.1411185339645672,0.6891426112633994,0.5480240772988322,146537249,136351458,79.75894186806715,76.26839404217637,NaN,NaN,21.865308374851733,13.541469903112361
2015-11-02T09:30:00-05:00,45.35,45.78,45.24,45.56,11350745,7780724.2,66.15395041889033,61.20190352440384,NaN,NaN,152.45774140154185,120.69158740450402,0.13970885110068276,0.7226601411746856,0.5829512900740028,157887994,141276004.6,81.80213563624037,76.64054542187174,NaN,NaN,23.421920946101636,14.952962909253685
2015-11-03T09:30:00-05:00,45.44,46.085,45.41,45.74,7603936,7457088.6,67.30775125209237,61.72843714617937,NaN,NaN,154.66233639377265,138.4410281548022,0.1376740442102493,0.7550438453368145,0.6173698011265651,165491930,148954682.6,84.43967990666684,77.2617741717374,NaN,NaN,25.06120722729998,16.396997811831728
2015-11-04T09:30:00-05:00,45.66,45.98,45.42,45.44,6841179,7002495.95,63.426876560753506,61.92722869480685,NaN,NaN,121.27967216316115,142.02186318492096,0.10440782400235593,0.74787958112951,0.6434717571271541,158650751,153736021.2,85.81804181342618,78.17520131453509,NaN,NaN,25.443261573553816,17.689321206363456
2015-11-05T09:30:00-05:00,45.38,45.38,44.85,45.21,10284953,6816999.3,60.54462807666516,61.911262995517696,NaN,NaN,63.34257903739058,128.47899383259,0.057539499130028315,0.7153961310396895,0.6578566319096611,148365798,155386744.4,86.27022820937864,79.10799161677946,NaN,NaN,24.990876369361274,18.732400515363143
2015-11-06T09:30:00-05:00,44.84,45.4,44.77,45.33,4601403,6593240.85,61.526947723564405,62.182925928353384,NaN,NaN,59.09319033377981,110.16710386592919,0.026807591785255713,0.6913661216412308,0.6645585298559751,152967201,156672734.8,86.62793559434141,80.03313630797979,NaN,NaN,24.860896487815722,19.607899939999225
2015-11-09T09:30:00-05:00,45.12,45.32,44.62,45.02,5382090,6491704.65,57.54136369360404,62.13355729217742,NaN,NaN,35.972029397609354,86.86996146514271,-0.019701999668417236,0.6399310302704535,0.6596330299388707,147585111,154612158.2,82.90093274223126,80.58915071218294,NaN,NaN,23.666758020771457,20.187736808680974
2015-11-10T09:30:00-05:00,44.86,45,44.415,44.69,4904596,6303757.15,53.56364853561199,62.080225184056054,NaN,NaN,-0.4509579302060929,55.847302600346964,-0.0748940766533539,0.5660154341221784,0.6409095107755323,142680515,150049875.2,75.18785681184565,80.55961717039472,NaN,NaN,21.50784755553646,20.37632405823176
2015-11-11T09:30:00-05:00,44.79,44.88,44.465,44.74,6279413,6283077.95,54.081590517846536,61.472473734434104,NaN,NaN,-6.5695918013270465,30.27744980744932,-0.10821349648453771,0.5056426401698602,0.6138561366543979,148959928,148111710.6,72.1180890596425,80.25998896219146,NaN,NaN,19.830230627916475,20.29831071104386
2015-11-12T09:30:00-05:00,44.28,44.34,43.84,43.84,9022226,6505363.3,44.46723205706673,60.025114646588015,NaN,NaN,-95.98753702640586,-1.5885734053099696,-0.18645703968920746,0.38078483704288857,0.567241876732096,139937702,146426091.4,69.46190598221706,79.723248477719,NaN,NaN,15.261795217368974,19.578808497661733
2015-11-13T09:30:00-05:00,43.81,44.63,43.74,44.4,7082381,6497455.8,50.37838201124282,59.268302999147906,NaN,NaN,-65.94031628907972,-26.595274729881872,-0.19515773478974419,0.3232947082449158,0.51845244303466,147020083,145236667.8,67.57072056505207,79.00378847316263,NaN,NaN,13.032329839127268,18.64359726072824
2015-11-16T09:30:00-05:00,44.49,45,44.33,44.97,7731495,6688782.2,55.563236665798335,59.01726663198424,NaN,NaN,-5.955295402530465,-34.98073968990984,-0.15873123456096216,0.3200383998334573,0.47876963439441944,154751578,146669961.2,68.67741627495971,78.40410162177753,NaN,NaN,12.739493947885302,17.800153930322104
2015-11-17T09:30:00-05:00,45.05,45.37,44.8,44.92,12751124,7135878.3,55.0201523184414,58.4187239099494,NaN,NaN,26.912747574230735,-29.507998589022474,-0.1351345908681097,0.30985139580928234,0.44498598667739203,142000454,146533949,68.43873390479612,77.71456680307563,NaN,NaN,12.341611442657298,17.02036214636999
2015-11-18T09:30:00-05:00,45.08,45.755,44.9615,45.72,7880256,7254065.85,61.50358113110052,58.24394192575208,NaN,NaN,94.82827750971855,-9.228424726813358,-0.0662634144378137,0.3621567186301249,0.4284201330679386,149880710,146718105.4,68.59786651395466,76.97646320591568,NaN,NaN,14.082476285965607,16.60066416631222
2015-11-19T09:30:00-05:00,45.61,45.93,45.59,45.67,5293053,7155768.65,60.91262022949585,57.999425799441006,NaN,NaN,127.06960250034155,35.38300317853613,-0.026719365393643557,0.39502092632588415,0.4217402917195277,144587657,147648096.4,69.4359593867575,76.23910731439355,NaN,NaN,15.283222367127976,16.412458195000188
2015-11-20T09:30:00-05:00,45.78,45.99,45.42,45.53,3729735,7016928.3,59.19746217129917,57.50253378175592,NaN,NaN,98.50180247335244,68.27142693102255,-0.013312646933648364,0.40509948305246724,0.4184121299861156,140857922,146415664.2,66.88823919040667,75.173828996834,NaN,NaN,15.765858761016796,16.320086847288273
2015-11-23T09:30:00-05:00,45.6,45.94,45.515,45.59,3828129,7008607.2,59.72092310263844,56.960617485366356,NaN,NaN,93.72514032187088,88.20751407590282,-0.004197228276035081,0.4131655946410717,0.4173628229171068,144686051,144402558.8,62.832765178957345,73.63047794485475,NaN,NaN,16.30964023750502,16.318594474462095
2015-11-24T09:30:00-05:00,45.23,46.09,45.23,45.97,6253367,7012939.5,62.961810049783885,56.92739844886853,NaN,NaN,98.34982544444067,102.49492964994481,0.022181860247098117,0.4450901482259795,0.42290828797888136,150939418,146190351.6,64.86984159471966,72.13417792923285,NaN,NaN,17.722378346355402,16.519135027589712
2015-11-25T09:30:00-05:00,45.97,46.05,45.62,45.68,4158988,6838613,59.056536748070286,56.82110621111175,NaN,NaN,90.42546884572084,101.61436791714526,0.015190255475042047,0.4418961073226839,0.42670585184764187,146780430,145570295.6,63.56851134782613,70.51262672483624,NaN,NaN,17.814425014093064,16.70417645423305
2015-11-27T09:30:00-05:00,45.62,45.71,45.41,45.62,1270771,6633745.35,58.25149347040326,56.58714519302881,NaN,NaN,53.203946329208,86.84123668291855,0.002292499131722192,0.4295714757622946,0.4272789766305724,145509659,145754696,63.80108252858805,68.88213722013958,NaN,NaN,17.667128327327493,16.841741007532256
2015-11-30T09:30:00-05:00,45.74,45.94,45.57,45.73,6561316,6640557.8,59.34566211058532,56.71602365138462,NaN,NaN,72.92145203317739,81.72516659488356,-0.002787219115485018,0.42379495273621615,0.42658217185170116,152070975,147997306.6,66.59413085993464,67.71736565711839,NaN,NaN,17.837216244511257,16.983951755672113
2015-12-01T09:30:00-05:00,45.76,46.06,45.6,46.05,7717036,6458872.35,62.43042362461036,57.34936472917021,NaN,NaN,89.89188955295903,80.95851644110118,0.01070760671760057,0.4399666802487019,0.4292590735311013,159788011,151017698.6,69.95637555014132,67.34368842413951,NaN,NaN,18.84082871529822,17.249219892761555
2015-12-02T09:30:00-05:00,45.91,46.02,45.28,45.43,8005887,6478969.9,53.89729884395504,57.33620103817797,NaN,NaN,45.351219814906855,70.35879531519443,-0.024875832928053454,0.3981642823710345,0.42304011529908797,151782124,151186239.8,70.1369962346061,67.20218179377977,NaN,NaN,17.221483627831187,17.245257569200074
2015-12-03T09:30:00-05:00,45.65,45.73,44.795,45.03,5828780,6428349.95,49.22283875337999,57.675887230771764,NaN,NaN,-8.434370712506972,50.58682740354886,-0.07525865277171423,0.32896679933444517,0.4042254521061594,145953344,151020822.6,69.6941319683593,67.2187693642185,NaN,NaN,14.376147157874339,16.835384653296398
2015-12-04T09:30:00-05:00,45.13,45.94,44.99,45.82,5607746,6194489.6,57.130755202107544,58.158199601547814,NaN,NaN,46.6045184056105,49.26694181882935,-0.05616173710603112,0.33402328072362053,0.39018501782965165,151561090,152231108.8,71.1304656841275,67.4730368727239,NaN,NaN,14.359459410243566,16.481681047145994
2015-12-07T09:30:00-05:00,45.57,45.79,44.71,45,6163064,6272572.65,48.659749602062114,57.665093382709514,NaN,NaN,-14.09899893829561,31.862851624534756,-0.0971357959318257,0.2687652729148695,0.3659010688466952,145398026,150896519,67.34038359427277,67.3775345383891,NaN,NaN,11.359055167720696,15.749877350085237
2015-12-08T09:30:00-05:00,44.53,44.91,44.09,44.15,7426193,6374777.8,41.74933201768805,56.717177646941416,NaN,NaN,-115.45434118306919,-9.206394522670887,-0.17530638771769325,0.14676808419957865,0.3220744719172719,137971833,146533283.4,56.70279938773137,66.53925350145592,NaN,NaN,6.215713575747795,14.387853953751318
2015-12-09T09:30:00-05:00,45.29,46.06,45.01,45.48,12961441,6777620.05,52.99731160447073,56.10958696646786,NaN,NaN,34.40115501490894,-11.396407482670474,-0.13317114831319526,0.15561053652577783,0.2887816848389731,150933274,146363513.4,56.32994119444921,65.66297312149123,NaN,NaN,6.128645126373189,13.207966978411585
2015-12-10T09:30:00-05:00,45.2,45.57,44.84,45.14,5285799,6727939.35,50.322180797555916,55.353127007043575,NaN,NaN,-17.404265828015973,-13.190386505772272,-0.12411131809533332,0.13364253721980646,0.2577538553151398,145647475,146302339.6,56.18657032883111,64.71658818878221,NaN,NaN,5.059214228942522,12.043859442773147
2015-12-11T09:30:00-05:00,43.97,44.47,43.88,43.94,9544225,6754039.3,42.22165126416976,54.14056908510576,NaN,NaN,-184.64900195934473,-59.441090578763315,-0.19085776093329732,0.019181654148518135,0.21003941508181545,136103250,143210771.6,49.350435400765,63.46388791809352,NaN,NaN,0.9523230748483196,10.459354247355314
2015-12-14T09:30:00-05:00,43.71,43.86,42.97,43.36,8887168,6844278.65,38.95745707244987,52.657464368663724,NaN,NaN,-255.00561121147493,-107.62241303339917,-0.2616171932735819,-0.1169820765101619,0.14463511676341997,127216082,139574382.8,42.76029079580481,62.03013974786834,NaN,NaN,-3.4792233697750703,8.468128873479545
2015-12-15T09:30:00-05:00,43.8,44.0599,43.505,43.6,5047003,6710054.05,40.990428006797536,51.08807993702184,NaN,NaN,-180.18639567795503,-120.56882393237633,-0.27825580048803616,-0.20318463384662522,0.07507116664141093,132263085,138432633.2,40.912937913736826,60.31893234208384,NaN,NaN,-6.127645811768424,6.3830182041584065
2015-12-16T09:30:00-05:00,43.83,44.09,43.23,44.05,8066414,6475818.55,44.70870123026879,50.063234542893156,NaN,NaN,-142.5507808700655,-155.95921110937124,-0.24606438906767186,-0.2325093196931789,0.01355506937449296,140329499,136311878.2,37.658496179398995,58.468216972910476,NaN,NaN,-6.969521799005826,4.475512489420659
2015-12-17T09:30:00-05:00,44.12,44.12,43.17,43.17,9196504,6541630.95,39.47088198403201,48.72176229386664,NaN,NaN,-140.45892354591928,-180.5701426529519,-0.26927145730320695,-0.32303425225451576,-0.05376279495130879,131132995,133408982.2,33.70618529475661,56.31858145620823,NaN,NaN,-9.520110781737781,2.476137736398025
2015-12-18T09:30:00-05:00,42.76,43.05,42.27,42.27,14249249,6989440.75,34.95988102163483,46.97992078751303,NaN,NaN,-178.53962653598475,-179.3482675682799,-0.32664729563253614,-0.46207191449197893,-0.13542461885944282,116883746,129565081.4,29.31832617797643,53.6560239789255,NaN,NaN,-13.272667726733436,0.2263083845221021
2015-12-21T09:30:00-05:00,42.56,42.77,42.29,42.65,5887095,7097308.75,38.17281170464928,45.24723422180153,NaN,NaN,-145.85611370703413,-157.51836806739175,-0.3200006158959663,-0.5354253887294007,-0.21542477283343442,122770841,128676033.2,28.397534211418787,50.687535311873894,NaN,NaN,-15.13389802021793,-1.9680068161550452
2015-12-22T09:30:00-05:00,42.87,43.39,42.73,43.19,5268201,7169312.35,42.51835483748494,44.43445250705366,NaN,NaN,-96.60252305676774,-140.8015935431543,-0.26263411974896567,-0.5437174225196415,-0.28108330277067584,128039042,127831224.6,27.513269578144616,47.64298340784093,NaN,NaN,-15.192823897501517,-3.8572663992045415
2015-12-23T09:30:00-05:00,43.5,44.28,43.5,44.21,5819613,7147624.65,49.70868243098975,44.46915562688294,NaN,NaN,-34.29815114725488,-119.15106759859216,-0.14525359688689077,-0.4626502988792893,-0.31739670199239856,133858655,126537055.8,26.16894210788483,44.5340412749499,NaN,NaN,-12.73550001304851,-5.1255854868965365
2015-12-24T09:30:00-05:00,44.11,44.29,44.02,44.11,3717012,7125525.85,49.06073753627808,43.89272579360941,NaN,NaN,-20.45017766556676,-95.14931842252165,-0.0675554468619583,-0.40184101056984645,-0.33428556370788814,130141643,126338785.4,25.959668886735216,41.307555789421876,NaN,NaN,-11.042556924836031,-5.970867120887893
2015-12-28T09:30:00-05:00,43.92,43.92,43.54,43.8,4161561,7270065.35,47.01482518966686,43.77523119272403,NaN,NaN,-42.7530239006322,-67.99199789545114,-0.03205024164369569,-0.37434836576250774,-0.34229812411881205,125980082,128158052.6,31.38203244833852,38.73910213614086,NaN,NaN,-10.300966775707385,-6.589452785862106
2015-12-29T09:30:00-05:00,44.05,44.365,44.03,44.21,3885382,7136268.65,49.98550396806995,44.36352918917988,NaN,NaN,-4.976071812128189,-39.815989516469955,0.021169768588327587,-0.31583591338340256,-0.33700568197173014,129865464,129576977.2,35.35834280604186,37.21449809459161,NaN,NaN,-8.767997256273333,-6.900673424492281
2015-12-30T09:30:00-05:00,44.07,44.21,43.74,43.8,3339072,6917370.45,47.13928074797055,43.94509841371558,NaN,NaN,-22.133371136405113,-24.92215913239743,0.030324460016622312,-0.29910010695095224,-0.32942456696757455,126526392,129274447.2,34.89405457745313,35.683363336234756,NaN,NaN,-8.339775765796455,-7.10625947325002
2015-12-31T09:30:00-05:00,43.7,43.93,43.42,43.42,4679514,6751051.8,44.60423721114928,43.53667387182939,NaN,NaN,-46.17455759206025,-27.297440421358505,0.013225373589887068,-0.3128928499802157,-0.3261182235701028,121846878,126872091.8,31.371304439138797,33.910844344113876,NaN,NaN,-8.734245014111417,-7.33882883623022
2016-01-04T09:30:00-05:00,42.72,42.86,42.255,42.74,14430190,7181122.3,40.41569827763878,43.40767722993433,NaN,NaN,-128.6790594505805,-48.94321677836125,-0.03860815225772518,-0.37437841389225923,-0.33577026163453405,107416688,122327100.8,26.019402183575295,32.244341971457466,NaN,NaN,-10.358559774615513,-7.770218970285262
2016-01-05T09:30:00-05:00,42.92,42.92,42.4,42.72,9498958,7375682.9,40.295844296068566,43.50327631733567,NaN,NaN,-114.53662976169966,-63.29993795057474,-0.06728769883237834,-0.41987988517500696,-0.3525921863426286,97917730,116714630.4,21.207915397767934,30.704886585883397,NaN,NaN,-11.696242369573575,-8.331079455897878
2016-01-06T09:30:00-05:00,42.14,42.18,41.365,41.6,9307382,7532898.8,34.182499322804844,43.01699569705047,NaN,NaN,-184.39740345895146,-99.1842042799394,-0.14999741846659542,-0.5400889594258729,-0.39009154095927745,88610348,108463607.2,16.405070922362086,28.95432465792806,NaN,NaN,-14.863842727228771,-9.264331351802293
2016-01-07T09:30:00-05:00,40.84,41.245,40.25,40.47,12579674,7790572.85,29.3452204608231,41.91960421351864,NaN,NaN,-225.96170530731428,-139.9498711141212,-0.26253272584173565,-0.718257448261447,-0.45572472241971135,76030674,98364463.6,12.633744969432371,27.16684242864473,NaN,NaN,-19.330826509587048,-10.702402088628686
2016-01-08T09:30:00-05:00,40.86,40.9,39.95,40.06,8700176,7577509.6,27.807594076663563,41.08651222013517,NaN,NaN,-207.80688971169192,-172.27633753804756,-0.34131576389102514,-0.8823694272834928,-0.5410536633924676,67330498,87461187.6,9.96914987356945,25.471339898559933,NaN,NaN,-23.456799969121736,-12.524458928699122
2016-01-11T09:30:00-05:00,40.27,40.28,39.07,39.38,10065653,7816502.3,25.42783711473892,40.40565194107118,NaN,NaN,-210.73695946220894,-188.68791754037323,-0.41126643794341944,-1.055136710821742,-0.6438702728783225,57264845,77430819,8.246118253113963,23.966182189641188,NaN,NaN,-27.717281865117215,-14.694862205330278
2016-01-12T09:30:00-05:00,39.96,39.96,38.95,39.44,7270259,7702804,26.029364716846388,39.53826287051383,NaN,NaN,-180.429575981611,-201.86650678435552,-0.4238517968042641,-1.1736850188836527,-0.7498332220793886,64535104,70754293.8,7.337090241723217,22.46186476323436,NaN,NaN,-30.89708566184951,-17.009465556261596
2016-01-13T09:30:00-05:00,39.73,39.81,38.48,38.53,10809584,7798924.8,22.99919914218374,38.144037463706596,NaN,NaN,-166.74021629072982,-198.3350693507112,-0.46075903206789215,-1.3257820121642538,-0.8650229800963617,53725520,63777328.2,6.5273173929839885,20.96286817858003,NaN,NaN,-34.67785568209706,-19.533521288523804
2016-01-14T09:30:00-05:00,38.68,39.335,38.21,39.05,10372593,8065204.3,28.146696869968338,36.60389563791936,NaN,NaN,-139.99288629104203,-181.14130554745674,-0.4186665877135918,-1.3883562147383515,-0.9696896270247597,64098113,61390816,6.272312339252565,19.541680337963438,NaN,NaN,-36.21603659415788,-21.916737760757243
2016-01-15T09:30:00-05:00,38.25,38.51,37.75,38.25,9358896,8129828.4,25.340096881203266,34.90956416255686,NaN,NaN,-141.54487070405364,-167.8889017459291,-0.4125503205387959,-1.4853775276982546,-1.0728272071594587,54739217,58872559.8,6.0056891949137,18.116396074261896,NaN,NaN,-38.43985607289532,-24.277183233919825
2016-01-19T09:30:00-05:00,38.6,38.73,37.29,37.78,9865573,8163281.85,23.836315306914273,33.25395631378883,NaN,NaN,-128.61154536506305,-151.46381892649993,-0.40730373438699763,-1.5819568751432058,-1.1746531407562082,44873644,56394319.6,5.746794012610934,16.28530761456707,NaN,NaN,-40.75097885491383,-26.630582608347538
2016-01-20T09:30:00-05:00,36.94,37.82,36.2926,37.5,12825387,8092088.75,22.962071799768623,31.323711158910154,NaN,NaN,-130.8206941775025,-141.5420425656782,-0.38982359844245407,-1.6619326388092759,-1.2721090403668218,32048257,49896950.2,5.1232264532466445,14.125656446510272,NaN,NaN,-42.90248934540031,-28.95514071364079
2016-01-21T09:30:00-05:00,37.68,38.11,37.175,37.83,11700652,8382766.6,26.388785862360436,29.841532952795145,NaN,NaN,-101.55685553281158,-128.50537041409456,-0.3257747863389906,-1.67932752329056,-1.3535527369515694,43748909,47901628,4.945746267831183,11.98649156725156,NaN,NaN,-43.66860024023555,-31.05706350315433
2016-01-22T09:30:00-05:00,38.54,39.08,38.15,38.51,9537605,8596236.8,33.0020302322972,29.012803882877137,NaN,NaN,-68.6885639822911,-114.24450595234438,-0.2128164857986925,-1.6195733441999351,-1.4067568584012426,53286514,45739308.2,4.75356232996954,10.08522427373947,NaN,NaN,-42.31461392344001,-32.66528499176657
2016-01-25T09:30:00-05:00,38.14,38.22,37.22,37.28,11141731,8862342.7,28.086704945136276,28.132161501984097,NaN,NaN,-90.80647892945893,-104.09682759742546,-0.19653081228175506,-1.6524203737534364,-1.4558895614716814,42144783,43220421.4,4.532605909620614,8.550453111314138,NaN,NaN,-42.663904407534034,-34.09365919401906
2016-01-26T09:30:00-05:00,37.68,38.02,37.285,37.92,7587807,9055882.45,33.62617239791426,27.655756366401647,NaN,NaN,-79.5033504387758,-94.275188612168,-0.12190442562528947,-1.6082700935032932,-1.4863656678780037,49732590,44192210.6,6.341375749267499,7.488557422135535,NaN,NaN,-41.14151548497038,-35.10049580701211
2016-01-27T09:30:00-05:00,37.85,38.5,37.52,37.62,7814346,9238521.7,32.367552337240966,27.526117296004227,NaN,NaN,-69.63682612970798,-82.03841500260909,-0.07433400786706068,-1.5792831777118295,-1.5049491698447688,41918244,46166208,10.068709292502291,7.035960162859834,NaN,NaN,-40.300648411355496,-35.84337475048974
2016-01-28T09:30:00-05:00,37.96,38.02,37.3435,37.68,6655502,9377027.7,32.908430990749196,27.78063233385609,NaN,NaN,-72.48662845117816,-76.2243695862824,-0.023071685943792275,-1.5337887772745091,-1.5107170913307169,48573746,47131175.4,11.914180322817572,6.984562688101635,NaN,NaN,-39.467775157576675,-36.361146237216445
2016-01-29T09:30:00-05:00,37.99,38.8,37.7,38.77,8001009,9610124.55,41.98542018965928,28.79333419907007,NaN,NaN,-40.02057735691078,-70.49077226120635,0.09360217313525121,-1.393714374911653,-1.4873165480469042,56574755,47788823.6,13.221181017721278,7.216850626969625,NaN,NaN,-35.83060860828164,-36.28535514736862
2016-02-01T09:30:00-05:00,38.55,39.03,38.08,38.93,13595400,10055918.85,43.200203503946675,30.062788941156334,NaN,NaN,-22.215631649247943,-56.77260280516414,0.18559471434735886,-1.2553231551127055,-1.4409178694600644,70170155,53393898,23.62290623245687,8.315192625494118,NaN,NaN,-32.529260055764155,-35.74877013428227
2016-02-02T09:30:00-05:00,38.78,38.87,38.22,38.67,11509388,9909878.75,41.67314392505767,31.180201741742856,NaN,NaN,-20.21573570620104,-44.91507985864919,0.23006865595689208,-1.1533320495139492,-1.3834007054708413,58660767,55179533.4,26.639721395990563,9.693951993656073,NaN,NaN,-30.231546104130576,-34.96059527283202
2016-02-03T09:30:00-05:00,39.13,39.97,38.63,39.97,14414225,10155642.1,50.99974167300363,33.180240493944275,NaN,NaN,56.88501406275027,-19.61071182015753,0.34145864496542266,-0.9565773992640629,-1.2980360442294856,73074992,61410883,36.121965503963374,11.8078554301546,NaN,NaN,-25.078562395361697,-33.54887629033626
2016-02-04T09:30:00-05:00,40.13,41.35,40.1,41.08,14590407,10419793.35,57.28091692260841,35.261256211989995,NaN,NaN,168.24308188186134,28.53523024645036,0.4760474593701147,-0.7029767200168422,-1.179024179386957,87665399,69229213.6,45.61948274115494,14.618367601719058,NaN,NaN,-18.412177989614648,-31.386490818804603
2016-02-05T09:30:00-05:00,40.77,41.1875,40.47,40.61,11431867,10362403,54.11761426353815,37.31679316787106,NaN,NaN,159.7784744615169,68.4950406101359,0.5162045627623115,-0.5337684759340675,-1.049973038696379,76233532,73160969,49.672004227277796,17.737390104030776,NaN,NaN,-14.017029001575654,-28.90513913062904
2016-02-08T09:30:00-05:00,40,40.32,38.965,39.54,11603720,10507580.2,47.66414566322241,39.0187810504645,NaN,NaN,76.15151917989881,88.16847077596525,0.45560146451526295,-0.48047120805230037,-0.9360726725675633,64629812,72052900.4,48.57338993291754,20.796432669766965,NaN,NaN,-12.369510238463306,-26.54290643174822
2016-02-09T09:30:00-05:00,39.16,40.23,39.16,40.03,10256796,10517137.35,50.571063840786366,40.99085191053719,NaN,NaN,90.03928929111797,110.21947577542906,0.43353788614142674,-0.3941503148907799,-0.8276882010322066,74886608,75298068.6,51.92683736508192,24.139547734898056,NaN,NaN,-10.08278223779061,-24.191460118325708
2016-02-10T09:30:00-05:00,40.2,40.61,39.55,39.65,11372359,10722242.35,48.32917008675332,42.55802221227954,NaN,NaN,95.23130106571814,117.88873317602263,0.38027725336666296,-0.3523416343238779,-0.7326188876905408,63514249,73385920,49.86356736875577,27.34796352782124,NaN,NaN,-8.93678524947803,-22.012220851347468
2016-02-11T09:30:00-05:00,38.84,39.3501,38.47,38.79,13535045,10858515.4,43.616536722454235,43.316201247290756,NaN,NaN,11.946554521394425,86.62942770392925,0.27875571424476586,-0.3841742448845835,-0.6629299591293494,49979204,65848681,42.66691161994213,30.056059905676424,NaN,NaN,-9.475922818223141,-20.221321132329706
2016-02-12T09:30:00-05:00,39.34,39.94,38.9,39.94,8596391,10769705.3,50.55916882217053,44.92137723850749,NaN,NaN,62.81738754342522,67.23721032031092,0.2799452644450291,-0.312998378573063,-0.5929436430180921,58575595,62317093.6,39.770559004969286,32.57305655534419,NaN,NaN,-7.628317509997551,-18.422320614853685
2016-02-16T09:30:00-05:00,40.34,40.6,39.83,40.55,6786824,10641101.7,53.8082006217999,46.36295068307076,NaN,NaN,102.73409099773689,72.55372468387853,0.3103501870545159,-0.2050059091999472,-0.5153560962544631,65362419,62463615,39.9526840238017,34.973864289239486,NaN,NaN,-5.0464037201836796,-16.511475344186543
2016-02-17T09:30:00-05:00,40.88,41.58,40.87,41.35,7494220,10522534.05,57.73132161948856,48.174648488945586,NaN,NaN,143.46118450191796,83.23810372603853,0.36889086808100047,-0.05424251115321255,-0.423133379234213,72856639,62057621.2,39.59540412530554,37.082913920154006,NaN,NaN,-1.5881185926216184,-14.379567236820126
2016-02-18T09:30:00-05:00,41.4,41.41,40.93,41.23,5410158,10151772.6,56.94998819471496,49.89190257494314,NaN,NaN,123.76919828760781,88.94568317041646,0.3824446705501921,0.0549224589535271,-0.327522211596665,67446481,62844067.6,40.701619937022414,39.13915960688292,NaN,NaN,0.899744861217606,-12.19680836567188
2016-02-19T09:30:00-05:00,41.01,41.04,40.58,40.75,5930473,9863263.65,53.81270036849057,50.73670830200251,NaN,NaN,89.94698087475132,104.54576844108783,0.34324502861916195,0.10153407417728744,-0.24171095444187451,61516008,65151428.4,43.945123246417566,41.333726908932654,NaN,NaN,2.0201216057608504,-10.165818369752918
2016-02-22T09:30:00-05:00,41.21,41.67,41.15,41.53,5360470,9654406.9,57.87386324722285,51.78482685509367,NaN,NaN,118.9901698151884,115.78032489544049,0.35266339130518265,0.1991182846896038,-0.15354510661557885,66876478,66811605,46.2243153216988,42.94811327244994,NaN,NaN,4.239709549189459,-8.107885809904007
2016-02-23T09:30:00-05:00,41.2,41.22,40.44,40.51,6533736,9424007.15,51.49709257286328,52.48653747279407,NaN,NaN,67.6042765851701,108.75436201292712,0.27638526518575546,0.19193647486661547,-0.08444879031913999,60342742,65807669.6,45.03190959979664,44.261841001293234,NaN,NaN,4.138199208230741,-6.358445093027614
2016-02-24T09:30:00-05:00,40.1,40.98,39.91,40.93,10142443,9551738.95,53.7565410301517,52.68345171259036,NaN,NaN,54.034299735395514,90.86898505962263,0.24166036348583192,0.2176266640381499,-0.024033699447682008,70485185,65333378.8,44.44855208297844,44.85659718550859,NaN,NaN,4.753768393545971,-4.770986023517102
2016-02-25T09:30:00-05:00,41.03,41.49,40.665,41.46,5135660,9417804.65,56.50974199369032,52.62836778909622,NaN,NaN,87.57231299806026,83.62960800171311,0.24126970472831658,0.2775534314627137,0.03628372673439714,75620845,66968251.6,46.99735316892412,44.95501650177782,NaN,NaN,6.110513256429457,-3.216486126381879
2016-02-26T09:30:00-05:00,41.8,42.29,41.8,42.06,6753080,9422683.55,59.45286136700927,53.009456867915574,NaN,NaN,138.03811666488946,93.24783515974075,0.26633689726619353,0.36920484831713907,0.10286795105094552,82373925,71139835,52.931673231029585,45.187850002045806,NaN,NaN,8.156655849289251,-1.5917515584288604
2016-02-29T09:30:00-05:00,42.14,42.56,41.78,41.8,6838992,9364582.7,57.632774151415994,53.72150175992941,NaN,NaN,128.12072032008479,95.07394526072002,0.250556287594606,0.4160633105442031,0.16550702294959704,75534933,72871526,55.17527215020079,45.65941301756603,NaN,NaN,9.298534553895477,-0.03599639952538358
2016-03-01T09:30:00-05:00,42.3,42.98,42.0312,42.87,12092542,9289439.8,62.694385026375606,54.58745327318578,NaN,NaN,160.2958973079571,113.61226940527743,0.2943067369025021,0.5333904440777246,0.23908370717522254,87627475,78328472.6,61.41664884924285,46.337256695006104,NaN,NaN,11.88956356420408,1.6676550238645398
2016-03-02T09:30:00-05:00,42.39,42.79,42.2625,42.7,9864349,9207187.85,61.43850205385842,55.52383412797901,NaN,NaN,146.72500023684228,132.15040950556678,0.293271942104124,0.6056736348053775,0.3124016927012535,77763126,79784060.8,62.90054585747238,47.26846944420015,NaN,NaN,13.61614088106951,3.374581574893821
2016-03-03T09:30:00-05:00,42.61,43.07,42.53,42.96,8605688,8916761,62.67014805997813,56.884806366373574,NaN,NaN,145.96249093094974,143.8284450921447,0.29099403895026843,0.676144241389089,0.3851502024388206,86368814,81933654.6,65.03895488171474,48.866472534326775,NaN,NaN,15.403479392297312,5.092995548808606
2016-03-04T09:30:00-05:00,43.01,43.74,42.865,43.46,9907754,8682628.35,64.98622150203695,57.91531012922117,NaN,NaN,154.52563921689887,147.12594960254657,0.30270939604902347,0.7635369475000999,0.46082755145107646,96276568,84714183.2,67.63744854341935,50.85696464421607,NaN,NaN,17.605970641003342,6.880563419122139
2016-03-07T09:30:00-05:00,43.48,44.06,43.47,43.96,7884393,8505254.65,67.17917885103516,58.87038000273798,NaN,NaN,158.08885817332583,153.11957717319478,0.3218913832563761,0.8631917805215465,0.5413003972651704,104160961,90439388.8,72.21647365941253,53.161521046759695,NaN,NaN,20.132573726266102,8.773707748714134
2016-03-08T09:30:00-05:00,43.6,43.61,42.85,43.1,6288850,8239511.15,60.19572907250109,59.046409106524585,NaN,NaN,105.00469826639713,142.0613373648828,0.25722207973059685,0.8628279969284165,0.6056059171978196,97872111,92488316,73.65321322645774,55.594221696842,NaN,NaN,20.2887888995702,10.418719341693572
2016-03-09T09:30:00-05:00,43.33,43.58,43.07,43.37,5612808,8007311.75,61.54721978383398,59.374782791461655,NaN,NaN,100.93008940684378,132.90235519888307,0.21491418235809834,0.8742486451454425,0.6593344627873442,103484919,97632674.6,76.88520418539312,58.17876342886848,NaN,NaN,20.808338532558313,11.90295065467425
2016-03-10T09:30:00-05:00,43.48,43.86,43.1,43.6,7579079,7817647.75,62.70877224373334,60.01021649683613,NaN,NaN,99.79633052645993,123.6691231179851,0.18579729159383018,0.891581077279632,0.7057837856858018,111063998,102571711.4,79.4869689555279,60.71746669380492,NaN,NaN,21.56795086705007,13.283664970727937
2016-03-11T09:30:00-05:00,44.03,44.52,44.03,44.4,5019959,7391893.45,66.4993950178432,60.6263259090233,NaN,NaN,134.90136442260203,119.74426815912575,0.20242722251217715,0.9588178138260233,0.7563905913138461,116083957,106533189.2,81.3046253469567,63.22320312418049,NaN,NaN,23.357621019141643,14.722801549072752
2016-03-14T09:30:00-04:00,44.12,44.34,43.93,44.1,5471967,7235672.25,63.87719582634988,61.51061899855806,NaN,NaN,111.93648100372799,110.51379272520617,0.17619780375322258,0.9766378460053744,0.8004400422521518,110611990,107823395,81.86814697304324,65.85436293655525,NaN,NaN,24.100052215314037,16.06240878710722
2016-03-15T09:30:00-04:00,43.7,44.2,43.44,44.2,4984327,7145547.4,64.38137919147911,62.26953601008144,NaN,NaN,92.98305338086311,108.10946374809937,0.1496054395046913,0.987446841633016,0.8378414021283247,115596317,111368236.2,83.35284746282323,68.63324117797274,NaN,NaN,24.85187371498546,17.318046633946967
2016-03-16T09:30:00-04:00,43.5,44.57,43.5,44.57,7289733,7135323.05,66.25794988398752,62.9658365736741,NaN,NaN,100.32013518946576,107.98747290462377,0.14106939190248347,1.014178142006429,0.8731087501039456,122886050,115248462.4,84.81827000377942,71.33473523760526,NaN,NaN,26.016096486386235,18.560625184295432
2016-03-17T09:30:00-04:00,44.49,45.53,44.49,45.39,7781119,7253871.1,70.02686851101815,63.721122798246164,NaN,NaN,140.95512378948052,116.21923155722789,0.17269459052406533,1.0889769882590272,0.9162823977349619,130667169,119169096.6,86.1453648584308,73.70714178241963,NaN,NaN,28.16897514834572,19.93324660773119
2016-03-18T09:30:00-04:00,45.51,45.74,45.17,45.42,7630194,7338857.15,70.15819805136437,64.61579593395676,NaN,NaN,145.00838199462763,118.24063507163301,0.17702467473590544,1.1375632411548438,0.9605385664189383,138297363,123611777.8,87.48082219707779,76.01468107148227,NaN,NaN,29.96492659684393,21.36634374903301
2016-03-21T09:30:00-04:00,45.32,45.63,44.76,45.63,5074746,7324570.95,71.11236637779338,65.21708031620089,NaN,NaN,126.97009365491319,121.24735760187005,0.17510342430548587,1.1794178468007956,1.0043144224953098,143372109,130163801.6,89.14294120165654,77.99513052522612,NaN,NaN,31.748170602268715,22.849461870923825
2016-03-22T09:30:00-04:00,44.75,45.28,44.68,45.11,4096125,7202690.4,65.52537264648547,65.50899964424569,NaN,NaN,100.50895463348333,122.75253785239408,0.12237868284138576,1.157287776047042,1.0349090932056562,139275984,134899735,90.15989419578116,79.94222683510532,NaN,NaN,31.7740769717281,24.124406885324436
2016-03-23T09:30:00-04:00,44.73,44.87,44.47,44.55,5663612,6978748.85,60.05344500137238,65.3220922829167,NaN,NaN,68.72305681239851,116.43312217698062,0.03774358317004323,1.0820885721682103,1.044344988998167,133612372,137044999.4,90.58987020641952,81.76729221544136,NaN,NaN,30.221174307716485,24.995373659951873
2016-03-24T09:30:00-04:00,44.18,44.57,43.99,44.55,3762072,6910069.45,60.05344500137238,64.9697511042978,NaN,NaN,44.38982082691931,97.1200615844684,-0.02680373256448365,1.0108403232925625,1.037644055857046,133612372,137634040,90.70990678736383,83.41532494715169,NaN,NaN,28.948207660681202,25.560064231484635
2016-03-28T09:30:00-04:00,44.5,44.9,44.46,44.74,3949338,6769882.35,61.32432257670823,64.55154708470302,NaN,NaN,64.05663977097616,80.9297131397381,-0.06319029028856193,0.9586561929963437,1.0218464832849057,137561710,137486909.4,90.39971697264279,84.71412804095385,NaN,NaN,28.194625849464476,25.936430176910328
2016-03-29T09:30:00-04:00,44.43,45,44.28,44.99,4095555,6632710.5,62.9926579948855,64.7513277220162,NaN,NaN,62.83531585337174,68.1027575794298,-0.07604570369169483,0.9267893536702871,1.002835057361982,141657265,137143940.6,89.63029614997222,85.85534824977631,NaN,NaN,27.979243572010937,26.2282606619247
2016-03-30T09:30:00-04:00,45.19,45.3822,45,45.19,4036329,6229899.85,64.31871029882554,64.94929133022988,NaN,NaN,95.05273054923187,67.01151276257953,-0.07649590934503081,0.9072151706806935,0.9837110800257243,145693594,138427462.6,89.97420937886478,86.79027719216715,NaN,NaN,28.138961262055133,26.501217890514763
2016-03-31T09:30:00-04:00,45.24,45.3,44.661,44.81,5557764,6014570.6,59.92511622197269,64.75045875724699,NaN,NaN,63.713726522285036,66.00964670455683,-0.10598706594863927,0.8512272475899252,0.9572143135385645,140135830,139732154.2,90.32544828130544,87.56445428686554,NaN,NaN,27.09674741566121,26.586293536964256
2016-04-01T09:30:00-04:00,44.49,45.24,44.16,45.24,8590546,6013813.5,63.00474369594572,64.50084080568287,NaN,NaN,52.85824109108145,67.70333075738925,-0.10020067917559461,0.8319634645690712,0.9321641437446658,148726376,142754955,91.10313935556657,88.26434814462338,NaN,NaN,27.00680156295204,26.64636611210537
2016-04-04T09:30:00-04:00,44.95,45.21,44.57,44.65,5660555,5801453.55,56.579982868792264,63.979611308714475,NaN,NaN,39.43831934616868,62.779666672427766,-0.13747198308751762,0.7603241648852688,0.8977961479727864,143065821,143855777.2,91.37504937783703,88.94341260210867,NaN,NaN,25.064329990933214,26.42036095193792
2016-04-05T09:30:00-04:00,44.32,44.59,44.26,44.37,5483161,5681391.95,53.77730335103431,63.22217732011127,NaN,NaN,-13.637233164332796,47.48515686888686,-0.17968038777505257,0.6731956632539706,0.8528760510290232,137582660,143040856.2,89.20162659743393,89.36118254029513,NaN,NaN,22.599777104544234,25.874563259453108
2016-04-06T09:30:00-04:00,44.26,44.88,43.97,44.88,5672738,5650586.35,57.87076760617764,62.62309287169628,NaN,NaN,-0.8611578658947938,28.302379185861533,-0.1719451548961063,0.6379446074088904,0.8098897623049967,143255398,142553217,87.85498879461161,89.57809102535457,NaN,NaN,21.611261176650743,25.265520104767056
2016-04-07T09:30:00-04:00,44.54,44.61,44.04,44.23,5067081,5623300,51.598807950412834,61.306802831653044,NaN,NaN,-57.5019638648859,4.059241108427329,-0.20694830348846738,0.5512043829444124,0.7581526864328798,138188317,142163714.4,86.72873191009076,89.61976010047314,NaN,NaN,18.79779684063604,24.341559638462623
2016-04-08T09:30:00-04:00,44.47,45.02,44.47,44.52,4405767,5464634.4,53.99445858526552,60.152250012645986,NaN,NaN,-3.5153772722083056,-7.215482564230619,-0.20644383768424213,0.5000978893275771,0.7065417270118193,142594084,140937256,83.11562469636601,89.30796027899373,NaN,NaN,17.161760478105524,23.315874044125895
2016-04-11T09:30:00-04:00,44.92,45.19,44.72,44.72,3845688,5405920.85,55.62569052014771,59.046058879957,NaN,NaN,33.299574919565174,-8.443231449551323,-0.18898339448229673,0.4703124839089483,0.659295878391245,146439772,141612046.2,83.52236148145082,88.90649029897904,NaN,NaN,16.278042684076414,22.310469564118826
2016-04-12T09:30:00-04:00,44.99,45.42,44.74,45.34,4704884,5367566.7,60.322435236242235,58.67442049351106,NaN,NaN,85.41291998515584,11.366799180346403,-0.13457642823713967,0.4910753430948205,0.6256517713319601,151144656,144324445.4,85.07837738291748,88.54352481234592,NaN,NaN,16.92178907336654,21.540658065439928
2016-04-13T09:30:00-04:00,45.63,45.94,45.59,45.79,4825903,5359645.5,63.35419717003669,58.91018850555851,NaN,NaN,192.65034346158623,50.06909944584261,-0.07040647614245521,0.5376436761538912,0.6080501522963464,155970559,146867477.6,86.37725060152253,88.24262341199615,NaN,NaN,18.40839974675341,21.093192591341854
2016-04-14T09:30:00-04:00,45.99,46.07,45.72,45.82,3538305,5172074.1,63.5541335343256,59.16023768648375,NaN,NaN,181.503978389063,97.87028789663239,-0.030124116784898347,0.5703950063152234,0.6005191231001218,159508864,151131587,88.22768519833082,88.06532186992236,NaN,NaN,19.664482230548785,20.88909111122856
2016-04-15T09:30:00-04:00,45.94,46.06,45.6467,46.03,3437427,4954889.5,64.99390620412623,59.422350802727884,NaN,NaN,160.2982263236923,130.6330086158125,0.004630132826456634,0.6063067891331926,0.601676656306736,162946291,155202028.4,89.6701372190787,88.01320903038206,NaN,NaN,21.136240251054666,20.924398131203716
2016-04-18T09:30:00-04:00,45.8,46.245,45.63,46.24,4465687,4796664.15,66.42240511679367,59.66733274000704,NaN,NaN,161.9541818116899,156.36392999423745,0.03408704214357994,0.6442854589862108,0.6101984168426309,167411978,159396469.6,90.90660512220771,88.10437395697029,NaN,NaN,22.789472882965686,21.190837381455427
2016-04-19T09:30:00-04:00,46.42,47.26,46.35,47.23,6326080,4859230.85,72.18497604126689,60.22920886446713,NaN,NaN,235.10217714491418,186.3017814261891,0.10837958784280577,0.7456729016461381,0.6372933138033323,173738058,163915150,92.01542790214128,88.25017528006147,NaN,NaN,26.1944643437061,21.905641233205525
2016-04-20T09:30:00-04:00,47.29,47.32,46.9699,47.09,6506675,4979758.35,70.34638141883467,60.97358494995727,NaN,NaN,198.27513612211774,187.4267399582954,0.1345187246899634,0.8054417196657866,0.6709229949758232,167231383,166167314.8,92.50591536067844,88.40592292858811,NaN,NaN,28.414361509035146,22.8354584154669
2016-04-21T09:30:00-04:00,47.23,47.41,46.87,46.88,6070639,5000109.7,67.56637541884587,61.29941578730728,NaN,NaN,154.31360315313202,181.98866491110923,0.12433214915764268,0.8263381814228765,0.7020060322652338,161160744,166497690.8,92.57794207561233,88.51126598001997,NaN,NaN,29.453415833411373,23.78088090374468
2016-04-22T09:30:00-04:00,47.03,47.3565,46.9501,47.21,5429761,5083494.15,69.59950015221042,62.229381307551435,NaN,NaN,138.83550476733302,177.69612059983737,0.12608947831758788,0.8596178801622187,0.7335284018446309,166590505,167226533.6,92.74363508621184,88.60902210204674,NaN,NaN,30.939825279651203,24.8035872431599
2016-04-25T09:30:00-04:00,47.16,47.16,46.69,47.05,4601892,5116121.85,67.39363900344841,63.2019767112953,NaN,NaN,106.68140899243683,166.64156603598676,0.10368285475132044,0.8631319702837814,0.759449115532461,161988613,166141860.6,89.53997476407466,88.63318982823536,NaN,NaN,31.552340042473176,25.767694785918938
2016-04-26T09:30:00-04:00,47.09,47.49,47.05,47.43,5040021,5163345.15,69.8385995274356,64.05682184852802,NaN,NaN,117.79038641650801,143.17920789030555,0.10153055024503677,0.8863623033387569,0.7848317530937201,167028634,164799975.8,85.60048773588504,88.47215403832634,NaN,NaN,32.79311562526803,26.77132633439738
2016-04-27T09:30:00-04:00,47.55,47.88,47.3367,47.83,5705787,5246818.05,72.201532745375,65.52844504816818,NaN,NaN,125.71383805712271,128.66694827730652,0.11323103250774069,0.926370543728396,0.8131395112206553,172734421,165900583.4,86.13914758339207,88.43004087213356,NaN,NaN,34.5704325567364,27.885484366160096
2016-04-28T09:30:00-04:00,47.47,47.91,47.18,47.38,5664100,5252134.85,65.9425614072139,66.38188096402163,NaN,NaN,100.20858715925499,117.84594507853112,0.07849772385744658,0.9112616660424635,0.8327639421850169,167070321,167082498.8,86.713928035445,88.68706253921063,NaN,NaN,34.24123939285881,28.793449369974198
2016-04-29T09:30:00-04:00,47.22,47.54,46.78,47.1,6371915,5141203.3,62.322376509772624,66.86021567756627,NaN,NaN,69.471932828073,103.97323069067912,0.027151482726294196,0.8667032955928846,0.8395518128665904,160698406,165904079,83.01751818325761,88.6510023036254,NaN,NaN,32.880610728294485,29.377329564019952
2016-05-02T09:30:00-04:00,47.29,47.3001,46.81,47.27,6204001,5168375.6,63.627970225986445,67.09632531969086,NaN,NaN,61.705004706654904,94.97794983352273,-0.0032597028355058066,0.8354771843222082,0.838736887157714,166902407,166886837.8,83.64371037135645,88.5485260885139,NaN,NaN,32.12084472241413,29.769260300933407
2016-05-03T09:30:00-04:00,46.83,46.86,46.29,46.49,9322214,5360328.25,54.32622496595879,66.45147016225673,NaN,NaN,18.353194807740824,75.0905115117693,-0.07957434765125315,0.7392689525936476,0.8188433002449007,157580193,164997149.6,77.71019109975165,87.92945040981598,NaN,NaN,28.480150490322213,29.58510175656038
2016-05-04T09:30:00-04:00,46.08,46.37,45.72,46.02,8070638,5480223.25,49.619125089543566,65.45611241620087,NaN,NaN,-25.08643428638571,44.93045704306761,-0.16069500982636709,0.6179745379619419,0.778669547788309,149509555,160352176.4,65.4245563693024,86.30065549345682,NaN,NaN,23.853187685300103,28.766256889237482
2016-05-05T09:30:00-04:00,46.31,46.38,45.71,45.79,6970993,5575418.85,47.45233836715544,64.20314328498867,NaN,NaN,-41.94466655543055,16.49980630013051,-0.22489301566865072,0.4975532782024956,0.7224462938711463,142538562,155445824.6,55.45218503352339,83.85651605163143,NaN,NaN,19.37509522810725,27.42466236621888
2016-05-06T09:30:00-04:00,45.69,46.2,45.54,46.16,6777265,5693993.75,51.14812485451997,63.112123266254834,NaN,NaN,-51.78839127980596,-7.752258521445283,-0.2363156878549394,0.42705168405247207,0.6633673719074115,149315827,153169308.8,51.52759585378914,81.04372967531583,NaN,NaN,16.70424934958809,25.89317479241448
2016-05-09T09:30:00-04:00,45.81,45.8789,45.54,45.6,6569086,5830163.65,45.88770071550991,61.2337464572722,NaN,NaN,-89.2268132722934,-37.93862211723494,-0.27287282407874536,0.3222763418089798,0.5951491658877252,142746741,148338175.6,44.353510153636975,77.63930697899409,NaN,NaN,12.695221140497345,24.007752842140604
2016-05-10T09:30:00-04:00,45.83,46.4,45.74,46.36,6788160,5934327.45,52.95869739266324,59.99176902683137,NaN,NaN,-47.654197710331104,-51.14010062084933,-0.2384061213352362,0.29714151421867996,0.5355476355539162,149534901,146729117.2,42.24391870061957,74.04916436041846,NaN,NaN,11.492783283022403,22.21990004798086
2016-05-11T09:30:00-04:00,46.44,46.6,46.17,46.2,5682506,5977157.6,51.43487821543655,58.83951922658785,NaN,NaN,-34.99514970411594,-53.121843704395374,-0.21939872873589772,0.261299224634044,0.4806979533699417,143852395,145597685.2,40.77530063126206,70.348975685822,NaN,NaN,10.05113609309054,20.481505197282242
2016-05-12T09:30:00-04:00,47.04,47.19,46.24,46.4,9937625,6297123.6,53.24584726526163,57.67140116323436,NaN,NaN,-6.5547344724176435,-46.04385728779279,-0.18760291810966223,0.24619430573286394,0.43379722384252617,153790020,147847976.8,44.87971455196883,66.93012421909036,NaN,NaN,9.430048542784414,18.902725675211123
2016-05-13T09:30:00-04:00,46.38,46.62,45.78,45.95,5623949,6406449.7,48.83348216326276,56.34567567464967,NaN,NaN,-70.08253224801106,-49.70268548143382,-0.1905122602330388,0.1956568985512277,0.3861691587842665,148166071,147618025.6,44.540026460187434,63.715842197384134,NaN,NaN,7.532074463706764,17.2783469307105
2016-05-16T09:30:00-04:00,46.05,46.79,46.03,46.74,5837143,6475022.5,55.76393272355001,55.34034233151498,NaN,NaN,-23.39634090039572,-36.536591007054284,-0.13545348811613006,0.21685229863910394,0.352305786755234,154003214,149869320.2,48.638737133345444,61.07571715434559,NaN,NaN,8.111485627644663,15.96879531598681
2016-05-17T09:30:00-04:00,46.51,46.97,46.4,46.5,6422449,6479840.95,53.39765024429414,53.99720786715206,NaN,NaN,-7.793514293159017,-28.564454323619866,-0.11237116467043173,0.21184183091719433,0.32421299558762606,147580765,149478493,47.9758683250952,58.34976863589582,NaN,NaN,7.833765876353875,14.806648253182106
2016-05-18T09:30:00-04:00,46.24,46.58,45.58,45.79,9594756,6634245,47.03850822803666,52.646918354353694,NaN,NaN,-86.07877752161797,-38.78117988712028,-0.14027925868151403,0.14886392223573353,0.28914318091724756,137986009,148305215.8,45.95125003119097,55.4381487784491,NaN,NaN,5.4980163571431,13.476843696605105
2016-05-19T09:30:00-04:00,45.7,46.01,45.4185,45.95,6264884,6643957.25,48.52618656519075,51.66147621545498,NaN,NaN,-100.70503223641222,-57.6112394399192,-0.14284307777448718,0.11058933369913859,0.2534324114736258,144250893,146397390.4,42.78914290541089,52.56469340146004,NaN,NaN,4.098185477395617,12.137035379575178
2016-05-20T09:30:00-04:00,46.14,46.47,46.11,46.28,4912622,6618100.3,51.54912364005777,50.79870145931722,NaN,NaN,-31.549500503951553,-49.9046330911073,-0.11821262559818763,0.10566662947589123,0.22387925507407885,149163515,146596879.2,43.22905906547249,49.6779325938969,NaN,NaN,3.868116054919984,10.955761190338722
2016-05-23T09:30:00-04:00,46.5,47.03,46.48,46.82,4284726,6602242,56.09313772025074,50.924909513195225,NaN,NaN,37.68330804142748,-37.68870330274266,-0.06415736014646245,0.1436825548910008,0.20783991503746324,153448241,146485884.6,43.03079734476645,47.20083303996938,NaN,NaN,5.110789126172725,10.12076518117215
2016-05-24T09:30:00-04:00,46.97,47.24,46.89,47.13,4514671,6575974.5,58.499410795813134,51.55921563507162,NaN,NaN,84.80115503859365,-19.169769436392123,-0.009024693200725242,0.1965590485365567,0.20558374173728194,157962912,148562314,47.849413046880564,45.94546565979639,NaN,NaN,6.893779365247581,9.65976720746864
2016-05-25T09:30:00-04:00,48.02,48.02,47.4,47.71,5624039,6571887.1,62.6263580064335,52.64307418073434,NaN,NaN,173.4846236985836,32.74291080764819,0.06114446095710108,0.2820143179336583,0.2208698569765572,163586951,153682502.4,57.414651686080944,46.08564184926478,NaN,NaN,9.764855867388599,9.674779873171492
2016-05-26T09:30:00-04:00,47.86,48.18,47.17,47.2,3333631,6455363.65,57.23653105800601,53.0779603381262,NaN,NaN,145.23260387295036,81.9304380295207,0.06735919682828251,0.30506885301191033,0.23770965618362783,160253320,156882987.8,62.09470770099839,46.84043555263686,NaN,NaN,10.493374319462653,9.791721936927372
2016-05-27T09:30:00-04:00,47,47.35,47,47.18,4312805,6352408.15,57.02924989940673,53.873785279833115,NaN,NaN,96.11412731497254,107.46316359330551,0.06427988563236597,0.3180595132240853,0.25377962759171935,155940515,158238387.8,63.90391075974339,48.23689273878732,NaN,NaN,11.008079783401852,9.965487343566583
2016-05-31T09:30:00-04:00,47.4,47.4,46.865,46.94,4451886,6264802.4,54.47956740184736,53.9824188519177,NaN,NaN,81.64949239425128,116.25640046387028,0.04135027546988068,0.3054674719290702,0.2641171964591895,151488629,157846465.4,62.96802078721215,49.717185744972504,NaN,NaN,10.691332804583347,10.069179552283263
2016-06-01T09:30:00-04:00,46.85,47.09,46.37,47,4911813,6044282.35,55.02097355396901,54.23856851895573,NaN,NaN,42.946074415548196,107.8853843392612,0.026231944036663513,0.29690712650501894,0.2706751824683554,156400442,157533971.4,62.18600362215733,51.2465216728936,NaN,NaN,10.583638562735791,10.142673696633624
2016-06-02T09:30:00-04:00,46.95,47.29,46.74,47.26,3382047,5809852.8,57.38620579811609,54.53430841415962,NaN,NaN,73.29033677580874,87.84652695470622,0.029505843553809807,0.3075574869106177,0.2780516433568079,159782489,156773079,60.22473365723063,52.342594466126585,NaN,NaN,11.152918608738494,10.286994398362891
2016-06-03T09:30:00-04:00,47.47,47.77,47.17,47.66,4974177,5710012,60.80132924443849,55.389154634243596,NaN,NaN,118.70824706280533,82.54165559267722,0.05300323703995924,0.3443056896567569,0.29130245261679766,164756666,157673748.2,61.76205964843623,53.57273969385864,NaN,NaN,12.634802691244676,10.622395583060289
2016-06-06T09:30:00-04:00,47.87,48.2,47.79,48.15,6934737,5717885.6,64.54934367739423,56.01668398808961,NaN,NaN,161.48900673547274,95.61663147677726,0.09356733720248345,0.40826162411990197,0.3146942869174185,171691403,160823925.8,66.62138127527047,54.85721427542473,NaN,NaN,15.066560097020115,11.257276227911692
2016-06-07T09:30:00-04:00,48.19,48.33,47.96,48.17,3640672,5571464.9,64.69771546340951,56.82383150374072,NaN,NaN,153.9737094639232,110.08147489071166,0.11249452043066732,0.45531243745575267,0.34281791702508535,175332075,165592615,72.34972720100981,56.598204195132915,NaN,NaN,17.08654772566805,12.090029299019744
2016-06-08T09:30:00-04:00,48.48,48.6,48.28,48.45,3942223,5429168.05,66.79311980254491,58.23487518763416,NaN,NaN,162.40962067350316,133.97418414230265,0.13320410390587228,0.5093230469074257,0.3761189430015534,179274298,170167386.2,76.51388437985331,58.78124950575165,NaN,NaN,19.429158171251938,13.1384762807672
2016-06-09T09:30:00-04:00,48.2,48.216,47.88,48.1,3965573,5343321.4,61.85107185671543,59.18665270845735,NaN,NaN,108.36092752833315,140.98830229280753,0.11343650343598938,0.5179145722965401,0.40447806886055077,175308725,173272633.4,78.84301070271854,61.356525776987915,NaN,NaN,20.075335226410147,14.129456130144764
2016-06-10T09:30:00-04:00,47.8,48.02,47.62,47.74,4808883,5086884.3,57.1658413266328,59.587846828927,NaN,NaN,70.54236856726901,131.35512659370025,0.06843811714838738,0.490025715296035,0.4215875981476476,170499842,174421268.6,79.6470545684849,63.957811170060225,NaN,NaN,19.27931615161341,14.865150418926
2016-06-13T09:30:00-04:00,47.76,47.9299,47.2,47.21,5318868,5071630.25,51.03638831943025,59.2266504431541,NaN,NaN,28.03851856677185,104.66502895996007,-0.0010205342843122578,0.42031193029225733,0.4213324645765696,165180974,173119182.8,76.1156925259127,66.32101796871352,NaN,NaN,16.70366401319357,15.127795218107082
2016-06-14T09:30:00-04:00,47.07,47.22,46.545,46.86,7562520,5157899.1,47.42039866570076,58.43529243386036,NaN,NaN,-39.21301575722867,66.0276839157297,-0.0706797632615383,0.3329827604996467,0.403662523761185,157618454,169576458.6,67.36416469116989,67.71492880044848,NaN,NaN,13.397534106804521,14.880615059349573
2016-06-15T09:30:00-04:00,47.04,47.4,46.96,47.07,4167893,5045171.3,49.722157470810274,57.513563824172984,NaN,NaN,-11.717446813970515,31.202270418234964,-0.10091407325303459,0.2775199321948918,0.3784340054479264,161786347,166078868.4,60.026332920561636,67.90147746005424,NaN,NaN,11.318359959845976,14.371721473706202
2016-06-16T09:30:00-04:00,46.87,47.25,46.46,47.23,5872664,4859066.7,51.46548345564093,57.10134613828976,NaN,NaN,-40.64984252178201,1.4001164082119302,-0.10781355492740474,0.24366706178867048,0.3514806167160752,167659011,164548925.6,57.096523047633966,67.54446427052821,NaN,NaN,10.086690927448256,13.75957425281221
2016-06-17T09:30:00-04:00,46.9,47.3,46.79,47.2,5927089,4842176.95,51.10765581337079,56.67837513214433,NaN,NaN,-38.327461275048464,-20.373849560251557,-0.11160516327837594,0.2119741626181053,0.32357932589648125,161731922,162795341.6,53.85210806954391,66.82647836408539,NaN,NaN,8.976007177818309,13.07620752781308
2016-06-20T09:30:00-04:00,47.65,48.06,47.44,47.47,5965972,4894844.45,54.19441971175304,56.65800743999474,NaN,NaN,37.5812752584965,-18.465298221906625,-0.09385038457683614,0.20626634517543607,0.3001167297522722,167697894,163298725.6,54.6487686624293,66.23224606945804,NaN,NaN,8.862354038103582,12.474228457854581
2016-06-21T09:30:00-04:00,47.51,47.58,47.165,47.34,3063382,4833777.25,52.47654281459278,56.47626238718215,NaN,NaN,-15.958226968560554,-13.814340464173009,-0.08883464424821758,0.18907342444200026,0.27790806869021784,164634512,164701937.2,56.88324606886467,65.85347767279428,NaN,NaN,8.298874882477305,11.877749375657828
2016-06-22T09:30:00-04:00,47.38,47.56,47.31,47.39,3041740,4760130.7,53.09241680254521,56.16956317321281,NaN,NaN,-9.073544105113296,-13.285559922401566,-0.08037676816088168,0.17743710848911576,0.25781387664999744,167676252,165879918.2,58.721925905871224,65.7461342619829,NaN,NaN,7.987388551312251,11.32198354360846
2016-06-23T09:30:00-04:00,47.86,48.14,47.8,48.12,3558230,4656840.25,61.03248276294712,56.18607413882057,NaN,NaN,92.34200856995868,13.312810295946573,-0.02662559759651223,0.22453187965435717,0.2511574772508694,171234482,166595012.4,59.84148583375769,65.60895041807728,NaN,NaN,10.04090180375585,11.13897186648666
2016-06-24T09:30:00-04:00,46.48,47.07,45.9,46.02,12447507,5112534.05,40.03706870232194,54.43519735488684,NaN,NaN,-169.13089685843255,-12.847876820730244,-0.12784649619270447,0.09134935700998881,0.21919585320269327,158786975,166006023,58.43564969610827,65.02425530528,NaN,NaN,4.065102457778894,10.128419093814122
2016-06-27T09:30:00-04:00,45.67,45.67,44.22,44.47,9059325,5349860.05,31.44011450799877,52.05965442950036,NaN,NaN,-301.9102734237385,-80.74618655717725,-0.28550361554161574,-0.13768366622432637,0.14781994931728934,149727650,162411974.2,50.620770640590436,63.47218697953575,NaN,NaN,-4.942131594913644,7.975483281138727
2016-06-28T09:30:00-04:00,44.83,45.12,44.38,44.85,10370561,5645793.8,35.11836023118357,49.79717160297455,NaN,NaN,-235.45045224431658,-124.64463161232842,-0.34645040633537394,-0.2852430586019281,0.06120734773344584,160098211,161504714,48.844959756127054,61.495835220698154,NaN,NaN,-10.030415769795107,5.403211988148179
2016-06-29T09:30:00-04:00,45.4,45.76,45.29,45.61,6655461,5732976.2,41.83909130060056,48.367744420394914,NaN,NaN,-139.4792725049892,-150.72577729230363,-0.3185457624915065,-0.3369748553809373,-0.018429092889430787,166753672,161320198,48.47252478184421,59.32651479777856,NaN,NaN,-11.377052406003598,3.006031360412211
2016-06-30T09:30:00-04:00,45.74,46.36,45.49,46.34,5977783,5862763,47.467863997954275,47.67503175406074,NaN,NaN,-82.7479500452088,-185.74376901533714,-0.2376020679822743,-0.31543167786727366,-0.07782960988499937,172731455,161619592.6,49.150035192842246,57.148156270946934,NaN,NaN,-10.25157003469787,1.1120883039679137
2016-07-01T09:30:00-04:00,46.34,46.6565,46.21,46.36,4964119,5862260.1,47.61743970636813,47.43082113884201,NaN,NaN,-48.66940574762132,-161.65147079317487,-0.17242672440809872,-0.2933630153951228,-0.12093629098702405,177695574,165401312.4,56.8650456743342,55.773110067262756,NaN,NaN,-9.370903764389105,-0.3854819915116603
2016-07-05T09:30:00-04:00,46.12,46.3,45.36,45.52,5570113,5794028.9,42.184632957608684,47.05683787397829,NaN,NaN,-90.1584067184095,-119.30109745210909,-0.17504147242352214,-0.33973813151642673,-0.1646966590929046,172125461,169880874.6,63.859730600299606,55.52279334648631,NaN,NaN,-10.558227194324193,-1.8387313061991648
2016-07-06T09:30:00-04:00,45.36,45.76,45.0134,45.7,5837925,5903891.55,43.66780920032129,46.62438442608622,NaN,NaN,-94.53292119883133,-91.11759124301203,-0.1545156951064366,-0.35784127797595033,-0.20332558286951374,177963386,173453909.6,68.27829972812495,56.11221954702655,NaN,NaN,-10.979826590906033,-3.144602061157289
2016-07-07T09:30:00-04:00,45.54,46.19,45.54,45.82,4258624,5919711.6,44.68657290677053,46.14017652973833,NaN,NaN,-60.113034114379445,-75.24434356489007,-0.12403876728620578,-0.35837404197727096,-0.2343352746910652,182222010,176547577.2,71.52454951153862,57.14279286587688,NaN,NaN,-10.990361970433462,-4.265424905339599
2016-07-08T09:30:00-04:00,46.14,47.05,46.14,46.96,5241479,5983506.9,53.32289824316188,46.29840813186627,NaN,NaN,11.527996553359523,-56.38915424517643,-0.023545575498375382,-0.2637672440640344,-0.24022166856565902,187463489,179493984,74.22945909774236,58.598317939319635,NaN,NaN,-8.058136088976427,-4.807240788716289
2016-07-11T09:30:00-04:00,47.12,47.32,47,47.19,4622254,5974175.45,54.85441372810714,46.34555056160584,NaN,NaN,52.80943726051428,-36.0933856435493,0.05754402598852776,-0.1682916360799993,-0.22583566206852707,192085743,182372017.8,76.57061778652164,60.16416430532623,NaN,NaN,-5.2345367530897855,-4.868283069341074
2016-07-12T09:30:00-04:00,47.55,48.31,47.52,48.05,6754242,6045944.15,60.123012761890436,46.89172698641282,NaN,NaN,113.95695800857783,4.729687301848171,0.16229495581060358,-0.02296696730527259,-0.18526192311587616,198839985,187714922.6,80.17188239803913,61.827638328838695,NaN,NaN,-1.0103574326598825,-4.317150835529476
2016-07-13T09:30:00-04:00,48.13,48.25,47.8901,48.18,3930419,5864339.1,60.86647414251515,47.447016796410665,NaN,NaN,113.21811627982775,46.279894797579985,0.2294283333830054,0.1015234936128806,-0.1279048397701248,202770404,192676326.2,82.81362386510482,63.54847389735538,NaN,NaN,2.557019517615389,-3.3351264993659235
2016-07-14T09:30:00-04:00,48.37,48.6999,48.3164,48.61,4975527,5904720.8,63.303554559878016,47.60923621047716,NaN,NaN,131.71862354708009,84.6462263298719,0.2880869009583423,0.23220378642780304,-0.05588311453053922,207745931,197781110.4,85.02442574619697,65.34725531967247,NaN,NaN,6.300065953358132,-1.9586704346910586
2016-07-15T09:30:00-04:00,48.78,48.92,48.65,48.78,3631142,5792644.7,64.25141603905332,49.33883244881512,NaN,NaN,130.14894005101704,108.37041502940338,0.32110944185702817,0.34550368779074603,0.024394245933717834,211377073,202563827.2,86.74483795575493,67.36934019536152,NaN,NaN,9.629148993026211,-0.30326765930287736
2016-07-18T09:30:00-04:00,48.78,49.15,48.47,49.1,2955493,5644064.9,66.03010815334865,51.80954628062582,NaN,NaN,121.51634496848064,122.11179657099665,0.34517349792698937,0.4558611183424546,0.11068762041546518,214332566,207013191.8,88.11297674573242,70.04735491715738,NaN,NaN,12.956069023890398,1.5909232954390191
2016-07-19T09:30:00-04:00,48.84,49.02,48.61,48.81,3514757,5521504.15,62.97220625710146,53.79910671104852,NaN,NaN,106.87991557510868,120.69638808430284,0.3226455765258578,0.5139945910727874,0.19134901454692962,210817809,209408756.6,88.78420435813513,72.90015810301509,NaN,NaN,14.884186275494871,3.4899608640184265
2016-07-20T09:30:00-04:00,48.69,48.96,48.47,48.83,4012225,5568946.3,63.09912765707707,55.31768073651113,NaN,NaN,93.8973796432762,116.83224075699252,0.2911437583980103,0.5552787125444425,0.2641349541464322,214830034,211820682.6,89.43128671304066,75.82578395524341,NaN,NaN,16.49605832192696,5.347974786576788
2016-07-21T09:30:00-04:00,48.86,48.87,48.35,48.53,3625277,5598123.15,59.78857021228767,56.19773118039209,NaN,NaN,77.95157257364711,106.07883056230591,0.23458342507630847,0.5573642354918178,0.3227808104155093,211204757,212512447.8,89.61632431850245,78.71623317850485,NaN,NaN,16.98593375417932,7.01054035337715
2016-07-22T09:30:00-04:00,48.58,48.77,48.45,48.66,3889387,5614681,60.74958227076963,57.135741363563625,NaN,NaN,76.82262126836333,95.41356680577519,0.1921888183939468,0.5630168334079428,0.37082801501399604,215094144,213255862,89.82254578261258,81.07034032909618,NaN,NaN,17.654968842488202,8.531172994678728
2016-07-25T09:30:00-04:00,48.61,48.61,48.25,48.58,4839166,5234263.95,59.8024092473482,58.394153955687884,NaN,NaN,62.93672688073803,83.69764318822666,0.14705566347481824,0.5546475943575189,0.4075919308827006,210254978,212440344.4,87.76341730326769,82.77774652216532,NaN,NaN,17.975507441920996,9.880363629999053
2016-07-26T09:30:00-04:00,48.57,48.98,48.53,48.95,4172125,4989903.95,62.69909766396852,59.75353170309125,NaN,NaN,73.0312831673033,76.92791670666558,0.130954773249836,0.5712853974449956,0.4403306241951596,214427103,213162203.2,88.02509915948383,84.18823219583382,NaN,NaN,19.026926468831114,11.187015464117918
2016-07-27T09:30:00-04:00,48.99,49.18,48.65,49.01,4257071,4684229.45,63.162676958863145,61.07325342109787,NaN,NaN,74.34194744363532,73.01683026673741,0.11381283115662433,0.58259666314094,0.4687838319843157,218684174,213933031.2,88.31252387415641,85.38737322173507,NaN,NaN,20.034740713056266,12.450976213966253
2016-07-28T09:30:00-04:00,48.9,49.1,48.655,48.94,3665648,4534738.8,62.191568634881435,61.70672987764926,NaN,NaN,67.32991337792205,70.89249842759241,0.08836128809069993,0.5792354420976906,0.4908741540069907,215018526,214695785,88.60400864922514,86.41412676112671,NaN,NaN,20.65302718990861,13.622697781958019
2016-07-29T09:30:00-04:00,48.8,48.84,48.35,48.69,4272812,4449490.25,58.719289785637784,61.982792453187166,NaN,NaN,47.27109268175786,64.98219271027132,0.04734708732661752,0.5500580131652626,0.5027109258386451,210745714,213826099,85.97124932813946,87.08560044267084,NaN,NaN,20.318445066667646,14.57923310834511
2016-08-01T09:30:00-04:00,48.7,48.7,48.2236,48.42,3565837,4379576.15,55.13875050051681,61.6267737202319,NaN,NaN,31.686724073351467,58.732192148794,-0.002655720472787726,0.49939127524766036,0.5020469957204481,207179877,213211078.8,84.06883802529136,87.363954416046,NaN,NaN,19.087133167352086,15.223218831060391
2016-08-02T09:30:00-04:00,48.38,48.5235,47.97,48.29,6051599,4403650.45,53.448815481908994,61.096940958760044,NaN,NaN,10.783127568196456,46.28256102897263,-0.046730657354481564,0.4436336740273461,0.49036433138182767,201128278,210551313.8,76.21420870220415,86.89256761869595,NaN,NaN,17.58541153443769,15.560674931542863
2016-08-03T09:30:00-04:00,48.37,48.6,48.06,48.41,3475372,4285522.8,54.825175770519465,60.49134247380586,NaN,NaN,8.784783172843527,33.17112817481427,-0.06871871399001844,0.4044659388943046,0.47318465288432304,204603650,207735209,68.87663005372116,85.73915364066197,NaN,NaN,16.62707963090281,15.713018460022855
2016-08-04T09:30:00-04:00,48.41,48.74,48.31,48.61,3552513,4250217.25,57.10171311857311,59.980649408057275,NaN,NaN,22.990891467124097,24.30332379265468,-0.07044845476389888,0.38512408442944945,0.45557253919334834,208156163,206362736.4,65.5636450624219,84.22621129113817,NaN,NaN,16.354826643982424,15.80470534344565
2016-08-05T09:30:00-04:00,48.68,48.87,48.595,48.77,3156008,4145943.7,58.88670113092099,59.470406049312444,NaN,NaN,52.83315941825858,25.415737139954828,-0.061782140028902144,0.3783448641572207,0.4401270041861228,211312171,206476027.8,65.71026386404318,82.62601751387466,NaN,NaN,16.56986785859464,15.914014274181222
2016-08-08T09:30:00-04:00,48.82,49.01,48.75,48.87,4731765,4151419.25,60.00677453927367,59.258589498039036,NaN,NaN,84.4908709363355,35.97656651255164,-0.05074232747951363,0.3766990948367308,0.42744142231624443,216043936,208248839.6,68.00584924520383,81.14184929152243,NaN,NaN,17.03822916169324,16.074616400968655
2016-08-09T09:30:00-04:00,48.89,49.06,48.62,48.72,3991880,4013301.15,57.47726568729409,58.85702792876883,NaN,NaN,54.487946910242805,44.71753038096091,-0.054632341624592795,0.3591509952855034,0.4137833369100962,212052056,210433595.2,70.61654950085082,79.79793949065173,NaN,NaN,16.810791060680675,16.179784209498944
2016-08-10T09:30:00-04:00,48.81,48.9455,48.66,48.73,2255744,3929567.4,57.60556908409506,58.70109927675507,NaN,NaN,39.99847073228503,50.96026789284921,-0.05734081656515533,0.3421073162036521,0.3994481327688074,214307800,212374425.2,72.74426538395724,78.59279242389849,NaN,NaN,16.648123720291153,16.24668985389783
2016-08-11T09:30:00-04:00,48.97,49.03,48.68,48.94,2695719,3815577,60.31365274966617,58.669961453819106,NaN,NaN,75.6977939592924,61.501648391282856,-0.04627251880727695,0.3416074842597112,0.38788000306698817,217003519,214143896.4,74.55344047390227,77.5021420447049,NaN,NaN,17.178901550869128,16.37986295346516
2016-08-12T09:30:00-04:00,48.94,48.99,48.32,48.42,3382188,3803129.3,51.53506200252628,58.079436650617545,NaN,NaN,-43.981532365986325,42.13871003443388,-0.0736308554369875,0.2958414337707538,0.3694722892077413,213621331,214605728.4,75.0195080608892,76.59186281310645,NaN,NaN,15.247011169790456,16.218026984368773
2016-08-15T09:30:00-04:00,48.59,49.03,48.56,48.91,2317074,3771208.35,57.772196176476804,57.72751511579671,NaN,NaN,61.2794516693947,37.49642618104572,-0.05901643277020335,0.2957017482449871,0.3547181810151904,215938405,214584622.2,74.95194435810038,75.65806604157906,NaN,NaN,15.307936233473724,16.088014019955196
2016-08-16T09:30:00-04:00,48.99,49.18,48.63,48.65,3384643,3764702.65,53.81470172981429,57.059802599436075,NaN,NaN,55.60496017896895,37.719828834790945,-0.06658914738440835,0.27148174678467996,0.3380708941690883,212553762,214684963.4,75.06691031404387,74.7119507872853,NaN,NaN,14.171722181334815,15.814258043009428
2016-08-17T09:30:00-04:00,48.61,48.715,48.205,48.61,3076380,3717910.4,53.21079136767815,56.41831850892156,NaN,NaN,-63.60372445356432,16.999389797621074,-0.07347969942028038,0.24622126989373783,0.3197009693140182,209477382,213718879.8,71.65676762294495,73.50143357112243,NaN,NaN,13.070059183929256,15.422229634569403
2016-08-18T09:30:00-04:00,48.63,48.92,48.6101,48.92,3377924,3705542.75,57.217806457459915,56.311069699765994,NaN,NaN,52.26781027930025,12.313393061622644,-0.05707781360935493,0.24835370230232456,0.3054315159116795,212855306,212889237.2,68.76762453878017,72.27260322902532,NaN,NaN,13.268602379894206,15.114568598187232
2016-08-19T09:30:00-04:00,48.8,49.06,48.51,48.99,4906103,3756378.55,58.09059257117851,56.52191556195611,NaN,NaN,60.91970745165878,33.29364102515167,-0.04212264039596886,0.2527782154167184,0.29490085581268727,217761409,213717252.8,70.06487854402216,71.27232040893468,NaN,NaN,13.680199270761145,14.909658694269218
2016-08-22T09:30:00-04:00,48.81,48.99,48.55,48.92,3049985,3666919.5,56.841780363938405,56.76427019638678,NaN,NaN,44.058620178753586,29.84947472702345,-0.03769668041981239,0.24778000528792177,0.28547668570773416,214711424,213471856.6,69.14820455338986,70.7676058268765,NaN,NaN,13.683397319243493,14.734478497836973
2016-08-23T09:30:00-04:00,49.35,49.57,49.23,49.34,4129724,3664799.45,62.10561381002913,57.28430148492318,NaN,NaN,231.9031234326956,65.10910737776877,-0.008745669820910185,0.2745445984315964,0.2832902682525066,218841148,214729333.8,71.22568300883017,70.93539532367001,NaN,NaN,15.228914320870427,14.805112186841752
2016-08-24T09:30:00-04:00,49.27,49.27,48.71,48.77,3903916,3647141.7,52.709692891153296,56.9705857543932,NaN,NaN,65.1355952715667,90.85697132279498,-0.02910004646462816,0.24691521017172136,0.2760152566363495,214937232,215821303.8,72.93032948885441,71.46158706841518,NaN,NaN,13.676960357852447,14.64394763984328
2016-08-25T09:30:00-04:00,48.72,49.07,48.71,49.01,3388152,3633266.9,55.74558391885029,56.74622023924529,NaN,NaN,68.99483456778374,94.20237618049168,-0.02753244198572763,0.24159970415418996,0.2691321461399176,218325384,216915319.4,74.55663221224107,72.0934705218579,NaN,NaN,13.333465759799958,14.456735942694234
2016-08-26T09:30:00-04:00,49.2,49.52,48.53,48.73,5984825,3718867.55,51.58486998277379,56.14465562806673,NaN,NaN,62.81657539334348,94.58174976882862,-0.045429174036303754,0.2123456785945379,0.25777485263084166,212340559,215831149.4,70.06428156840907,72.24050140208684,NaN,NaN,11.727615427419625,14.06686158336929
2016-08-29T09:30:00-04:00,48.66,49.2799,48.65,49.17,2983773,3689764.35,57.01437193622884,56.11159178870493,NaN,NaN,97.7257756298612,105.31518085905013,-0.028535338643930985,0.22210567932592795,0.25064101796985894,215324332,215953731,70.28231092970583,72.21662721843363,NaN,NaN,12.092317185725948,13.784783812277384
2016-08-30T09:30:00-04:00,49.15,49.41,48.96,49.05,3765845,3575476.65,55.19633628204018,55.93950373141529,NaN,NaN,139.0505007805584,86.74465632862271,-0.026393906279642915,0.2176486351203053,0.24404254139994822,211558487,214497198.8,64.29058218877866,71.6127927044923,NaN,NaN,11.817958789102793,13.503808808966728
2016-08-31T09:30:00-04:00,48.8,48.88,48.45,48.56,4190169,3611216.5,48.40839259170862,55.08912800584689,NaN,NaN,-102.80720758001091,53.156095758307174,-0.05716363031607935,0.17258800350484904,0.2297516338209284,207368318,212983416,58.69040960904647,70.47971907128832,NaN,NaN,9.349114399857662,12.910281036236862
2016-09-01T09:30:00-04:00,48.71,48.82,48.4,48.76,4731848,3670183.25,51.054221854398,55.05478228098059,NaN,NaN,-94.09692222636468,20.537744399477493,-0.06278395430020106,0.15127169094567705,0.2140556452458781,212100166,211738372.4,54.48654249299042,69.01307867358126,NaN,NaN,8.169578871544074,12.233037869852177
2016-09-02T09:30:00-04:00,49.13,49.25,48.98,49.25,3304483,3677607,56.88778449321504,54.991610017890466,NaN,NaN,135.4055246872495,35.0555342582587,-0.03369627504712863,0.17193530143696734,0.20563157648409597,215404649,212351190.4,56.151370965209786,67.67018057408907,NaN,NaN,9.070338543273428,11.781223680340927
2016-09-06T09:30:00-04:00,49.3,49.43,48.93,49.14,3204293,3601233.4,55.29454092688256,55.09731281768105,NaN,NaN,118.65186164628393,39.24075146154324,-0.02259291364600355,0.17739043442659153,0.19998334807259507,212200356,211726395.2,53.983269011499644,66.16420619533592,NaN,NaN,9.288317329684723,11.425094201675755
2016-09-07T09:30:00-04:00,49.03,49.21,48.76,49.07,5742053,3688742.05,54.25323384664947,55.171772994750434,NaN,NaN,49.30581396731554,21.29181409889467,-0.020739630439444212,0.17405881002328982,0.19479844046273403,206458303,210706358.4,50.55151351044738,64.65668804444324,NaN,NaN,9.151867202298286,11.100347487478974
2016-09-08T09:30:00-04:00,48.98,49.09,48.71,48.86,2865123,3719211,51.14167883765582,54.73776387905014,NaN,NaN,-4.693454382423012,40.914564738412246,-0.03366847233105025,0.1527128500489212,0.18638132237997146,203593180,209951330.8,48.113394891489264,63.18138592677961,NaN,NaN,8.11055754459782,10.673234638495952
2016-09-09T09:30:00-04:00,48.5,48.53,47.39,47.44,8673660,4018108.05,36.075137162538326,53.165231349861564,NaN,NaN,-330.0577522952519,-6.27760127536518,-0.1323273485614656,0.020972136678139464,0.15329948523960507,194919520,206515201.6,38.914708878559175,60.95637380781796,NaN,NaN,1.3211333820537967,9.33722017328993
2016-09-12T09:30:00-04:00,47.16,48.02,47.07,47.89,6512770,4174637.15,41.91510747648521,52.09904042932919,NaN,NaN,-276.767062164082,-88.71211864563148,-0.15990765599715756,-0.046585084756841866,0.11332257124031568,201432290,203720729.8,33.33319877995804,58.398159109715685,NaN,NaN,-1.97662425391065,7.720956683689847
2016-09-13T09:30:00-04:00,47.4,47.59,46.69,47,10473968,4582481.85,35.08767251359515,50.16918747958391,NaN,NaN,-274.901527388141,-167.42279645251648,-0.22664269586460795,-0.16998079859044424,0.056661897274163694,190958322,199472323,26.994214546214195,55.23876850524312,NaN,NaN,-7.486296294079111,5.5484919725799955
2016-09-14T09:30:00-04:00,47,47.18,46.75,46.89,7789753,4802737.35,34.343088515029166,48.85728716700362,NaN,NaN,-219.501282261147,-221.184215698209,-0.2641264600760189,-0.27349617782086,-0.00936971774484105,183168569,194814376.2,22.04435209749002,51.604055834431385,NaN,NaN,-11.856905145586092,3.0620066699848407
2016-09-15T09:30:00-04:00,46.82,47.29,46.71,47.19,6125024,4955169.55,38.19516450295537,47.60368578015398,NaN,NaN,-159.81648900283514,-252.20882262229142,-0.25454389074362055,-0.3275495811743667,-0.07300569043074619,189293593,191954458.8,19.660591365136938,47.682910059638225,NaN,NaN,-13.994696697224418,0.625334760383518
2016-09-16T09:30:00-04:00,46.63,46.84,46.55,46.76,8579002,5215223.45,35.02337555560915,46.420721892499365,NaN,NaN,-155.71837205801273,-217.34094657484357,-0.2619701270621714,-0.4004683492584604,-0.13849822219628904,180714591,189113473,17.62203956846774,43.937035631071,NaN,NaN,-16.836584607689645,-1.869225149341219
2016-09-19T09:30:00-04:00,46.97,47.135,46.75,46.83,3676521,5153744.35,35.95574988818939,44.916534603353696,NaN,NaN,-116.42809248252918,-185.27315263853302,-0.24716194284880624,-0.44745065075729684,-0.2002887079084906,184391112,185705237.4,15.540285609994655,40.02689096537733,NaN,NaN,-18.750018431927025,-4.280767046853477
2016-09-20T09:30:00-04:00,47.18,47.24,46.68,46.69,3999387,5201214.45,34.87780396392884,43.46521086634574,NaN,NaN,-102.72661067944374,-150.83816929679355,-0.2320323014224136,-0.4903290846865076,-0.258296783264094,180391725,183591918,14.40402655992817,36.463565563316585,NaN,NaN,-20.624951478439378,-6.615650537080034
2016-09-21T09:30:00-04:00,46.95,47.46,46.86,47.4,5596234,5274539.95,44.04039423959683,43.153210984052045,NaN,NaN,-66.75534730676749,-120.28898230591767,-0.16272043485140497,-0.4616973268283502,-0.2989768919769452,185987959,184155796,16.165379767386284,33.42606343176942,NaN,NaN,-19.311087116856672,-8.429284334190982
2016-09-22T09:30:00-04:00,47.74,47.96,47.43,47.55,2995691,5229128.7,45.77618314297299,42.77620821895025,NaN,NaN,-32.28362291622951,-94.78240908859655,-0.09844866077387177,-0.4220377179442849,-0.32358905717041314,188983650,184093807.4,16.126094142023348,30.686031406700344,NaN,NaN,-17.709382616300413,-9.755012660206614
2016-09-23T09:30:00-04:00,47.39,47.62,47.3,47.31,4310207,5275231.45,43.4536943209138,41.816630349500166,NaN,NaN,-45.32576482863759,-72.70388764272153,-0.0653696561065113,-0.4053011273035523,-0.339931471197041,184673443,184885577.8,18.839196713340925,28.02087610299543,NaN,NaN,-17.0849280164282,-10.802143425381125
2016-09-26T09:30:00-04:00,47.34,47.41,47.03,47.09,3757813,5163880.85,41.38110952527314,40.822813820813785,NaN,NaN,-58.120646556177206,-61.04239845745114,-0.05215038714067605,-0.40511945512288605,-0.35296906798221,180915630,184190481.4,18.280148173302663,25.470653185981355,NaN,NaN,-17.181053614212818,-11.713416309499939
2016-09-27T09:30:00-04:00,46.93,47.27,46.85,47.23,3321752,5180779.8,43.23653923710534,40.0359070629892,NaN,NaN,-58.424173883298394,-52.18191109822207,-0.028978571432939693,-0.38919228227338465,-0.36021371084044496,184237382,184959612.8,21.07116847946871,23.36491425519717,NaN,NaN,-16.72008790721085,-12.428655109172926
2016-09-28T09:30:00-04:00,47.34,47.82,47.12,47.77,4566609,5220818,49.83252303738462,39.9423959343984,NaN,NaN,-15.429833859439016,-41.91680840875638,0.024809716443863927,-0.32920156528561506,-0.354011281729479,188803991,185522819.2,23.141217588409063,21.581187304977156,NaN,NaN,-14.281795849898998,-12.693389500705221
2016-09-29T09:30:00-04:00,47.58,47.9,47.25,47.4,4661351,5244377.1,45.89712350034345,40.64396638709876,NaN,NaN,-16.505320627859128,-38.76114795108229,0.03683752456883149,-0.3079643760184396,-0.3448019005872711,184142640,184554617.2,22.06964075368549,20.377968153200467,NaN,NaN,-13.39218035383008,-12.793216765437343
2016-09-30T09:30:00-04:00,47.69,47.92,47.54,47.75,4695270,5242548.2,49.92561611748381,41.216145575741514,NaN,NaN,11.460653303637548,-27.40386432462728,0.06792491322212318,-0.25989575905961715,-0.32782067228174033,188837910,185387510.6,25.27524382736486,19.802399942300955,NaN,NaN,-11.387257651476558,-12.592365463442945
2016-10-03T09:30:00-04:00,47.78,47.91,47.63,47.69,8099736,5482310.85,49.24862308605662,42.22764204520305,NaN,NaN,23.383286080733384,-11.10307779724516,0.08300876864017953,-0.22405971148151593,-0.30706848012169546,180738174,185352019.4,25.22762317405808,19.676214844289802,NaN,NaN,-9.964513456888277,-12.216958033935136
2016-10-04T09:30:00-04:00,47.76,47.85,46.9601,47.04,5916792,5617935.8,42.52167710566878,42.81182694453445,NaN,NaN,-28.468857364322957,-5.112014493450074,0.049429583413356015,-0.24528150085500044,-0.29471108426835646,174821382,183468819.4,22.775570960784435,19.728444763096544,NaN,NaN,-10.76218408207234,-12.009133183669022
2016-10-05T09:30:00-04:00,47.13,47.5699,47.13,47.36,6742787,5667972.5,46.40304883421729,43.398104396767444,NaN,NaN,-6.207704631866697,-3.267588647935608,0.04890009733059009,-0.23358596260511888,-0.28248605993570897,181564169,182020855,21.079081436397757,19.82976548247231,NaN,NaN,-10.224223807871981,-11.75414612998373
2016-10-06T09:30:00-04:00,47.25,47.775,47.18,47.75,5229775,5786205.1,50.76660201575976,44.52262057249249,NaN,NaN,59.308583634647825,11.89519220456582,0.0734690621815976,-0.19064973220871195,-0.26411879439030955,186793944,182551115.8,23.33132920274454,20.23757188492065,NaN,NaN,-8.393594438793423,-11.274067316956543
2016-10-07T09:30:00-04:00,47.81,47.81,46.7,46.86,5890851,5647064.65,42.30257445095318,44.97596518411848,NaN,NaN,-41.48200823714346,1.3066598964096188,0.030627243563733697,-0.2258347399356424,-0.2564619834993761,180903093,180964152.4,21.366107655353787,20.653702031017737,NaN,NaN,-9.595086506449492,-11.034212915455536
2016-10-10T09:30:00-04:00,47.14,47.48,47.04,47.14,3091942,5476023.25,45.38749362597429,45.72665730283602,NaN,NaN,-12.172412226916878,-5.804479765120435,0.02237635173950575,-0.22849154382499393,-0.2508678955644997,183995035,181615524.6,24.188730153150374,21.35260943053361,NaN,NaN,-9.542716319546917,-10.821141973182876
2016-10-11T09:30:00-04:00,46.81,46.86,46.2,46.5,11350539,5519851.8,40.1087227407921,45.44582362434996,NaN,NaN,-176.24615384615421,-35.359939061486685,-0.022524342868846303,-0.27902332415055753,-0.2564989812817112,172644496,181180147.4,23.579476242678425,21.882187750197335,NaN,NaN,-11.296090059895182,-10.888991699856062
2016-10-12T09:30:00-04:00,46.54,46.58,46.181,46.41,4058156,5333271.95,39.41449840344852,44.99141757152679,NaN,NaN,-182.14334080963212,-70.54706629703978,-0.05289160259804743,-0.3226134845292705,-0.2697218819312231,168586340,178584581.6,20.29721755204683,22.180125136627584,NaN,NaN,-12.89061735113522,-11.17493822146737
2016-10-13T09:30:00-04:00,45.91,46.28,45.56,46.17,4947051,5274373.3,37.548108066555486,44.56958998192977,NaN,NaN,-213.43843009398364,-125.09646904276606,-0.08200978388134861,-0.3722341117829089,-0.2902243279015603,163639289,173953650.6,16.01408330694565,21.97833132188506,NaN,NaN,-14.780757522511342,-11.690055264473651
2016-10-14T09:30:00-04:00,46.37,46.65,46.27,46.32,4768706,5083858.5,39.47710211700828,44.43358945276798,NaN,NaN,-128.19450322095372,-142.4389680395281,-0.08374283803982657,-0.3949028754513435,-0.31116003741151693,168407995,171454631,14.264739899262167,21.69151644516788,NaN,NaN,-15.748976492698013,-12.269901154219989
2016-10-17T09:30:00-04:00,46.34,46.53,46.27,46.36,3269079,5063486.4,40.00923865264408,44.203067982449326,NaN,NaN,-118.25144070366963,-163.6547737348787,-0.07504965164442418,-0.40497210196704714,-0.32992245032262296,171677074,168991038.8,12.782334435776619,21.099456870618447,NaN,NaN,-16.38432139422474,-12.857675474220668
2016-10-18T09:30:00-04:00,46.82,46.92,46.62,46.78,2919849,5009509.5,45.434213916081845,43.88890304521341,NaN,NaN,-53.751924849611726,-139.15592793557016,-0.03585544526756945,-0.3747417569070848,-0.3388863116395153,174596923,169381524.2,14.302503699068254,20.468120164236957,NaN,NaN,-15.358838187084753,-13.214984433201252
2016-10-19T09:30:00-04:00,46.89,47.2,46.71,47.12,2684793,4863937.45,49.42163826725065,44.1406540999925,NaN,NaN,-14.018505700489618,-105.53096091374168,0.01537789317424848,-0.3196639451717047,-0.3350418383459532,177281716,171120599.4,20.913797481788095,20.385559930530004,NaN,NaN,-13.290590482588652,-13.225785297399453
2016-10-20T09:30:00-04:00,47.06,47.235,46.755,47.08,2728197,4850562.75,48.96826851025191,44.072272128047366,NaN,NaN,-7.239278064657441,-64.29113050787643,0.04718562851755492,-0.27605980269900954,-0.32324543121656446,174553519,173303445.4,28.382215574901167,20.607486483925452,NaN,NaN,-11.728425715265073,-13.01187678566597
2016-10-21T09:30:00-04:00,46.7,47.09,46.6,47.06,3862896,4828197.2,48.727574716415205,44.0350543873587,NaN,NaN,-21.23379148281739,-42.898988160249175,0.06631916581298591,-0.24034647395033204,-0.30666563976331795,170690623,173759971,29.873756577989482,20.939353155634844,NaN,NaN,-10.502133583663136,-12.65334204252271
2016-10-24T09:30:00-04:00,47.24,47.32,47.05,47.17,3020715,4791342.3,50.178075658559955,44.581939998279495,NaN,NaN,23.248019242847704,-14.599096170945703,0.08465089117276065,-0.20085202579736716,-0.2855029169701278,173711338,174166823.8,31.247977792152795,21.544525072161154,NaN,NaN,-9.07185408450627,-12.141700905663217
2016-10-25T09:30:00-04:00,46.96,47.15,46.635,46.74,3372022,4793855.8,44.83807218038921,44.470155951577496,NaN,NaN,-31.10593649077783,-10.069898499178922,0.0668646020442028,-0.20192216441487432,-0.2687867664590771,170339316,173315302.4,29.926164620134955,22.17645958528524,NaN,NaN,-9.23596470142102,-11.726595733628617
2016-10-26T09:30:00-04:00,46.68,46.75,46.4562,46.67,3345110,4732780.85,44.0168498242289,43.98803079503957,NaN,NaN,-59.90613867427888,-19.24742509393678,0.05019458884412209,-0.20604353040392454,-0.2562381192480466,166994206,171257800.4,26.958755786945034,22.4355614841567,NaN,NaN,-9.594948505042007,-11.422074700973386
2016-10-27T09:30:00-04:00,46.79,46.87,46.4,46.61,4758562,4737641.4,43.28505439385297,44.05820793381813,NaN,NaN,-53.42217324931596,-28.48400413086848,0.03562187842487169,-0.21171077121695703,-0.24733264964182872,162235644,168794225.4,23.902561407183228,22.616736752144515,NaN,NaN,-10.090030584077802,-11.231782684274018
2016-10-28T09:30:00-04:00,46.75,47.115,46.48,46.73,5305748,4768165.3,45.24571980950808,44.04808123264196,NaN,NaN,-21.48713545745557,-28.534672925796116,0.03453363233826559,-0.20416560921899674,-0.23869924155726233,167541392,168164379.2,23.17907457763141,22.544618496750306,NaN,NaN,-10.012113187441939,-11.057544184726577
2016-10-31T09:30:00-04:00,46.74,46.89,46.655,46.75,7162100,4721283.5,45.58337312544957,44.43912768868893,NaN,NaN,-16.01327436779399,-36.38693164792445,0.03549375940067895,-0.19433204230641365,-0.2298258017070926,174703492,168362810,23.959960821066716,22.571795966635182,NaN,NaN,-9.861561715791451,-10.886689546307274
2016-11-01T09:30:00-04:00,46.85,47.04,46.22,46.48,14226947,5136791.25,41.83287375521814,44.61186878524389,NaN,NaN,-50.059544323083266,-40.17765321438554,0.019099415657716834,-0.20595153213494655,-0.22505094779266338,160476545,166390255.8,21.608501679317925,22.66545911858312,NaN,NaN,-10.700669269950975,-10.860115221113517
2016-11-02T09:30:00-04:00,46.55,46.64,46.23,46.23,5839835,5091643.65,38.66099490327933,44.69136070215274,NaN,NaN,-89.78865378605077,-46.15415623673992,-0.006080133740053423,-0.23265111496773017,-0.22657098122767674,154636710,163918756.6,19.081630882042603,22.884569659661473,NaN,NaN,-12.30833844345662,-11.067004252876817
2016-11-03T09:30:00-04:00,46.2,46.475,46.12,46.24,4241369,5042223.35,38.860688486541946,44.64733115711943,NaN,NaN,-101.17698984846494,-55.70511955656972,-0.018839675810605777,-0.25012057599093396,-0.23128090018032818,158878079,163247243.6,18.45032331218161,23.18353990344143,NaN,NaN,-13.604769288042023,-11.429542115043276
2016-11-04T09:30:00-04:00,46.24,46.65,46.17,46.4,4415660,4968463.8,42.10818868561778,44.79725615947469,NaN,NaN,-63.488169647042376,-64.10532639448708,-0.013530132619804847,-0.24819356595508424,-0.2346634333352794,163293739,162397713,17.654546363937982,23.531555041167245,NaN,NaN,-13.909001068053712,-11.783750536901909
2016-11-07T09:30:00-05:00,46.94,47.11,46.79,47.11,7098546,5168794,53.82821004665037,45.39682731165817,NaN,NaN,96.13982286509112,-41.67470694791005,0.03795698113760962,-0.18721720691326738,-0.225174188050877,170392285,161535471.6,16.859720007924594,23.7142133489427,NaN,NaN,-10.653888014711903,-11.62234160516048
2016-11-08T09:30:00-05:00,46.99,47.41,46.89,47.26,5291849,4865859.5,55.86126331520906,45.85680052936948,NaN,NaN,125.74642227821285,-6.513513627650832,0.07986385856058142,-0.12534436485015021,-0.20520822341073164,175684134,164576989.4,29.00218486856737,24.291955305141215,NaN,NaN,-7.324680516750435,-11.008390021101903
2016-11-09T09:30:00-05:00,47.23,48.37,46.85,48.26,14765147,5401209.05,66.46323497337428,47.10644099102108,NaN,NaN,234.85462071010087,58.4151412715795,0.1676321900433572,0.004332014143464846,-0.16330017589989235,190449281,171739503.6,48.19139466112119,25.706896668442646,NaN,NaN,-0.17675293607137976,-9.461013294668971
2016-11-10T09:30:00-05:00,48.48,49.06,48.46,48.82,20335357,6170624.35,70.70659009737739,48.67637066108981,NaN,NaN,330.10106861916955,144.67075296510637,0.2510827917307956,0.15055331376360215,-0.10052947796719346,210784638,182120815.4,63.563172172322496,28.113283496609288,NaN,NaN,7.461681967014424,-7.043485400142773
2016-11-11T09:30:00-05:00,48.75,48.8,47.85,48.15,6714039,6267891,60.79531004277656,49.43474454567671,NaN,NaN,193.5244500102348,196.07327689656182,0.24838451062790393,0.20995116031768646,-0.03843335031021747,204070599,190276187.4,70.8741709138961,30.943725862448098,NaN,NaN,10.231070290030642,-4.575691730117999
2016-11-14T09:30:00-05:00,48.37,48.42,47.96,48.26,8338953,6521384.7,61.7434622995508,50.6422724113311,NaN,NaN,151.5442891603782,207.15417015561925,0.24104288636238763,0.26287025764276706,0.021827371280379433,212409552,198679640.8,76.17823525606305,34.24744519358582,NaN,NaN,12.661831078257757,-2.113188471778605
2016-11-15T09:30:00-05:00,48.23,48.47,47.89,48.46,6960690,6723426.75,63.473175011301464,52.03200992469343,NaN,NaN,131.80096988041103,208.36507967605888,0.23636996888210535,0.3172898323830111,0.08091986350090577,219370242,207416862.4,80.21294182737044,38.05131562504477,NaN,NaN,15.169256376478621,0.35573222082957034
2016-11-16T09:30:00-05:00,48.35,48.54,48.2069,48.37,3716488,6775011.5,62.11222369752079,53.37680773209827,NaN,NaN,119.76364352532383,185.34688423910347,0.21456884969038323,0.3491309256138848,0.13456207592350158,215653754,212457757,82.09695477263026,42.208058008291,NaN,NaN,16.72079696802335,2.6935986132858245
2016-11-17T09:30:00-05:00,48.52,48.56,48.14,48.39,4135866,6845394.95,62.305643470812775,54.59537370790576,NaN,NaN,101.22748484109817,139.5721674834892,0.18970585339568763,0.3716943926681111,0.18198853927242348,219789620,214258753.4,82.72964879672901,46.461670452512244,NaN,NaN,18.013003121659708,4.88208497162495
2016-11-18T09:30:00-05:00,48.38,48.38,48.175,48.32,3894162,6846958.25,61.129380366682206,55.70580279656523,NaN,NaN,82.7398928918794,117.41525605981815,0.15805112344416528,0.37955244357763007,0.2215013201334648,215895458,216623725.2,83.55167616445817,50.718221548468776,NaN,NaN,18.738119185668065,6.861518430773966
2016-11-21T09:30:00-05:00,48.39,48.91,48.39,48.89,3799109,6885877.95,66.6505082620857,57.47849097562717,NaN,NaN,105.03877212555584,108.11415265285368,0.16428193402782493,0.42685373766824597,0.26257180364042104,219694567,218080728.2,84.05520372308126,55.178700265880444,NaN,NaN,21.09949801496105,8.895515514229263
2016-11-22T09:30:00-05:00,49.02,49.29,48.88,49.19,5135054,6974029.55,69.13535026188801,59.65523064409922,NaN,NaN,119.34385838154807,105.6227303530811,0.17632683707809504,0.48298034998803985,0.3066535129099448,224829621,219172604,84.43963512172951,59.8471291401438,NaN,NaN,23.874934438727866,11.03543250344335
2016-11-23T09:30:00-05:00,49.1,49.44,48.96,49.41,3498823,6981715.2,70.85059226857632,61.94022377138739,NaN,NaN,117.06261007898291,105.0825236638129,0.18587718929322372,0.5389999995264745,0.35312281023325076,228328444,221707542,85.32429750441264,64.62384158244602,NaN,NaN,26.717920539537072,13.275787937171025
2016-11-25T09:30:00-05:00,49.46,49.59,49.375,49.56,1602589,6823916.55,71.9934114574383,64.07488254080315,NaN,NaN,122.56841566622218,109.35070982883772,0.18847247194731365,0.5887134001673928,0.4002409282200792,229931033,223735824.6,86.00967733775876,69.50635093771893,NaN,NaN,29.412883953917074,15.581087368134746
2016-11-28T09:30:00-05:00,49.59,49.59,49.2501,49.36,4529691,6785113.7,68.15652750195578,65.09833378761067,NaN,NaN,105.20822751437933,113.8443767533377,0.1638066535135973,0.6049992451120758,0.4411925915984785,225401342,225637001.4,86.63952157036076,74.49062247789296,NaN,NaN,30.566973529454028,17.721928248323216
2016-11-29T09:30:00-05:00,49.19,49.6099,49,49.41,3430694,6598543.4,68.60697458066936,66.00874173514354,NaN,NaN,94.4250590842191,111.72163414507035,0.13892819547034008,0.6148528359364036,0.47592464046606353,228832036,227464495.2,87.23444780608799,78.65006983057299,NaN,NaN,31.64080183280423,19.71033876039193
2016-11-30T09:30:00-05:00,49.67,50.06,49.51,49.94,7427726,6258582.35,72.97148978563777,66.47361707887664,NaN,NaN,126.43093896520982,113.13905026180271,0.14553646209238713,0.6578452180815475,0.5123087559891604,236259762,229750523.4,87.95686962404997,81.49046089935361,NaN,NaN,33.949152835817415,21.744455056881286
2016-12-01T09:30:00-05:00,50.11,50.33,49.81,49.96,8206717,6376926.45,73.12334053424311,66.64624211008133,NaN,NaN,130.8671775740499,115.89996376081608,0.13865486589633613,0.6856273383595806,0.5469724724632444,244466479,232978130.4,88.91103976659006,83.30102287037273,NaN,NaN,35.8567636491864,23.7604991414963
2016-12-02T09:30:00-05:00,49.92,50.135,49.69,49.98,6264132,6478064.6,73.28497541618647,67.5383610653249,NaN,NaN,112.35457087163209,113.85719480189805,0.12336280718548764,0.701175981445104,0.5778131742596163,250730611,237138046,90.00967746753433,84.66784476706117,NaN,NaN,37.46910272909234,25.718871082581447
2016-12-05T09:30:00-05:00,50.18,50.54,50.06,50.37,5312900,6522926.6,76.28057188621132,68.57672603580066,NaN,NaN,134.4801106364568,119.71157142631355,0.1269322353158835,0.7364784684044707,0.6095462330885872,256043511,243266479.8,91.36670839504643,85.75273570555999,NaN,NaN,39.80034541788348,27.73051027333888
2016-12-06T09:30:00-05:00,50.37,50.44,50.05,50.43,6714811,6503739.85,76.7131942629739,69.5224416966344,NaN,NaN,120.77265029795056,124.98108966905984,0.12078742936999398,0.7605305198010797,0.6397430904310857,262758322,250051737,92.57007073087735,86.63538777009619,NaN,NaN,41.851710483338344,29.74782458905309
2016-12-07T09:30:00-05:00,50.53,51.18,50.43,51.15,7450712,6611683,81.1550602193387,70.88264430533569,NaN,NaN,160.74194358975402,131.84329059396867,0.1507204097179029,0.8281436025784643,0.6774231928605614,270209034,256841591.4,93.54037150145808,87.45277467929817,NaN,NaN,45.25780930922042,31.963536691934134
2016-12-08T09:30:00-05:00,51.21,51.69,51.1899,51.49,7007109,6223781.1,82.82143790505373,72.34805819349575,NaN,NaN,183.76204719175797,142.42226451751029,0.17710287672809177,0.8988017887706761,0.7216989120425843,277216143,263391524.2,94.31205333816241,88.28008928940055,NaN,NaN,48.69572098462701,34.353848733747405
2016-12-09T09:30:00-05:00,51.62,51.62,51.24,51.5,4492418,5431634.15,82.86941750079728,73.90091798878969,NaN,NaN,154.8264182950952,150.9166340022029,0.17841345590732038,0.9447157319267347,0.7663022760194144,281708561,269587114.2,94.92913582812193,89.09276497966225,NaN,NaN,51.4291830628121,36.79318220932807
2016-12-12T09:30:00-05:00,51.57,51.69,51.24,51.27,4737486,5332806.5,77.50743191400328,74.67641253535523,NaN,NaN,131.03420831810234,150.22745353853202,0.1482178791194959,0.9515746249187842,0.8033567457992883,276971075,273772627,95.30009607819284,89.89597157645595,NaN,NaN,52.14300856564562,38.98601454594487
2016-12-13T09:30:00-05:00,51.46,51.49,50.875,51.19,4637285,5147723.1,75.6733400117927,75.14341180320557,NaN,NaN,103.33522786303162,146.73996905154823,0.10909258722297444,0.9397224798280064,0.830629892605032,272333790,275687720.6,95.46361983449358,90.68339905593909,NaN,NaN,52.19763175024694,40.873388432273735
2016-12-14T09:30:00-05:00,51.18,51.26,50.4901,50.58,9369166,5268146.9,63.36138691719415,74.60846856382112,NaN,NaN,66.49200445768342,127.88998122513411,0.03234932944955049,0.87106655441697,0.8387172249674195,262964624,274238838.6,92.83203460970637,91.21966599203151,NaN,NaN,48.30037920213617,41.934387113682654
2016-12-15T09:30:00-05:00,50.4,51.04,50.31,50.91,6431039,5403874.45,66.53359655213355,74.21848178487078,NaN,NaN,58.14168649220159,102.76590908522284,-0.004034258846520644,0.8336744014092687,0.8377086602557894,269395663,272674742.6,89.94937885929687,91.50107324356993,NaN,NaN,45.97638313673781,42.511815116976244
2016-12-16T09:30:00-05:00,50.79,50.79,50.29,50.42,5177338,5455948.05,58.4423186815114,73.52460972626761,NaN,NaN,31.85991885543433,78.17260919729065,-0.06553518982993622,0.7557896729683691,0.8213248627983053,264218325,269176695.4,83.69021207381122,91.29040827953067,NaN,NaN,41.21250105590508,42.326198822537506
2016-12-19T09:30:00-05:00,50.27,50.46,50.13,50.32,3202265,5421353.2,56.92094185595726,72.68989310307389,NaN,NaN,7.345543582345704,53.434876250139325,-0.1145169473354477,0.6781786786289956,0.7926956259644433,261016060,265985692.4,78.33518743906988,90.65474682474367,NaN,NaN,36.93815459584759,41.55647821872466
2016-12-20T09:30:00-05:00,50.26,50.4,50.09,50.36,4426417,5452718.6,57.39866604440321,71.57754855012855,NaN,NaN,-2.4260873575945188,32.28261320601409,-0.14388874455290357,0.6128346952733139,0.7567234398262175,265442477,264607429.8,76.07108608800796,89.80576228645496,NaN,NaN,33.66131622660714,40.42859793413645
2016-12-21T09:30:00-05:00,50.55,50.586,50.3,50.38,3280135,5359972.65,57.65153955966307,70.47241990908712,NaN,NaN,6.222310567385319,20.228674427954466,-0.16037808214695148,0.5562508371425281,0.7166289192894796,268722612,265759027.4,76.67763391071578,88.93194758246393,NaN,NaN,31.073338688247965,39.09213232758095
2016-12-22T09:30:00-05:00,50.33,50.39,50.02,50.17,3315439,5350803.45,54.02534048508717,69.09673169972288,NaN,NaN,-29.069698025515372,2.7863975244110932,-0.18224107388744204,0.4888275769301771,0.6710686508176191,265407173,264961329.4,75.25465692390264,87.87801754363308,NaN,NaN,27.793369990955224,37.4780234223487
2016-12-23T09:30:00-05:00,50.31,50.31,49.97,50.27,2157398,5378543.9,55.46194545567337,67.60968695468446,NaN,NaN,-36.74591265962853,-10.934768778601478,-0.1861272337335853,0.4384096086506375,0.6245368423842228,267564571,265630578.6,75.66272735028659,86.75630461186452,NaN,NaN,25.428751510160136,35.75669886346462
2016-12-27T09:30:00-05:00,50.41,50.601,50.21,50.54,3886527,5346385.7,59.17157011276261,66.35671380109794,NaN,NaN,-7.900877120635704,-13.98405291919776,-0.16726892023240159,0.4154506920937209,0.5827196123261225,271451098,267717586.2,76.93982775505634,85.63985868502016,NaN,NaN,24.384428586609936,34.13208882391395
2016-12-28T09:30:00-05:00,50.73,50.97,49.99,50.03,3077810,5328741.5,50.59865042036093,64.17411310117096,NaN,NaN,-36.32956199955528,-20.764747847589913,-0.18453993349993936,0.3520446954511982,0.5365846289511376,268373288,268303748.4,77.30012019876288,84.47984073482765,NaN,NaN,20.7572697085366,32.22140037886005
2016-12-29T09:30:00-05:00,50.01,50.24,49.9515,50.03,2863618,5100536.1,50.598650420360926,61.87248542369291,NaN,NaN,-81.79968482437023,-38.369146925941024,-0.19058312140621592,0.29835572719336767,0.4889388485995836,268373288,268233883.6,77.14540678271074,83.25365169515251,NaN,NaN,17.85897121583819,30.169624784142638
2016-12-30T09:30:00-05:00,50.1,50.18,49.5,49.7,4929908,4936695.65,45.63679681334831,59.21301251744655,NaN,NaN,-123.98803651681057,-57.352814624200064,-0.20989758357437366,0.2265668691316165,0.43646445270599016,263443380,267841125,76.22181710453489,81.91741464346774,NaN,NaN,13.793698617707776,27.83020676036623
2017-01-03T09:30:00-05:00,49.83,50.27,49.63,49.99,7737466,5010362.35,50.253542133568935,57.26630610455839,NaN,NaN,-96.67677427412555,-69.33898694709947,-0.19647237670225703,0.19087398182816884,0.38734635853042587,271180846,268564380,76.77326884921277,80.59406984139774,NaN,NaN,11.674767734752079,25.52228689956421
2017-01-04T09:30:00-05:00,50.19,50.81,50.19,50.72,4542345,4971834.6,59.56291222090822,56.11556126235235,NaN,NaN,1.2155794679831677,-67.5156956293757,-0.13470277870826813,0.2189678851450907,0.3536706638533588,275723191,269418798.6,77.43892890739086,79.30659191803325,NaN,NaN,12.855912050631721,23.71280477828814
2017-01-05T09:30:00-05:00,50.66,50.85,50.4,50.57,3903017,4831244.9,57.19445711393938,55.67506627640558,NaN,NaN,4.373904033156317,-59.37500242283337,-0.10172244662114854,0.22651760557692313,0.3282400521980717,271820174,270108175.8,77.98709561790271,78.24623913290442,NaN,NaN,13.027645389901101,22.18635343708999
2017-01-06T09:30:00-05:00,50.57,50.66,50.3326,50.62,2947082,4606063.4,57.796874199556896,55.05101467979296,NaN,NaN,-4.385413147195423,-43.89214808739841,-0.07552017337339617,0.23383983548132647,0.30936000885472265,274767256,271386969.4,79.00609605728208,77.46457607561764,NaN,NaN,13.350545777262205,20.924095199971735
2017-01-09T09:30:00-05:00,50.58,51.09,50.53,50.61,7100596,4610737.75,57.62221081664963,54.992435546588545,NaN,NaN,43.94701846417293,-10.305137091201711,-0.05859675663196923,0.23611406306476113,0.29471081969673035,267666660,272231625.4,79.67533994775094,77.17779949518477,NaN,NaN,13.559072059943366,19.87194903711054
2017-01-10T09:30:00-05:00,50.64,50.83,50.4207,50.64,2844161,4528324.9,58.03196377918709,55.07179425539068,NaN,NaN,33.88655703380154,15.807529170383702,-0.04569004044360986,0.23759826914221804,0.2832883095858279,270510821,272097620.4,79.24373940159245,77.24269606393638,NaN,NaN,13.844618446092765,19.010901809822286
2017-01-11T09:30:00-05:00,50.55,51.075,50.55,51.05,6599903,4621445.75,63.260333608792834,55.490484795704226,NaN,NaN,110.7263316864159,37.709679614070254,-0.011622656640400963,0.2687599887853267,0.28038264542572766,277110724,272375127,79.49149814719217,77.48701121102097,NaN,NaN,15.664343565278497,18.532822060601745
2017-01-12T09:30:00-05:00,51.05,51.05,50.63,50.95,3156001,4547381.55,61.25587887191322,55.7479376037221,NaN,NaN,117.52618371170236,60.34013554977946,0.001401436959387159,0.2821344416249616,0.28073300466557444,273954723,272802036.8,79.88919919439142,77.71640873128352,NaN,NaN,16.606299240430907,18.257604514863054
2017-01-13T09:30:00-05:00,50.96,51.01,50.74,50.87,2448449,4201345.7,59.62811820506804,56.14813601229216,NaN,NaN,113.29815077932366,83.87684833508328,0.0018264185461957516,0.28301602784831914,0.2811896093021234,271506274,272149840.4,77.41919105963814,77.87101831240749,NaN,NaN,16.942057755753375,18.06966926356167
2017-01-17T09:30:00-05:00,50.74,50.86,50.48,50.64,3681657,4063876.6,55.09518853739582,56.121939089558055,NaN,NaN,58.553908785349975,86.79822639931868,-0.015244569778359529,0.262133897079174,0.27737846685753353,267824617,272181431.8,77.45555116194691,77.9990771560975,NaN,NaN,15.952747873435097,17.76725192211502
2017-01-18T09:30:00-05:00,50.78,51.01,50.61,50.96,3036690,3956844.2,59.686959880823316,56.15875264441953,NaN,NaN,100.83915670036188,100.18874633263076,-0.007252343115748405,0.268313037962848,0.2755653810785964,270861307,272251529,77.54196312524886,78.04208682539696,NaN,NaN,16.42563576708029,17.575592471395773
2017-01-19T09:30:00-05:00,51.02,51.13,50.45,50.64,3303200,3961890.95,53.76615143944095,56.38500271721096,NaN,NaN,63.95350291232285,90.83418057781213,-0.024796719868871164,0.24456948124250744,0.2693662011113786,267558107,270341005.6,69.70034722233065,77.49924589850896,NaN,NaN,15.037112958100495,17.21295254092502
2017-01-20T09:30:00-05:00,50.82,51.175,50.78,51.09,5006861,3990913.15,59.8045970273466,57.04257033199565,NaN,NaN,119.46893739931224,91.22273131533413,-0.008231121816610232,0.2590772988406158,0.26730842065722604,272564968,270063054.6,68.61322796582077,76.88980455444538,NaN,NaN,15.74268625451827,17.00291450000977
2017-01-23T09:30:00-05:00,51.09,51.27,50.895,51.19,4161091,4034960.95,61.02287687873275,58.141576050951684,NaN,NaN,128.4417771345394,94.25145658637726,0.006528129655808512,0.2754685827269867,0.2689404530711782,276726059,271107011.6,70.47582566160347,76.479376594236,NaN,NaN,16.691084096783772,16.95836729954891
2017-01-24T09:30:00-05:00,51.38,52.63,51.38,52.51,7980975,4268237.75,72.75952275956769,59.74914609566588,NaN,NaN,297.3495454219113,142.01058391368952,0.09722416466560402,0.3904706589031832,0.2932464942375792,284707034,274483495,75.53311480030763,76.39079416217135,NaN,NaN,22.313298808010813,17.723357515043467
2017-01-25T09:30:00-05:00,52.73,52.91,52.3999,52.86,8220939,4571414.8,74.9162969032817,60.845816430121126,NaN,NaN,302.5600550178595,182.35476357718906,0.1686367409925193,0.5040424204782283,0.33540567948570904,292927973,278896828.2,80.28639005216053,76.5941842439406,NaN,NaN,27.53059219508543,19.124391040763747
2017-01-26T09:30:00-05:00,52.87,53.26,52.74,53,5320588,4643117.85,75.74359323382704,62.17075472439882,NaN,NaN,254.16702755461986,220.39746850564842,0.21043318709880138,0.5984471633592108,0.3880139762604094,298248561,285034919,84.72975163096974,77.07580253058825,NaN,NaN,31.801396791518165,20.935391862300094
2017-01-27T09:30:00-05:00,52.87,52.97,52.7,52.81,4652569,4721855.8,72.26038096077677,63.20386235020023,NaN,NaN,179.1330408023675,232.3302891862595,0.20993632891284686,0.650434387401468,0.4404980584886211,293595992,289241123.8,86.90750933327668,77.64018919315929,NaN,NaN,34.00574665167124,22.80258540363883
2017-01-30T09:30:00-05:00,52.62,52.62,52.0475,52.27,6043066,4880828.2,63.34443644962748,63.612592752555805,NaN,NaN,106.44642628345939,227.93121901604349,0.16014222338558337,0.6406758377206003,0.48053361433501696,287552926,291406497.2,87.86683205889292,78.22529577252658,NaN,NaN,32.791849560075484,24.229623140272636
2017-01-31T09:30:00-05:00,52.25,52.29,51.75,51.96,5526674,4910666.5,58.85489181899111,63.67137332682751,NaN,NaN,66.12567973449237,181.6864458785597,0.09637291372129586,0.6009997564866367,0.5046268427653409,282026252,290870340.8,86.18296701438828,78.7209548877263,NaN,NaN,30.26746089907384,25.092171391529952
2017-02-01T09:30:00-05:00,51.94,52.32,51.785,52.22,10074860,5027536.2,61.33037572067215,63.53351919196175,NaN,NaN,65.33908835119176,134.24225254522617,0.0633435244464744,0.5838062483234339,0.5204627238769595,292101112,290704968.6,85.63783250892598,79.15997877070728,NaN,NaN,29.037844733423164,25.65583901180041
2017-02-02T09:30:00-05:00,52.2,52.2,51.81,51.99,5065709,5053704.4,58.005682264232114,63.30136229141309,NaN,NaN,49.15220480672444,93.23928799564709,0.019897748928861647,0.5453349100380365,0.5254371611091748,287035403,288462337,78.39588130139633,79.0533132069219,NaN,NaN,26.959231316625846,25.842037912489758
2017-02-03T09:30:00-05:00,52.07,52.1559,51.91,52.08,5541846,5135645.85,58.94358196407929,63.252466845628184,NaN,NaN,47.32812222186763,66.87830427954711,-0.00742301491648667,0.5161583924635664,0.5235814073800531,292577249,288258588.4,77.75256283215346,79.0771254763873,NaN,NaN,25.58114130222579,25.804766968166334
2017-02-06T09:30:00-05:00,51.96,52.01,51.72,51.94,2722633,5124423.4,56.817791637651,63.37550992421784,NaN,NaN,28.661036225332012,51.32122626792166,-0.03786587837838895,0.47624905940706697,0.5141149377854559,289854616,288718926.4,78.18806846409208,79.12944814082623,NaN,NaN,23.81196902759216,25.52008154808431
2017-02-07T09:30:00-05:00,51.8,51.88,51.4543,51.53,4200800,4979433.6,51.01517609661768,62.75609679677457,NaN,NaN,0.2861094198672997,38.153312204996645,-0.0858142134221781,0.40684717100773327,0.49266138442991136,285653816,289444439.2,78.88946866642483,79.2256985366245,NaN,NaN,20.462462085973794,24.797564482068523
2017-02-08T09:30:00-05:00,51.5,51.67,51.33,51.65,4689193,5071685.2,52.54282448660228,62.66871630014324,NaN,NaN,-11.852235367210593,22.715047461316157,-0.10820215818810891,0.3574086866947752,0.4656108448828841,290343009,289092818.6,77.58727324151249,79.7890503951375,NaN,NaN,18.16414891771384,23.84993368716071
2017-02-09T09:30:00-05:00,51.67,51.79,51.52,51.63,8117431,5147561.6,52.250352340479985,62.12912739393848,NaN,NaN,-6.109705569610136,11.662665386049243,-0.12208359078488418,0.3130063564017789,0.43508994718666305,282225578,288130853.6,73.98900160943234,80.17303422682403,NaN,NaN,16.213954448683733,22.759079510235427
2017-02-10T09:30:00-05:00,51.86,52.18,51.83,52.1,3477481,5163635.6,58.1463461725128,61.92366091492277,NaN,NaN,32.01328750025842,8.599698441727401,-0.09835671024883519,0.31214405937561907,0.41050076962445425,285703059,286756015.6,69.05949139206082,80.07186749328527,NaN,NaN,16.186526076312422,21.820143305389283
2017-02-13T09:30:00-05:00,52.3,52.67,52.3,52.53,3714068,5226916.55,62.685917997124406,61.20411771760539,NaN,NaN,79.51059627412731,18.769610451486464,-0.05463000163427301,0.34221326758161297,0.396843269215886,289417127,286668517.8,68.7455766922732,79.58704334271138,NaN,NaN,17.577380263601576,21.214034299419612
2017-02-14T09:30:00-05:00,52.44,52.545,52.175,52.52,3662282,5225947.8,62.51609769745557,60.31838920290352,NaN,NaN,64.65002842185119,31.64239425188324,-0.028615273817223674,0.3610741769443564,0.38968945076158007,285754845,286688723.6,68.78086840177596,78.76522036768392,NaN,NaN,18.638908648934315,20.84615920649314
2017-02-15T09:30:00-05:00,52.38,52.62,52.35,52.45,3104904,5229358.5,61.26493351658364,59.28419922310042,NaN,NaN,68.54666255496248,47.72217383631786,-0.018829647277198325,0.3661523916650822,0.3849820389422805,282649941,285150110,62.951696723037784,77.20964501711735,NaN,NaN,19.166012333034242,20.60613822457044
2017-02-16T09:30:00-05:00,52.5,52.7545,52.28,52.45,3204440,5224420.5,61.26493351658364,58.49881011994377,NaN,NaN,65.39406586079748,62.02292812239938,-0.01521893267864488,0.3659583730939744,0.38117730577261927,282649941,285234982.6,63.13728440192038,75.51177180773475,NaN,NaN,19.59967645987301,20.46235797247081
2017-02-17T09:30:00-05:00,52.35,52.42,52.11,52.3,3964137,5172284.3,58.3621394214685,58.14293176078956,NaN,NaN,21.55313009660062,59.93089664166782,-0.02520577542936908,0.3496700864859079,0.374875861915277,278685804,283831531.6,57.96632623021041,73.37602139140029,NaN,NaN,19.20382678559975,20.2825678029178
2017-02-21T09:30:00-05:00,52.27,52.62,52.18,52.47,7375933,5333026.4,60.638387001882535,58.27032427385323,NaN,NaN,41.32197954993059,52.29317329682848,-0.02271267541622618,0.3464850176449943,0.36919769306122047,286061737,283160453.6,55.62057977679659,71.19299373157232,NaN,NaN,19.467682725663153,20.16615564902428
2017-02-22T09:30:00-05:00,52.26,52.9,52.23,52.61,5114433,5189699.3,62.45853261021485,58.350906908820555,NaN,NaN,67.11552471996151,52.786272556450534,-0.014390844610662035,0.35120913729789294,0.36559998190855497,291176170,284244718.6,58.53990641790282,69.25742758221351,NaN,NaN,20.18442711303932,20.168765858169284
2017-02-23T09:30:00-05:00,52.72,52.91,52.27,52.32,3535262,4955415.45,56.618122374256984,58.251795488108044,NaN,NaN,54.93703230516592,50.064346506491226,-0.030260718183446778,0.32777408417924647,0.35803480236269325,287640908,285242912,61.078288172757205,68.02045664445357,NaN,NaN,19.209209253882666,20.031686343271197
2017-02-24T09:30:00-05:00,52.1,52.47,52.02,52.43,4812330,4930002.55,58.21422003230219,58.19969820726682,NaN,NaN,24.397116203289002,41.864956574989534,-0.034865522568052865,0.3144528991526272,0.34931842172068006,292453238,287203571.4,65.54102393515497,67.14820386609654,NaN,NaN,18.815506119842098,19.857946311352755
2017-02-27T09:30:00-05:00,52.43,52.73,52.22,52.3,6297832,5012265.7,55.61021946241405,58.11344305189276,NaN,NaN,58.06394114294883,49.16711878425918,-0.04740498210899069,0.29006219408444167,0.33746717619343236,286155406,288697491.8,68.5042898814347,66.45650539590672,NaN,NaN,17.76717723967984,19.559265015399482
2017-02-28T09:30:00-05:00,52.26,52.5,52.17,52.25,3862245,4903224.65,54.59862822533925,58.36940391823001,NaN,NaN,31.18345770419408,47.13941441511188,-0.059046931943803505,0.263658511263678,0.3227054432074815,282293161,287943776.6,65.44642232218821,65.49628779988983,NaN,NaN,16.614244675969932,19.138547824052402
2017-03-01T09:30:00-05:00,52.73,53.44,52.73,53.27,5901095,4921945.7,67.56202972048409,59.44220429207871,NaN,NaN,202.5390343787526,74.22411634687009,-0.0010965696479552922,0.3213347311475374,0.3224313007954927,288194256,287347393.8,63.048270893725416,64.45778763219076,NaN,NaN,19.714617205894307,19.220843450029818
2017-03-02T09:30:00-05:00,53.23,53.253,52.7,52.7,4574684,4646936.9,57.654944035489514,59.82824655600797,NaN,NaN,129.31810160518324,89.10033020687356,-0.004032534251757147,0.3173906329807963,0.32142316723255343,283619572,286543126.6,59.86256314787167,63.44875631350784,NaN,NaN,18.923557957329447,19.178374093929765
2017-03-03T09:30:00-05:00,52.7,52.87,52.52,52.66,2962128,4541757.85,57.023022317090984,59.74800913776356,NaN,NaN,80.13329377158239,100.24756572053222,-0.011144408091502855,0.30749265711817486,0.3186370652096777,280657444,284183967.8,51.62278231703628,62.203277093863235,NaN,NaN,18.107890634700063,19.025447885468378
2017-03-06T09:30:00-05:00,52.47,52.61,52.24,52.32,3556714,4442501.25,51.82356931018061,58.97212708869614,NaN,NaN,14.08028692749215,91.4508348774409,-0.039620743546003645,0.26911113577717316,0.3087318793231768,277100730,282373032.6,46.34890253587139,60.60351465412026,NaN,NaN,15.686932970956391,18.548517183395237
2017-03-07T09:30:00-05:00,52.35,52.4,52.005,52.03,3838142,4498276.7,47.81852465795655,57.92230044301764,NaN,NaN,-45.90933624970317,76.03227608666144,-0.07671394620292132,0.21283944656952514,0.28955339277244646,273262588,280566918,41.766017526015226,58.67388244870879,NaN,NaN,12.346400715887494,17.662500545179846
2017-03-08T09:30:00-05:00,52.07,52.57,51.95,52.03,5089134,4542693.4,47.81852465795655,56.96184266740142,NaN,NaN,-49.38230309517064,25.648008591876795,-0.09858157820081542,0.16632642002142717,0.2649079982222426,273262588,277580584.4,35.51330701945977,56.71399746988179,NaN,NaN,9.737577001665636,16.530368610392102
2017-03-09T09:30:00-05:00,52.1,52.165,51.62,51.87,4519840,4534225.75,45.565294407373905,55.840439873886446,NaN,NaN,-145.43006840342935,-29.30162540984573,-0.11974591892717465,0.11522559956327427,0.23497151849044892,268742748,274605219.6,30.598251295328495,54.38978081941094,NaN,NaN,6.8864366176037946,15.152664039993773
2017-03-10T09:30:00-05:00,52.15,52.275,51.87,52.11,4769091,4366808.75,49.4156555760167,55.20140531349703,NaN,NaN,-104.87975591026894,-66.304235346216,-0.11355998989785288,0.09302153111813283,0.2065815210159857,273511839,273176098.6,28.554072620816044,52.288905561597055,NaN,NaN,5.605456596142594,13.788777262300748
2017-03-13T09:30:00-04:00,52.17,52.27,52.03,52.26,3535187,4369694.05,51.71448707995237,54.563983890502016,NaN,NaN,-77.25631768952405,-84.57155626961924,-0.0960404818257202,0.08653091873383545,0.18257140055955565,277047026,273165357.8,28.5386411312753,50.35448137263124,NaN,NaN,5.2144638804900385,12.563875350613504
2017-03-14T09:30:00-04:00,52.05,52.09,51.75,51.81,5656510,4466816.15,45.09365743298092,53.323635663556736,NaN,NaN,-152.1313221615618,-105.81595345199096,-0.11040741014574215,0.04456213787737795,0.1549695480231201,271390516,272790943.4,27.971160720160427,48.17099953707822,NaN,NaN,2.7914507283053585,11.16781469028377
2017-03-15T09:30:00-04:00,52.03,52.73,51.985,52.64,5699045,4568654.3,56.2255938519418,53.295597911962794,NaN,NaN,20.092978780962838,-91.92089707676426,-0.06206875042322116,0.07738360999409366,0.13945236041731482,277089561,273556338,30.992046243784657,46.02198225643731,NaN,NaN,4.4333980571939255,10.205755171270935
2017-03-16T09:30:00-04:00,52.76,52.83,52.2,52.28,6540079,4740413.05,51.36157114353055,52.806122991336245,NaN,NaN,16.238519898842792,-59.58717941630984,-0.05276298804885099,0.07349862535625107,0.12626161340510206,270549482,273917684.8,32.43279193075661,43.65710854183743,NaN,NaN,4.075232145184642,9.329966167544322
2017-03-17T09:30:00-04:00,52.36,52.53,52.29,52.34,5130588,4836720.45,52.105245703803575,52.55576772286407,NaN,NaN,2.7328992846279068,-38.06464837733047,-0.04148643665407961,0.07440356758750255,0.11589000424158216,275680070,274351331,34.20803191755971,41.20737583013207,NaN,NaN,4.04274844113294,8.574649349485554
2017-03-20T09:30:00-04:00,52.38,52.655,52.18,52.6217,2755200,4776273.6,55.542184414549425,52.62316459352195,NaN,NaN,30.482881168598553,-16.51680860570594,-0.01532283629022449,0.09673645887880156,0.11205929516902605,278435270,274628979.8,35.37872104785677,39.05968288196555,NaN,NaN,5.13447113853649,8.083195319349974
2017-03-21T09:30:00-04:00,52.67,52.78,51.67,51.75,7339681,4774461,44.82324104715082,50.99896540256957,NaN,NaN,-88.60080597440553,-3.810705368274688,-0.054772230810892025,0.04359400665541102,0.09836623746630305,271095589,274569994.4,35.23527789560201,37.07304052495673,NaN,NaN,2.296695798541873,7.256552530663102
2017-03-22T09:30:00-04:00,51.71,51.94,51.37,51.9,5651396,4801309.15,46.728410341363755,50.21849871013201,NaN,NaN,-157.88485871408943,-39.406272867285146,-0.06795123282661424,0.013427196433035249,0.08137842925964948,276746985,274501479.2,35.057472319875956,35.30124832295704,NaN,NaN,0.7410041702432661,6.325759907745983
2017-03-23T09:30:00-04:00,51.82,52.28,51.7,52.12,4766377,4862864.9,49.48344590859694,49.67995753809673,NaN,NaN,-71.30353796731305,-56.91468444051632,-0.05935148562741008,0.007189072225386894,0.06654055785279697,281513362,276694255.2,44.67910730232715,34.8052715361921,NaN,NaN,0.3952660543297916,5.478546500115098
2017-03-24T09:30:00-04:00,52.09,52.23,51.44,51.66,6020295,4923263.15,44.32200684888379,49.1441316480041,NaN,NaN,-119.34299264156205,-81.3298628257543,-0.08081279065806395,-0.034475430469782964,0.04633736018828098,275493067,276656854.6,44.557848608433574,34.677339112803686,NaN,NaN,-1.6261717346992697,4.463586752284474
2017-03-27T09:30:00-04:00,51.17,51.87,51.04,51.77,4288885,4822815.8,45.778478728097106,48.99841408158557,NaN,NaN,-147.65599831435887,-116.95763872234579,-0.08343048670147843,-0.05795074818856705,0.025479738512911375,279781952,276926191,45.70073616780671,34.95839044436023,NaN,NaN,-2.765794331911662,3.4308180259707406
2017-03-28T09:30:00-04:00,51.84,52.55,51.71,52.37,3933585,4826382.8,53.00044600037472,49.368551320329736,NaN,NaN,-4.60049638387512,-100.15757680423971,-0.04263933951482765,-0.02781943588062319,0.014819903634204462,283715537,279450180.6,55.051655762619134,36.35398678315732,NaN,NaN,-1.356126541383443,2.7469688020630003
2017-03-29T09:30:00-04:00,52.29,52.55,52.23,52.41,3011362,4681896.15,53.445628120599785,49.931432299845866,NaN,NaN,52.44169175317068,-58.09226671078768,-0.012419417758394124,-0.0007043685637881936,0.01171504919460593,286726899,281446163.4,60.80066489427101,38.51130204022464,NaN,NaN,-0.11319820272666205,2.338373515664477
2017-03-30T09:30:00-04:00,52.38,52.7,52.36,52.42,2991586,4602741.25,53.56404756700295,50.22774601348774,NaN,NaN,89.04955611769488,-26.021647893786092,0.007704262913245278,0.021345377836162527,0.013641114922917249,289718485,283087188,64.78824938226865,41.09945752318554,NaN,NaN,0.9116688656763935,2.1345585656661794
2017-03-31T09:30:00-04:00,52.46,52.7,52.36,52.41,3712696,4640269.65,53.417717838049846,50.34940535335185,NaN,NaN,94.24165023741425,16.69528068200917,0.01915098582607722,0.03757984720551377,0.018428861379436553,286005789,285189732.4,69.1222731258777,43.998288379942856,NaN,NaN,1.7045717159157476,2.073131872844689
2017-04-03T09:30:00-04:00,52.43,52.6425,51.79,52.21,4515467,4688207.3,50.44927435935381,50.73194941952134,NaN,NaN,17.62235025894136,49.750950396669225,0.012390098490491223,0.03391648449255058,0.021526386002059358,281490322,285531406.4,69.77336886725203,46.9841603904494,NaN,NaN,1.5685885464644582,2.0010542547903705
2017-04-04T09:30:00-04:00,52.17,52.415,52.03,52.4,3263334,4659466.9,53.114827012804355,50.50975178815437,NaN,NaN,35.090706942587566,57.689191061961765,0.019432100025363046,0.04581651103376316,0.026384411008400117,284753656,285739030.2,70.18479065143754,49.78364213385318,NaN,NaN,2.191695575256456,2.0282887291426683
2017-04-05T09:30:00-04:00,52.56,52.9866,52.31,52.36,5004881,4655254.25,52.47482794140685,50.58927013085982,NaN,NaN,102.45021816885446,67.6908963450985,0.02003397917629343,0.05142688497876691,0.031392905802473475,279748775,284343405.4,63.88966538179075,52.0305616660699,NaN,NaN,2.5409846885049587,2.101531009051567
2017-04-06T09:30:00-04:00,52.41,52.84,52.24,52.64,3081999,4583362.2,56.43224212763813,50.89834130399087,NaN,NaN,99.63158114252252,69.80730135006402,0.03694375381388386,0.0775725980698283,0.040628844255944443,282830774,282965863.2,58.328531767550274,53.7534545124978,NaN,NaN,3.947430545785282,2.365230942870669
2017-04-07T09:30:00-04:00,52.49,52.77,52.43,52.59,2530906,4471452.95,55.542811008590036,50.89838606070805,NaN,NaN,95.03296808881335,69.96556492034384,0.042044531729769595,0.09318450891815644,0.051139977188386844,280299868,281824679,54.125432767759776,55.092505349633726,NaN,NaN,4.890994820105558,2.7260543539042246
2017-04-10T09:30:00-04:00,52.59,52.745,52.4,52.6,3461507,4467768.95,55.6932186481477,51.67481303220783,NaN,NaN,82.32831400160627,82.90675766887682,0.04320949990829869,0.10515185207376021,0.06194235216546152,283761375,282278889.6,55.4999042050557,56.53997865745185,NaN,NaN,5.7206854145537065,3.153858791139865
2017-04-11T09:30:00-04:00,52.44,52.56,52.16,52.46,3915723,4380729.6,52.99027619860606,52.12208916486799,NaN,NaN,29.763074994719194,81.84123127930316,0.03217537647249591,0.1021615727560814,0.06998619628358549,279845652,281297288.8,51.88211130683472,57.74173858509176,NaN,NaN,5.757991807304077,3.525877793449038
2017-04-12T09:30:00-04:00,52.39,52.4799,51.775,51.81,3889809,4290267.8,42.642497765114136,51.63345001176208,NaN,NaN,-64.83653181743378,48.383881282045515,-0.018546817006357588,0.04680267502563851,0.0653494920319961,275955843,280538702.4,49.21230352617864,58.06553831536687,NaN,NaN,2.705088893495738,3.408622236312852
2017-04-13T09:30:00-04:00,51.71,51.81,51.27,51.31,4193478,4172937.75,36.70483479721228,51.08936629378554,NaN,NaN,-175.45533042246268,-6.6335010309515265,-0.08187086118565304,-0.03698908445007021,0.04488177673558283,271762365,278325020.6,42.361676573199084,57.90866888427869,NaN,NaN,-1.9968897246735446,2.636406241886224
2017-04-17T09:30:00-04:00,51.45,51.7,51.35,51.68,3850971,4108956.9,43.02690249646357,50.892825134383145,NaN,NaN,-126.01067999525176,-50.842230647764545,-0.09406598243689086,-0.07270070131053075,0.021365281126360113,275613336,277387714.2,39.83323307157084,57.48956152026184,NaN,NaN,-3.98943448976346,1.6898575659362691
2017-04-18T09:30:00-04:00,51.45,51.78,51.39,51.62,2536904,4098042.1,42.289248363095965,50.127739588863236,NaN,NaN,-106.44185127239231,-88.59626370256426,-0.1008023969612078,-0.10463771507514963,-0.003835318113941836,273076432,275250725.6,34.7418235526749,56.03885921955153,NaN,NaN,-5.802991158365988,0.6194506053216609
2017-04-19T09:30:00-04:00,51.8,51.95,51.5999,51.69,3130224,3887569.25,43.50612220914703,49.417774880902336,NaN,NaN,-69.69609040904459,-108.48809678331702,-0.0952382205318607,-0.12288309377876772,-0.027644873246907013,276206656,274522926.4,33.18606470251561,54.066387777283296,NaN,NaN,-6.920081626346991,-0.4576254277738607
2017-04-20T09:30:00-04:00,51.92,52.47,51.88,52.26,4069392,3808469.05,52.32204785687603,49.32906061589326,NaN,NaN,13.068355498244308,-92.90711932018141,-0.05013005623945847,-0.0903074435462301,-0.04017738730677163,280276048,275386967.4,36.80420428162721,52.06752741295177,NaN,NaN,-5.117804578109224,-1.1233653063931983
2017-04-21T09:30:00-04:00,52.22,52.335,52.055,52.2,3591645,3749732.45,51.412560133456715,49.185835065565186,NaN,NaN,10.244701817426552,-55.76711287220356,-0.02269200262545453,-0.0685423905885898,-0.045850387963135265,276684403,276371375,40.741467480586344,50.04032700971667,NaN,NaN,-3.95182297391334,-1.527430687467504
2017-04-24T09:30:00-04:00,52.77,52.94,52.68,52.8,5566796,3727057.5,59.07378741700646,49.801871712540375,NaN,NaN,125.97484475149729,-5.370007922853754,0.03440379761634074,-0.0028456409427093377,-0.03724943855905008,282251199,277698947.6,45.65852915789536,48.31783845904833,NaN,NaN,-0.3235706939398541,-1.3554506883921256
2017-04-25T09:30:00-04:00,53.26,53.72,53.23,53.65,7882260,3906726.25,67.00993684019537,50.79437955735401,NaN,NaN,238.79860806108243,63.678083943841195,0.12297144542387069,0.11646486822078828,-0.006506577203082408,290133459,281110353,55.80638002001735,47.2908091282326,NaN,NaN,5.988956909802614,-0.3062496029357342
2017-04-26T09:30:00-04:00,53.57,53.82,53.44,53.64,3166945,3868394.25,66.84570870173863,51.820871040234856,NaN,NaN,210.57612232508308,119.73252649066674,0.17145870744355335,0.2078168071013593,0.03635809965780594,286966514,283262324.6,60.78168292636978,47.068810381416824,NaN,NaN,10.678784601280661,1.263040997666608
2017-04-27T09:30:00-04:00,53.57,53.68,53.17,53.52,4604985,3948075.4,64.79357233842617,52.41810891243399,NaN,NaN,153.1035773613166,147.7395708632812,0.1848718456443048,0.26744790671318697,0.08257606106888214,282361529,283679420.8,61.6821046772116,47.308351303535495,NaN,NaN,13.753570871773785,3.0474024082533475
2017-04-28T09:30:00-04:00,53.41,53.57,53.07,53.07,4040002,4000496.2,57.64659661029602,52.568379312555855,NaN,NaN,106.3417897355913,166.95898844691413,0.15411687427362236,0.2752221539109101,0.12110527963728773,278321527,284006845.6,62.411679710972,47.900226085193516,NaN,NaN,14.066694467015267,4.621586988076479
2017-05-01T09:30:00-04:00,53.32,53.32,52.95,53.1,3974782,4013600.5,57.97936830869354,52.73167571688055,NaN,NaN,81.27554143843061,158.0191277843008,0.12757162902283584,0.2805698159158325,0.15299818689299668,282296309,284015867.6,62.43290491465486,48.39544042159345,NaN,NaN,14.41511463782795,6.020662366612403
2017-05-02T09:30:00-04:00,53.12,53.27,52.95,53.19,3465819,3961118.1,59.019623637873664,53.16234339111396,NaN,NaN,75.05224417417351,125.26985500691903,0.10859480244947453,0.28874168995483984,0.1801468875053653,285762128,283141601.4,58.95857183165786,48.90090188765225,NaN,NaN,15.005737603195222,7.3042445432670915
2017-05-03T09:30:00-04:00,52.97,53.09,52.515,52.67,6598859,4127894.35,51.1419155963954,53.76944466477691,NaN,NaN,25.10551757392625,88.17573405668766,0.05618022623515381,0.2503721702993076,0.19419194406415377,279163269,281580952.4,53.26071971384667,49.19007447248568,NaN,NaN,13.05333609400042,8.125543336228995
2017-05-04T09:30:00-04:00,52.82,52.86,52.56,52.73,3743801,4064840.35,51.93904428264743,54.85760248516514,NaN,NaN,18.60429904644987,61.27587839371431,0.022441373953436428,0.22224366150594932,0.1998022875525129,282907070,281690060.6,53.5983446603524,49.99269362156807,NaN,NaN,11.720630645484547,8.639127237551216
2017-05-05T09:30:00-04:00,52.83,53.52,52.83,53.48,5723720,4196926.4,60.59374186688445,56.112376725909485,NaN,NaN,79.50638840060057,55.90879812671616,0.046159789614718644,0.2575020245709112,0.21134223495619256,288630790,283751913.2,59.545439950578206,51.40070839864003,NaN,NaN,13.328819030530484,9.309083207976826
2017-05-08T09:30:00-04:00,53.36,53.43,52.94,53.05,5108129,4325787.55,54.530676436149975,56.98676444541335,NaN,NaN,57.74176008488708,51.20204185600746,0.029237898346092694,0.24788960788880843,0.21865170954271573,283522661,283997183.6,60.19892911168449,53.21907308142642,NaN,NaN,12.642777464670644,9.785325244647371
2017-05-09T09:30:00-04:00,53,53.1,52.58,52.65,4693230,4387373.7,49.56253227665962,57.41936516452138,NaN,NaN,15.43080559610336,39.277754140393434,-0.01042158564024201,0.20562472749241323,0.21604631313265524,278829431,282610644.2,54.80887016414319,54.76355918582839,NaN,NaN,10.381303410174135,9.870464982579765
2017-05-10T09:30:00-04:00,52.73,52.89,52.6,52.82,3194017,4351288.4,51.58153959593408,57.36647171731124,NaN,NaN,12.806443381804378,36.817939301969055,-0.025853715279092804,0.18372916903378922,0.20958288431288202,282023448,283182680,56.53785652750894,56.173105774819945,NaN,NaN,9.225322009284511,9.778301700680442
2017-05-11T09:30:00-04:00,52.68,52.86,52.26,52.74,3340290,4323812.45,50.5559290824039,57.30528378509319,NaN,NaN,-8.42195839615266,31.41268781344855,-0.04118712094636573,0.15809898312992487,0.1992861040762906,278683158,282337897.6,53.2949758451398,57.06978494371662,NaN,NaN,7.986648242982019,9.522351206723524
2017-05-12T09:30:00-04:00,52.7,52.77,52.57,52.61,2359174,4232097.25,48.85594963291594,56.57543822908672,NaN,NaN,-13.938102836197084,12.723789566089021,-0.05875185528947574,0.12584628496444594,0.18459814025392168,276323984,279876536.4,45.166275948408234,57.03462400018183,NaN,NaN,6.461847866707822,9.085136443864139
2017-05-15T09:30:00-04:00,52.77,53.23,52.77,53.07,3263078,4202702.6,54.664990706661406,55.693656362405726,NaN,NaN,32.422234797534045,7.659884508618409,-0.03900804180506445,0.13583808799759112,0.17484612980265557,279587062,279089416.6,42.91221367879998,56.113612118666296,NaN,NaN,6.899915290589343,8.772961993396311
2017-05-16T09:30:00-04:00,53.09,53.21,53.005,53.08,3034408,4227577.8,54.78522174149785,54.83219300810281,NaN,NaN,36.540902843663076,11.881903958130351,-0.025543998157157854,0.14291613210620824,0.1684601302633661,282621470,279847824.4,45.72291549615082,55.03798587365066,NaN,NaN,7.284984239042336,8.560393742774314
2017-05-17T09:30:00-04:00,52.71,52.75,51.95,51.96,8132436,4477688.4,41.50776416147745,53.16892099546362,NaN,NaN,-134.26192763368417,-17.531770244967355,-0.0887775401748486,0.05748820504480534,0.14626574521965394,274489034,278340941.6,41.36511652590798,53.586772434271836,NaN,NaN,3.05128093422527,7.773377627267308
2017-05-18T09:30:00-04:00,51.76,52.12,51.35,51.99,6963348,4622386.2,41.91384457882672,52.045152993215815,NaN,NaN,-196.57108177818287,-55.1615949213734,-0.12317618088532878,-0.007704480887007037,0.11547169999832174,281452382,278894786.4,43.4966907075929,52.23570179117332,NaN,NaN,-0.07679709400173408,6.651924095657445
2017-05-19T09:30:00-04:00,52.09,52.66,52.08,52.44,4989333,4692270.6,47.77117861880492,51.3159965867952,NaN,NaN,-96.57000311817725,-71.68797497776943,-0.1106142682585797,-0.022796135324902878,0.08781813293367682,286441715,280918332.6,50.56746526071793,51.38817038732068,NaN,NaN,-0.8351876958536798,5.582336696870142
2017-05-22T09:30:00-04:00,52.62,52.75,52.345,52.5,2871593,4557510.45,48.51662733205448,50.56578256495097,NaN,NaN,-65.58582901748865,-91.28958774077397,-0.09391368339118451,-0.029573971305303814,0.0643397120858807,289313308,282863581.8,56.23699509187038,51.19377204876444,NaN,NaN,-1.2036158088500424,4.612914910338687
2017-05-23T09:30:00-04:00,52.61,52.735,52.47,52.54,3547953,4340795.1,49.038831514228306,50.4155622733676,NaN,NaN,-50.88548379397599,-108.77486506830178,-0.07655683619303653,-0.03135633315541497,0.04520050303762156,292861261,284911540,61.27292202909188,51.76607221413909,NaN,NaN,-1.3467628339092397,3.761532375446126
2017-05-24T09:30:00-04:00,52.65,53.01,52.64,52.89,3149903,4339943,53.48474958825948,50.52596979519704,NaN,NaN,8.245700067200247,-80.27333952812491,-0.039740566791830544,-0.00447520545216662,0.035265361339663924,296011164,289215966,69.2755882573352,52.88587532820929,NaN,NaN,-0.1383950910615617,3.204399880230742
2017-05-25T09:30:00-04:00,53.08,53.21,52.705,52.83,4853767,4352382.1,52.636974047422235,49.957629236664026,NaN,NaN,32.1753040958611,-34.52406235331611,-0.018732143598244794,0.011850181841857932,0.030582325440102726,291157397,291156969,72.0775906844767,53.78102895205918,NaN,NaN,0.6078143818502684,2.833459094747817
2017-05-26T09:30:00-04:00,52.75,52.98,52.69,52.93,2120070,4256385.5,53.94718296131356,49.91595113131857,NaN,NaN,26.74770726240329,-9.860520277200008,0.0015204521379001308,0.03248289061247789,0.030962438474577757,293277467,292524119.4,73.88419529212128,54.758547964947525,NaN,NaN,1.597973946960464,2.6569612164924807
2017-05-30T09:30:00-04:00,52.85,53.015,52.74,52.92,2798812,4197587,53.78694600826501,50.217694969290385,NaN,NaN,37.63440860215249,10.783527246728223,0.01321422689430593,0.04748022209246017,0.03426599519815424,290478655,292757188.8,74.19077181161273,56.142969511195346,NaN,NaN,2.374969231991927,2.616676647278116
2017-05-31T09:30:00-04:00,52.99,53.09,52.57,53.08,6169455,4332768.8,56.03696527246291,50.535939660471016,NaN,NaN,48.19669083472835,30.599962172469088,0.029749376429691908,0.07145271573526912,0.041703339305577215,296648110,293514558.6,75.20920679438677,57.476637387400906,NaN,NaN,3.651580259815981,2.764520020497811
2017-06-01T09:30:00-04:00,53.05,53.78,53.04,53.72,7904058,4398028.75,63.65888672276435,51.47186520621104,NaN,NaN,181.33415561722583,65.2176532824742,0.07901687980775042,0.14047443906526524,0.061457559257514824,304552168,295222759.4,77.37748405342577,59.19681654513562,NaN,NaN,7.194358640969016,3.397354109136555
2017-06-02T09:30:00-04:00,53.7,53.965,53.59,53.85,4905434,4456110.4,64.98676157993582,52.62406605956961,NaN,NaN,206.48024855747911,100.0786421747978,0.11349060050600103,0.2033208098900161,0.08983020938401508,309457602,298882800.4,81.17639349351839,61.76896779835778,NaN,NaN,10.533428663967522,4.416793331255264
2017-06-05T09:30:00-04:00,53.8,53.91,53.605,53.68,2829321,4311390.45,61.806357357145494,53.13416367746133,NaN,NaN,174.80262611152642,129.68962594462243,0.11748072823898213,0.23668111968274275,0.11920039144376061,306628281,301552963.2,83.37039287581008,64.65883774100135,NaN,NaN,12.453813994946064,5.56493914035395
2017-06-06T09:30:00-04:00,53.53,53.86,53.405,53.71,4128611,4262414.55,62.15831059040495,53.6608128809547,NaN,NaN,143.27633620623317,150.8180114654386,0.11465093179749716,0.26251405619063206,0.1478631243931349,310756892,305608610.6,86.03318970993527,67.53814304198596,NaN,NaN,14.132390443624162,6.788860755106837
2017-06-07T09:30:00-04:00,53.88,53.97,53.61,53.78,4166014,4236053.75,63.0147254507937,55.19702440162014,NaN,NaN,139.30753564155108,169.04018042680312,0.10998627550046514,0.2853459687687163,0.17535969326825118,314922906,309263569.8,87.91175510930448,70.8629029408,NaN,NaN,15.779215381871753,8.073197130358968
2017-06-08T09:30:00-04:00,53.69,54.11,53.68,53.94,3576218,4255163.8,64.96639009013208,56.843634795284814,NaN,NaN,133.1214179068534,159.39763288472864,0.10990900235797546,0.3127459462157205,0.20283694385774503,318499124,312052961,89.11503759310894,74.12135628976543,NaN,NaN,17.742215487674663,9.454485467118353
2017-06-09T09:30:00-04:00,54.06,54.69,54.06,54.63,7498298,4463064.2,71.86213617617872,58.564417477954365,NaN,NaN,173.0222445224947,152.70603207773175,0.1462839198648697,0.38569184368883214,0.23940792382396245,325997422,315360925,90.34274299279399,76.9624475563423,NaN,NaN,21.84357138109082,11.224354883400133
2017-06-12T09:30:00-04:00,54.56,54.86,54.3,54.42,5760444,4633127.7,67.50701574656117,59.92087379327627,NaN,NaN,150.4329606348851,147.83209898240347,0.14583022291263792,0.42169570246475985,0.27586547955212193,320236978,318082664.4,91.22019349387658,79.46124744219988,NaN,NaN,23.954987808988104,13.0430167299127
2017-06-13T09:30:00-04:00,54.39,55.12,54.39,55.1,3362501,4638098.85,73.17592065712284,61.64495158919731,NaN,NaN,155.87046174537932,150.3509240902327,0.1787821916714692,0.4993432191414584,0.3205610274699892,323599479,320651181.8,91.96238611414402,81.65335201970359,NaN,NaN,27.847465777158124,15.157938022376332
2017-06-14T09:30:00-04:00,55.18,55.22,54.37,54.52,5591171,4765937,63.06879089466402,62.32952596822621,NaN,NaN,120.70308154410931,146.63003327074435,0.15012705068082488,0.5082198408210203,0.35809279014019546,318008308,321268262.2,92.13441703996736,83.28612550417733,NaN,NaN,27.65032162736659,16.942564251660656
2017-06-15T09:30:00-04:00,54.14,54.34,53.81,54.04,4860124,4602321.4,56.15599548183325,62.58088464211271,NaN,NaN,57.83971856331354,131.57369340203635,0.09039951313405553,0.4710921815577649,0.38069266842370936,313148184,320198074.2,88.5929629065065,84.46579494860804,NaN,NaN,24.989272670269642,18.092094025747652
2017-06-16T09:30:00-04:00,54.04,54.05,53.72,54.02,4575143,4482911.15,55.881156692035034,62.71902562287852,NaN,NaN,39.8227229852822,104.93378909459386,0.04347750219128821,0.4350395461628196,0.3915620439715314,308573041,316713198,78.06961928959305,84.76475380557031,NaN,NaN,22.87429534203309,18.77526564235986
2017-06-19T09:30:00-04:00,54.29,54.52,54.22,54.45,2506414,4358765.2,60.37180767320488,63.18937288465994,NaN,NaN,82.16744999453456,91.28068696652376,0.03566033128405577,0.4361374580766011,0.4004771267925453,311079455,314881693.4,73.15166929205694,84.6905321970306,NaN,NaN,22.571097022028237,19.31752726802677
2017-06-20T09:30:00-04:00,54.34,54.34,54.14,54.15,3458442,4388107.65,56.082840988223126,63.192649721499954,NaN,NaN,56.835183872745255,71.47363139199695,0.006094933845440298,0.4080957940993457,0.4020008602539054,307621013,311686000.2,65.40914992456933,83.9905281349008,NaN,NaN,20.896234573472253,19.543056883090408
2017-06-21T09:30:00-04:00,54.22,54.27,53.51,53.58,4761300,4448775,48.96508221448013,62.143092256622516,NaN,NaN,-0.3234621605044313,47.2683226510742,-0.05279662447953143,0.3360050796544911,0.38880170413402254,302859713,308656281.2,59.030132708138034,82.6800030388088,NaN,NaN,16.975135587946298,19.176210983784106
2017-06-22T09:30:00-04:00,53.58,53.8366,53.54,53.64,3352112,4458885.45,49.6889146235953,61.050388902598186,NaN,NaN,-22.937895387187087,31.1127998609741,-0.08665659711286183,0.28048095774294524,0.36713755485580707,306211825,307269009.4,56.32159964431407,80.90466062100849,NaN,NaN,14.156876706294517,18.459163229857023
2017-06-23T09:30:00-04:00,53.77,54.01,53.56,53.85,3345351,4383464.65,52.242023023803895,60.367222164502365,NaN,NaN,-10.84916441094986,20.97842238172769,-0.0932821035743856,0.25053492538782507,0.34381702896221067,309557176,307465836.4,56.62568868774107,78.994324607575,NaN,NaN,12.637785385622847,17.627537823537853
2017-06-26T09:30:00-04:00,54.03,54.1,53.79,54.01,4054062,4480164.25,54.1510848913832,59.7952774717151,NaN,NaN,6.516122182759597,5.8481568193726945,-0.08546852866967125,0.2369813681251216,0.32244989679479286,313611238,307972193,57.446467526272045,76.95241588017049,NaN,NaN,11.968731834072626,16.819136967899965
2017-06-27T09:30:00-04:00,54.12,54.19,53.66,53.68,3613190,4520883.15,49.735210774416124,58.8467407091167,NaN,NaN,-26.410967459627095,-10.801073447101777,-0.10009027300923135,0.19733705553325365,0.297427328542485,309998048,308447600,58.24536677397776,74.83338814193284,NaN,NaN,10.036116273218862,15.85013401151695
2017-06-28T09:30:00-04:00,54.07,54.3,53.97,54.17,3295991,4377209.95,55.533611241882326,58.17297079138458,NaN,NaN,23.390820107893994,-6.058216993422092,-0.0754489344983102,0.20311616041959724,0.27856509491790743,313294039,310534465.2,61.649027646830724,72.87153028862727,NaN,NaN,10.178954950582938,15.039965574240663
2017-06-29T09:30:00-04:00,54.15,54.24,53.375,53.52,4405816,4202297.85,47.676690037732506,56.4454389243527,NaN,NaN,-75.39487481976622,-16.549612879937918,-0.10007016936032093,0.15347738321750626,0.2535475525778272,308888223,311069744.8,62.493564070496355,70.88230322274886,NaN,NaN,7.64323427581903,13.983289674466144
2017-06-30T09:30:00-04:00,53.61,54.05,53.6,53.81,3129348,4113493.55,51.00710902374572,55.26687415843732,NaN,NaN,-51.521422961257436,-24.68406458999943,-0.09406086087502596,0.13597147648404473,0.2300323373590707,312017571,311561823.8,63.29380398104049,68.88756111468913,NaN,NaN,6.679092465826149,12.939832930374717
2017-07-03T09:30:00-04:00,53.94,54.415,53.89,54.28,3108488,4127451.9,55.90569474086688,54.03328659299046,NaN,NaN,27.78322666192175,-20.430643694167003,-0.0574663758969228,0.1581993674879172,0.21566574338484,315126059,311864788,63.80583251842717,66.87637871499507,NaN,NaN,7.509369500695284,12.164052440420512
2017-07-05T09:30:00-04:00,54.34,54.36,53.92,54.1,5705736,4206308.15,53.69156513350923,53.36348475290798,NaN,NaN,7.245599465479389,-13.699330309145704,-0.04497054218508126,0.15945256565348842,0.20442310783856968,309420323,311749243,63.442354121201056,64.82694564936891,NaN,NaN,7.463093958821824,11.492486943049272
2017-07-06T09:30:00-04:00,53.8,54.15,53.7,53.86,4929441,4244479.5,50.802511569182364,52.98109304486148,NaN,NaN,-48.9272063132857,-28.162935593381643,-0.05196089133685666,0.13947199366749885,0.1914328850043555,304490882,309988611.6,58.01874337634416,62.643072825785886,NaN,NaN,6.517178458294566,10.781728588084315
2017-07-07T09:30:00-04:00,53.95,54.2,53.74,54.14,2623391,4196838.15,53.91790713674866,52.8408609337696,NaN,NaN,-20.449713275526037,-17.17390328453361,-0.03749474217676338,0.14456445728340128,0.18205919946016466,307114273,309633821.6,56.96197006967811,61.135383595791964,NaN,NaN,6.69517916170999,10.197935812887982
2017-07-10T09:30:00-04:00,54.13,54.695,53.9101,54.48,3855861,4014716.3,57.44207269774218,52.631594149807974,NaN,NaN,66.07680405899474,6.345742119516828,-0.006423897068499745,0.17402932812453997,0.18045322519303972,310970134,309424334.2,56.30978833584633,59.932392098919784,NaN,NaN,7.947996760630437,9.876515948279762
2017-07-11T09:30:00-04:00,54.48,54.54,54.07,54.4,2008603,3827124.25,56.35009316140851,52.650683590749786,NaN,NaN,64.69766521646075,13.728629830424632,0.006636887288369697,0.18874933430350183,0.18211244701513213,308961531,308191428.6,52.50001073680301,59.01031072836504,NaN,NaN,8.637299323914153,9.699485001941818
2017-07-12T09:30:00-04:00,54.69,55.08,54.6,55.03,2901222,3804060.3,62.410312687767394,53.611057195984586,NaN,NaN,213.6814253981209,55.01579501695293,0.05302006108312046,0.2483875233690327,0.19536746228591223,311862753,308679914.6,53.832784367106214,58.63907156114848,NaN,NaN,11.199591692147719,9.91378595768552
2017-07-13T09:30:00-04:00,55.08,55.175,54.89,54.97,2133388,3631171.15,61.53408660250381,54.45714090876377,NaN,NaN,223.23865890666315,109.4489680609427,0.07370254892244046,0.2874956484389628,0.21379309951652234,309729365,309727611.2,56.64269954675347,58.66200726846559,NaN,NaN,12.986253354338267,10.352709871493055
2017-07-14T09:30:00-04:00,55.17,55.36,55.02,55.25,3254406,3550885.25,64.06931330910417,55.30194735771379,NaN,NaN,211.80910670074206,155.90073205619632,0.09872215720171174,0.337195796018662,0.23847363881695027,312983771,310901510.8,59.60905789333345,58.87510506886504,NaN,NaN,15.271418934110608,11.055382594724133
2017-07-17T09:30:00-04:00,55.28,55.5,55.16,55.36,2989834,3471619.8,65.04403664628954,56.080015340207105,NaN,NaN,188.79561017125073,180.4444932786475,0.11407460872510888,0.3810668997233364,0.2669922909982275,315973605,311902205,61.99602024740411,59.200073120374476,NaN,NaN,17.438394346711622,11.96724141643663
2017-07-18T09:30:00-04:00,55.21,55.22,54.92,55.13,2317272,3462162.7,61.29954446334028,56.90603917513026,NaN,NaN,125.45250697989025,192.59546163133342,0.10060506799409047,0.3927486259908406,0.2921435579967501,313656333,312841165.4,64.137587258867,59.62094601215228,NaN,NaN,18.215379816823752,12.859832616491934
2017-07-19T09:30:00-04:00,55.15,55.695,55.15,55.66,3423050,3460393.1,66.13725929575544,57.66344260754977,NaN,NaN,153.5496914801031,180.56911484772985,0.11804868167640897,0.43970441009226136,0.3216557284158524,317079383,313884491.4,66.40306444803443,59.96052006938112,NaN,NaN,20.402764264151717,13.937394280443332
2017-07-20T09:30:00-04:00,55.53,55.55,55.075,55.25,4520545,3448355.35,59.89935114291582,58.53648982934857,NaN,NaN,107.34205234318308,157.38979353503385,0.0936959777913241,0.4387757006550075,0.3450797228636834,312558838,314450386,67.59865753808977,60.32516960278065,NaN,NaN,20.35209337044985,14.853779864729978
2017-07-21T09:30:00-04:00,55.09,55.2699,55.01,55.26,2723463,3416922.9,59.99845040579335,59.178728499494824,NaN,NaN,82.01982570935216,131.43193733675585,0.07101262748008452,0.433845507213789,0.3628328797337045,315282301,314910092,68.57693397652118,60.702536031029275,NaN,NaN,20.340710455813905,15.637627092027682
2017-07-24T09:30:00-04:00,55.2,55.29,54.975,55.21,2761074,3387709.05,59.210547344835774,59.41478939977832,NaN,NaN,70.66228902783173,107.80527310807206,0.046573782382498874,0.42105010771182805,0.3744763253293292,312521227,314219616.4,65.3837687818839,60.81524576413333,NaN,NaN,20.109687159425974,16.276492815941722
2017-07-25T09:30:00-04:00,55.69,55.92,55.615,55.8,4555217,3412766.8,65.04394817394218,60.225673902666394,NaN,NaN,125.79280596334405,107.8733329047628,0.06305290557805004,0.4532924573018917,0.39023955172384167,317076444,314903638.6,67.02199634514952,61.07093449441537,NaN,NaN,21.66426536867232,17.046174609188952
2017-07-26T09:30:00-04:00,55.76,55.76,55.375,55.46,3811965,3422705.55,59.741665735535754,60.86418491454878,NaN,NaN,89.6391011265306,95.09121483404832,0.04482061804206644,0.44626532427642474,0.4014447062343583,313264479,314140657.8,63.41681615717672,61.45651112161768,NaN,NaN,21.36895508083891,17.66371467656752
2017-07-27T09:30:00-04:00,55.52,55.62,55,55.26,3789289,3447370.45,56.80806040531801,61.070624433732306,NaN,NaN,57.74874291369378,85.17255294815045,0.014619975051067102,0.4197196750481922,0.4050996999971251,309475190,313523928.2,60.58016497494678,61.71495361485116,NaN,NaN,20.23516656771113,18.031064946730893
2017-07-28T09:30:00-04:00,55.31,55.48,54.85,55.06,4691189,3461639.1,53.95481423225891,60.82153454334065,NaN,NaN,34.37233947926757,75.64305570213354,-0.02153235554423677,0.3781842555668291,0.3997166111110659,304784001,311424268.2,52.04487407349776,61.41031688182626,NaN,NaN,18.432585139391797,18.08842497425388
2017-07-31T09:30:00-04:00,55.18,55.245,54.605,54.64,4509838,3530663.6,48.45131592791383,60.257336169519604,NaN,NaN,-11.602694725849869,59.190058951397226,-0.07351073316391876,0.3078281946561674,0.38133892782008616,300274163,308974855.4,44.218056404445164,60.818748715229276,NaN,NaN,15.14130456098034,17.66740777235766
2017-08-01T09:30:00-04:00,54.87,54.87,54.41,54.68,10532153,3901846.85,48.9850214886256,59.29838679815233,NaN,NaN,-43.129269540581724,25.405643850612073,-0.10316010682527488,0.2523887942884926,0.35554890111376747,310806316,307720829.8,40.83241163902262,59.89015066322331,NaN,NaN,12.63832570954013,16.94896747766944
2017-08-02T09:30:00-04:00,54.52,54.81,54.28,54.73,3219458,3777532.95,49.68625949527387,58.45211343335019,NaN,NaN,-57.88825624540646,-4.099827623775345,-0.11638652484088263,0.21006574506266418,0.3264522699035468,314025774,307873088.8,41.41890149432411,58.80273651662121,NaN,NaN,10.771288051441774,16.066441845351203
2017-08-03T09:30:00-04:00,54.91,54.91,54.26,54.32,3991785,3730650.15,44.30792635497012,57.04058579376919,NaN,NaN,-88.81013453700903,-33.411603113915916,-0.14771685865869594,0.1418061965801769,0.28952305523887284,310033989,307984848.6,41.87434219956355,57.53597110992336,NaN,NaN,7.499183707992237,14.842547825728495
2017-08-04T09:30:00-04:00,54.48,54.64,54.45,54.58,2636333,3731297.25,48.14151406234396,55.833262752058786,NaN,NaN,-90.53057163022895,-58.39218533581523,-0.14565747694178327,0.10745120906164374,0.253108686003427,312670322,309562112.8,48.01678323335768,56.53745418034861,NaN,NaN,5.803214658931266,13.551214516186034
2017-08-07T09:30:00-04:00,54.66,54.805,54.57,54.61,2528128,3664910.6,48.581324458481845,54.92481846599747,NaN,NaN,-76.43036418182665,-71.35771922701058,-0.13712410441118936,0.0817035554894403,0.21882765990062966,315198450,312546970.2,57.22834023464433,56.04393653576128,NaN,NaN,4.540098710951682,12.263912258295413
2017-08-08T09:30:00-04:00,54.5,54.55,54.065,54.18,4162009,3772580.9,42.957674216793635,53.2691338175002,NaN,NaN,-156.49345375491905,-94.03055606987803,-0.15402388513422546,0.026297803482847826,0.1803216886170733,311036441,312592995.2,57.35382899529846,55.39756257485157,NaN,NaN,1.7234447666615818,10.75813118806201
2017-08-09T09:30:00-04:00,54.14,54.295,54.05,54.23,3454863,3800262.95,43.77272046957801,52.1172316265475,NaN,NaN,-145.62996546399796,-111.57889791359635,-0.1549952289409841,-0.013422347559156833,0.14157288138182728,314491304,312686101.2,57.62467988954881,54.68513559995579,NaN,NaN,-0.3550988715498331,9.170526893831745
2017-08-10T09:30:00-04:00,54.03,54.12,53.56,53.61,6478822,4017534.65,36.75891002914765,50.45726445678709,NaN,NaN,-179.771885919003,-129.77124818999513,-0.18833658690507007,-0.09384785224951031,0.09448873465555976,308012482,312281799.8,55.96256848941896,53.7841094937342,NaN,NaN,-4.515470553037172,7.2153844014219
2017-08-11T09:30:00-04:00,53.45,53.68,53.41,53.48,3914992,4050563.95,35.475357598415954,48.76189376061425,NaN,NaN,-180.41534569771835,-147.74820300349302,-0.20851912110434523,-0.16616016672487177,0.04235895437947346,304097490,310567233.4,49.44868354513179,52.645889119680476,NaN,NaN,-8.31526856174029,4.996719692398731
2017-08-14T09:30:00-04:00,53.76,54.065,53.76,53.98,3579822,4080063.35,43.62844894530295,47.23221524428288,NaN,NaN,-110.13887198181533,-154.48990456349074,-0.17871557224261786,-0.18103551092379888,-0.002319938681181015,307677312,309063005.8,44.54944414527968,51.040706819689774,NaN,NaN,-9.132162344492086,2.9783079728429
2017-08-15T09:30:00-04:00,54.02,54.09,53.83,53.99,1986510,4063525.25,43.781448804133724,46.09219974918273,NaN,NaN,-94.68813302533039,-142.12884041757303,-0.1500073925200423,-0.1898291793312339,-0.03982178681119159,309663822,308788482,43.69851819128265,49.63225696498306,NaN,NaN,-9.7339309255814,1.1622738444965715
2017-08-16T09:30:00-04:00,54.17,54.52,54.16,54.52,5326670,4158706.25,51.32231920579318,45.70036109207382,NaN,NaN,-35.43319967120515,-120.08948725901446,-0.08996361679602141,-0.15227630780621837,-0.06231269101019695,314990492,308888319.6,44.11657118679234,48.456285980114885,NaN,NaN,-7.86687269592518,-0.12760423270653565
2017-08-17T09:30:00-04:00,54.34,54.43,53.68,53.69,4452046,4155281.3,41.85412778053596,44.83602634552218,NaN,NaN,-89.8462677096355,-102.10436361714095,-0.10001386802233159,-0.18733002603811144,-0.08731615801577985,310538446,309393512.4,46.28985065777077,48.04521287899153,NaN,NaN,-9.436578177266568,-1.457457653357969
2017-08-18T09:30:00-04:00,53.5,53.945,53.47,53.71,3768660,4207541.15,42.131167515731875,44.384587173223466,NaN,NaN,-107.98934753661791,-87.61916398492086,-0.0989978805366559,-0.21106350868659973,-0.11206562814994384,314307106,311435435.6,54.06552746251487,48.748603668853654,NaN,NaN,-10.54797628002563,-2.7561031714533493
2017-08-21T09:30:00-04:00,53.8,53.905,53.63,53.76,2701598,4204567.35,42.86408828323703,43.94737765855285,NaN,NaN,-90.53443526170875,-83.69827664089955,-0.08895888264832913,-0.22326423146035523,-0.1343053488120261,317008704,313301714,59.794641758991375,50.10304867742285,NaN,NaN,-11.203946924639324,-3.96293799333706
2017-08-22T09:30:00-04:00,53.91,54.46,53.91,54.46,3120377,4132825.35,52.02502323451556,44.11443221135583,NaN,NaN,-14.788244918505676,-67.71829901953461,-0.03210646073277537,-0.1744384247279953,-0.14233196399521994,320129081,315394765.8,65.05822974540021,51.79157212392828,NaN,NaN,-8.739044835684773,-4.645238970815305
2017-08-23T09:30:00-04:00,54.22,54.535,54.16,54.36,4109603,4147707.25,50.772612471419016,44.57619550538789,NaN,NaN,6.290404590687352,-59.3735781671561,0.00012645659967477907,-0.14217389324562646,-0.14230034984530124,316019478,315600563,65.53598773158811,53.481689661930034,NaN,NaN,-7.175675208305004,-5.006729861885262
2017-08-24T09:30:00-04:00,54.35,54.45,54.19,54.26,2665166,4091501.1,49.4895934993223,44.67248689374349,NaN,NaN,6.806626892004092,-40.04299924682818,0.015238354409389004,-0.12325240683356498,-0.13849076124295398,313354312,316163736.2,66.8709211745099,54.82841380058377,NaN,NaN,-6.295215595558422,-5.190799252409999
2017-08-25T09:30:00-04:00,54.46,54.545,54.315,54.43,2914439,4002663.6,51.723047538093844,44.89689568514434,NaN,NaN,43.4111062654456,-9.762908486415476,0.03602297615578179,-0.09346204104822675,-0.12948501720400854,316268751,316556065.2,67.80644704365437,55.5839928583702,NaN,NaN,-4.896816399583277,-5.148801702006182
2017-08-28T09:30:00-04:00,54.63,54.63,54.28,54.51,2310809,3892712.15,52.7811728433384,45.59857415846896,NaN,NaN,59.52653247941409,20.249285061809086,0.05344789375689969,-0.06267515000788393,-0.11612304376478362,318579560,316870236.4,68.57180830596377,56.38527709484629,NaN,NaN,-3.440261518534212,-4.904724532938758
2017-08-29T09:30:00-04:00,54.18,54.32,54.035,54.25,3009808,3516594.9,49.02068110180294,45.97342848934217,NaN,NaN,2.7217516706259945,23.751284379635425,0.04603374665480532,-0.05858086044627697,-0.1046146071010823,315569752,315958370.6,63.82870238027041,56.82842155846926,NaN,NaN,-3.2479671455196333,-4.668044906164598
2017-08-30T09:30:00-04:00,54.21,54.705,54.055,54.65,5141917,3612717.85,54.40304182873163,47.23372361788388,NaN,NaN,71.03282890928726,36.699769243355405,0.06545435475114678,-0.02279666366214883,-0.0882510184132956,320711669,316896808.8,66.40420269480374,57.57425257313961,NaN,NaN,-1.4575287668805013,-4.209399743409727
2017-08-31T09:30:00-04:00,54.9,55.1899,54.85,55.07,4640252,3645141.2,59.26609282578964,48.93306184841057,NaN,NaN,189.59545489063999,73.2575348430826,0.10180357672463758,0.03900345249250137,-0.06280012423213621,325351921,319296330.6,71.91140722043505,59.17873283566127,NaN,NaN,1.6472253632225728,-3.3727390138908273
2017-09-01T09:30:00-04:00,55.26,55.4863,55.125,55.43,5283697,3777509.4,62.91688456647452,50.31080724992283,NaN,NaN,224.31673762752428,109.43866111549832,0.14279674886132865,0.1156958118445246,-0.02710093701680405,330635618,322169704,76.8130525292498,61.48327629165914,NaN,NaN,5.480013631741213,-2.1080600645148215
2017-09-05T09:30:00-04:00,55.48,55.62,54.74,54.8,6827968,3992501.4,53.825289283600014,51.02822442702757,NaN,NaN,151.80775800550947,127.89490622071739,0.12104677931567345,0.12420753712778776,0.0031607578121143134,323807650,323215322,78.29725207177091,63.954614425979734,NaN,NaN,5.876811209420743,-0.9673641682383125
2017-09-06T09:30:00-04:00,54.85,55.015,54.535,54.94,6258511,4097326.5,55.36871058046353,51.31725238236117,NaN,NaN,95.54581701929257,146.45971929045072,0.1099745044881817,0.14062888842234145,0.030654383934159743,330066161,326114603.8,81.77984587826197,66.64484833251328,NaN,NaN,6.688198242549959,0.1262876047314403
2017-09-07T09:30:00-04:00,55.01,55.06,54.68,55.03,4442630,4146714.85,56.37815745619283,52.354683073479514,NaN,NaN,98.87891435241752,152.02893637907675,0.10273369145906167,0.15907149825798683,0.05633780679892516,334508791,328874028.2,84.35333652070953,69.36366875129463,NaN,NaN,7.648215378617628,1.2008487152866099
2017-09-08T09:30:00-04:00,54.99,55.07,54.765,55.01,2719220,3958734.75,56.0746406782876,53.35064544223349,NaN,NaN,93.02887438551817,132.7156202780524,0.09101984595760969,0.17011261424593727,0.07909276828832758,331789571,330161558.2,85.39023740805187,71.60114803311869,NaN,NaN,8.33367408643475,2.219823768307773
2017-09-11T09:30:00-04:00,55.31,55.875,55.21,55.73,5072313,4016600.8,63.65953434857555,54.836034446900534,NaN,NaN,173.32353258136914,122.51697926882136,0.12413406808164973,0.23426035339038975,0.11012628530874002,336861884,331406811.4,86.33355118222428,73.49678442049246,NaN,NaN,11.419971769151122,3.534130625571108
2017-09-12T09:30:00-04:00,55.98,56.39,55.97,56.2,6643687,4169794.05,67.59338516721397,55.94806029923613,NaN,NaN,208.22720370899086,133.80086840951765,0.1673724096816481,0.31934179741080015,0.15196938772915206,343505571,335346395.6,88.79784272681763,75.19247106202228,NaN,NaN,15.392695196516806,5.22821127856335
2017-09-13T09:30:00-04:00,56.21,56.23,55.9,56.18,4390288,4289982.95,67.2597288653803,57.12571147023336,NaN,NaN,165.63702165321683,147.8191093363025,0.18303759706946685,0.3807663840659856,0.19772878699651877,339115283,337156220,89.71532506503742,76.9195665858401,NaN,NaN,18.405832671815883,7.110728620456569
2017-09-14T09:30:00-04:00,56.18,56.455,56.0489,56.37,4278758,4237587.35,68.83367207889695,58.50743136877441,NaN,NaN,158.89857547256992,159.82304156033297,0.19358380026278216,0.4397085373249965,0.24612473706221433,343394041,338933270,90.53503978099432,78.60986077201756,NaN,NaN,21.388990295563556,9.150480288328996
2017-09-15T09:30:00-04:00,56.03,56.17,55.88,56.07,4700899,4250030,63.63209158483009,59.35807737211271,NaN,NaN,117.62860382715004,164.74298744865936,0.16865680202658068,0.45694573959544016,0.2882889375688595,338693142,340313984.2,91.12679424358667,80.275599857727,NaN,NaN,22.371344723800608,11.039175207682083
2017-09-18T09:30:00-04:00,56.18,56.44,56.08,56.38,4425690,4282881.5,66.45314505789591,60.33464681600968,NaN,NaN,127.49964055904793,155.57820904419515,0.16134697476312432,0.48997265602276485,0.32862568125964053,343118832,341565373.8,91.63712504930416,81.92312248225132,NaN,NaN,24.07210028850951,12.901021647800286
2017-09-19T09:30:00-04:00,56.56,56.7,56.32,56.67,3031963,4299399.75,68.88472018301923,61.75350675038227,NaN,NaN,132.1752841120039,140.36782512479775,0.16381834651915944,0.5333986144085898,0.3695802678894304,346150795,342094418.6,91.85052075846077,83.92468093783634,NaN,NaN,26.263254632266552,14.80991207415261
2017-09-20T09:30:00-04:00,56.85,56.985,56.56,56.87,4432406,4365001.2,70.47419728499463,62.90144642582964,NaN,NaN,133.96677300067003,134.0337753942884,0.16617386604373957,0.5772976004441048,0.41112373440036526,350583201,344388002.2,92.71805081736889,85.80424151801958,NaN,NaN,28.57183358403434,16.775900861278572
2017-09-21T09:30:00-04:00,56.76,56.955,56.74,56.75,3172419,4318142,68.22232872036554,63.54117756115649,NaN,NaN,118.08930334150004,125.87192096807439,0.1475328951324038,0.59553985331587,0.4480069581834662,347410782,345191350.4,92.99916231943945,87.31050973937704,NaN,NaN,29.824285981701383,18.63995587848183
2017-09-22T09:30:00-04:00,56.65,56.73,56.46,56.55,2943561,4332061.75,64.52188841055695,63.65582069287667,NaN,NaN,88.15599027272494,119.97739825718938,0.1112672508671182,0.5870910217673639,0.47582377090024575,344467221,346346166.2,93.39395241207346,88.4948597310073,NaN,NaN,29.816951449234253,20.236669531446463
2017-09-25T09:30:00-04:00,56.51,56.65,56.25,56.65,5489030,4460791.3,65.52867974412577,64.49177715434278,NaN,NaN,75.07254390185312,109.49197892575042,0.08474760636227308,0.5817582788530871,0.497010672490814,349956251,347713650,93.83714486156485,89.60485207313543,NaN,NaN,30.09072761071383,21.644392114198943
2017-09-26T09:30:00-04:00,56.7,56.77,56.38,56.4,2745321,4482516.9,60.877526351879965,64.88526399515825,NaN,NaN,68.51817918249618,96.76055793984888,0.043197430008708126,0.5510074600016992,0.5078100299929911,347210930,347925677,93.90541774722769,90.47096434949013,NaN,NaN,28.99962102455833,22.695139101393142
2017-09-27T09:30:00-04:00,56.47,56.55,55.99,56.4,3968619,4530457.45,60.87752635187997,65.20664748770733,NaN,NaN,44.98930492306179,78.96506432432724,0.010260496658501372,0.5206356508161178,0.5103751541576165,347210930,347251222.8,90.47200135853117,90.90801183790596,NaN,NaN,28.104764747001276,23.467942765051447
2017-09-28T09:30:00-04:00,56.35,56.81,56.2,56.8,4356703,4491196.75,65.43065336373334,65.87493410809631,NaN,NaN,70.03886325329306,69.35497630668581,0.00995246540817174,0.5228157359178311,0.5128632705096594,351567633,348082593,90.91304433387552,91.30249804689336,NaN,NaN,28.574757284927248,24.197487696462275
2017-09-29T09:30:00-04:00,56.76,56.875,56.53,56.8,4144433,4466405.8,65.43065336373334,66.00144260917901,NaN,NaN,80.66225873982032,67.85623000010489,0.004561996165400428,0.51856576571641,0.5140037695510096,351567633,349502675.4,91.6260808342341,91.68053587917977,NaN,NaN,28.95919609261001,24.87773175305481
2017-10-02T09:30:00-04:00,56.73,57.42,56.71,57.42,7515940,4578017.95,71.41165063580115,66.27417585693523,NaN,NaN,125.41049507768656,77.92382023527158,0.03582508441207377,0.5587851250661018,0.522960040654028,359083573,351328139.8,92.44658570724853,91.94116037778198,NaN,NaN,31.153926815706484,25.774331047719336
2017-10-03T09:30:00-04:00,57.5,57.685,57.335,57.66,3668846,4420061.85,73.33487640526079,66.70811496692671,NaN,NaN,163.36731278639508,96.89364695605137,0.0640906847852698,0.6030733966356152,0.5389827118503454,362752419,354436437.6,93.59703496281202,92.21842537048016,NaN,NaN,33.603568265095056,26.89279350734444
2017-10-04T09:30:00-04:00,57.72,57.85,57.64,57.68,3840511,4299161.85,73.49489635618205,67.04105955816136,NaN,NaN,173.3341153804489,122.56260904752881,0.07480982667739178,0.6324949951970851,0.5576851685196933,366592930,358312837.6,94.6843828249075,92.51480701647395,NaN,NaN,35.62529591715831,28.140293851603563
2017-10-05T09:30:00-04:00,57.8,58.03,57.72,58.03,3669984,4260529.55,76.18797810756566,67.93790859549961,NaN,NaN,187.4710201603854,146.04904042894728,0.09485859552678755,0.6762584129281777,0.5813998174013901,370262914,362051893.8,95.4814650300171,92.82585492979044,NaN,NaN,38.233192235966484,29.582136477941123
2017-10-06T09:30:00-04:00,57.78,57.93,57.67,57.9,2631175,4256127.3,73.21244404178414,68.42071566577734,NaN,NaN,152.78986867472608,160.4745624159284,0.08885532365639526,0.6924689719718842,0.6036136483154889,367631739,365264715,96.03205056133984,93.13977818065011,NaN,NaN,39.536386765443844,31.004172233298654
2017-10-09T09:30:00-04:00,57.96,57.985,57.7,57.89,1669516,4085987.45,72.9763408312356,68.71297428350708,NaN,NaN,134.09466071641094,162.2113955436733,0.07429343920803055,0.696480447325527,0.6221870081174965,365962223,366640445,96.24314781767133,93.45353725630801,NaN,NaN,40.53379526763511,32.365546952489574
2017-10-10T09:30:00-04:00,58.11,58.11,57.73,57.93,2572249,3882415.55,73.34660711173822,68.91814641398877,NaN,NaN,119.80149453231583,153.49823189285743,0.058152093663747295,0.6948771251971806,0.6367250315334333,368534472,367796855.6,96.41576213769763,93.71765949347436,NaN,NaN,41.46602267229957,33.66561491246243
2017-10-11T09:30:00-04:00,57.9,57.96,57.66,57.96,2016799,3763741.1,73.63834220450406,69.30500451999866,NaN,NaN,97.64874443232144,138.36115770323195,0.0410962114869311,0.6880952958920972,0.6469990844051661,370551271,368588523.8,96.53319717128984,93.9700905543208,NaN,NaN,42.326863444384905,34.9029361313085
2017-10-12T09:30:00-04:00,57.84,58.15,57.82,58.07,3188107,3709208.55,74.73050854543351,70.03419167248985,NaN,NaN,101.12104981738777,121.09116363463242,0.0293729595201061,0.6837152838052987,0.6543423242851926,373739378,369283816.6,96.63740134243443,94.20176547791802,NaN,NaN,43.35796252691678,36.11079704496682
2017-10-13T09:30:00-04:00,58.44,58.5,58.32,58.35,3357867,3642056.95,77.30768898669078,70.8755494755302,NaN,NaN,126.23420745302163,115.78003139029154,0.03238870503126612,0.6948282055742752,0.662439500543009,377097245,371176917.8,96.90975871367044,94.42123789592556,NaN,NaN,45.00490393298098,37.38138374325456
2017-10-16T09:30:00-04:00,58.61,58.64,58.14,58.31,3313103,3586427.6,76.1134361084671,71.96382874385786,NaN,NaN,110.15773964292084,110.99264717559352,0.02398900542482907,0.6924257573240453,0.6684367518992163,373784142,372741301.6,97.11752889710023,94.65067440663074,NaN,NaN,46.07596613313583,38.62346694180903
2017-10-17T09:30:00-04:00,58.24,58.28,58.01,58.16,2741054,3571882.15,71.64383872096433,72.73285105593531,NaN,NaN,80.05430951199841,103.04321017153002,0.0018000332900429683,0.67068679351177,0.668886760221727,371043088,373243024.8,97.18294603752325,95.13002759798732,NaN,NaN,45.82156549952183,39.651766735768
2017-10-18T09:30:00-04:00,58.18,58.22,57.97,58.02,4439289,3572226.3,67.65081778788212,72.8914342290888,NaN,NaN,65.84090428903495,96.68164214287273,-0.027234531139870177,0.6348435962968892,0.6620781274367594,366603799,372453530.4,93.58382111179104,95.32079736783842,NaN,NaN,44.51615348313027,40.346679128248326
2017-10-19T09:30:00-04:00,57.9,58.24,57.7,58.24,2725386,3549874.65,70.43900021798845,73.24917329010701,NaN,NaN,60.0741386829489,88.47225991598495,-0.03600130837463833,0.6170764919684615,0.6530778003430998,369329185,371571491.8,89.59175147241791,95.17548812770869,NaN,NaN,44.104947434424055,40.88357460055914
2017-10-20T09:30:00-04:00,58.46,58.74,58.44,58.74,4737369,3639565.05,75.58868906829736,73.54753317814246,NaN,NaN,117.03762736950034,86.63294389928069,-0.013654060165676052,0.6360102251360047,0.6496642853016807,374066554,370965353.6,86.8499521459837,94.77572858761835,NaN,NaN,45.29739954905159,41.51412102177235
2017-10-23T09:30:00-04:00,58.92,59.17,58.6,58.63,3146515,3522439.3,72.59255450527274,73.49451018528616,NaN,NaN,131.399961250982,90.88138822089293,-0.01187427782933681,0.6348214380150097,0.6466957158443465,370920039,370392533,84.2266470252911,94.10641516350972,NaN,NaN,45.36851333030906,42.06474849442045
2017-10-24T09:30:00-04:00,58.78,59.0482,58.74,58.96,4225181,3596432.3,75.70389216482012,73.65229560018888,NaN,NaN,143.4812023974995,103.56676679799314,0.0050277521859174445,0.6529804060767432,0.6479526538908258,375145220,371212959.4,84.92880154303526,93.40958792909028,NaN,NaN,46.40719702860952,42.68509828501889
2017-10-25T09:30:00-04:00,58.96,59.03,58.3901,58.65,5658901,3680946.4,67.90532436851102,73.06067747597069,NaN,NaN,108.79338392420769,112.1572627250277,-0.01033268237053997,0.6350368009276508,0.6453694832981908,369486319,371789463.4,85.41995249808333,92.69090846252358,NaN,NaN,44.76735785134608,42.982563937351344
2017-10-26T09:30:00-04:00,59.15,59.6175,58.93,59.43,6992972,3812759.85,74.90907794289761,73.18186561176451,NaN,NaN,182.80361128441822,136.70315724532156,0.024475418503083324,0.6759637564270449,0.6514883379239615,376479291,373219484.6,86.58756730605262,92.01630251571736,NaN,NaN,45.769728568018536,43.380730313160946
2017-10-27T09:30:00-04:00,59.38,59.38,58.78,59.12,5191108,3865093.6,68.51018585083327,72.86285454173577,NaN,NaN,130.50058658993143,139.39574908940776,0.019286449301901376,0.6755963995513383,0.656309950249437,371288183,372663810.4,83.779916961592,91.12607174028312,NaN,NaN,44.23587085384677,43.502893247544634
2017-10-30T09:30:00-04:00,59.05,59.17,58.72,58.84,5245711,3751582.15,63.25435044325049,72.14197906541521,NaN,NaN,92.02238618193125,131.5202340755976,-0.008829322014946905,0.6452732977307534,0.6541026197457003,366042472,371688297,78.94058395995751,89.87784472758742,NaN,NaN,41.122943094723944,43.16290036857025
2017-10-31T09:30:00-04:00,58.91,59.15,58.89,59,4005945,3768437.1,64.91090379503453,71.51859060759597,NaN,NaN,96.77792807614065,122.17957921132583,-0.021741397649754135,0.6269258726835076,0.6486672703332618,370048417,370668936.4,74.1224941211256,88.27708022400425,NaN,NaN,39.227090735161646,42.600641849511874
2017-11-01T09:30:00-04:00,59.3,59.48,59.07,59.29,5601046,3856463.85,67.74886948144162,71.01990210302513,NaN,NaN,120.33244901544955,124.48739222957423,-0.016101369695251333,0.6285405582141976,0.644641927909449,375649463,371901565.2,76.02782802004997,86.80496784383391,NaN,NaN,38.611274032829826,42.03073216141444
2017-11-02T09:30:00-04:00,59.37,59.37,58.73,58.86,12818828,4313906.05,59.99995253935065,69.7836352139294,NaN,NaN,69.752707950131,101.87721156271677,-0.04504092188023079,0.5883407755591605,0.6333816974393913,362830635,369171834,64.67159029449792,84.50224152817874,NaN,NaN,35.4009917476134,41.083626388014295
2017-11-03T09:30:00-04:00,58.9,58.9048,58.5544,58.83,3791017,4371898.15,59.48872866947527,68.59615611114427,NaN,NaN,32.13447804676777,82.20398985408403,-0.06850750293408636,0.5477473187717834,0.6162548217058698,359039618,366722121,56.51340815211949,81.60194718925155,NaN,NaN,32.75374676453004,39.8936435846594
2017-11-06T09:30:00-05:00,58.75,58.995,58.52,58.58,3698343,4473339.5,55.26303160575429,67.42609846005783,NaN,NaN,17.052169508693638,67.20994651943651,-0.10119731833955581,0.48975817378142494,0.5909554921209808,355341275,364581881.6,50.51751768909656,78.26870230722106,NaN,NaN,29.186887837862574,38.36410704940271
2017-11-07T09:30:00-05:00,58.67,58.76,58.46,58.64,3625964,4526025.25,56.06957000911674,66.5988664758603,NaN,NaN,-2.2973313192344396,47.3948946403615,-0.11794029926988203,0.4435301180336282,0.5614704173035102,358967239,362365646,45.17288047768377,74.8107779762134,NaN,NaN,26.56946748299719,36.67915853991621
2017-11-08T09:30:00-05:00,58.73,58.81,58.54,58.7,2566659,4553518.25,56.90624638787447,65.63224120228074,NaN,NaN,2.1645021645032756,23.761305270172237,-0.1235416087669644,0.40704340634480474,0.5305850151117691,361533898,359542533,39.44763377890437,71.22905528381958,NaN,NaN,24.673056622839034,34.9640011231909
2017-11-09T09:30:00-05:00,58.4,58.495,58.02,58.2,4727059,4630465.85,48.599559767424516,63.704446252218396,NaN,NaN,-100.97581671616693,-10.384399663087342,-0.15732221998179136,0.33393224013452993,0.4912544601163213,356806839,358337773.8,37.27639778024453,67.6880871148382,NaN,NaN,20.309497890508382,32.87050066137911
2017-11-10T09:30:00-05:00,58.01,58.265,57.985,58.11,2850003,4605072.65,47.262227685797576,61.89513719368445,NaN,NaN,-118.2455387476332,-40.46040302196754,-0.18047042480221598,0.2656664291135513,0.4461368539157673,353956836,357321217.4,35.5008174027773,64.20767071323007,NaN,NaN,16.35789300223151,30.511556710072313
2017-11-13T09:30:00-05:00,57.89,58.49,57.7,58.41,2704230,4574629,52.00335122255768,60.20224141209428,NaN,NaN,-96.29051828740164,-63.12894058118659,-0.17044075863886388,0.23308590561718745,0.4035266642560513,356661066,357585175.6,36.34863510971937,60.73765882513607,NaN,NaN,14.370780216593133,28.205731496718144
2017-11-14T09:30:00-05:00,58.06,58.12,57.73,57.88,3686724,4621912.5,44.40781866091814,58.52384814726622,NaN,NaN,-147.4901297236357,-92.16750026206684,-0.19272180938167693,0.16262440252895516,0.3553462119106321,352974342,356386596.2,34.15331683172937,57.07575627753937,NaN,NaN,10.067716928242103,25.614586558364422
2017-11-15T09:30:00-05:00,57.53,57.68,57.26,57.53,5480646,4673980.35,40.22909180106625,56.04670627999254,NaN,NaN,-203.12091100094858,-133.2245828951572,-0.2221601505466566,0.07764602372731133,0.29980617427396794,347493696,353578555.8,29.637176413282248,53.00787121377006,NaN,NaN,5.034841107454481,22.674622922520147
2017-11-16T09:30:00-05:00,57.73,58.3,57.68,58.23,3507354,4713078.75,50.3016771460159,54.74609851536273,NaN,NaN,-99.30416676029445,-132.8902529039827,-0.18702644127005785,0.06602312268639565,0.2530495639564535,351001050,352417398,27.989032927399492,49.02280806847059,NaN,NaN,4.112981570177714,20.022959872185513
2017-11-17T09:30:00-05:00,58.08,58.495,58.03,58.31,2825905,4617505.55,51.311520344725196,53.89303922261093,NaN,NaN,-55.3903661541063,-120.31921838527732,-0.15240266931689464,0.06254622731033521,0.21494889662722985,353826955,352391421.8,27.951584491466676,45.3807366778641,NaN,NaN,3.744775861139498,17.697505013464653
2017-11-20T09:30:00-05:00,58.26,58.5552,58.18,58.39,4159083,4668133.95,52.3541309729608,52.99612687817709,NaN,NaN,-34.8183260690525,-108.02477994160749,-0.11956619502652963,0.06549115284406781,0.18505734787059744,357986038,352656416.2,28.995291736756045,42.15736507898057,NaN,NaN,3.786026952999226,15.710151004826734
2017-11-21T09:30:00-05:00,58.72,58.99,58.63,58.7,3100151,4611882.45,56.26258853576877,52.17567823920045,NaN,NaN,33.5184304668752,-71.82306790350533,-0.07462072830521202,0.09178143748908241,0.16640216579429443,361086189,354278785.6,35.18574606501569,39.24007351076385,NaN,NaN,5.07297866651143,14.190554956495976
2017-11-22T09:30:00-05:00,58.76,58.78,58.54,58.54,2375836,4447729.2,53.80912801113207,51.73347648718483,NaN,NaN,8.132966635767133,-29.57229237616219,-0.05426592161300545,0.09856976377803761,0.15283568539104306,358710353,356522117,42.633451169204235,37.66592071610001,NaN,NaN,5.377035801011591,12.931480791426779
2017-11-24T09:30:00-05:00,58.67,58.91,58.64,58.84,1223172,4159239.2,57.54723163951038,51.59479812790163,NaN,NaN,45.336222196499996,-0.6442145848032951,-0.02091128845997045,0.12669657481608,0.14760786327605044,359933525,358308612,47.77963075232398,37.04207947325748,NaN,NaN,6.807049994095676,12.056562106093764
2017-11-27T09:30:00-05:00,58.87,58.87,58.48,58.49,3801194,4089743.5,52.23598535447247,51.37858053852437,NaN,NaN,17.42767669984077,13.91939398598611,-0.022590941340752096,0.11936918660011031,0.1419601279408624,356132331,358769687.2,49.04998593519265,36.93725577655006,NaN,NaN,6.370839426806563,11.244316009052735
2017-11-28T09:30:00-05:00,58.59,59.17,58.56,59.14,4400650,4047490.45,59.67877460691539,51.63638086693856,NaN,NaN,82.04979301410096,37.29301780261681,0.017727797341547114,0.1641198746177963,0.1463920772762492,360532981,359279075.8,50.483164323405965,37.31656176553022,NaN,NaN,8.52124077882548,10.855305261877414
2017-11-29T09:30:00-05:00,59.21,59.27,59.02,59.23,3869076,4040647,60.59437702907699,51.899818769881584,NaN,NaN,119.4737273730369,54.48407718384915,0.04647844233225329,0.2044901301915658,0.15801168785931252,364402057,359942249.4,52.36193072599719,38.23901154746542,NaN,NaN,10.507900710184579,10.80567604020701
2017-11-30T09:30:00-05:00,59.36,59.97,59.25,59.56,7508643,4136026.85,63.83698164323693,52.98820604672534,NaN,NaN,188.23890265452803,90.50526438760133,0.08168157953422384,0.2601136622770923,0.17843208274286848,371910700,362582318.8,59.02681250129072,39.792612598968724,NaN,NaN,13.238027780676878,11.153154860274133
2017-12-01T09:30:00-05:00,59.67,59.75,58.615,59.07,8183852,3904278.05,56.413831887680466,53.64189206114555,NaN,NaN,104.29605708876535,102.29723136605439,0.06656695405338625,0.2616407753096013,0.19507382125621503,363726848,363340983.4,60.727205332537444,41.59449745109445,NaN,NaN,13.152310899006423,11.438748580093032
2017-12-04T09:30:00-05:00,59.49,60.1662,59.47,59.68,6523438,4040899.1,62.292302255279225,54.37681713491137,NaN,NaN,186.40384541581975,136.0924651092502,0.09075417402949654,0.3085165387930857,0.21776236476358918,370250286,366164574.4,66.32806002054681,43.73588494472498,NaN,NaN,15.129067653434616,11.96593701914183
2017-12-05T09:30:00-05:00,59.7,59.8,59.36,59.38,8226523,4267308.1,58.13930554784672,55.35763762683484,NaN,NaN,126.00283747366119,144.88307400116224,0.08002617410174184,0.3177950823907665,0.23776890828902464,362023763,366462730.8,66.86542691593237,46.07246423645376,NaN,NaN,15.319242996574104,12.444980730203584
2017-12-06T09:30:00-05:00,59.27,59.4,59.01,59.03,4038694,4287944.6,53.645712916256606,56.315967706491286,NaN,NaN,65.46225849587533,134.08078022572994,0.044603091212561286,0.29352277230472623,0.24891968109216495,357985069,365179333.2,62.259567883332444,48.40263505574306,NaN,NaN,13.966125932642104,12.662287187694801
2017-12-07T09:30:00-05:00,58.97,59.44,58.85,59.43,3580298,4338626.55,57.67219894414743,56.84243354921496,NaN,NaN,70.454020357901,110.52380376640451,0.043320133681427675,0.30306984819394955,0.2597497145125219,361565367,363110266.6,55.60909156736124,50.375496387168894,NaN,NaN,14.187666819840544,12.880198563715622
2017-12-08T09:30:00-05:00,59.5,59.7,59.295,59.43,5135190,4359033.1,57.67219894414743,57.29676773488798,NaN,NaN,91.42262244162633,107.94911683697671,0.03787699919987053,0.30709596351236,0.2692189643124895,361565367,362677970.4,54.30391455071662,52.25780567711532,NaN,NaN,14.359405505533237,13.091513841118138
2017-12-11T09:30:00-05:00,59.59,59.76,59.42,59.51,5228742,4477970.05,58.50818321120189,57.73634289476234,NaN,NaN,92.87664242888272,89.2436762395893,0.03513076826818945,0.3131324246477263,0.27800165637953683,366794109,361986735,52.19442690045129,53.91488676023641,NaN,NaN,14.746303602240577,13.327912378421344
2017-12-12T09:30:00-05:00,59.63,59.71,59.46,59.52,6014525,4643484.8,58.61820442306272,57.90460117242619,NaN,NaN,84.53299924591461,80.94970859404,0.029671559602894804,0.31509110588315536,0.28541954628026056,372808634,364143709.2,57.71445675665044,55.524080381067456,NaN,NaN,15.090667053953444,13.57973447492593
2017-12-13T09:30:00-05:00,59.56,59.76,59.535,59.68,4181825,4668239.85,60.42631557577128,58.37725742704328,NaN,NaN,89.99930110459326,85.8571171157836,0.03230311187880275,0.325798436128764,0.2934953242499613,376990459,367944787.2,65.31509297750912,57.144197653089236,NaN,NaN,15.885766398079348,13.90916760680499
2017-12-14T09:30:00-05:00,59.83,59.83,58.99,59.02,4184542,4603434.65,50.60408723733027,57.88131854117328,NaN,NaN,31.998328840225753,78.16597881224854,-0.012536263606865217,0.2778249947413798,0.290361258348245,372805917,370192897.2,68.87812146866119,58.65123270425618,NaN,NaN,13.634856530894785,13.86998031024639
2017-12-15T09:30:00-05:00,58.96,59.25,58.87,59.08,5028992,4679516.55,51.37785393382119,57.82002343969818,NaN,NaN,-11.890900968014273,57.50327413032041,-0.03880165216297948,0.24185919314452065,0.28066084530750013,377834909,373446805.6,73.17361749960624,60.374349244571434,NaN,NaN,12.035883018782604,13.60796641146585
2017-12-18T09:30:00-05:00,59.47,60,59.43,59.95,4871311,4781786.85,60.93378556094895,57.90966707927201,NaN,NaN,115.42411737735385,62.01276912001464,-0.0002676059736064218,0.2803263378404921,0.2805939438140985,382706220,376629227.8,76.57848117991657,62.2383004486079,NaN,NaN,13.653179634506305,13.614425443328772
2017-12-19T09:30:00-05:00,59.99,60.09,59.83,59.88,3154826,4731574,59.913487685565336,57.86103212616404,NaN,NaN,130.78323345577357,71.26281596198643,0.016873458104377903,0.3016857664445709,0.284812308340193,379551394,377977779.8,77.86079472229437,64.05964787691485,NaN,NaN,14.611421362994612,13.756853431852463
2017-12-20T09:30:00-05:00,60.16,60.19,59.895,59.9,4758526,4814492.75,60.11895935220972,57.595459105376385,NaN,NaN,127.0511053998063,78.67317682102905,0.025412384262062937,0.31657778866777164,0.2911654044057087,384309920,379441672,79.19254910720177,65.50005763447993,NaN,NaN,15.437025273200097,13.99687798061641
2017-12-21T09:30:00-05:00,60.17,60.24,59.88,60.11,3211897,4856295.8,62.303825960866384,58.0161729677468,NaN,NaN,131.45346020549184,98.56420309408225,0.04017946856454391,0.34138974011138856,0.30121027154684465,387521817,382384852,81.59028616904155,66.99027769423022,NaN,NaN,16.776923174693763,14.394027294056032
2017-12-22T09:30:00-05:00,60.21,60.39,60.09,60.34,3005570,4945415.7,64.59182190798049,58.18042437151117,NaN,NaN,156.60769145242324,132.26392157816977,0.059260902912147695,0.3752864001870293,0.3160254972748816,390527387,384923347.6,83.37025553667371,68.20757737395355,NaN,NaN,18.59225297510857,14.99377381992068
2017-12-26T09:30:00-05:00,60.37,60.44,60.25,60.29,1659846,4838348.3,63.68685102846174,58.57667762012654,NaN,NaN,154.83546162448113,140.1461904275952,0.06204219451217119,0.3935782404150956,0.3315360459029244,388867541,386155611.8,84.17036339447507,69.44364426527804,NaN,NaN,19.835103086972776,15.685392286642408
2017-12-27T09:30:00-05:00,60.4,60.485,60.32,60.37,4186580,4827644.8,64.54283521514893,59.35504349861885,NaN,NaN,146.51244304242107,143.2920323449247,0.06261596210787668,0.4098059985377702,0.34719003642989354,393054121,388856157.2,85.78455723444301,71.12400064750021,NaN,NaN,21.11272169174118,16.460725058799376
2017-12-28T09:30:00-05:00,60.44,60.65,60.305,60.64,1565375,4712459.75,67.3409399844331,60.04566785863926,NaN,NaN,149.164539070726,147.71471907910865,0.07375866026085276,0.4393883617559595,0.36562970149510676,394619496,390918072.4,86.88427453858228,73.35794228830171,NaN,NaN,23.028916357300737,17.39903810144243
2017-12-29T09:30:00-05:00,60.87,60.87,60.47,60.53,2484820,4461268.6,65.0873737914662,60.57532320487632,NaN,NaN,141.32742606966303,149.6895122519429,0.06652281752601175,0.44878322340262145,0.3822604058766097,392134676,391840644.2,87.3556126088279,75.7187778638811,NaN,NaN,24.042938260756408,18.34816669563014
2018-01-02T09:30:00-05:00,60.85,61.41,60.69,61.39,8979239,4501037.95,72.76199417196662,61.59345255921665,NaN,NaN,192.0926096644606,156.78649589435037,0.10989849119282374,0.5196335198676394,0.40973502867481565,401113915,393957949.8,88.38706732127687,78.30396646536863,NaN,NaN,27.54252566532518,19.661646548443716
2018-01-03T09:30:00-05:00,61.55,61.89,61.41,61.82,4952274,4422479.75,75.64483193556529,62.809640238681126,NaN,NaN,215.14247897450676,168.8478993643555,0.1550305820104606,0.6035232561878914,0.4484926741774308,406066189,397397679.4,89.83744387157394,80.59846554500602,NaN,NaN,31.518862414126374,21.355534529255525
2018-01-04T09:30:00-05:00,62.08,62.4872,62.05,62.36,4120092,4217158.2,78.69446339131058,64.11450793979107,NaN,NaN,225.94093275491554,184.7335973068544,0.20556425925695931,0.7054479982486299,0.4998837389916706,410186281,400824111.4,91.0381556110613,82.43582716168832,NaN,NaN,36.03059624212631,23.451971916808493
2018-01-05T09:30:00-05:00,62.63,62.925,62.49,62.86,4671998,4248823.4,81.05935829007976,66.2898844435589,NaN,NaN,219.38372586218608,198.77743466514642,0.2538132582858108,0.817150311848934,0.5633370535631232,414858279,404871868,92.20920340653558,84.10233301439364,NaN,NaN,40.680750073234364,25.913225939155044
2018-01-08T09:30:00-05:00,62.92,63.01,62.6444,62.95,4539115,4296764.25,81.4583149828679,68.4384888042051,NaN,NaN,184.41215540118134,207.39438053145008,0.2713572390906174,0.902533602426395,0.6311763633357776,419397394,410324411.6,93.45069042384138,85.55069536612473,NaN,NaN,44.43133840315885,28.558670576869872
2018-01-09T09:30:00-05:00,63.03,63.32,62.81,62.85,4755486,4277779.05,79.45569623438556,69.76148242373628,NaN,NaN,157.78747457277387,200.53335351311273,0.25599239070062774,0.9511668517115623,0.6951744610109346,414641908,413030010.2,93.96463115193832,86.79256322126913,NaN,NaN,46.804829620670354,31.165264725984226
2018-01-10T09:30:00-05:00,62.73,62.74,62.34,62.47,4220417,4227362.8,72.19256930394498,70.63855968219197,NaN,NaN,106.83347576985427,178.87155287218224,0.20235397215383943,0.9481169262032338,0.7457629540493944,410421491,413901070.6,94.12448856482813,87.95425563859297,NaN,NaN,46.546766761124196,33.36262215957565
2018-01-11T09:30:00-05:00,62.72,63.29,62.67,63.29,5821321,4217702.6,77.06469103326351,71.84896908798153,NaN,NaN,121.07508132160575,157.89838258552027,0.20365822679520051,1.000335737543395,0.7966775107481945,416242812,415112376.8,94.3486552738391,89.03683465049565,NaN,NaN,47.976056055728776,35.450255573311814
2018-01-12T09:30:00-05:00,63.53,63.57,63.17,63.39,4548754,4236049.05,77.58057562394134,72.94016549248688,NaN,NaN,119.65799088748382,137.95323559057982,0.1929182171475491,1.0378252821826308,0.8449070650350817,420791566,416299034.2,94.56732819412069,89.96376622371558,NaN,NaN,49.25838014061707,37.42284479721256
2018-01-16T09:30:00-05:00,63.58,63.66,62.26,62.65,8512923,4452468.1,65.7879452511703,73.02560287414329,NaN,NaN,81.50387341683984,117.37157919371153,0.12114556778540664,0.99633902476684,0.8751934569814334,412278643,414875284,90.06445457306633,90.44192329774363,NaN,NaN,46.28195691215477,38.68843224220431
2018-01-17T09:30:00-05:00,63.1,63.22,62.68,62.94,10849439,4743490.45,67.85039908673635,73.32299916402005,NaN,NaN,77.97734352563971,101.40955298428467,0.08033736160517302,0.9756151589878996,0.8952777973827266,423128082,416572518.8,90.63680935843273,90.90381229516917,NaN,NaN,44.57485650316324,39.52934999376987
2018-01-18T09:30:00-05:00,62.75,63.13,62.53,62.9,5893749,4794612.35,67.2482105455401,73.51624025904799,NaN,NaN,66.40188220822719,93.32323427195925,0.039833367973232114,0.9450695073492668,0.9052361393760346,417234333,417935087.2,91.08102088155924,91.28213112710604,NaN,NaN,43.053629888928214,40.03281855022106
2018-01-19T09:30:00-05:00,63.19,63.3125,62.93,63.28,4933242,4883533.15,69.97453829372738,73.70435442399757,NaN,NaN,77.44664839738402,84.59754768711491,0.028355965649190296,0.9406810964375225,0.9123251307883322,422167575,419120039.8,91.46044801911238,91.60900066142962,NaN,NaN,42.615483953373165,40.40177075067136
2018-01-22T09:30:00-05:00,63.19,63.19,62.79,63.13,5718967,4931555.2,67.58302391720918,73.88261514726493,NaN,NaN,64.14279704048336,73.49450891771482,0.0017855420088551677,0.9145570582994011,0.912771516290546,416448608,418251448.2,88.48877675878126,91.68994095785487,NaN,NaN,41.52672160924801,40.56247801618231
2018-01-23T09:30:00-05:00,63,63.17,62.67,63.12,4021486,4972034.65,67.41759948093178,73.50087266933387,NaN,NaN,56.83183951419166,68.56010213718518,-0.023921626156287568,0.8828694835951865,0.906791109751474,412427122,418281144,88.50253090947604,91.69818835701196,NaN,NaN,40.60491590575289,40.56854057183525
2018-01-24T09:30:00-05:00,63.28,63.71,63.12,63.39,5744187,5108965.5,69.58248167964408,73.06784765105378,NaN,NaN,82.10433905114195,69.38550124228564,-0.029816642185523046,0.8695203070195703,0.8993369492050933,418171309,417289789.4,84.85733905722263,91.3424665845583,NaN,NaN,40.42947749510334,40.548674418016404
2018-01-25T09:30:00-05:00,63.68,64.08,63.5548,63.81,7768292,5414387.8,72.62905221285433,72.63460399544977,NaN,NaN,110.73464414613404,78.252053629867,-0.013344150868357607,0.8826567606196463,0.8960009114880039,425939601,419030843,85.95168991803993,90.97914760648533,NaN,NaN,41.182010966667036,40.63915106782364
2018-01-26T09:30:00-05:00,63.85,64.17,63.39,64.09,3881313,5399124.45,74.46522252289024,72.16359429779337,NaN,NaN,117.64431347031348,86.29158664445289,0.007380286593165586,0.9052262697294609,0.8978459831362953,429820914,420561510.8,86.85137052854266,90.59644525805724,NaN,NaN,42.37364519957607,40.886935943788274
2018-01-29T09:30:00-05:00,64.04,64.12,63.32,63.36,5331318,5587421.6,62.66254214344621,70.82103909497754,NaN,NaN,93.59256842810532,92.18154092197729,-0.03478930935502478,0.8543593464425143,0.8891486557975391,424489596,422169708.4,87.73976570658974,90.18852206396785,NaN,NaN,39.624189000159035,40.70654352326981
2018-01-30T09:30:00-05:00,63.09,63.39,62.76,62.9,8817685,5904064.85,56.57715876823093,69.18685784739506,NaN,NaN,15.39086370763914,83.89334576066679,-0.09685900597902275,0.7680748983237606,0.8649339043027834,415671911,422818666.2,88.0894837358989,89.76886867710789,NaN,NaN,35.25878016821125,39.9282916154043
2018-01-31T09:30:00-05:00,63.1,63.16,62.53,62.95,9912767,5950741.25,57.065233023385254,68.10633382735509,NaN,NaN,-24.338604953890975,62.6047569596602,-0.135380134301058,0.6957087364264609,0.8310888707275189,425584678,424301340,88.87058178846979,89.39358962165373,NaN,NaN,31.973447831171054,38.79188536051383
2018-02-01T09:30:00-05:00,62.51,62.92,61.98,62.09,9486148,6177434.95,47.23161022197779,65.97539948369182,NaN,NaN,-151.25341846280799,10.207144437871795,-0.21488765038662838,0.5624793077442334,0.7773669581308618,416098530,422333125.8,81.25286082675838,88.45817573257655,NaN,NaN,25.551266450322696,36.90036837334367
2018-02-02T09:30:00-05:00,61.75,61.84,60.411,60.46,9674665,6455163.6,34.94146746414002,62.92974890084887,NaN,NaN,-364.8561773285813,-86.29295372190715,-0.3645665536280257,0.32165876609582966,0.6862253197238554,406423865,417653716,66.62978169139548,86.46263669666759,NaN,NaN,14.261125085296063,33.66619076076544
2018-02-05T09:30:00-05:00,60.21,60.874,58.15,58.15,18570711,7150099.25,25.009451620464645,60.01699935579846,NaN,NaN,-393.2380305260464,-183.6590735127375,-0.5929461979285084,-0.054957427686780136,0.5379887702417283,387853154,410326427.6,51.11665102103877,83.68065072866561,NaN,NaN,-1.00768509816728,28.712779923775052
2018-02-06T09:30:00-05:00,57.3,60.15,57.14,60.05,19340291,7890158.05,40.092906186777675,58.0343212915157,NaN,NaN,-256.61763146220346,-238.060772546706,-0.5886580947062695,-0.1978338481411086,0.3908242465651609,407193445,408630734.4,48.313245346802184,80.65753901354914,NaN,NaN,-5.747151042435773,23.78993264288779
2018-02-07T09:30:00-05:00,59.78,60.6,59.51,59.51,16751044,8489935.95,37.76780994472495,55.92857839145747,NaN,NaN,-156.71901174609954,-264.5368539051477,-0.5931365731607466,-0.3505964698857724,0.24254010327497424,390442401,401602279,38.811888515383416,76.9240295588223,NaN,NaN,-10.027967958413623,18.95880398555902
2018-02-08T09:30:00-05:00,59.6,59.73,57.4,57.42,12799993,8918914.75,30.415748683284434,53.102950562140116,NaN,NaN,-192.68196656605673,-272.8225635257975,-0.7004405066203148,-0.6330105300004192,0.06742997661989555,377642408,393911054.6,31.509277949147844,72.6418031252534,NaN,NaN,-16.90257273270484,13.835750168664184
2018-02-09T09:30:00-05:00,58.05,58.81,56.62,58.42,26417518,9948724.6,36.75916623459883,50.90124644195367,NaN,NaN,-160.24882031221426,-231.9010921225241,-0.6677753669179571,-0.7672892320275508,-0.09951386510959373,404059926,393438266.8,31.121635578297912,68.54415018379031,NaN,NaN,-19.12288634530088,9.127373523812032
2018-02-12T09:30:00-05:00,58.88,59.95,58.71,59.6,10470180,10244795.9,43.32473820321151,49.18032777925936,NaN,NaN,-87.56345655605844,-170.76617732852648,-0.5360835097835994,-0.7696182523390931,-0.2335347425554936,414530106,398773657.2,40.08036776803032,65.0854242451156,NaN,NaN,-18.02877055117426,5.247924370242562
2018-02-13T09:30:00-05:00,59.36,59.72,59.22,59.45,6776315,10157965.5,42.71761626753862,47.261408821251834,NaN,NaN,-75.61015612731414,-134.56468226154863,-0.432882779510798,-0.7746382169439912,-0.34175543743319314,407753791,398885726.4,40.25614463735336,61.89962464369637,NaN,NaN,-17.476199011684724,2.001621029967236
2018-02-14T09:30:00-05:00,58.96,60.37,58.84,60.25,7999701,10015478.6,46.98464041070629,45.4296651210984,NaN,NaN,-56.30976083386884,-114.4828320791025,-0.291336280357518,-0.7059257878800906,-0.4145895075225726,415753492,403947944.6,47.7170561857066,59.168579377101125,NaN,NaN,-15.472910556247363,-0.49474062520627804
2018-02-15T09:30:00-05:00,60.68,60.74,59.96,60.7,6149076,10028244.95,49.273636030037856,43.63026608589467,NaN,NaN,-30.004555629574348,-81.94734989180603,-0.15484766555303375,-0.6081490894638648,-0.45330142391083106,421902568,412799976.6,57.671524552590384,57.084304664533114,NaN,NaN,-13.12200209420056,-2.29863512077689
2018-02-16T09:30:00-05:00,60.42,61.07,60.21,60.48,8458471,10204506.4,48.17844253176099,42.59568754220287,NaN,NaN,-22.0297339727455,-54.30353262391229,-0.07108909900124905,-0.5421627976623924,-0.47107369866114335,413444097,414676810.8,59.43503003301051,55.062537830706034,NaN,NaN,-11.644840653840234,-3.633807339785939
2018-02-20T09:30:00-05:00,60.22,60.6639,59.99,60.21,5243741,10180745.1,46.803512926057905,41.89756998204764,NaN,NaN,-29.113998149631698,-42.613640942626944,-0.027800324360993334,-0.505824104112385,-0.47802377975139165,408200356,413410860.8,57.689152900207375,52.89108562815664,NaN,NaN,-10.8843518186232,-4.669599408191262
2018-02-21T09:30:00-05:00,60.26,61.07,59.99,60,4997306,10229536.1,45.710847517168745,41.08654244588932,NaN,NaN,-22.93545785717177,-32.078701288598474,-0.008254077966965034,-0.48834137721009796,-0.4800872992431329,403203050,412500712.6,56.406293682010734,50.57220790626669,NaN,NaN,-10.589030262181337,-5.515232387332701
2018-02-22T09:30:00-05:00,60.26,60.96,60.18,60.4,4529447,10168799.1,48.19187730783458,41.15513295202195,NaN,NaN,-11.671481040537001,-23.1510453299321,0.03433375279900752,-0.4371701082443735,-0.47150386104338105,407732497,410896513.6,54.12181050703492,48.63427574057216,NaN,NaN,-9.619486848214311,-6.101554453172931
2018-02-23T09:30:00-05:00,60.75,61.31,60.44,61.29,3531989,9956983.95,53.30518869174512,42.46682732542232,NaN,NaN,19.100884496660548,-13.32995730468512,0.12032347950085998,-0.3210995116673061,-0.4414229911681661,411264486,408768897.2,51.16223335954328,47.52945085972557,NaN,NaN,-7.222863056842825,-6.261741396554345
2018-02-26T09:30:00-05:00,61.55,61.595,60.946,61.56,3254457,9925641.15,54.76383047171673,44.592140100511756,NaN,NaN,49.165312400159834,0.9090519698959441,0.18916775706020317,-0.2049632948429121,-0.39413105190311526,414518943,408983866.4,51.45110459338752,47.55334040060763,NaN,NaN,-4.8189322368047405,-6.055625802304402
2018-02-27T09:30:00-05:00,61.5,61.59,60.71,60.71,5918592,9955004.85,49.51943373071541,45.26546349650731,NaN,NaN,40.41685785983949,14.815223171790183,0.17174973341131394,-0.1794438851389728,-0.35119361855028675,408600351,409063865.4,51.56591799264984,47.78567416102532,NaN,NaN,-4.253868298246434,-5.798231873153264
2018-02-28T09:30:00-05:00,60.88,60.94,59.62,59.63,5570694,9792655.3,43.78236033953053,45.69507423899342,NaN,NaN,-12.328258231330484,16.93666309695844,0.08610773706326702,-0.24355894722120297,-0.32966668428447,403029657,409029186.8,51.509051236694084,48.69261435540466,NaN,NaN,-5.539457193662237,-5.7612640617974025
2018-03-01T09:30:00-05:00,59.6,59.85,58.58,59.02,9962511,9795142.5,40.900120689776806,46.443957953742874,NaN,NaN,-71.25814670284534,5.01932996449681,-0.008008183645630496,-0.3396769138415081,-0.3316687301958776,393067146,406096116.6,46.807346949037935,49.78533356968252,NaN,NaN,-7.5128228540977515,-6.011486746411738
2018-03-02T09:30:00-05:00,58.67,59.12,58.365,58.96,8009690,9721319.6,40.616887815613794,46.71950949524394,NaN,NaN,-89.51238751467035,-16.703324437769368,-0.06738371652384245,-0.4158983758506807,-0.3485146593268382,385057456,400854710.6,39.81355449490871,50.40618492086901,NaN,NaN,-9.176279598072869,-6.463600010934757
2018-03-05T09:30:00-05:00,58.69,59.91,58.61,59.74,6580643,9566618.5,45.86524386875322,46.900974185639775,NaN,NaN,-33.02472408594158,-33.141331734989656,-0.048111665068915954,-0.40865424066298317,-0.3605425755940672,391638099,396278541.8,34.90924283328573,50.036818854101526,NaN,NaN,-9.067926666707784,-6.835646676045189
2018-03-06T09:30:00-05:00,60.01,60.85,59.72,60.4,8807460,9078455.95,49.90012714431456,47.41401067683805,NaN,NaN,41.80768638461639,-32.86316603003427,0.01189643236485266,-0.3456720351380014,-0.35756846750285404,400445559,394647583.4,33.333263647267415,49.54232735480968,NaN,NaN,-7.759800901794782,-6.967668708295131
2018-03-07T09:30:00-05:00,59.76,60.34,59.66,60.18,8393342,8531108.5,48.59979978690531,47.52937920370942,NaN,NaN,14.469009252443445,-27.503712533279487,0.03810471206833993,-0.3099375774174291,-0.34804228948576904,392052217,392452095.4,31.28573813716801,48.36866177991406,NaN,NaN,-7.059064148165267,-6.98072519970515
2018-03-08T09:30:00-05:00,60.31,60.43,59.82,60.23,5167301,7951921.35,48.92555152379685,47.5045160246922,NaN,NaN,22.296013115069,-8.79288056969662,0.058897960384764025,-0.27441983900481404,-0.33331779938957806,397219518,393282569.8,32.96316973789939,46.60377929315042,NaN,NaN,-6.3955013209572735,-6.897121788455453
2018-03-09T09:30:00-05:00,60.61,61.35,60.38,61.32,5863174,7605080.4,55.54051610624693,48.030378422869774,NaN,NaN,99.32882016170751,28.975360965578954,0.14144328550322766,-0.15651369251054348,-0.29795697801377113,403082692,396887617,39.82987259862187,45.203410904979805,NaN,NaN,-3.8202741344038547,-6.457572123590939
2018-03-12T09:30:00-04:00,61.39,61.69,61.05,61.17,4775171,6522963.05,54.49452934423198,48.57973673845363,NaN,NaN,125.46825183610699,60.673956149988655,0.17891017268968218,-0.0743192621516684,-0.2532294348413506,398307521,398221501.4,42.189447799053255,44.09628911204022,NaN,NaN,-1.998445807518142,-5.820554078437683
2018-03-13T09:30:00-04:00,61.5,61.7448,60.85,60.92,6069204,6302914.25,52.7127045045251,49.07986938040766,NaN,NaN,101.23958019253558,72.5603349115725,0.17936915330228015,-0.029017993213500404,-0.20838714651578055,392238317,396580053,40.10520934426324,42.93192594505825,NaN,NaN,-0.955486297020814,-5.12554439537813
2018-03-14T09:30:00-04:00,61.19,61.2,60.05,60.17,5429430,6235570,47.67630019708914,49.04304244392584,NaN,NaN,13.371395922085497,72.34081224550091,0.12429058402268364,-0.05302391648742599,-0.17731450051010963,386808887,395531387,38.78688256348074,41.836573949090095,NaN,NaN,-1.4675688343442688,-4.6029764580875785
2018-03-15T09:30:00-04:00,60.25,60.3,59.37,59.38,5235269,6097348.4,43.01433514435021,48.307981476254774,NaN,NaN,-85.32215404645608,50.817178813195895,0.03445347409135227,-0.1342476578959193,-0.16870113198727157,381573618,392402207,35.08114941060295,40.68792509559436,NaN,NaN,-3.314424779517089,-4.418897646863223
2018-03-16T09:30:00-04:00,59.04,59.47,58.93,59.15,5526465,6066217.85,41.73480567792194,47.377336848126575,NaN,NaN,-126.87941390538833,5.575531999776723,-0.03680084068304673,-0.21470218284108,-0.17790134215803327,376047153,386995099.2,29.78556105682263,39.140386271554,NaN,NaN,-5.215080839470735,-4.532638102950011
2018-03-19T09:30:00-04:00,58.98,59.02,57.874,58.3,6341261,5960357.35,37.316882085625856,46.505726016334464,NaN,NaN,-176.55767386229368,-54.829653139903414,-0.13215562554599142,-0.34309587409052256,-0.21094024854453114,369705892,381274773.4,25.41471021489353,37.27244285885712,NaN,NaN,-8.250233149954227,-5.063723109664899
2018-03-20T09:30:00-04:00,58.51,58.7,58.12,58.24,3614418,5878891.2,37.018988357834985,46.02262801764193,NaN,NaN,-150.56867489781206,-105.19130415797295,-0.18690029894900734,-0.4445656222307903,-0.257665323281783,366091474,376045404.8,22.206560212176868,35.17940778567733,NaN,NaN,-10.79808726535911,-5.882917989049786
2018-03-21T09:30:00-04:00,58.38,59.43,58.18,58.9,4853669,5871709.35,42.46026990182719,46.13406724707409,NaN,NaN,-94.86543489469179,-126.8386703213284,-0.16694683346040756,-0.46634886510729245,-0.2994020316468849,370945143,372872656,20.514551309336227,33.301350954270056,NaN,NaN,-11.459791927343352,-6.679614265948866
2018-03-22T09:30:00-04:00,58.43,58.6364,57.105,57.14,7699710,6030222.5,34.01964254323234,45.66283544190399,NaN,NaN,-159.60303548547407,-141.694846609132,-0.25527825612583677,-0.6184998518041809,-0.3632215956783441,363245433,369207019,18.73812971618797,31.79596347007572,NaN,NaN,-14.916888649384182,-7.856367749296769
2018-03-23T09:30:00-04:00,57.27,57.56,55.97,56.02,7908914,6249068.75,29.940729948313717,44.5253701618726,NaN,NaN,-198.3970487287031,-155.99837357379494,-0.36542493409594606,-0.8200027632982767,-0.45457782920233064,355336519,365064892.2,16.951811776134065,30.513289823136315,NaN,NaN,-19.308825224733404,-9.492433102930574
2018-03-26T09:30:00-04:00,56.68,57.22,56.15,57.17,5842129,6378452.35,38.14189855575698,43.68549669126134,NaN,NaN,-155.18866028284617,-151.72457085790546,-0.33777194638259234,-0.8767927621805711,-0.5390208157979788,361178648,363359443.4,16.26431863082118,29.29407946481873,NaN,NaN,-20.155419575966942,-11.015716884792912
2018-03-27T09:30:00-04:00,57.32,57.68,56.3,56.59,7290986,6447072.05,35.86178304975677,42.77563835289359,NaN,NaN,-136.05333764468722,-148.82150340728046,-0.33483312096683204,-0.9575622170065188,-0.6227290960396867,353887662,360918681,15.30750332241547,28.152776978050692,NaN,NaN,-21.608620461978852,-12.528988824390904
2018-03-28T09:30:00-04:00,56.69,56.9,55.69,55.87,11844180,6760746.35,33.207880990194326,41.652947600493405,NaN,NaN,-149.71725866096955,-159.791868160536,-0.35571003229280596,-1.0673666364056942,-0.7116566041128882,342043482,355138348.8,13.310420826832555,26.749009198688775,NaN,NaN,-23.69118047500257,-14.123587631621142
2018-03-29T09:30:00-04:00,56.13,57.24,56.075,56.94,6210656,6573153.6,40.28086222630943,40.56297232335502,NaN,NaN,-103.51433641182182,-148.5741283458056,-0.2753754304818763,-1.0558758922152336,-0.7805004617333573,348254138,352140089.8,12.40628354725962,24.790181409305756,NaN,NaN,-23.037191632628378,-15.396959631765032
2018-04-02T09:30:00-04:00,56.75,57.03,55.21,55.7,9329353,6639136.75,35.578773234391875,39.21184688693786,NaN,NaN,-120.803262210037,-133.05537104207235,-0.28260585271316074,-1.1337577776248082,-0.8511519249116475,338924785,348857743,11.48641239944125,22.597107452190613,NaN,NaN,-24.116955943424433,-16.642673390573517
2018-04-03T09:30:00-04:00,55.83,56.65,55.48,56.49,6786440,6649426.6,40.355725849953494,38.32920555446846,NaN,NaN,-97.92178294541587,-121.6019955745863,-0.2141473314631469,-1.118836089240581,-0.9046887577774342,345711225,345764258.4,10.682504053461301,20.495485645704758,NaN,NaN,-23.34985619826829,-17.600842363101343
2018-04-04T09:30:00-04:00,55.55,56.905,55.2302,56.86,6436682,6530887.7,42.50604748585304,37.95990178938017,NaN,NaN,-84.24664990256927,-111.24065802616272,-0.1281524893012841,-1.0648793694040393,-0.9367268801027552,352147907,345416307.4,10.592702526196916,18.48161564304163,NaN,NaN,-22.036372060346412,-18.23448946270778
2018-04-05T09:30:00-04:00,57.13,58.12,57.04,57.92,7694313,6495936.25,48.260997347195534,38.33466337529769,NaN,NaN,-24.622339932014366,-86.22167428037167,0.008652060827149866,-0.9259118040688179,-0.9345638648959678,359842220,348976055,18.17151190403098,17.273784392572203,NaN,NaN,-18.9961960372309,-18.343304687639655
2018-04-06T09:30:00-04:00,57.35,57.62,56.15,56.51,7911408,6633141.6,42.2087118362326,38.36851381517703,NaN,NaN,-58.111499909124454,-77.1411069798322,0.012482281558502506,-0.9189610129478396,-0.9314432945063421,351930812,349711389.8,19.686013709699594,16.552388153491982,NaN,NaN,-18.432310619692103,-18.356019820790006
2018-04-09T09:30:00-04:00,56.82,57.5,56.42,56.82,6289207,6654443.25,43.875211001422535,38.83696588059108,NaN,NaN,-46.4595143932646,-62.27235741647773,0.04250391438654144,-0.8783134015231653,-0.9208173159097067,358220019,353570436.6,27.291548750064933,16.68644804886137,NaN,NaN,-17.44498342166707,-18.225871763772446
2018-04-10T09:30:00-04:00,57.58,58.3115,57.495,57.99,12833656,7057367.5,49.76327954319653,39.74727239383119,NaN,NaN,10.890901720373826,-40.50982048331979,0.1421543491682129,-0.7431243794494407,-0.8852787286176536,371053675,358638926.6,35.88000837418595,17.6631229175763,NaN,NaN,-14.635269617750204,-17.712928600054983
2018-04-11T09:30:00-04:00,57.57,57.795,57.34,57.56,6457404,7076777.5,47.779352608048775,40.12720687284701,NaN,NaN,0.7754809227279996,-23.505394318260336,0.17779066699969004,-0.663040394868041,-0.840831061867731,364596271,361128599.4,39.6509449065487,19.03000817452005,NaN,NaN,-13.007244896620197,-17.04068807099287
2018-04-12T09:30:00-04:00,57.82,58.41,57.67,58.17,3536764,6982144.2,50.77732711598797,41.32418434232956,NaN,NaN,48.02325345041899,-8.976275641773665,0.237401211296298,-0.5440795477473586,-0.7814807590436565,368133035,362786762.4,42.093545021670735,20.698252124911672,NaN,NaN,-10.718385787428746,-16.13750203048371
2018-04-13T09:30:00-04:00,58.49,58.65,57.9,58.11,4321757,6936468.6,50.47040472679366,42.79058968364956,NaN,NaN,69.14179572208904,16.47438348446903,0.26561453290979953,-0.4494625929064071,-0.7150771258162066,363811278,365162855.6,45.49776152627775,22.737248535636223,NaN,NaN,-8.98206064049371,-15.115296117627995
2018-04-16T09:30:00-04:00,58.54,58.975,58.24,58.89,6332117,6976751.2,54.33472281555718,43.947219987921,NaN,NaN,113.11104069106165,48.38849450133428,0.3256711430295798,-0.30798819702923197,-0.6336593400588117,370143395,367547530.8,48.75389009979499,25.057932211991492,NaN,NaN,-6.324429475518162,-13.85945802589802
2018-04-17T09:30:00-04:00,59.27,59.73,59.01,59.56,4781151,6898745.7,57.408655296638656,45.486282291269696,NaN,NaN,159.1974992718806,78.04981401163563,0.39477602930534683,-0.1401893034271282,-0.534965332732475,374924546,368321705,49.8023805276677,27.52185201236665,NaN,NaN,-3.133634336600598,-12.327197498855531
2018-04-18T09:30:00-04:00,59.9,60.25,59.76,59.99,4736216,6954835.6,59.30212472973963,47.35015684409437,NaN,NaN,179.62967894423025,113.8206536159361,0.44971359371046377,0.027176659405604653,-0.4225369343048591,379660762,371334603.2,53.766870345261644,30.411598406540158,NaN,NaN,0.09494112548420235,-10.552606266806997
2018-04-19T09:30:00-04:00,60.06,60.06,59.1,59.32,5819648,7003134.55,55.185396968932345,48.414766468567436,NaN,NaN,136.54272238299112,131.5245474024505,0.4216670188803454,0.10454683929557262,-0.3171201795847728,373841114,372476219,55.2103222526321,33.46902974263819,NaN,NaN,1.6694870999670424,-8.80659292869642
2018-04-20T09:30:00-04:00,59.33,59.51,58.75,59,4351133,6835705.7,53.28287617215582,49.67934524983629,NaN,NaN,96.28898734545466,136.95398572712364,0.3644529589505594,0.13844601910342647,-0.22600693984713294,369489981,373611959.6,56.660033345670634,36.69571695308315,NaN,NaN,2.4387084986527534,-7.200121296217967
2018-04-23T09:30:00-04:00,58.88,59.07,58.67,58.83,3097737,6595146.85,52.252266994398084,50.52909818872519,NaN,NaN,73.39260189182382,129.01029796727607,0.30069852754961734,0.14986621958988877,-0.15083230795972857,366392244,372861729.4,55.384786996689535,39.88873716331374,NaN,NaN,2.7927734009779916,-5.772564910904259
2018-04-24T09:30:00-04:00,59.05,59.05,56.64,57.24,8724227,6739251.75,43.732240258147165,50.6166833867462,NaN,NaN,-5.862599121884448,95.99827828852305,0.14488039527141466,0.030268186129539743,-0.11461220914187491,357668017,369410423.6,49.82868429006363,42.69130728930422,NaN,NaN,0.5108307681847706,-4.874936956748683
2018-04-25T09:30:00-04:00,57.34,57.73,56.82,57.55,7950693,6772237.1,45.59486333271174,50.426245242854506,NaN,NaN,-26.18291835878459,54.83575882792011,0.06045011235134459,-0.03904956870269416,-0.09949968105403875,365618710,366602013.2,45.802183637592506,44.664926698844326,NaN,NaN,-0.8200775620759416,-4.295671328938291
2018-04-26T09:30:00-04:00,57.82,58.15,57.49,57.91,4937570,6426906.6,47.75764935663765,50.82259792288344,NaN,NaN,0.4738300175517845,27.621980354832242,0.028243430498620395,-0.06419539293076326,-0.09243882342938366,370556280,365945046.4,44.88838631581737,46.465096170709884,NaN,NaN,-1.311352848039734,-3.8693401173813546
2018-04-27T09:30:00-04:00,57.92,58.07,57.345,57.76,7898374,6511292.5,46.92067653449936,51.04013117524607,NaN,NaN,-12.69147026544204,5.825888832652903,-0.0021535635008143317,-0.09513077780540158,-0.09297721430458725,362657906,364578631.4,42.968236528249946,47.584859583437385,NaN,NaN,-1.9516898963076093,-3.595390085799391
2018-04-30T09:30:00-04:00,57.85,58.05,56.95,57.01,4875198,6288584.75,42.87469288573919,50.54808927114197,NaN,NaN,-50.70123006072399,-18.992877557856666,-0.06810850944293814,-0.17811285110825992,-0.11000434166532178,357782708,362856724.2,40.61072583421257,47.92276797343929,NaN,NaN,-3.6843762626251517,-3.6081023967744996
2018-05-01T09:30:00-04:00,56.7,56.98,56.22,56.96,6281069,6263316.2,42.610893413576655,50.178913614393956,NaN,NaN,-105.59822869837544,-38.94000347315485,-0.10806542579674813,-0.24508612391125695,-0.13702069811450882,351501639,361623448.6,38.96187608424416,47.8735487718461,NaN,NaN,-5.182176395803987,-3.8329701109215693
2018-05-02T09:30:00-04:00,57.05,57.27,56.72,56.83,6370269,6259995.55,41.88923225359409,49.544049695651545,NaN,NaN,-92.59952496514339,-52.22332479442662,-0.13449178342983376,-0.305135427401801,-0.17064364397196724,345131370,357525980.6,34.01977243023276,47.296850729600536,NaN,NaN,-6.6352695428046475,-4.23329860119058
2018-05-03T09:30:00-04:00,56.9,57.46,56.29,57.09,9760780,6363318.9,43.934376875229766,49.07719056339698,NaN,NaN,-85.5160670191048,-69.42130420175792,-0.12585671278441465,-0.32796453495248556,-0.2021078221680709,354892150,354393154.6,30.80266429366999,46.247200927271415,NaN,NaN,-7.356068496651924,-4.6794085862564865
2018-05-04T09:30:00-04:00,56.72,58.115,56.69,57.8,4453112,6190404.1,49.19287491484812,48.709915713346334,NaN,NaN,-41.57832896671692,-75.1986759420129,-0.06669368119420607,-0.2854749236608285,-0.21878124246662242,359345262,353730625.8,30.153250423376065,44.918583807527206,NaN,NaN,-6.576215565441956,-4.950381011854411
2018-05-07T09:30:00-04:00,57.86,58.14,57.5849,57.78,4945845,6123236,49.05330568790746,48.11310502700839,NaN,NaN,-20.683449439613813,-69.19511981779087,-0.025397012648014278,-0.2505275082766403,-0.225130495628626,354399417,353053967.6,29.469872714690084,43.46626182088595,NaN,NaN,-5.963666785422878,-5.095136122364192
2018-05-08T09:30:00-04:00,57.64,57.9,57.35,57.66,3674612,5665283.8,48.170221625185256,47.31796909096879,NaN,NaN,-36.70282187576676,-55.41603845326913,-0.003787355386202923,-0.22986468986137965,-0.22607733447517672,350724805,352898600.8,29.305643095791908,41.71903130306668,NaN,NaN,-5.666097445337192,-5.1767020256460485
2018-05-09T09:30:00-04:00,57.88,58.57,57.88,58.49,12032851,5944056.15,54.29859041789898,47.25462576589497,NaN,NaN,20.422342328093908,-32.81166499462167,0.06498546343723194,-0.1448455051786368,-0.20983096861586875,362757656,356423858,37.7785188982695,40.47390249204078,NaN,NaN,-3.7024244185838504,-4.966090938922878
2018-05-10T09:30:00-04:00,58.54,59.25,58.5,58.91,4832997,6008867.8,57.065098198104025,47.524784482034136,NaN,NaN,64.53348735330185,-2.801754120140347,0.13340069623917555,-0.043080098316899296,-0.17648079455607485,367590653,358963558.6,43.072078603199465,39.50333429614999,NaN,NaN,-1.217392765742478,-4.430562628468535
2018-05-11T09:30:00-04:00,58.95,59.3655,58.81,58.89,3552474,5970403.65,56.88849760668966,47.855943811483534,NaN,NaN,68.74332735834876,19.262577144872793,0.1696215422454578,0.0355461332507474,-0.1340754089947104,364038179,359902142,44.93650928614187,38.757028745396575,NaN,NaN,0.799895876792475,-3.683354270574105
2018-05-14T09:30:00-04:00,59.06,59.31,58.89,59.12,2785781,5793086.85,58.479838215499946,48.90934366558016,NaN,NaN,72.00014191435758,37.79929541566707,0.19933262786610667,0.11509037583792292,-0.08424225202818374,366823960,362387050.6,49.63909454521282,38.74348662076437,NaN,NaN,2.964888500818507,-2.733605303232303
2018-05-15T09:30:00-04:00,58.82,59.04,58.46,58.94,7164115,5912235.05,56.71542409785554,49.703669434519,NaN,NaN,53.615801522243736,55.863020095269164,0.19678645604359482,0.1617408180263098,-0.035045638017285025,359659845,364174058.6,52.763392191077635,39.24071580315617,NaN,NaN,4.377494328724555,-1.7177339272384664
2018-05-16T09:30:00-04:00,58.94,59.72,58.94,59.64,3362412,5843544.85,61.571227471790095,50.69035358560132,NaN,NaN,110.68997100801491,73.91654583125337,0.22986656273732645,0.252287565404373,0.02242100266704658,363022257,364226978.8,52.856665810534224,39.80987862420738,NaN,NaN,7.033505963864785,-0.4675567999380019
2018-05-17T09:30:00-04:00,59.5,60,59.5,59.78,10367324,6070928.65,62.47785777362811,51.80158081696766,NaN,NaN,134.73437693276637,87.95672374714627,0.24728061262256776,0.33152176844525627,0.08424115582268851,373389581,365386764.4,54.955891083383776,40.66613966385979,NaN,NaN,9.524972313659658,0.9599473591473782
2018-05-18T09:30:00-04:00,59.71,60.03,59.68,59.86,3275355,6017139.75,63.01482530547836,53.24016170409188,NaN,NaN,132.56719332865708,100.72149694120793,0.24956994596690835,0.39620358828132396,0.1466336423144156,376664936,367912115.8,59.21454948043911,41.994984210018835,NaN,NaN,11.772713875132037,2.504628290002329
2018-05-21T09:30:00-04:00,60.18,60.32,59.97,60.18,5296034,6127054.6,65.16242341224694,54.85098527542548,NaN,NaN,139.32946293556853,114.18736114545013,0.2570068082875912,0.4678921526739046,0.2108853443863134,381960970,370939517.8,63.65122386712682,43.75850905165331,NaN,NaN,14.330676114273796,4.1940636934696816
2018-05-22T09:30:00-04:00,60.18,60.36,59.62,59.68,3852495,5883468,59.36225702198047,56.09905847316737,NaN,NaN,105.01714685171996,124.46763021134537,0.21436393460104386,0.47884026263761825,0.2644763280365744,378108475,374629243.8,68.19261552097129,46.19942641527748,NaN,NaN,15.054588160278026,5.745567188728017
2018-05-23T09:30:00-04:00,59.29,59.56,59.01,59.54,3649405,5668403.6,57.81060805380167,57.09021784306536,NaN,NaN,62.61027702480096,114.85169141470257,0.16505324269956934,0.47079288141103603,0.3057396387114667,374459070,376916606.4,70.64144957461637,49.04505393534509,NaN,NaN,15.24984595192651,7.103321297756373
2018-05-24T09:30:00-04:00,59.42,59.64,59.03,59.33,3549370,5598993.6,55.46850771707812,57.53847732893893,NaN,NaN,54.671004056772624,98.83901683950381,0.1093048132754334,0.4423706553057585,0.3330658420303251,370909700,376420630.2,69.39388480335035,51.847956391057544,NaN,NaN,14.789073785742385,8.201285938897232
2018-05-25T09:30:00-04:00,59.08,59.19,58.795,59.01,4057666,5406958.2,52.01066128468604,57.74971701442312,NaN,NaN,28.376037398927867,78.00078565355798,0.04517468868262775,0.38953420288360974,0.344359514200982,366852034,374458049.8,64.53693994133258,54.35274690724629,NaN,NaN,13.437420962379695,8.949305227966155
2018-05-29T09:30:00-04:00,58.51,58.86,57.8,57.99,5849906,5455693.6,42.84273201953201,57.369182042590744,NaN,NaN,-31.36253300141044,43.862386466162185,-0.06562243988609628,0.26233146434336163,0.3279539042294579,361002128,370266281.4,55.58789469331,56.23005059278329,NaN,NaN,9.27856611589982,8.996342497670964
2018-05-30T09:30:00-04:00,58.41,58.85,58.23,58.67,4353085,5359294.4,49.263576517872956,57.009538192588884,NaN,NaN,-12.591068702780436,20.3407433552621,-0.09122177858908848,0.2139266809930973,0.3051484595821858,365355213,367715629,50.95752817116754,57.1714083979903,NaN,NaN,7.617235023285223,8.799327144187288
2018-05-31T09:30:00-04:00,58.74,58.83,58.1501,58.18,5778257,5329693.8,45.31337751435314,56.17012957232096,NaN,NaN,-39.8564571967188,-0.15260348904185578,-0.1365375873049865,0.13447647545095265,0.27101406275593914,359576956,364739206.2,46.12877412291111,57.38974379225541,NaN,NaN,4.935104273790098,8.247295305559117
2018-06-01T09:30:00-04:00,58.61,59.255,58.61,59.07,3802671,5031788.35,52.727801948441446,55.87293702530324,NaN,NaN,8.179781289728677,-9.45084804245064,-0.10345619503120881,0.14169381896692812,0.24515001399813693,363379627,363233191.6,43.863854635443154,57.3131256029198,NaN,NaN,5.038370815594322,7.788877521278432
2018-06-04T09:30:00-04:00,59.3,59.53,59.26,59.41,4539890,5036127.25,55.22528617609617,55.64046902248867,NaN,NaN,50.11785641811131,-5.102484238613957,-0.05783505473488215,0.17285619557953424,0.2306912503144164,367919517,363446688.2,44.28151820310729,56.93044157848368,NaN,NaN,5.940656690169395,7.524845973977142
2018-06-05T09:30:00-04:00,59.48,60.065,59.4,59.86,3325726,4955121.3,58.360859722911,55.758000138564064,NaN,NaN,88.42650143945541,18.855322649559213,0.00040598193551072415,0.2311987277338048,0.23079274579829406,371245243,365495311.2,48.259564643942106,56.608739610831144,NaN,NaN,7.709888811318606,7.5512806650259225
2018-06-06T09:30:00-04:00,59.93,60.99,59.76,60.97,8192437,5181012.55,64.89195434649426,55.995194915328646,NaN,NaN,173.28767271931164,56.03107093397763,0.10562256658883717,0.36282095403434056,0.2571983874455034,379437680,368311804.6,53.205997780144976,56.63369189437477,NaN,NaN,11.591778430596504,8.128494631536006
2018-06-07T09:30:00-04:00,61,61.05,60.39,60.66,5157258,4837232.9,61.968613855199415,55.9588203497266,NaN,NaN,168.5367691665126,97.70971620662391,0.1439050696049965,0.43707972445174903,0.29317465484675254,374280422,371252497.8,57.747883433922325,56.83311991941324,NaN,NaN,13.70569599231857,8.925237683076372
2018-06-08T09:30:00-04:00,60.6,60.94,60.27,60.83,3785980,4784882.05,62.95421071502372,55.9544907361227,NaN,NaN,141.7862559121495,124.43101113110806,0.16853224478252776,0.5038399608249122,0.33530771604238446,378066402,374189852.8,61.74232424546857,57.013675259772484,NaN,NaN,15.6996716616914,9.893013965735662
2018-06-11T09:30:00-04:00,60.75,61.07,60.64,60.92,2886786,4751597.65,63.49360259604864,55.835289249251396,NaN,NaN,139.51839783919436,142.31111941532467,0.17781999561934347,0.5575827105665638,0.37976271494722036,380953188,376796587,64.91251072835962,57.103767178431966,NaN,NaN,17.461509573953503,10.974227624052496
2018-06-12T09:30:00-04:00,61.01,61.205,60.77,61,4477894,4836203.3,63.99543110397612,56.166230255108225,NaN,NaN,131.2799691486108,150.88181295715577,0.175962948829805,0.5997164009844766,0.42375345215467164,385431082,379633754.8,68.01874812105889,57.09134807843823,NaN,NaN,19.04319621663668,12.126937422993093
2018-06-13T09:30:00-04:00,61.07,61.1,60.27,60.34,4059216,4680958.35,57.03028078395276,56.110492592976165,NaN,NaN,82.26485907890296,132.67725022907402,0.11959178188091563,0.5732431795058162,0.45365139762490053,381371866,380020592,68.42913803828958,56.93332582584346,NaN,NaN,18.373791920885395,13.019345208406278
2018-06-14T09:30:00-04:00,60.59,60.73,60.19,60.43,2539707,4639823.1,57.706271536056825,56.27033286576035,NaN,NaN,64.35516743624407,111.84092988302032,0.07959796425195853,0.5531488529398487,0.4735508886878902,383911573,381946822.2,70.4617331279795,57.00960070617412,NaN,NaN,18.018626082066728,13.733528190357772
2018-06-15T09:30:00-04:00,59.76,59.932,59.31,59.73,6548212,4448867.5,50.9876052883506,56.19725743745067,NaN,NaN,-10.886206078636484,81.30643748486312,0.0013683196240085183,0.4752612882179008,0.4738929685938923,377363361,381806214,70.10690960753695,57.407455682331566,NaN,NaN,15.654812153976893,14.007997328017646
2018-06-18T09:30:00-04:00,59.27,59.69,59.2,59.58,8991531,4734676.3,49.65350683176219,56.68374135260997,NaN,NaN,-24.680825839975327,48.466592749029175,-0.06162927695356607,0.3968563724019347,0.4584856493555008,368371830,379289942.4,63.90499951784804,58.00153459836999,NaN,NaN,13.317386443131888,13.909338630176824
2018-06-19T09:30:00-04:00,58.88,59,57.99,58.49,7211672,4830458.2,41.21446958241621,56.10880514293449,NaN,NaN,-105.08123245923534,1.1943524274599497,-0.1716254211959028,0.2439538728606223,0.4155792940565251,361160158,374435757.6,53.98365749587822,58.21768669299219,NaN,NaN,8.35266701242415,13.1155283990693
2018-06-20T09:30:00-04:00,58.73,58.73,58.055,58.3,5335255,4904596.2,39.94018952858105,55.725006001093625,NaN,NaN,-103.68459971667342,-35.99553933165534,-0.24748609847307895,0.10622167096517643,0.3537077694382554,355824903,369326365,45.90509438210095,58.2017095686486,NaN,NaN,3.9415560091204283,11.80496091479089
2018-06-21T09:30:00-04:00,58.16,58.22,57.58,57.68,7186477,5081449.8,36.025901338909186,54.532013100412755,NaN,NaN,-130.73970717618332,-75.0145142541408,-0.324852108875578,-0.05235736665621715,0.2724947422193609,348638426,362271735.6,37.54968509359152,57.75069745851635,NaN,NaN,-1.143985719350055,9.955111395627897
2018-06-22T09:30:00-04:00,58.11,58.66,58.11,58.52,7114403,5259701.45,44.02932005979175,53.732301234962435,NaN,NaN,-76.80200392258095,-88.1976738229297,-0.3051917859705634,-0.1089949902438434,0.19619679572672,355752829,357949629.2,33.52376157205936,56.98228627058436,NaN,NaN,-2.9927043262568724,8.105423435358645
2018-06-25T09:30:00-04:00,58.23,58.23,57.1351,57.61,9790554,5546345.85,38.42151804171343,52.30806254344832,NaN,NaN,-119.86155813436817,-107.23382028180826,-0.3367331815414043,-0.22471968120003538,0.11201350034136892,345962275,353467718.2,29.939083343045994,55.67368046337749,NaN,NaN,-6.537003687023516,6.013648132161194
2018-06-26T09:30:00-04:00,57.71,58.0063,57.59,57.83,3708118,5439256.45,40.397932360870435,50.558489544475194,NaN,NaN,-105.75224072328646,-107.3680219346185,-0.3258319270864657,-0.2952764085167132,0.030555518569752485,349670393,351169765.2,28.269971630634274,53.89253573841244,NaN,NaN,-8.68811289397269,3.9133965569992104
2018-06-27T09:30:00-04:00,58.14,58.75,57.63,57.65,5787753,5510989.85,39.286888621320706,48.938366313483854,NaN,NaN,-87.54457329832105,-104.14001665094801,-0.31368433227434334,-0.3615498967731767,-0.04786556449883336,343882640,348781312.6,26.60945563344407,51.66836232409256,NaN,NaN,-10.757963704208267,1.8174879482552853
2018-06-28T09:30:00-04:00,57.67,58.01,57.26,57.87,5889365,5516545.25,41.40791387285564,47.399345110471856,NaN,NaN,-101.00183215661791,-98.19244164703494,-0.2751503368928254,-0.3918034856148651,-0.1166531487220397,349772005,349008028.4,27.047489587927288,49.1901598485539,NaN,NaN,-11.814993418070598,-0.13000938979126953
2018-06-29T09:30:00-04:00,57.99,58.77,57.99,58.07,5042866,5578555,43.34562399497487,45.96020378182372,NaN,NaN,-61.210425451440415,-95.07412595280684,-0.22274710253763935,-0.3950870268940889,-0.17233992435644957,354814871,348820436.8,26.904400252663407,46.47529481457559,NaN,NaN,-12.122407890603053,-1.8432091756215243
2018-07-02T09:30:00-04:00,57.65,57.89,57.35,57.76,7682862,5735703.6,41.07797785570728,44.323242835518805,NaN,NaN,-86.95591372855246,-88.4929970716437,-0.19643728486591425,-0.4178865304388424,-0.22144924557292814,347132009,349054383.6,27.42008603492559,43.57539037985179,NaN,NaN,-13.035563058602259,-3.4421168731902005
2018-07-03T09:30:00-04:00,58.13,58.49,57.53,57.66,3389430,5738888.8,40.34474819577259,43.13141907922022,NaN,NaN,-67.21565196367037,-80.78567931972047,-0.17401208966606907,-0.43896435765551445,-0.2649522679894454,343742579,347868820.8,26.40349228551311,40.573558540367756,NaN,NaN,-13.994820202172528,-4.949645920187676
2018-07-05T09:30:00-04:00,58.06,58.21,57.61,58.16,5559184,5607226.15,45.57567570259925,42.264947948258964,NaN,NaN,-56.571822339442726,-74.59112912794481,-0.11651005932023784,-0.4105898421397427,-0.29407978281950486,349301763,348952645.4,28.995196734007664,37.61166308365548,NaN,NaN,-13.343310409707994,-6.148740847262006
2018-07-06T09:30:00-04:00,58.06,58.62,57.79,58.45,4530920,5575909.25,48.40171355311058,42.08024139574183,NaN,NaN,-35.45590465092163,-61.48194362680556,-0.05317305911340525,-0.3605461067112614,-0.30737304759785616,353832683,349764781,30.957205115657246,34.81525561994979,NaN,NaN,-11.975929629654205,-6.981196387603749
2018-07-09T09:30:00-04:00,58.73,59,58.68,58.97,4537813,5613500.9,53.1040165066726,42.32670637252114,NaN,NaN,8.128024116271229,-47.614253713263224,0.025300211785463267,-0.2757477828660271,-0.30104799465149035,358370496,350475906,32.71052969622701,32.58707920411972,NaN,NaN,-9.371613397124678,-7.322684531821024
2018-07-10T09:30:00-04:00,58.95,59.5,58.95,59.47,5973637,5767843.45,57.14790123905213,43.46480863370942,NaN,NaN,48.32021078401222,-20.559028810750295,0.10781288780764253,-0.16628188489193718,-0.2740947726995797,364344133,353918330.8,40.5773490711929,31.62948574521362,NaN,NaN,-5.868510483145511,-7.114945382010236
2018-07-11T09:30:00-04:00,58.85,59.02,58.21,58.47,11345587,6111228.1,48.19646044638366,44.054542270695315,NaN,NaN,-0.04537434150319561,-7.124973286316866,0.09255971077589253,-0.15839513422971407,-0.2509548450056066,352998546,355769524.2,44.345468142492614,31.518083870955884,NaN,NaN,-5.520196422988241,-6.887124102149952
2018-07-12T09:30:00-04:00,58.83,58.88,58.37,58.61,6618968,6239215.7,49.39162517566303,45.00923683046345,NaN,NaN,17.554510514508898,7.700293284473456,0.0893695622823242,-0.13924289215270136,-0.22861245443502556,359617514,357832674.4,48.281699166537265,32.28465630473772,NaN,NaN,-4.870407185001739,-6.599021685414493
2018-07-13T09:30:00-04:00,58.51,58.79,58.42,58.58,3462018,6285331.25,49.130051847388096,45.37357481529176,NaN,NaN,31.488855062801566,21.089245227218093,0.0828548250732431,-0.12504392309347168,-0.20789874816671478,356155496,358297237,49.153740630159504,33.40108338031631,NaN,NaN,-4.42558513227472,-6.288530749251668
2018-07-16T09:30:00-04:00,58.61,58.73,57.98,58.11,4491575,6182499.4,45.10027822581229,45.85062911415597,NaN,NaN,-5.7712029707089325,18.309399809822064,0.04632919836893329,-0.14998725020554815,-0.19631644857448144,351663921,356955922,46.705081982851944,34.59865471173102,NaN,NaN,-5.234011902024644,-6.137885199647807
2018-07-17T09:30:00-04:00,58.16,59.065,57.94,58.87,7681982,6117021.95,51.96180172877571,46.676619783292054,NaN,NaN,67.77686274659234,22.20073020233814,0.07129819412534988,-0.10719370591779409,-0.17849190004314397,359345903,355956276,44.909480961401144,35.78719109250008,NaN,NaN,-3.80701965230529,-5.804904407170305
2018-07-18T09:30:00-04:00,58.8,59.14,58.32,58.32,5887189,6050797.8,47.34967536030125,47.25253312179067,NaN,NaN,60.20362251748607,34.250529574135996,0.04973826926678465,-0.11631906345966314,-0.1660573327264478,353458714,356048309.6,45.11867780712736,37.10927839062032,NaN,NaN,-4.048864294361815,-5.554041533911949
2018-07-19T09:30:00-04:00,58.53,58.6,58.12,58.53,6417509,6104910.5,49.20359647123437,47.80936759310343,NaN,NaN,26.68228748968889,36.07608496917199,0.0485331861936531,-0.10539084998438142,-0.15392403617803452,359876223,356100051.4,45.244566086804376,38.40906956911153,NaN,NaN,-3.677123566198111,-5.285910395667115
2018-07-20T09:30:00-04:00,58.29,58.4968,58.02,58.29,7321014,6111637.35,47.15979487378835,48.08180837016153,NaN,NaN,-5.007265649976288,28.776860826616417,0.03132073039227645,-0.11477312318768895,-0.1460938535799654,352555209,355379994,43.740875527438156,39.611674945881155,NaN,NaN,-3.979078228479093,-5.099220086068827
2018-07-23T09:30:00-04:00,58.27,58.29,57.92,57.97,4149457,5963390.05,44.50532798693369,48.32661909382057,NaN,NaN,-42.17195395111379,21.496710630535446,-0.00019933053098170062,-0.14634301674369254,-0.14614368621271084,348405752,354728360.2,42.36855100058688,40.67942244342839,NaN,NaN,-5.0213277347436005,-5.08809260730808
2018-07-24T09:30:00-04:00,58.38,59.045,58.38,58.72,7116827,5829703.7,51.408680706778306,49.11689998746383,NaN,NaN,76.53229951380881,23.24779798397874,0.029250567117265425,-0.10958047731612908,-0.1388310444333945,355522579,353963695.4,40.75278370928467,41.70437183084065,NaN,NaN,-3.803771743670945,-4.904618198217061
2018-07-25T09:30:00-04:00,58.75,59.26,58.335,59.18,4733608,5880978.2,55.09807433255107,49.79707131817467,NaN,NaN,105.88004819232101,32.38308311894573,0.07679765084901011,-0.04283398087213186,-0.11963163172114197,360256187,355323190,44.78447679784048,42.83217754968585,NaN,NaN,-1.6103798508115903,-4.4340127200162796
2018-07-26T09:30:00-04:00,59.17,59.63,58.98,59.52,6197677,5901474.4,57.657144608786105,50.4581735364372,NaN,NaN,167.36932056661226,60.52048973433041,0.1253620464811212,0.03707092638025955,-0.08829112010086165,366453864,356638718.2,48.44070931545148,44.08099927824259,NaN,NaN,1.012601153268094,-3.655925023832798
2018-07-27T09:30:00-04:00,59.7,59.75,59.15,59.3,5521057,5883059,55.45480214212766,50.626086796112574,NaN,NaN,155.4949413577304,92.62093113587176,0.13599463043591914,0.08170216794403728,-0.05429246249188186,360932807,358314237.8,52.733684683944986,45.51122463450815,NaN,NaN,2.5195830297835298,-2.773709587601894
2018-07-30T09:30:00-04:00,59.36,59.73,59.09,59.19,3472168,5804524.1,54.337208976495496,50.42532306307282,NaN,NaN,128.05581502268922,126.66648493063235,0.129004895820562,0.10696365728382062,-0.022041238536741364,357460639,360125215.2,56.90984989351099,46.67783183610231,NaN,NaN,3.435703679938198,-1.8866505493818808
2018-07-31T09:30:00-04:00,59.32,59.8848,59.295,59.73,5237590,5682260.5,58.733880007202316,51.17799588884558,NaN,NaN,155.25251764235816,142.4105285563422,0.15252369999389342,0.1686133864556254,0.016089686461731992,362698229,361560345.2,59.9311618457805,47.79109567205143,NaN,NaN,5.555696514102603,-0.8234581117412403
2018-08-01T09:30:00-04:00,59.6,59.73,59.01,59.12,6060357,5815806.85,52.57551009039419,51.405416239897804,NaN,NaN,86.22486839845585,138.4794925975692,0.12019382489864434,0.16633196758503743,0.04613814268639309,356637872,360836682.2,57.732942316303955,48.46618446846334,NaN,NaN,5.538042726092737,0.08532772223504215
2018-08-02T09:30:00-04:00,58.63,58.76,58.06,58.73,9268116,6001253.45,49.035479898555835,51.39866110069549,NaN,NaN,-46.07884288533835,95.78985990717906,0.06831980508187764,0.13153789903874014,0.0632180939568625,347369756,357019860.6,47.778801262190605,48.367974513608424,NaN,NaN,4.4329288125907675,0.7064135922858601
2018-08-03T09:30:00-04:00,58.93,59.315,58.89,59.29,5329586,6041186.75,53.84147673462283,52.02303242275339,NaN,NaN,58.1180463997111,76.3144809155752,0.06738628179453504,0.1474509462000313,0.08006466440549626,352699342,355373167.6,44.23520976077808,48.191555069174576,NaN,NaN,4.97491900339553,1.3162000795872415
2018-08-06T09:30:00-04:00,58.83,59.5,58.64,59.27,4631077,6045849.95,53.646901824078675,52.14339671527504,NaN,NaN,49.26014229648135,60.55534637033363,0.06126237970241974,0.15664263903352094,0.0953802593311012,348068265,353494692.8,40.5413217618564,47.87954369777852,NaN,NaN,5.349770205513635,1.892424383291012
2018-08-07T09:30:00-04:00,59.44,59.82,59.405,59.47,4757422,5985039.2,55.383310329904816,52.71722778453243,NaN,NaN,114.43244101655084,52.39133104517217,0.06610653048119264,0.178013422432592,0.11190689195139936,352825687,351520184.4,37.04005242318861,47.30249902749718,NaN,NaN,6.162449747859211,2.5024280068007547
2018-08-08T09:30:00-04:00,59.52,59.69,59.185,59.22,6506249,5743072.3,52.72454110991312,52.968723830152335,NaN,NaN,73.82465488646184,49.911288342773375,0.04870268705165577,0.17278525076596907,0.1240825637143133,346319438,349456497.6,33.75849383312256,46.48206529509134,NaN,NaN,6.097025314154435,3.0159419078512806
2018-08-09T09:30:00-04:00,59.41,59.8654,59.41,59.54,4244066,5624327.2,55.6588342076843,53.57579806828777,NaN,NaN,99.35806027130386,78.99866897410183,0.05453163519942217,0.192247107713591,0.13771547251416882,350563504,350095247.2,35.65856917859092,45.90475769874511,NaN,NaN,6.876018926766105,3.5673814819819696
2018-08-10T09:30:00-04:00,59.14,59.249,58.61,58.68,6052286,5753840.6,47.182933938201806,53.76705563623549,NaN,NaN,-16.88842212559037,63.99737526904154,-0.000812248011989869,0.1367001624991815,0.13751241051117136,344511218,348457622.4,33.041758934418326,45.23855826544735,NaN,NaN,4.959335084624728,3.766231996645221
2018-08-13T09:30:00-04:00,58.73,58.965,57.865,58.09,5436071,5801065.4,42.41125613051388,53.1243824522166,NaN,NaN,-100.88348307839738,33.96865019406579,-0.07436423848699328,0.044557112402429766,0.11892135088942304,339075147,346658998.8,30.402800932535456,44.499273781393846,NaN,NaN,1.7573134547673404,3.4792436335198094
2018-08-14T09:30:00-04:00,58.33,58.885,58.29,58.58,4136045,5623768.55,47.188157154191785,52.55938836804808,NaN,NaN,-57.15410078935097,-0.34865816711457426,-0.08638043290063166,0.010945809763633463,0.09732624266426512,343211192,344736099.8,27.842568005256396,43.2891374390664,NaN,NaN,0.5719933202022384,3.063922160188728
2018-08-15T09:30:00-04:00,58,58.02,57.015,57.65,8489476,5753882.9,40.347513539811295,51.3229861488356,NaN,NaN,-184.21648628428377,-51.9568864012637,-0.14962147786403557,-0.08970060466577934,0.05992087319825623,334721716,342416555.4,25.0970775662433,41.62173517126582,NaN,NaN,-2.8346411853941547,2.2212702536768876
2018-08-16T09:30:00-04:00,57.87,58.32,57.87,58,6344664,5750240.65,43.65781404097682,50.48034414161054,NaN,NaN,-108.58810823174501,-93.54612010187347,-0.1596264393839344,-0.13961217603166176,0.020014263352272632,341066380,340517130.6,23.089257836561615,39.50427611073844,NaN,NaN,-4.49180200475274,1.2622599310440836
2018-08-17T09:30:00-04:00,57.89,58.54,57.87,58.43,5258994,5647139.65,47.51159758506642,49.99280047079417,NaN,NaN,-80.16223077890237,-106.20088183253588,-0.13027034449060543,-0.14282366726098417,-0.012553322770378732,346325374,340879961.8,24.33453627078366,37.17746799482934,NaN,NaN,-4.601552613292821,0.42457242471024015
2018-08-20T09:30:00-04:00,58.54,58.95,58.54,58.84,4841534,5681743.5,50.956190519461984,49.43725122166986,NaN,NaN,-20.9013885046455,-90.20446291778549,-0.07876183780107425,-0.11100562002172154,-0.03224378222064729,351166908,343298314,32.21273911752928,35.19758065709711,NaN,NaN,-3.581163007964728,-0.1476754942433267
2018-08-21T09:30:00-04:00,58.96,59.34,58.86,59.07,4958048,5573804.55,52.826449625909255,49.455175474206655,NaN,NaN,21.51408461739328,-74.47082583643665,-0.02737645492260253,-0.06646435087390046,-0.03908789595129793,356124956,345881066.8,39.46217552774564,33.89252588648581,NaN,NaN,-2.1690768662599273,-0.4364471188171268
2018-08-22T09:30:00-04:00,59.04,59.135,58.695,58.77,5432679,5608758.1,50.14057936067013,49.534111150071965,NaN,NaN,-10.290849588700176,-39.68569849731992,-0.012522915689316592,-0.05474154056294367,-0.04221862487362708,350692277,349075179,47.00970026664693,33.83759010108983,NaN,NaN,-1.8083027917640442,-0.6324265006666864
2018-08-23T09:30:00-04:00,58.65,58.65,58.21,58.37,4442032,5520975.85,46.72908758251915,49.02608335349313,NaN,NaN,-68.27399494566676,-31.622875840104268,-0.02769869950811283,-0.07684199925876811,-0.04914329975065528,346250245,350111952,49.222622718359695,34.193833883774225,NaN,NaN,-2.5365329953034,-0.9044417141862169
2018-08-24T09:30:00-04:00,58.68,59.205,58.62,59.13,4951582,5492502.1,53.23902512966715,48.9969493038923,NaN,NaN,17.229122172550614,-12.144605249813665,0.013190879380824985,-0.03265470052462405,-0.04584557990544903,351201827,351087242.6,51.28363116684469,34.96114169841625,NaN,NaN,-1.1103056674757628,-0.9338508503704377
2018-08-27T09:30:00-04:00,59.25,60.13,59.25,59.94,5609088,5599348.1,58.991058029679984,49.25464556816196,NaN,NaN,125.20500575934031,17.076673602983455,0.09023846066474103,0.06695249592547725,-0.023285964739263774,356810915,352216044,53.62958095146273,36.1461080218644,NaN,NaN,2.0636704529528203,-0.505633521324258
2018-08-28T09:30:00-04:00,60.03,60.295,59.52,59.71,3843119,5529624.55,56.8525292676979,49.54950186514659,NaN,NaN,130.59689228072008,38.89323513564882,0.11933417375134192,0.12588175244991362,0.006547578698571706,352967796,351584612,52.11768247639871,37.457478639241266,NaN,NaN,3.9314264298342594,0.12823218598410158
2018-08-29T09:30:00-04:00,59.72,60.265,59.46,60.16,4278504,5440531.9,59.91439874433725,49.8534707606218,NaN,NaN,133.2096298411079,67.59333102161042,0.15997336415074512,0.2065142838870031,0.04654091973625799,357246300,352895416.6,54.95655491022548,38.835906191500875,NaN,NaN,6.470680930929949,1.0342962924049368
2018-08-30T09:30:00-04:00,59.88,60.16,59.27,59.45,5839252,5269088.7,53.467488371946686,50.302367505889286,NaN,NaN,81.16955482396422,97.48204097553662,0.13132430729701317,0.21069630385752447,0.07937199656051129,351407048,353926777.2,57.11118171692712,40.555150675965784,NaN,NaN,6.579912058064904,1.8265271160706464
2018-08-31T09:30:00-04:00,59.36,59.74,59.14,59.27,4280737,5216646.25,51.9415596320805,50.983103470286906,NaN,NaN,47.72832855231066,103.58188225148862,0.09427259746487895,0.19721274339161,0.10294014592673104,347126311,353111674,54.87700458623882,42.303308079801745,NaN,NaN,6.192478171916132,2.450234409762859
2018-09-04T09:30:00-04:00,59.11,59.14,58.555,58.86,5972217,5283703.25,48.54320314651671,51.07989246973869,NaN,NaN,-16.967961458278648,75.14728880796484,0.03900365038969611,0.15169470891385117,0.11269105852415506,341154094,349980309.8,47.23259528487457,43.6883100283459,NaN,NaN,4.8148793335664815,2.7880408274490907
2018-09-05T09:30:00-04:00,58.81,59.36,58.64,59.25,4640380,5277851.15,51.7753317360203,51.89616519803933,NaN,NaN,15.760150900196738,52.179940531860176,0.02617901531565474,0.1454148276687235,0.11923581235306875,345794474,348545645.4,44.19501187310737,45.052448193121904,NaN,NaN,4.639655286725856,3.0525571787743426
2018-09-06T09:30:00-04:00,59.32,59.72,58.96,59.37,6004089,5252743.15,52.75859543628016,52.546221011989566,NaN,NaN,50.904681227391954,35.71895080911698,0.023339504781108134,0.14841019332945393,0.1250706885483458,351798563,347456098,41.98661194384033,46.40225920078467,NaN,NaN,4.784110529651619,3.299921943185382
2018-09-07T09:30:00-04:00,58.93,59.2,58.59,58.98,7299060,5405492.85,49.24440195032424,52.669992752365125,NaN,NaN,-0.7008685847736308,19.344866127369418,-0.00569287530130777,0.11795459442171108,0.12364746972301885,344499503,346074589,39.304718994394506,47.47155796675687,NaN,NaN,3.876326089369484,3.382265392640254
2018-09-10T09:30:00-04:00,59.14,59.37,59.02,59.05,4771496,5341453.35,49.88957856286157,52.59380618403652,NaN,NaN,28.191796649357332,15.43755974677875,-0.0202514126679781,0.09833320388804623,0.11858461655602433,349270999,346503526.6,40.57392676823535,48.06878565609303,NaN,NaN,3.3118740157822892,3.3722094816605446
2018-09-11T09:30:00-04:00,58.62,59.32,58.41,59.17,7748971,5457098.35,51.038569631516204,52.4661004701513,NaN,NaN,-1.4390274159323733,18.543346555248004,-0.0217378029829519,0.09141236282733445,0.11315016581028635,357019970,349676701.8,49.06024420667095,48.75436199030197,NaN,NaN,3.1501882597935618,3.3404921642509757
2018-09-12T09:30:00-04:00,59.16,59.47,58.93,59.2,6241297,5562360.95,51.338965961863906,52.551699513093716,NaN,NaN,29.32421305974914,21.256158987158482,-0.020646950632531164,0.0873414775196224,0.10798842815215356,363261267,353170060.4,56.43596021076503,49.427666272024695,NaN,NaN,3.0935780913175974,3.305218725260493
2018-09-13T09:30:00-04:00,59.67,59.87,59.4,59.43,4102894,5343031.85,53.68509846315489,53.04855743313912,NaN,NaN,78.84197276578995,26.843617294838083,-0.0051873254512081884,0.10150427133814333,0.10669159678935151,367364161,356283180,61.75098079623551,50.32254899187297,NaN,NaN,3.6579778323405145,3.3556128834147816
2018-09-14T09:30:00-04:00,59.56,59.67,59.26,59.41,4853712,5268484.25,53.44379954658051,53.06318417720437,NaN,NaN,50.571700438360025,37.09813109946481,0.0025253560828860516,0.10984829189295908,0.10732293581007303,362510449,359885369.2,66.79862033170562,51.430762503648715,NaN,NaN,4.073218077072291,3.45812791108014
2018-09-17T09:30:00-04:00,59.39,59.97,59.39,59.62,3883388,5199703.95,55.69556327806229,52.82779169494596,NaN,NaN,81.26255942756602,47.712283655106546,0.019650398792243964,0.13188593430037798,0.11223553550813402,366393837,363309936.8,70.750553481173,52.65368911291373,NaN,NaN,5.013285215722266,3.6802932403147293
2018-09-18T09:30:00-04:00,59.79,60,59.47,59.68,4078526,5161553.55,56.34523444033486,52.79155635013431,NaN,NaN,83.12918504004067,64.62592614630117,0.03215976729553624,0.1524352446275543,0.12027547733201807,370472363,366000415.4,73.42668624855416,54.175760810924835,NaN,NaN,5.981617586819919,4.009053861244042
2018-09-19T09:30:00-04:00,59.74,60.58,59.74,60.33,7927195,5310010.9,62.72256817116759,52.99213988062219,NaN,NaN,156.1061893840788,89.98232141116708,0.07869948189674342,0.21864982970294733,0.1399503478062039,378399558,369028073.6,76.07903531512576,55.68450941127485,NaN,NaN,8.682150664660748,4.676639118875
2018-09-20T09:30:00-04:00,60.75,61.16,60.7299,60.98,5597646,5318259.25,67.78994936374099,54.015172808607495,NaN,NaN,236.3692086195134,121.48776858191177,0.143949697373627,0.31988746952323766,0.17593777214961065,383997204,372354682.2,78.60577794528669,57.219837713300535,NaN,NaN,12.726156353369905,5.826570152374273
2018-09-21T09:30:00-04:00,60.94,61.05,60.4,60.56,8154300,5503872.65,61.931658654368675,54.72875131019951,NaN,NaN,170.05740905526892,145.38491030529354,0.14889377743733018,0.3620549939462734,0.2131612165089432,375842904,375021173.2,80.39352072241395,59.042446008741614,NaN,NaN,14.478903999197815,7.062617844777636
2018-09-24T09:30:00-04:00,60.36,60.435,59.61,59.71,4600665,5486326.8,52.11578020017002,54.98393538546047,NaN,NaN,48.33180978162042,138.79876037610444,0.08799900882291384,0.3231599775375855,0.23516096871467168,371242239,375990853.6,81.01481387988173,61.455461622670704,NaN,NaN,12.849798742412103,7.889357973011131
2018-09-25T09:30:00-04:00,59.85,59.91,59.33,59.4,5061837,5458964.25,49.06165983374546,54.790101678155125,NaN,NaN,-8.828021846516528,120.40731899879299,0.02329090068217421,0.26427459456738944,0.24098369388521523,366180402,375132461.4,78.63918928908183,63.91576000952602,NaN,NaN,10.517872293506729,8.264860018796217
2018-09-26T09:30:00-04:00,59.11,59.37,58.69,58.81,8511276,5692372.1,43.800613787037584,54.15024584606636,NaN,NaN,-93.64966717185537,70.45614768760616,-0.05833725938605544,0.16806211965264595,0.2263993790387014,357669126,370986375,68.23189000871056,65.79042272844532,NaN,NaN,6.745975415396294,8.0478765040248
2018-09-27T09:30:00-04:00,58.77,58.77,58.23,58.3,6279925,5792443.15,39.82513058883439,53.477440748817095,NaN,NaN,-153.52714273099517,-7.5231225824955406,-0.1410531216516729,0.05008297697411024,0.19113609862578315,351389201,364464774.4,55.736748496197436,66.96413912143124,NaN,NaN,2.2282863728649605,7.216506485287679
2018-09-28T09:30:00-04:00,58.13,58.22,57.82,57.93,5380947,5769527.9,37.18801619805051,52.570186294187735,NaN,NaN,-183.99478503104066,-78.33356139975746,-0.2108586708700385,-0.07243723996176499,0.13842143090827352,346008254,358497844.4,47.21688663031273,67.43863625443677,NaN,NaN,-2.362436010660433,5.848086128723663
2018-10-01T09:30:00-04:00,58.25,58.75,58.25,58.51,4386480,5774815.05,43.5034690168491,52.031964821711504,NaN,NaN,-103.21826120611068,-108.64357559730368,-0.20780559355647474,-0.1213355610373199,0.08647003251915483,350394734,354328343.4,42.34586804813817,66.9590379573987,NaN,NaN,-4.18014982189024,4.415480992921677
2018-10-02T09:30:00-04:00,58.55,58.9138,58.4592,58.76,3673757,5659892.05,46.0227102609023,51.65223227164283,NaN,NaN,-76.2988532588284,-122.13774187976605,-0.1798323860739594,-0.1383204500732944,0.04151193600066498,354068491,351905961.2,39.7783557412017,65.76920906671562,NaN,NaN,-4.837698701360308,3.0935981794528216
2018-10-03T09:30:00-04:00,58.96,59.04,58.29,58.34,3935036,5624624.85,42.58698201591267,50.85950966826838,NaN,NaN,-87.48886328833012,-120.905581103061,-0.18005408591808253,-0.18355567139693818,-0.003501585478855658,350133455,350398827,38.22543987359749,64.0888132865272,NaN,NaN,-6.488359684087865,1.7247470560898663
2018-10-04T09:30:00-04:00,58.32,58.32,57.61,58.07,5578897,5603365.25,40.49413309835861,49.93453349339539,NaN,NaN,-130.4600805023096,-116.29216865732387,-0.1879531563205965,-0.23844303087960128,-0.050489874559004784,344554558,349031898.4,36.82139830520335,61.94758314177704,NaN,NaN,-8.498650087273784,0.26426174989505924
2018-10-05T09:30:00-04:00,57.96,58.18,57.4,57.64,5352175,5506021,37.34639176429097,48.62387838526887,NaN,NaN,-139.641587035765,-107.42152905826875,-0.21003261447918983,-0.3130306426579921,-0.10299802817880224,339202383,347670724.2,35.4259877488592,59.4243998751832,NaN,NaN,-11.19414872787802,-1.3726540326439518
2018-10-08T09:30:00-04:00,57.41,57.71,57.17,57.61,6290341,5581963.25,37.12953949248078,47.25132874613643,NaN,NaN,-138.61455355667135,-114.5007875283809,-0.2138368509415845,-0.3702940918557829,-0.15645724091419838,332912042,344174185.8,32.06447237507861,56.46995602707779,NaN,NaN,-13.412128376159757,-3.092578938860495
2018-10-09T09:30:00-04:00,56.86,56.86,55.61,55.7,11357388,5762384.1,26.556794167814857,44.66805917446838,NaN,NaN,-210.28649667008094,-141.2983162106314,-0.32547693867228566,-0.5633034142545554,-0.2378264755822698,321554654,337671418.4,26.943903132377216,52.960303728310045,NaN,NaN,-19.66508289531001,-5.4600795040675685
2018-10-10T09:30:00-04:00,55.73,55.76,54.22,54.24,13201683,6110403.4,21.513790205357125,41.36261923458381,NaN,NaN,-238.05104592269348,-171.41075273750408,-0.4693943144766229,-0.8245693686780484,-0.35517505420142553,308352971,329315321.6,22.06715416876162,48.92183060141539,NaN,NaN,-27.223100718030313,-8.569082534633674
2018-10-11T09:30:00-04:00,54.2,54.68,53.42,53.61,18286782,6819597.8,19.76926753477281,38.35101986889839,NaN,NaN,-227.97756188687453,-190.91424901441707,-0.5719595769186121,-1.0701245253496907,-0.49816494843107856,290066189,318417647.8,17.594528515894908,44.436188300949745,NaN,NaN,-33.751531910972794,-12.16657530268212
2018-10-12T09:30:00-04:00,54.47,54.63,53.37,53.76,10650524,7109438.4,21.403442694770106,36.157281475655545,NaN,NaN,-181.89491011382296,-199.36491363002864,-0.5921481059412799,-1.2383500808576784,-0.6462019749163985,300716713,310720513.8,15.244330273258342,39.738296614762355,NaN,NaN,-38.0535852767647,-15.864719584693916
2018-10-15T09:30:00-04:00,53.75,54.09,53.56,53.58,5128260,7171682,20.854504250152175,34.14248464825603,NaN,NaN,-156.83281671637965,-203.00856626197032,-0.5793563820550526,-1.3703974524852143,-0.7910410704301617,295588453,303255796,13.378005337023652,35.076783475329634,NaN,NaN,-41.57271922255123,-19.537290961530672
2018-10-16T09:30:00-04:00,53.75,54.56,53.56,54.44,5526543,7244082.85,30.08117013385869,33.162524387314676,NaN,NaN,-118.70182399510591,-184.69163172697532,-0.47887299712582443,-1.3896323168374423,-0.9107593197116178,301114996,299167864.4,12.477122606227212,31.09430008943796,NaN,NaN,-41.429668083600305,-22.66477340754062
2018-10-17T09:30:00-04:00,54.38,54.5,53.74,54.09,8534954,7274470.8,28.618905784459017,32.36207975843072,NaN,NaN,-104.0234021051958,-157.88610296347576,-0.40482160779641685,-1.416786329457139,-1.0119647216607222,292580042,296013278.6,11.815872002235494,27.95709462558354,NaN,NaN,-41.7895399303662,-25.396882910801416
2018-10-18T09:30:00-04:00,53.84,54.36,53.19,53.48,7693953,7379286.15,26.226080294495603,31.57908433674822,NaN,NaN,-102.67960994133426,-132.8265125743677,-0.36688909969032224,-1.470576096273625,-1.1036869965833027,284886089,294977258.6,11.598470352956099,25.41292203434378,NaN,NaN,-42.86789454912438,-27.892741716276124
2018-10-19T09:30:00-04:00,53.35,53.83,53.01,53.1,7105852,7326863.75,24.83315341824786,30.24549036541956,NaN,NaN,-101.0179842858105,-116.6511274087652,-0.3380694142011209,-1.5262737643347037,-1.1882043501335828,277780237,290389963.4,10.662961047037783,23.14985724855089,NaN,NaN,-44.18823229679656,-30.22066894206476
2018-10-22T09:30:00-04:00,53.33,53.52,52.5,52.68,13326457,7763153.35,23.356581553596854,28.626481172040602,NaN,NaN,-102.16335133777989,-105.71723433304528,-0.31825442289243044,-1.5860223787491208,-1.2677679558566903,264453780,284163028.8,9.538302272931759,20.989853429388752,NaN,NaN,-45.74095085356219,-32.43785207227868
2018-10-23T09:30:00-04:00,51.83,52.43,51.03,52.16,20201873,8520155.15,21.64089966978831,27.130332433031718,NaN,NaN,-120.00685658395474,-105.97824085081501,-0.310778534209027,-1.6562411236179742,-1.3454625894089471,244251907,272790411,7.899541183262286,18.823717808650525,NaN,NaN,-47.58322600975207,-34.60147692048916
2018-10-24T09:30:00-04:00,51.97,52.23,50.395,50.51,20634010,9126291.85,17.298728401267184,25.473517811810897,NaN,NaN,-130.46815193921768,-111.2671908176194,-0.382834087411583,-1.8240051986734258,-1.4411711112618428,223617897,258997982,6.451801290298647,16.654460879014476,NaN,NaN,-50.85597422583553,-36.92354796411007
2018-10-25T09:30:00-04:00,50.81,51.55,50.74,51.16,14255848,9525088,23.78625341244883,24.504936500965037,NaN,NaN,-116.94667662345495,-114.12060415404353,-0.35330795333793663,-1.8828060529342636,-1.529498099596327,237873745,249595513.2,5.686675333667466,14.530224277929355,NaN,NaN,-51.24992534846257,-38.97017330473186
2018-10-26T09:30:00-04:00,50.45,51.39,50.09,50.86,23979274,10455004.35,22.89361847621386,23.48808499980311,NaN,NaN,-119.17587386466083,-117.7521820698136,-0.3214817147159217,-1.931350242991229,-1.6098685282753074,213894471,236818360,4.845696531111884,12.5860260033603,NaN,NaN,-51.8520869955471,-40.81044668913403
2018-10-29T09:30:00-04:00,51.51,51.88,50.22,50.74,17412655,11106313.1,22.52941636835027,23.20041515698421,NaN,NaN,-108.2996338771996,-118.97943857769754,-0.27766229779826346,-1.9569464005231367,-1.6792841027248733,196481816,223223967.2,4.143575105337661,10.957431144286046,NaN,NaN,-52.43923665363875,-42.471702398348995
2018-10-30T09:30:00-04:00,50.6,51.995,50.55,51.9,23172589,12081254.7,33.53650830621541,24.059180735616945,NaN,NaN,-87.51780003267812,-112.48162726744222,-0.14630341708574823,-1.8621633740820585,-1.7158599569963102,219654405,218304466.8,3.922102110139633,9.66135599724162,NaN,NaN,-49.30259968904679,-43.44754486844868
2018-10-31T09:30:00-04:00,52.49,52.95,52.27,52.61,13167732,12542889.5,39.22797881260101,25.44908868403325,NaN,NaN,-41.95649342190379,-94.77929556397945,0.004652960388664251,-1.7100437565104798,-1.714696716899144,232822137,220145314.8,5.947897989099218,8.829453816756212,NaN,NaN,-44.7747840954225,-43.63715047230208
2018-11-01T09:30:00-04:00,53.57,54.215,53.19,54.09,13724259,12950157.6,49.02675178613206,27.422182190559102,NaN,NaN,15.655742055458894,-68.25881182819668,0.20910828251771507,-1.4533113637520003,-1.6624196462697154,246546396,221879845,7.918030375136297,8.306146681176063,NaN,NaN,-37.19227142733646,-42.71645346587842
2018-11-02T09:30:00-04:00,54.46,54.61,53.25,53.96,13439825,13354540.1,48.29021661712478,29.381875931057145,NaN,NaN,32.34451415304653,-37.95473422465521,0.33315478205654214,-1.2459761686990376,-1.5791309507555797,233106571,225722265,12.300622619699695,8.229190772795784,NaN,NaN,-31.61399931589769,-41.130388587309746
2018-11-05T09:30:00-05:00,54,54.25,53.72,54.12,7856778,13432861.95,49.2997752951733,30.754633442579614,NaN,NaN,50.5468993741923,-6.185427574376841,0.4180476622591609,-1.0565713729316286,-1.4746190351907895,240963349,234618571.6,21.603987036595626,8.88110966067924,NaN,NaN,-26.881312642612816,-39.0948063094959
2018-11-06T09:30:00-05:00,54.28,55.06,54.13,55.01,6572605,13193622.8,54.60847685495619,32.61103137618655,NaN,NaN,97.16065020055461,30.750262472269704,0.5195836667367062,-0.8251394517699069,-1.344723118506613,247535954,240194881.4,26.842682248251393,9.954453249680373,NaN,NaN,-21.051941288900384,-36.51725416369654
2018-11-07T09:30:00-05:00,55.43,56.03,55.09,56,6781139,12872595.6,59.6674666151192,34.99970182765967,NaN,NaN,145.5559269782948,68.25274655230942,0.6314261040481757,-0.5554404884463935,-1.1868665924945692,254317093,244493872.6,30.688081367010426,11.317996893541395,NaN,NaN,-14.317154818277517,-33.34581140006525
2018-11-08T09:30:00-05:00,55.69,56.005,55.47,55.76,6447413,12280627.15,57.98040471622803,37.36736263465826,NaN,NaN,134.29376158987145,91.98035045919194,0.6639305741052126,-0.35695337486305334,-1.020883948968266,247869680,244758529.4,30.928784604005415,12.765555719039085,NaN,NaN,-9.472707922431018,-29.935368046117503
2018-11-09T09:30:00-05:00,55.43,55.43,54.57,54.98,9012442,12198723.05,52.759320960137636,39.46755830655402,NaN,NaN,89.01918976546344,103.31528558167531,0.609028834748259,-0.25959790553294226,-0.8686267402812012,238857238,245908662.8,32.03342078549312,14.372349898507752,NaN,NaN,-6.984472525932289,-26.656668686091045
2018-11-12T09:30:00-05:00,54.91,55.02,54.06,54.17,10059829,12445301.5,47.932263633687896,41.34551287540399,NaN,NaN,56.86830497795129,104.57956670242712,0.4989179867454202,-0.244979256849426,-0.7438972435948462,228797409,243475474.8,30.907273998612453,16.01575938531848,NaN,NaN,-6.420450446146503,-23.76578036609897
2018-11-13T09:30:00-05:00,54.29,54.87,53.93,54.01,9506174,12644283.05,47.01718269561636,43.46825961071465,NaN,NaN,49.242424242430296,94.99592151080225,0.40031967809232616,-0.24349764597943846,-0.6438173240717646,219291235,237826531,28.4101427422044,17.58421234616889,NaN,NaN,-6.250954698960945,-21.26366241365068
2018-11-14T09:30:00-05:00,54.33,54.72,53.67,53.95,9726306,12703850.65,46.657459364041415,45.10191717868555,NaN,NaN,41.45579041381995,74.17589419790728,0.31957524919331726,-0.2443482625801181,-0.5639235117734354,209564929,228876098.2,24.96802080239037,18.961451308220525,NaN,NaN,-6.2188999873905955,-19.11441063847067
2018-11-15T09:30:00-05:00,53.77,54.945,53.52,54.69,11991702,12918738.1,51.578072590858376,47.15080675830301,NaN,NaN,52.07979007726909,57.73309989538681,0.3045797970415693,-0.18319876547147373,-0.487778562513043,221556631,223613488.4,23.189016560152453,20.271688453151995,NaN,NaN,-4.738559615972572,-17.060717635256655
2018-11-16T09:30:00-05:00,54.52,55.38,54.37,55.24,8731044,12999997.7,54.907471083261996,49.46352495222528,NaN,NaN,74.07707628885585,54.744677200065304,0.3187610610332855,-0.08932723622143612,-0.4080882972547216,230287675,221899575.8,22.62365303952214,21.59169401987946,NaN,NaN,-2.4828218670412614,-14.97816109694017
2018-11-19T09:30:00-05:00,55.12,55.42,54.3,54.45,12284178,12947883.75,49.62899814190979,50.61298851191773,NaN,NaN,56.63958348863133,54.69893290220131,0.2642441297124322,-0.07778313511418133,-0.34202726482661355,218003497,219740793.4,21.8994125552548,22.875787623101967,NaN,NaN,-2.1216313320648514,-13.141513987672267
2018-11-20T09:30:00-05:00,53.93,54.04,53.22,53.46,11259331,12500756.65,43.92962442767196,50.94882034156566,NaN,NaN,-0.012411490550962294,44.847965755605046,0.1561605695134245,-0.14682655293483293,-0.30298712244825743,206744166,217231379.6,21.055619052081113,23.954910556172102,NaN,NaN,-3.6285917532020964,-11.782525097033671
2018-11-21T09:30:00-05:00,53.64,54.41,53.64,53.89,7013354,11819723.85,46.78799913743959,50.78890943808763,NaN,NaN,14.694924686159636,39.49579261007299,0.11043356401202098,-0.16494516743323118,-0.27537873144525216,213757520,218069897.8,22.135235717762214,24.970425223502527,NaN,NaN,-3.9881015095534793,-10.66903601310793
2018-11-23T09:30:00-05:00,53.39,53.67,53.15,53.31,3151109,11264486.9,43.56218340213964,50.451192779874404,NaN,NaN,-29.67552584378586,23.144729425862,0.04147998324989527,-0.22352875238288306,-0.2650087356327783,210606411,215879853.8,21.315327214100606,25.61433269453116,NaN,NaN,-5.2962547066684555,-9.901495826473719
2018-11-26T09:30:00-05:00,53.77,54.11,53.6,53.92,5357316,10333389,47.650147473718434,50.33336222119906,NaN,NaN,-8.862708707364982,6.556772426617833,0.03743157440248035,-0.21821926762967792,-0.25565084203215827,215963727,213015064.2,20.258247619882894,25.51820845048025,NaN,NaN,-5.147634391204819,-9.222372764292448
2018-11-27T09:30:00-05:00,53.51,53.81,52.9,53.26,5896450,9757578.75,43.94153957170441,49.571438129538215,NaN,NaN,-74.15836889519774,-19.60281805014798,-0.006857053007583602,-0.26422215829163775,-0.25736510528405415,210067277,211427820.2,19.676025490966026,25.006304396388437,NaN,NaN,-6.178151828860267,-8.787484059230708
2018-11-28T09:30:00-05:00,53.4,54.08,52.68,54.08,8531041,9025501.35,49.22866764700397,48.825809631815694,NaN,NaN,-65.82088252945888,-32.76451225792957,0.020419984263169988,-0.23184012495509165,-0.25226010921826164,218598318,213798650.6,23.22535348843263,24.473252405061455,NaN,NaN,-5.400062873074889,-8.303566746922733
2018-11-29T09:30:00-05:00,54.07,54.78,53.95,54.47,7138196,8724024.55,51.56828046096479,48.367800756439756,NaN,NaN,12.199586472191159,-33.263579900723265,0.0636349496153677,-0.17271642219905203,-0.23635137181441973,225736514,216194449.4,26.747890927486083,24.174617142452927,NaN,NaN,-4.039975477738346,-7.694482279896392
2018-11-30T09:30:00-05:00,54.09,54.77,54.03,54.61,6058166,8340719.9,52.415966049172425,48.34327540565653,NaN,NaN,17.398684489726932,-23.848737834020703,0.098474646750314,-0.11325806337652722,-0.21173271012684122,231794680,220432103.2,32.635371975552175,24.21761365602858,NaN,NaN,-2.68887493299486,-6.979395516053316
2018-12-03T09:30:00-05:00,55.74,56.14,54.98,55.57,8576077,8097532.5,57.862292795244294,49.05256320291055,NaN,NaN,136.33172140308895,5.1901481880700855,0.17834457422008743,0.01119800764826806,-0.16714656657181937,240370757,225313509.2,38.742957463663465,24.77730533210365,NaN,NaN,0.19679679805028213,-5.954225185467088
2018-12-04T09:30:00-05:00,55.5,55.605,53.83,53.92,9045808,8156984,47.74685658488191,49.10468276642951,NaN,NaN,1.9626686191826552,20.414355690946163,0.1152810781822807,-0.023045218843968485,-0.13832629702624918,231324949,229565043.6,43.54397594834351,25.85829341825644,NaN,NaN,-0.5396760007660404,-5.180718159081224
2018-12-06T09:30:00-05:00,53.02,53.19,51.88,53.19,13225283,8489617.9,44.07563065989311,48.92026643041892,NaN,NaN,-171.6469488148781,-0.7508575661376792,0.024385075856391658,-0.10784495220575963,-0.13223002806215128,218099666,229465313.2,43.45793345831863,27.17900146510846,NaN,NaN,-2.385652264164923,-4.781423031236039
2018-12-07T09:30:00-05:00,53.14,54,51.74,51.91,14026307,8851876.3,38.487598096881754,47.985232537992026,NaN,NaN,-168.3788847967789,-36.86655181993169,-0.11434617718536111,-0.27516274954385267,-0.16081657235849156,204073359,225132682.2,39.780351732313505,28.364096834548537,NaN,NaN,-5.941862488053042,-4.947200096495611
2018-12-10T09:30:00-05:00,51.93,52.27,51.11,52.05,11664895,9112750.4,39.392680701034685,46.87703322497579,NaN,NaN,-207.41023682198554,-81.82833608227419,-0.18490541643728892,-0.3919483429051027,-0.2070429264678138,215738254,221921397,37.263330989490655,29.409788116689146,NaN,NaN,-8.403981527726499,-5.441026015242881
2018-12-11T09:30:00-05:00,52.97,53.27,51.67,51.88,10071101,9165683.35,38.64902881003523,46.09274970127046,NaN,NaN,-139.89207139890382,-137.07309464267274,-0.2283989651788319,-0.49254163294135367,-0.26414266776252177,205667153,214980676.2,32.47986422147717,30.165534664276457,NaN,NaN,-10.59607997901455,-6.177462295781691
2018-12-12T09:30:00-05:00,52.65,52.94,52.3,52.33,7450950,9035239.4,41.78202263861869,45.93934957348095,NaN,NaN,-102.77870773349949,-158.02136991320918,-0.2125607407543545,-0.5298435937054649,-0.31728285295111036,213118103,211339307,30.283464083922752,30.824666452265145,NaN,NaN,-11.483323946302027,-6.9354425315703105
2018-12-13T09:30:00-05:00,52.49,52.66,51.53,51.72,14628594,9291360.4,38.88332139369407,45.37472973464198,NaN,NaN,-129.22321313169527,-149.53662277657259,-0.2275270309745614,-0.6016916416693121,-0.3741646106947507,198489509,207417275.6,28.080849387711723,31.24935314297582,NaN,NaN,-13.116261117017212,-7.818416615205582
2018-12-14T09:30:00-05:00,51.32,51.84,51.13,51.32,7979386,9204014.4,37.06730466706891,44.910809824994075,NaN,NaN,-145.26993474360813,-144.91483276593846,-0.24709614699818128,-0.6830347944424773,-0.435938647444296,190510123,204704628.4,26.63774619210905,31.629525927119282,NaN,NaN,-15.020838137113163,-8.847333975478094
2018-12-17T09:30:00-05:00,51.39,51.735,50.11,50.44,15251643,9367011.45,33.37432938121903,43.891108532672696,NaN,NaN,-162.55411942793637,-135.9436092871286,-0.2985936761964919,-0.8091807426899109,-0.510587066493419,175258480,196608673.6,22.86156705730852,31.815477315506826,NaN,NaN,-17.831998663816975,-10.130857502383648
2018-12-18T09:30:00-05:00,50.82,51.34,50.41,50.72,11682913,9514604.9,35.57374998824298,43.29340927671116,NaN,NaN,-137.27959697732132,-135.4211144028121,-0.2926946852245087,-0.8764554230240549,-0.5837607377995462,186941393,192863521.6,21.353533779816985,31.935299336139035,NaN,NaN,-19.499252500712814,-11.4691996450021
2018-12-19T09:30:00-05:00,50.8,51.79,49.8,50.03,19700379,9885414.95,32.708254024323566,42.11337973223399,NaN,NaN,-135.8532145252393,-142.03601576116006,-0.31236592572899835,-0.9742181449607941,-0.6618522192317957,167241014,183688103.8,18.188099295419036,31.575495465209492,NaN,NaN,-21.804904563408183,-12.94572891906011
2018-12-20T09:30:00-05:00,49.89,50.37,48.86,49.36,23173123,10481104.55,30.16719108539094,40.58473049112157,NaN,NaN,-165.1777575205042,-149.22692463892184,-0.34504459460658354,-1.0931579624900252,-0.7481133678834416,144067891,172803780.2,15.292141879662765,30.757227676079253,NaN,NaN,-24.561325016289985,-14.60509979009295
2018-12-21T09:30:00-05:00,49.31,50.12,48.55,48.6,20556071,11158240.4,27.55237815689867,38.808759927387726,NaN,NaN,-161.69354354533885,-152.511646399268,-0.3891201610882884,-1.234513569243802,-0.8453934081555137,123511820,159404119.6,12.626687147018146,29.328035902612537,NaN,NaN,-27.753555331372404,-16.4834505817043
2018-12-24T09:30:00-05:00,48.28,48.66,47.31,47.34,11328242,11567097.05,23.859914211324465,36.380018599964885,NaN,NaN,-185.20503416943558,-157.04182934756784,-0.4690505165180715,-1.431706553803103,-0.9626560372850316,112183578,146789139.2,10.730428690538076,27.32714099024644,NaN,NaN,-31.829713102796536,-18.675773799003192
2018-12-26T09:30:00-05:00,47.56,49.479,47.05,49.46,17116068,12155034.65,38.73665725646577,35.736432933649446,NaN,NaN,-128.90298473202947,-155.36650689850947,-0.3504911130175212,-1.400769928556933,-1.0502788155394118,129299646,135260789.8,9.348695031758936,24.884620924776108,NaN,NaN,-30.22767114513772,-20.32604484845098
2018-12-27T09:30:00-05:00,48.85,50.39,48.64,50.37,14923615,12606392.9,43.81160250178598,35.717573779498935,NaN,NaN,-74.96747204560432,-143.18935840258246,-0.19015778692245444,-1.2879760491924799,-1.0978182622700254,144223261,130657239.2,8.858169385367944,22.41320920527963,NaN,NaN,-27.111465220359353,-21.295390615866463
2018-12-28T09:30:00-05:00,50.64,50.9072,49.91,50.1,9453041,12652492.9,42.681855955927674,36.01716362657364,NaN,NaN,-49.658586693131475,-120.08552423710792,-0.08691774857615475,-1.2064654479902188,-1.119547699414064,134770220,128797705,8.660495455360632,20.19036232835443,NaN,NaN,-25.073900469678534,-21.835177737839615
2018-12-31T09:30:00-05:00,50.27,50.61,49.96,50.52,7797996,12685482.9,45.05534663702391,36.42163976485859,NaN,NaN,-41.838666663896575,-96.11454886081944,0.01935760084867355,-1.0953506983532222,-1.1147082992018957,142568216,132608984.2,12.948290312543321,18.453573708572474,NaN,NaN,-22.669931678930645,-21.95442830085262
2019-01-02T09:30:00-05:00,49.78,50.97,49.5,50.78,9123692,12838759.2,46.531402998476956,36.984666492604426,NaN,NaN,-33.90839818099435,-65.8552216631312,0.11170934892642936,-0.975071613043859,-1.0867809619702884,151691908,140510650.2,21.20671377892191,17.648348676961387,NaN,NaN,-20.27941894443629,-21.715141249936
2019-01-03T09:30:00-05:00,50.51,50.51,49.24,49.34,9833967,12901653.7,40.10523090768637,36.86489565468069,NaN,NaN,-61.656157460694395,-52.40585620886418,0.08174818549384577,-0.9845957301029813,-1.066343915596827,141857941,143022309.2,23.6850275299589,17.177031780249685,NaN,NaN,-20.208631281014846,-21.49992554009012
2019-01-04T09:30:00-05:00,50.14,51.48,50.06,51.28,8950618,12896894.2,50.10302796671401,37.66630326703926,NaN,NaN,14.742038941938857,-34.463954011355554,0.1922116554700739,-0.8260793462592346,-1.0182910017293085,150808559,144339368.8,25.016891735493914,16.958177662234128,NaN,NaN,-16.60416286200352,-20.800530871792034
2019-01-07T09:30:00-05:00,51.3,52.065,50.96,51.46,7474485,12609354.3,50.921608108400115,38.65589636999149,NaN,NaN,56.03551849177955,-13.325132974373384,0.2721427099990015,-0.6781126142305567,-0.9502553242295582,158283044,149041933.6,29.73230689144033,17.17921771218636,NaN,NaN,-13.554578062609806,-19.765394756194574
2019-01-08T09:30:00-05:00,51.71,52.08,51.42,52,10328615,12424469.7,53.39193282920409,40.08572518770471,NaN,NaN,83.41975170664458,11.726550699734847,0.3511006107679968,-0.5113795607695621,-0.862480171537559,168611659,154250622.2,34.63547616006798,18.02021121952632,NaN,NaN,-10.279760189692395,-18.41030410383712
2019-01-09T09:30:00-05:00,52.13,52.22,51.53,52.02,8125154,12247482.65,53.48531730863765,41.36512285344718,NaN,NaN,88.62182023489335,36.23259438291238,0.3913240394858548,-0.3733251221802405,-0.7646491616660953,176736813,159259603.2,39.04068916503813,19.283579461327832,NaN,NaN,-7.6645224053408025,-16.87519243262336
2019-01-10T09:30:00-05:00,51.65,52.51,51.6,52.48,8471371,12167496.15,55.68459877353397,43.00629033553365,NaN,NaN,107.70527473444697,70.10488082194065,0.43234873837110066,-0.22421323870221954,-0.6565619770733202,185208184,167929651.8,45.84411004965955,21.25900880091644,NaN,NaN,-4.823060145759956,-15.153459248785733
2019-01-11T09:30:00-05:00,52.21,52.4,51.93,52.27,6186215,12104259.4,54.419593912100105,44.73860482315573,NaN,NaN,110.84090286824112,89.3246536072011,0.42798183038067084,-0.12158468909748166,-0.5495665194781525,179021969,173572333.8,49.77302846295905,23.72192927115189,NaN,NaN,-2.831229462206696,-13.393140707845872
2019-01-14T09:30:00-05:00,51.81,52.15,51.55,51.87,11503238,11947991.6,51.996572795531925,46.48461872591525,NaN,NaN,88.14609700083949,95.7467693090131,0.3822924498263468,-0.07170095719521896,-0.45399340702156576,167518731,175419471.2,51.02557808764768,26.464707195482568,NaN,NaN,-1.8111231206511904,-11.73856676681806
2019-01-15T09:30:00-05:00,51.54,51.86,51.21,51.53,7547102,11926377.4,49.96032437313122,48.34893373747287,NaN,NaN,65.0849268216176,92.0798043320077,0.3160557948511683,-0.05892366345760536,-0.37497945830877366,159971629,173691465.2,49.77503053382638,29.25360732714602,NaN,NaN,-1.5040640480645346,-10.276494949853271
2019-01-16T09:30:00-05:00,51.54,52,51.46,51.73,13718673,11849728.9,51.171658021238194,49.23714807781376,NaN,NaN,71.69924194788769,88.69528867460657,0.27415392461409305,-0.03228705254115738,-0.3064409771552504,173690302,173082163,49.31607253472257,32.10842000592913,NaN,NaN,-0.9216754947776908,-8.94009217055676
2019-01-17T09:30:00-05:00,51.45,52.76,51.45,52.64,10205511,11775858.8,56.3493487192537,50.13270137906146,NaN,NaN,96.25722702326942,86.40567913237106,0.2943868803458337,0.06154262327704174,-0.23284425706879197,183895813,172819688.8,49.10601673661217,34.98326624530372,NaN,NaN,1.0677578673818657,-7.510399307994099
2019-01-18T09:30:00-05:00,53.08,53.76,52.93,53.51,8757625,11228721.1,60.64587016083897,51.41584525084083,NaN,NaN,141.27620009494203,92.49273857771125,0.34928042246902524,0.2037562710174896,-0.14552415145153563,192653438,175545982.6,51.420580912008674,38.03755806363573,NaN,NaN,4.107099642352791,-5.850756600801686
2019-01-22T09:30:00-05:00,53.26,53.35,52.46,52.77,7433445,10441737.2,55.63014641016784,52.17118809177968,NaN,NaN,101.3676760073109,95.13705437900553,0.3194784189884472,0.25382387228402337,-0.06565454670442383,185219993,179086235,54.32542955981552,40.99306800986945,NaN,NaN,5.260559575159123,-4.263425718521571
2019-01-23T09:30:00-05:00,52.85,52.99,51.91,52.41,5704980,9699182.65,53.31980381881227,52.656073864660776,NaN,NaN,72.38532396638013,96.59713380795804,0.2616757149267368,0.26144009695399717,-0.00023561797273963236,179515013,182994911.8,57.35720527720836,43.57524597403277,NaN,NaN,5.5487174997558935,-2.8616909730533617
2019-01-24T09:30:00-05:00,52.12,52.45,51.9,52.13,5249672,9395254.15,51.52736504496232,53.47194058875191,NaN,NaN,52.19456788963841,92.69619899630818,0.19386182868537816,0.24209166788398306,0.04822983919860491,174265341,183109919.6,57.44670835639856,45.986794604492744,NaN,NaN,5.277421774358209,-1.6989605805659946
2019-01-25T09:30:00-05:00,52.93,53.41,52.71,53.12,4916976,8785299.55,57.027891944392856,53.966573730014694,NaN,NaN,114.70223458782817,96.38520050921993,0.20393462610319943,0.3031481218276042,0.09921349572440477,179182317,182167220.4,56.40171116505212,48.22856742088976,NaN,NaN,6.668158007869775,-0.5036579250751705
2019-01-28T09:30:00-05:00,52.74,53.08,52.58,53.04,5971989,8337718.25,56.47023548256691,54.36290425674089,NaN,NaN,96.12972513755844,87.35590551774321,0.19354754668810983,0.34114792908454206,0.14760038239643222,173210328,178278598.4,52.18473873792534,49.832312552781545,NaN,NaN,7.641015066243698,0.6598667879703821
2019-01-29T09:30:00-05:00,53.17,53.7399,53.17,53.59,8222997,8276216.05,59.40901116833245,54.792695566678624,NaN,NaN,136.56313865924625,94.39499804813028,0.2106451149101938,0.41090677603417447,0.20026166112398067,181433325,177521264.8,51.37904372081676,51.0282816642636,NaN,NaN,9.326247427925678,1.8979211651068528
2019-01-30T09:30:00-05:00,53.81,54.59,53.5901,54.16,7075090,8240070.75,62.2531919799349,55.41897232891415,NaN,NaN,171.36404989734385,114.19074323432301,0.24486949547690035,0.5063485304701061,0.26147903499320574,188508415,179319945.2,53.226108505841154,52.04152590289239,NaN,NaN,11.611852041308836,3.2856255759928503
2019-01-31T09:30:00-05:00,53,53.58,52.43,53.35,12475263,8407649.3,56.2241875124536,55.45751438169412,NaN,NaN,77.9831295611907,119.34845556863347,0.19940804845673654,0.5107390955641264,0.3113310471073899,176033152,179673507.4,53.599255621133324,52.59546487228338,NaN,NaN,11.830846603048068,4.506371437000738
2019-02-01T09:30:00-05:00,53.32,53.635,53.08,53.51,5539469,8192924.4,57.107840082538125,55.64953196529684,NaN,NaN,94.18903226863169,115.24581510479418,0.16783287527501695,0.5211221412011611,0.3532892659261441,181572621,180151568.2,54.13208428529551,52.90682600245026,NaN,NaN,12.262972090246835,5.6144572446073235
2019-02-04T09:30:00-05:00,53.41,53.4675,53.0599,53.42,3557811,7923284.05,56.41796264964468,55.96534552630489,NaN,NaN,75.70047285616921,111.15996464851632,0.1302796312408186,0.5161388049771674,0.38585917373634876,178014810,181112464.6,55.24455010280642,53.208181146390174,NaN,NaN,12.429140741611167,6.587983458465016
2019-02-05T09:30:00-05:00,53.54,53.94,53.51,53.81,4428865,7771003.05,58.743763844270866,56.592734059957714,NaN,NaN,107.60211635968695,105.36776018860446,0.12128359631685803,0.5374636691324213,0.41618007281556324,182443675,181314534.6,55.48903645670966,53.61632442659612,NaN,NaN,13.209575382910103,7.533925161957171
2019-02-06T09:30:00-05:00,53.55,53.76,53.3915,53.49,4955033,7502323.95,56.0983989724375,56.944644127900524,NaN,NaN,79.23913285095756,86.94277677932722,0.08507128267437514,0.5225191761585322,0.437447893484157,177488642,179110580,52.14329299973369,53.81826874552549,NaN,NaN,13.15523601772929,8.336969569924618
2019-02-07T09:30:00-05:00,53.15,53.25,52.315,52.75,6367955,7414464,50.44150224987808,56.5226550943737,NaN,NaN,-4.001017858637139,70.54594729536164,0.006701328652426841,0.4458245542996906,0.43912322564726375,171120687,178128087,50.67638595917801,53.930437975708756,NaN,NaN,11.477613105137813,8.785632932097931
2019-02-08T09:30:00-05:00,52.46,52.71,52.03,52.7,4521382,7216964.55,50.07408144646647,55.76752732906137,NaN,NaN,-38.36898619135981,44.034343603363354,-0.04996502078946519,0.37666694966043224,0.4266319704498974,166599305,175133423.8,46.39234451507728,53.57127823307081,NaN,NaN,9.992913636035517,8.958101604089014
2019-02-11T09:30:00-05:00,52.89,52.96,52.53,52.78,4158324,7115570,50.692937334899135,55.41486953797075,NaN,NaN,-11.060714640377652,26.68210610405398,-0.08164725098926667,0.32457290671331407,0.40622015770258074,170757629,173681987.6,44.43180053404981,52.864590445516114,NaN,NaN,8.908470075222125,8.95101138567946
2019-02-12T09:30:00-05:00,53.27,54.03,53.12,53.96,10069829,7043899.55,58.804272454014686,55.80661729762807,NaN,NaN,91.9565171402055,23.55298626015769,-0.02562356361149487,0.3741907031882121,0.399814266799707,180827458,173358744.2,43.98597911373217,51.90950286241067,NaN,NaN,10.236270779488315,9.134619870509296
2019-02-13T09:30:00-05:00,54.26,54.42,54.01,54.03,7347124,7033900.65,59.232718053165726,56.35699965535689,NaN,NaN,136.20773450414902,34.94670659079598,0.011656433937800081,0.4143848092219571,0.402728375284157,188174582,175495932.2,47.72099196988839,51.2148088348028,NaN,NaN,11.444241959425181,9.464565883211565
2019-02-14T09:30:00-05:00,53.78,54.14,53.6,53.75,4884989,6592216.45,56.69282023142054,56.33306596157315,NaN,NaN,87.93464039053731,53.33383824063087,0.012871221047429271,0.4188174015934436,0.40594618054601433,183289593,177929713.4,51.67292310112637,50.877038258808106,NaN,NaN,11.767569753161697,9.793566436061584
2019-02-15T09:30:00-05:00,54.34,54.62,54.08,54.48,7647158,6464298.8,61.34646581229029,56.68136812798196,NaN,NaN,148.11839883876425,90.63131524665569,0.055843856144573656,0.4757510007267314,0.4199071445821577,190936751,182797202.6,58.43952571567198,51.32380875721858,NaN,NaN,13.418576326211673,10.31142499179731
2019-02-19T09:30:00-05:00,54.28,55.08,54.23,54.82,12264493,6639642.2,63.32327474190255,56.96095838323697,NaN,NaN,161.49434668583453,125.14232751189812,0.09772063650255258,0.5420579402103485,0.4443373037077959,203201244,189285925.6,65.395415679575,52.32497818284417,NaN,NaN,15.39512328358108,11.037667604909277
2019-02-20T09:30:00-05:00,54.92,56.1,54.84,55.76,11309283,6833434.1,68.16997425757285,57.38358568878254,NaN,NaN,216.14366072148292,149.9797562281536,0.17478317950893957,0.6628162780939704,0.4880330985850308,214510527,196022539.4,70.85017146835827,53.58383982302397,NaN,NaN,18.710245160347164,12.133750112828976
2019-02-21T09:30:00-05:00,55.83,55.96,55.31,55.54,8551895,6975779.85,65.97262633577517,58.07990274759123,NaN,NaN,185.69048701218452,159.8763067297607,0.19543287478805715,0.7323241920701022,0.5368913172820451,205958632,199579349.4,73.2479164279656,54.98731559494057,NaN,NaN,20.77576705936762,13.368323962334497
2019-02-22T09:30:00-05:00,55.82,55.95,55.58,55.78,4790764,6952834.45,67.21417861111672,58.80178407106113,NaN,NaN,171.859643049856,176.66130726162444,0.20855229316413482,0.7975816837372136,0.5890293905730788,210749396,205071310,76.46676172468521,56.582649697754114,NaN,NaN,22.858692112912312,14.72409084098847
2019-02-25T09:30:00-05:00,56.01,56.295,55.89,56.14,6187927,7016382,69.03902832753573,59.703288762339064,NaN,NaN,165.03981631138157,180.0455907561479,0.22344692506921082,0.8683380469095923,0.6448911218403814,216937323,210271424.4,79.0385435106409,58.28222065545658,NaN,NaN,25.165939230292008,16.215783468031834
2019-02-26T09:30:00-05:00,56.01,56.18,55.8,55.82,6192295,7027397.3,65.54663158009825,60.189207886326734,NaN,NaN,130.57257392995183,173.86123620497136,0.19476813306908358,0.8883512881767359,0.6935831551076523,210745028,211780181.2,79.73066595055606,60.01376561930275,NaN,NaN,26.12717144758385,17.631696036539264
2019-02-27T09:30:00-05:00,55.7,55.9,55.37,55.73,4631198,6847807.35,64.55750279219609,60.79342958773805,NaN,NaN,96.68776357058961,149.97005677479268,0.15451589949402733,0.8867280294751865,0.7322121299811591,206113830,210100841.8,76.69514478062982,61.767469317938186,NaN,NaN,26.650004222114443,18.920025777335717
2019-02-28T09:30:00-05:00,55.67,55.72,54.93,55.05,8762524,6932179.05,57.49753417967999,61.297431868438196,NaN,NaN,60.601401861928814,124.95223974474155,0.07111515090957543,0.8211060686181284,0.749990917708553,197351306,208379376.6,73.60171499996679,63.40499282085166,NaN,NaN,25.060280324971824,19.79720499842659
2019-03-01T09:30:00-05:00,55.45,55.74,54.79,54.98,9841530,6800492.4,56.80880965558968,61.77848388337556,NaN,NaN,50.646710322402235,100.7096531992508,0.0038084432116236577,0.7547514717230825,0.7509430285114589,187509776,203731452.6,65.87589838361075,64.79667524003263,NaN,NaN,23.55666934202051,20.334271333225722
2019-03-04T09:30:00-05:00,55.1,55.455,54.39,55.23,7960375,6921537.7,58.71101411590679,62.35120365344754,NaN,NaN,36.5457681078197,75.01084355853841,-0.029469530406266764,0.7141061155036255,0.7435756459098922,195470151,199438018.2,59.64746337139438,65.88350829984294,NaN,NaN,22.78570779391775,20.68447654189601
2019-03-05T09:30:00-05:00,55.11,55.25,54.91,54.97,5231730,7005233.65,55.951141748187894,62.147408603031344,NaN,NaN,33.2925853299799,55.55484583854403,-0.07215430790875499,0.6533827610239484,0.7255370689327034,190238421,195336696.8,54.36013183131743,66.6245192082419,NaN,NaN,21.358127268302095,20.780712359954023
2019-03-06T09:30:00-05:00,55.13,55.48,55.01,55.09,4615534,7014567.1,56.95683649243269,61.98484563440754,NaN,NaN,39.625914677630256,44.14247605995217,-0.09408231476234707,0.6079341754797696,0.7020164902421167,194853955,193084721.8,51.65267330843573,66.90535358956672,NaN,NaN,20.416201118873005,20.72863932551388
2019-03-07T09:30:00-05:00,54.97,54.98,54.23,54.64,11961864,7364908.65,52.14855631948849,61.66025535498384,NaN,NaN,-5.292310026924761,30.96373368218145,-0.1380125132949338,0.5295008486234494,0.6675133619183832,182892091,190192878.8,48.32422341162027,66.66616075460199,NaN,NaN,18.230871042218833,20.37181528504316
2019-03-08T09:30:00-05:00,54.35,54.77,54.06,54.73,7200394,7406530.6,53.00308749700001,61.06429976103453,NaN,NaN,-21.69191217836598,16.496009182027798,-0.1586542688239393,0.46919552588845903,0.6278497947123983,190092485,190709420.6,48.956928697172124,65.98883239613772,NaN,NaN,16.619337112164104,19.835746974631864
2019-03-11T09:30:00-04:00,54.96,55.53,54.88,55.51,6857708,7523346.9,59.717209013448326,60.80672363757351,NaN,NaN,39.319072009653596,17.0506699623946,-0.11922141131140751,0.4788230305731389,0.5980444418845464,196950193,191005429,49.339722818378625,64.84199719176654,NaN,NaN,17.046585590331944,19.437295348303305
2019-03-12T09:30:00-04:00,55.59,56.04,55.59,55.72,7216143,7676237.85,61.31942891674148,60.31739897037128,NaN,NaN,85.28399908788597,27.448952713975814,-0.0803064243972812,0.49766141138794495,0.5779678357852261,204166336,193791012,52.91804698835743,63.56113115748077,NaN,NaN,17.866963552256678,19.21296223458236
2019-03-13T09:30:00-04:00,56.03,56.34,55.875,55.99,5518388,7448665.8,63.3384574493628,60.129244049913254,NaN,NaN,113.2563194633751,42.17503367112479,-0.03974392224484624,0.5282879329791683,0.5680318552240146,209684724,196757165.8,56.44584686126329,62.360983331287756,NaN,NaN,19.146949096204388,19.20353178624265
2019-03-14T09:30:00-04:00,55.83,55.95,55.44,55.57,5039791,7333299.15,58.24536931155564,59.488614814230324,NaN,NaN,53.96172522138459,54.025840720786654,-0.04421874644392065,0.5127584221691137,0.5569771686130344,204644933,201107734.2,61.055161893156004,61.26015477189281,NaN,NaN,18.788151548403306,19.144191752265602
2019-03-15T09:30:00-04:00,55.56,55.83,55.19,55.4,7259022,7452000.8,56.27295675409015,58.576752558984204,NaN,NaN,20.822605136353086,62.52874418373047,-0.0606323171812192,0.4811867721365104,0.5418190893177296,197385911,202566419.4,62.48857267367745,60.07801399782399,NaN,NaN,17.92426930844596,18.969917117434225
2019-03-18T09:30:00-04:00,55.44,55.61,55.11,55.53,4345470,7286916.4,57.459325883722904,57.99908786638597,NaN,NaN,4.227066669679529,55.51034311573566,-0.06438494399571593,0.4613379093230847,0.5257228533188006,201731381,203522657,63.438592338850675,58.91429445413075,NaN,NaN,17.525187656231857,18.763527194405317
2019-03-19T09:30:00-04:00,55.8,56.15,55.21,55.46,5271277,6937255.6,56.569325695501426,57.42850378805064,NaN,NaN,32.930845225052956,45.03971234316905,-0.07262200399653984,0.4349453483231258,0.5075673523196657,196460104,201981410.6,60.76725009910106,57.77658769116441,NaN,NaN,16.951301730764502,18.504637842456628
2019-03-20T09:30:00-04:00,55.43,55.7,54.88,55.41,11234984,6933540.65,55.903250470505526,57.31462638025247,NaN,NaN,-18.807601337545076,18.626928182985008,-0.08179614603091412,0.405322169781023,0.4871183158119371,185225120,197089489.8,53.1212191328468,56.31369512922727,NaN,NaN,16.293155330229002,18.18871176928125
2019-03-21T09:30:00-04:00,55.22,56.205,55.16,56,7959661,6903928.95,61.64254776546463,57.65989338810068,NaN,NaN,67.27012863270957,21.288608865250012,-0.05004697443887085,0.4245595977633485,0.47460657220221936,193184781,194797459.4,49.949990743590945,55.17613029779728,NaN,NaN,17.281411596181098,18.059097458838373
2019-03-22T09:30:00-04:00,55.51,55.52,54.23,54.33,9123744,7120577.95,44.13329420150725,56.618627679929276,NaN,NaN,-124.5550527903226,-7.7869227200851245,-0.13842605976969924,0.3015739974900953,0.4400000572597945,184061037,192132484.6,46.4758735460216,54.2353024531278,NaN,NaN,12.133409939682826,17.21257067038758
2019-03-25T09:30:00-04:00,54.3,54.72,54.14,54.23,6562715,7139317.35,43.339443928078374,55.71779212135003,NaN,NaN,-163.75323409336025,-41.38298287269308,-0.19695699839149927,0.1938038092704204,0.3907608076619197,177498322,187285872.8,40.903961685302455,53.27414744269816,NaN,NaN,7.8845206671811745,15.879992098500953
2019-03-26T09:30:00-04:00,54.59,54.73,54.17,54.56,5899772,7124691.2,46.7438447495155,54.98829271114165,NaN,NaN,-126.15008471483614,-73.1991688606709,-0.20582090810919446,0.13348467252542662,0.3393055806346211,183398094,184673470.8,38.242561940437696,52.31628234498402,NaN,NaN,5.494881101170378,14.396404813168013
2019-03-27T09:30:00-04:00,54.42,54.685,54.1,54.49,9782585,7382260.55,46.110948253652865,54.55703499215339,NaN,NaN,-119.32986900505776,-93.30362239417343,-0.20814778356992059,0.07912085117222034,0.2872686347421409,173615509,182351548.6,36.00050970143911,51.43601707997107,NaN,NaN,3.3987850668335033,12.825316277977368
2019-03-28T09:30:00-04:00,54.57,55.045,54.55,55.02,4870911,7187679.9,51.46881234167644,54.44744390963029,NaN,NaN,-42.55877930756003,-115.26940398222735,-0.16749038475182393,0.07790565380236103,0.24539603855418496,178486420,179411876.4,33.335824702294545,50.32022393747982,NaN,NaN,3.255091476993039,11.458141306408178
2019-03-29T09:30:00-04:00,55.08,55.52,54.83,55.5,6327316,7011969.2,55.758908579683634,54.164708164361386,NaN,NaN,21.16216759763972,-86.12595990463488,-0.10483174231295736,0.11435636066298827,0.21918810297594563,184813736,179562416.2,33.6068424076727,49.19644676528653,NaN,NaN,4.506330989341943,10.465025546827288
2019-04-01T09:30:00-04:00,55.89,56.41,55.815,56.33,6454300,6936665.45,62.01223867180397,54.21419457543727,NaN,NaN,140.88389513110215,-25.19853405974241,-0.009092701100459982,0.20782222660037064,0.21691492770083062,191268036,182316359,38.53013531435944,48.16873878857239,NaN,NaN,7.7602672941143105,10.078631510725435
2019-04-02T09:30:00-04:00,56.47,56.76,56.24,56.52,7112307,7030694.3,63.2913664554145,54.210830933012396,NaN,NaN,161.8454577403009,32.400574431284994,0.061539113709662474,0.2938388198379087,0.23229970612824624,198380343,185312808.8,43.44425627749102,47.24005374687437,NaN,NaN,10.76981362874964,10.177371813300322
2019-04-03T09:30:00-04:00,56.98,57.62,56.81,57.26,17364483,7668141.75,67.83420519647663,54.89574778193532,NaN,NaN,208.72713593832324,98.0119754199612,0.14769102398419037,0.4169134861084842,0.26922246212429385,215744826,193738672.2,54.467249946159704,46.76948860780321,NaN,NaN,14.950215329651906,10.859206601350548
2019-04-04T09:30:00-04:00,57.3,57.86,57.27,57.84,6102846,7375190.85,70.87638792984804,55.93885000877517,NaN,NaN,211.79227059162594,148.8821853997984,0.22850695999641435,0.5548561621198118,0.32634920212339746,221847672,202410922.6,62.55639424041371,46.77433300542723,NaN,NaN,19.50743384627571,12.094667636339857
2019-04-05T09:30:00-04:00,57.85,58.05,57.65,57.82,3668642,7198603.25,70.62832799766056,56.87949301691357,NaN,NaN,191.10189027203447,182.87012993467735,0.26293049393362233,0.6550123195404254,0.39208182560680305,218179030,209083981.4,67.36134345083504,47.05452951342612,NaN,NaN,22.968600342482347,13.648086594360212
2019-04-08T09:30:00-04:00,57.78,57.895,57.54,57.84,6574723,7184454,70.7386175990847,57.89158529574096,NaN,NaN,151.98347323554972,185.09004555556686,0.26842506526087284,0.7276131571828941,0.45918809192202126,224753753,215781124.8,71.33678496978688,47.80949628990367,NaN,NaN,25.75963220915521,15.378307396473783
2019-04-09T09:30:00-04:00,57.6,57.68,57.25,57.42,6110767,7129185.2,65.2016913691096,58.55575964564124,NaN,NaN,108.92263603585822,174.50548121467835,0.22680792166271002,0.7426979940004088,0.5158900723376988,218642986,219833653.4,73.44457580425693,49.26116462357582,NaN,NaN,26.52366923747173,16.970501945187774
2019-04-10T09:30:00-04:00,57.47,57.58,57.17,57.39,3797388,7043135.2,64.8114613899025,58.78211061881537,NaN,NaN,91.73660356082806,151.1073747391793,0.18221565504826343,0.7436596411480281,0.5614439860997646,214845598,219653807.8,73.18736032230593,50.92097673634118,NaN,NaN,27.0328443298344,18.40797942870872
2019-04-11T09:30:00-04:00,57.37,57.57,57.2,57.36,3494571,6965874.2,64.39640407779356,60.229475609978685,NaN,NaN,80.92863398778796,124.93464741841169,0.13768093292978523,0.7335451522619962,0.595864219332211,211351027,217554478.8,70.10113384675728,52.60849532925088,NaN,NaN,27.34043393489902,19.684044358164478
2019-04-12T09:30:00-04:00,57.83,58.12,57.65,58.12,3608661,6783356.15,69.69174793419803,62.11178303898724,NaN,NaN,102.98216477724807,107.3107023194544,0.1456190140299688,0.777887986869672,0.6322689728397032,214959688,216910610.4,69.13816804026311,54.62522435460521,NaN,NaN,29.197572962387014,21.04311987305341
2019-04-15T09:30:00-04:00,58.12,58.155,57.75,57.85,2705083,6701336.8,65.93958762461244,63.48290753006558,NaN,NaN,89.4187228537173,94.79775224308794,0.11996581537128503,0.7822262420538095,0.6622604266825245,212254605,214410780.8,65.38284242920346,56.56381581808848,NaN,NaN,29.66549723940038,22.274888068245833
2019-04-16T09:30:00-04:00,57.79,58.12,57.52,58.11,3737478,6624646.85,67.74073308997498,65.02789216123145,NaN,NaN,80.63842120162882,89.14090927624204,0.10815297185810469,0.7974516415051554,0.6892986696470507,215992083,213880600.2,64.58164974375437,58.60532582111099,NaN,NaN,30.58457697315647,23.461986483233066
2019-04-17T09:30:00-04:00,58.23,58.5,57.73,57.75,3370239,6231409.6,62.78964396734231,65.83652299163616,NaN,NaN,77.45512285707146,86.28461313549072,0.06582078952773784,0.771574656556723,0.7057538670289851,212621844,213435849.4,63.87455331501832,60.78666357916269,NaN,NaN,29.92032353486424,24.38460606203752
2019-04-18T09:30:00-04:00,57.8,57.97,57.52,57.82,3634417,6015147.4,63.350560717134925,66.37878385859696,NaN,NaN,59.97171272301347,82.09322888253581,0.033870376381057055,0.7480918375053065,0.7142214611242494,216256261,214416896.2,64.79032907931847,63.01405548428024,NaN,NaN,29.5309151026151,25.119793067834316
2019-04-22T09:30:00-04:00,57.6,57.79,57.35,57.43,5988068,5858363.6,58.096048257862314,66.09905597188684,NaN,NaN,42.438322178774655,69.98446036284113,-0.01933137431203935,0.6900572432342003,0.7093886175462396,210268193,213478597.2,63.14167985220192,64.772022951269,NaN,NaN,27.662674893649363,25.48306190009361
2019-04-23T09:30:00-04:00,57.34,57.87,57.2,57.69,7645160,5912485.85,60.451147815566785,65.89618321189772,NaN,NaN,42.13087463184081,60.52689071846582,-0.04153858639548458,0.6574653845518839,0.6990039709473684,217913353,214610346.8,64.3209811071026,66.26321758195556,NaN,NaN,26.733335720563282,25.66167244587499
2019-04-24T09:30:00-04:00,57.63,57.81,57.33,57.33,3808269,5807910.7,55.77679309043728,65.03493949003777,NaN,NaN,30.974120970597664,50.59403067225959,-0.08262716011546611,0.5957200208030358,0.6783471809185019,214105084,214232947,63.59031959754194,66.91486541419714,NaN,NaN,24.548994476969867,25.502718450317115
2019-04-25T09:30:00-04:00,57.07,57.145,56.42,56.6,5180061,5577784.5,47.71904157493833,63.38084332182992,NaN,NaN,-50.93165062568798,24.91667597570771,-0.15682048618728706,0.48232157318439306,0.6391420593716801,208925023,213493582.8,62.10195183249833,66.88240524220318,NaN,NaN,19.968238846327775,24.712078506890066
2019-04-26T09:30:00-04:00,56.6,57.22,56.49,57.07,4950092,5581743.55,52.47902413461584,62.08446447446959,NaN,NaN,-52.02261663062481,2.5178101049800548,-0.17093527074553205,0.4254729709397651,0.5964082416852972,213875115,213017353.6,61.10981290993568,66.43586734642466,NaN,NaN,17.552275128840535,23.68924945288299
2019-04-29T09:30:00-04:00,56.92,57.12,56.75,56.96,6056504,5568202.95,51.30176084074308,60.69611756315947,NaN,NaN,-77.54726451394455,-21.479307233563794,-0.18327871802328077,0.36730984415619616,0.5505885621794769,207818611,212527437.2,60.04701834350138,65.62945544454712,NaN,NaN,15.247860567631436,22.48333675498991
2019-04-30T09:30:00-04:00,57.11,57.52,56.82,57.45,3399227,5415449.3,56.03327405461338,60.041230612124025,NaN,NaN,-39.3054760541634,-37.76657737076464,-0.15515653394479,0.3566428947484894,0.5117994286932794,211217838,211188334.2,57.12270551948314,64.46360756706328,NaN,NaN,14.714367379351204,21.373483987041524
2019-05-01T09:30:00-04:00,57.53,57.53,56.4,56.41,6550939,5387380.9,45.850754968270834,58.68689443915034,NaN,NaN,-144.75684220580737,-72.91277000604563,-0.20043287995609338,0.2612583287481627,0.46169120870425606,204666899,209300697.2,53.190336202503964,63.03524870136313,NaN,NaN,10.685241299670817,19.846592174559994
2019-05-02T09:30:00-04:00,56.14,56.44,55.725,56.12,10973368,5067825.15,43.478128259954836,57.192731880733284,NaN,NaN,-228.7559091432883,-108.47762170956571,-0.2410204668482524,0.1604156251439406,0.401436091992193,193693531,206254398.8,47.50655078097572,61.42134991095016,NaN,NaN,6.66063058391992,17.96288337589713
2019-05-03T09:30:00-04:00,56.23,56.7,56.18,56.67,6033379,5064351.8,48.88088737934981,55.70624184110127,NaN,NaN,-131.52563503192118,-124.37822538982498,-0.2223853899839846,0.1234543545122122,0.3458397444961968,199726910,203424757.8,42.91883558033285,59.54854044952657,NaN,NaN,5.08647436242705,16.12339637397283
2019-05-06T09:30:00-04:00,55.32,56.08,55.32,55.86,15601099,5660974.65,42.445975529947894,54.02812669148238,NaN,NaN,-198.11507282670473,-148.491787052377,-0.2538927378373848,0.028473822199465815,0.2823665600368506,184125811,198686197.8,36.55287157674599,57.48925681720818,NaN,NaN,1.4626655066608767,14.029006250071124
2019-05-07T09:30:00-04:00,55.33,55.43,54.59,54.88,9750966,5819786.8,36.231364507483896,51.777457507018724,NaN,NaN,-230.05385548182585,-186.6414629379095,-0.32544704878797737,-0.12444225094812111,0.20100479783985625,174374845,191317599.2,29.27993829572786,54.967705999492,NaN,NaN,-3.967304721484704,11.458104682706006
2019-05-08T09:30:00-04:00,54.84,55.09,54.6,54.83,6159679,5822232.4,35.942222645278136,49.859784555442715,NaN,NaN,-195.1247229956116,-196.71503909587037,-0.3582588381455868,-0.24681874984212726,0.11144008830345954,168215166,184027252.6,24.158362961863958,52.13083525998097,NaN,NaN,-8.160825844231232,8.655400321714971
2019-05-09T09:30:00-04:00,54.21,54.61,53.7799,54.4,6714372,5968081.6,33.468528313359485,47.725353669458755,NaN,NaN,-196.56271846234773,-190.27640095968223,-0.3885016852093023,-0.37418701820816835,0.014314667001133957,161500794,177588705.2,20.71255216324927,48.982422623118886,NaN,NaN,-12.418641946752079,5.644822854791107
2019-05-10T09:30:00-04:00,54.3,55.34,54.07,55.14,6472860,6116996.05,40.99479149301355,46.50383532911242,NaN,NaN,-128.17348330259446,-189.60597061381688,-0.33999684840181027,-0.41068139350112887,-0.07068454509931861,167973654,171238054,17.987309496950218,45.75711045488662,NaN,NaN,-13.500079826963418,2.9098367573976036
2019-05-13T09:30:00-04:00,54.12,55.1029,53.49,53.9,7048777,6289001.85,34.04488726737408,44.617673861384375,NaN,NaN,-146.869285941737,-179.35681323682334,-0.3702612454030656,-0.5335111018531506,-0.16324985645008502,160924877,166597867.2,16.299766543387236,42.32702370033553,NaN,NaN,-17.004148098350093,0.06498177800507587
2019-05-14T09:30:00-04:00,54.09,54.7698,53.95,54.36,6101857,6458840.55,38.22856892179543,43.364229277909956,NaN,NaN,-115.60066886135897,-156.46617591272997,-0.33897623367719343,-0.5869701485465768,-0.24799391486938338,167026734,165128245,15.794354673311204,38.91302620574761,NaN,NaN,-18.286594408903223,-2.556671962981824
2019-05-15T09:30:00-04:00,54,54.61,53.77,54.22,5262173,6535075.3,37.44996521020382,42.63072382328607,NaN,NaN,-109.62539617945112,-139.36631054949788,-0.30827125986826304,-0.6333329897047122,-0.32506172983644915,161764561,163838124,15.344546306294319,35.57321152530447,NaN,NaN,-19.53357432721464,-4.981943729300798
2019-05-16T09:30:00-04:00,54.63,55.16,54.63,54.98,4905329,6611829.8,44.10529166679829,42.03260007558481,NaN,NaN,-61.42769910243727,-112.3393066775158,-0.22140093805909922,-0.6018129024103231,-0.38041196435122393,166669890,164871943.2,17.375195580956813,32.44931028752027,NaN,NaN,-18.34173429837531,-6.890485239168585
2019-05-17T09:30:00-04:00,54.56,55.035,54.41,54.65,6083322,6734275.05,42.01488850274326,41.36925205144196,NaN,NaN,-66.87616088220513,-100.0798421934379,-0.1729377860812472,-0.596584196952783,-0.42364641087153576,160586568,163394526,16.756596828580967,29.357137322168803,NaN,NaN,-18.056032791462528,-8.485563460924862
2019-05-20T09:30:00-04:00,54.16,54.38,53.78,53.87,5016528,6685698.05,37.49174509446858,40.044857125717336,NaN,NaN,-96.933830781759,-90.09275116144232,-0.17941181111312254,-0.6479111747629389,-0.46849936364981637,155570040,162323558.6,16.303472645564426,26.44147783117461,NaN,NaN,-19.30520733480968,-10.031226871479836
2019-05-21T09:30:00-04:00,54.26,54.78,54.18,54.7,4371714,6522025.75,44.35642568616651,39.93811931985274,NaN,NaN,-59.16741755861235,-78.80610090089301,-0.11682466073947573,-0.6145301895741611,-0.49770552883468533,159941754,160906562.6,15.698592682916114,23.763496151204055,NaN,NaN,-18.028200380284257,-11.173651658451895
2019-05-22T09:30:00-04:00,54.6,54.8,54.315,54.32,5308497,6597037.15,42.078033001013694,39.838112515642656,NaN,NaN,-58.68443035439366,-68.61790773588152,-0.09118533158825304,-0.6116871933200017,-0.5205018617317486,154633257,159480301.8,15.091659231478815,21.44814675481142,NaN,NaN,-17.74362114036709,-12.112218727296924
2019-05-23T09:30:00-04:00,53.74,53.92,53.245,53.49,4922673,6584167.75,37.54207069193461,39.028197037970145,NaN,NaN,-112.25343406150438,-78.7830547276949,-0.11855835588445118,-0.6686998065873127,-0.5501414507028615,149710584,156088440.6,13.731977547968086,19.36337118107108,NaN,NaN,-19.015325421131138,-13.098376826416096
2019-05-24T09:30:00-04:00,54.03,54.19,53.5,53.79,4090366,6541181.45,40.05730316326238,38.8575775832069,NaN,NaN,-90.35065531712411,-83.4779536146787,-0.10533937854724384,-0.6818156738869163,-0.5764762953396725,153800950,154731317,13.21881062900789,17.696652541946936,NaN,NaN,-19.222490451729026,-13.9732502014608
2019-05-28T09:30:00-04:00,53.78,53.95,53.21,53.25,4826056,6479659.05,37.15672132701632,38.92367449888779,NaN,NaN,-115.17880110041064,-87.12694767840902,-0.12073782947447409,-0.7273985821827651,-0.606660752708291,148974894,153412287.8,12.72121798408979,16.513886805401363,NaN,NaN,-20.318703774745664,-14.879743569072923
2019-05-29T09:30:00-04:00,52.84,53.335,52.7,53.26,8738785,6746636.95,37.24734182957379,39.01689729776605,NaN,NaN,-141.7087595975102,-103.63521608618859,-0.11789101674796354,-0.7540245236432455,-0.6361335068952819,157713679,152966672.8,12.549350821743644,15.684671652535622,NaN,NaN,-21.156815691110868,-15.776468157935486
2019-05-30T09:30:00-04:00,53.28,53.59,53.205,53.35,4475082,6642844.1,38.112307977626436,39.348595845213694,NaN,NaN,-111.34313612754549,-114.16695724081896,-0.0983835502805579,-0.7591129447459792,-0.6607293944654213,162188761,154477773.6,16.661133194465805,15.395284583336801,NaN,NaN,-21.59348568430384,-16.607470661702393
2019-05-31T09:30:00-04:00,52.72,52.975,52.52,52.75,5991764,6393763.9,34.68033620452208,38.89756332460716,NaN,NaN,-159.72746595423394,-123.66176361936486,-0.11326607446779258,-0.8023119875501621,-0.6890459130823695,156196997,155775056.2,20.132978851825413,15.548546680113601,NaN,NaN,-22.980135304788096,-17.51785132500035
2019-06-03T09:30:00-04:00,52.9,54.43,52.75,54.41,13155424,6749866.15,48.4982371164055,39.929945456680834,NaN,NaN,-39.4773249542602,-113.4870975467921,-0.0044373355194162745,-0.6945925824816399,-0.6901552469622236,169352421,158885350.4,27.889433982711964,16.3763800686368,NaN,NaN,-19.662664351079673,-17.824253185868827
2019-06-04T09:30:00-04:00,55,56.05,54.68,55.94,17778221,6858722.25,57.43565584275068,41.301880236749064,NaN,NaN,162.7434505048016,-57.90264722574965,0.1679400614392106,-0.48023017016321035,-0.6481702316024209,187130642,166516500,42.61487499545539,18.292131520218526,NaN,NaN,-13.37109203669325,-17.188087307415174
2019-06-05T09:30:00-04:00,56.29,56.48,55.51,56.35,19704292,7356388.55,59.46563016953155,42.874427733843895,NaN,NaN,201.88818074598112,10.816740842948615,0.2992536652612783,-0.2741031500258231,-0.5733568152871014,206834934,176340751,55.27672512814723,21.14443000749373,NaN,NaN,-7.748013590990253,-15.8395053479259
2019-06-06T09:30:00-04:00,56.63,57.21,56.43,57.02,19911719,8043990.55,62.604275083063214,44.19578369214854,NaN,NaN,232.59293828993617,79.60395572644495,0.41385613594209403,-0.05603664535948383,-0.46989278130157786,226746653,189252329.4,65.91975190444067,24.61189831631401,NaN,NaN,-2.073790918072154,-13.87297471508965
2019-06-07T09:30:00-04:00,57.39,57.74,57.27,57.53,23211132,8868828.55,64.83627266658357,45.8258825609942,NaN,NaN,222.39246299827553,156.02794151694684,0.5008226531745976,0.15613553516666911,-0.34468711800792845,249957785,208004487,75.16397218947253,28.783853699234836,NaN,NaN,3.2618211827488466,-11.425146729684151
2019-06-10T09:30:00-04:00,57.89,57.97,57.58,57.63,14362623,9263316.7,65.27393766044256,47.8103248871352,NaN,NaN,189.0991269934409,201.74323190648707,0.5386018433465745,0.3285651861752896,-0.2100366571712848,264320408,226998084.4,80.83454911576635,33.39321630424926,NaN,NaN,7.587370796475179,-8.709072797375676
2019-06-11T09:30:00-04:00,57.93,58.15,57.49,57.59,7868652,9304310.45,64.92583357799788,49.2795683079803,NaN,NaN,153.6617899865306,199.92689980283288,0.5334088667745147,0.4567244262968586,-0.0766844404776561,256451756,240862307.2,83.7509434346141,38.25409850079911,NaN,NaN,10.937448943500968,-5.902426834393298
2019-06-12T09:30:00-04:00,57.62,57.86,57.545,57.78,3550419,9176738.55,65.85725460232729,50.978084136645556,NaN,NaN,127.53409509768669,185.056082673174,0.5150163089825581,0.5670859457505415,0.05206963676798343,260002175,251495755.4,85.56520944265475,43.28792351588311,NaN,NaN,13.978299670406717,-3.0623230479932957
2019-06-13T09:30:00-04:00,57.99,58.1901,57.92,58.12,7392116,9283235.7,67.5194863269005,53.11932811057169,NaN,NaN,121.75309275742882,162.88811356667253,0.4977135008994581,0.6742115128923061,0.17649801199284798,267394291,259625283,86.78045795243888,48.505672116202454,NaN,NaN,17.041204471855163,-0.19039054515780185
2019-06-14T09:30:00-04:00,58,58.06,57.67,57.87,3937713,9234854.9,65.0131457640419,54.90188829634165,NaN,NaN,98.26680489291356,138.06298194560011,0.44321395721510737,0.7305154585117322,0.2873015012966248,263456578,262325041.6,87.16685346187674,53.78767517569309,NaN,NaN,18.9454246864136,2.5432973450666836
2019-06-17T09:30:00-04:00,57.78,57.815,57.26,57.34,7507049,9306041.25,59.93384814719562,56.52882592635446,NaN,NaN,74.26032934006435,115.09522241492479,0.3493780562821599,0.7240240716493247,0.3746460153671648,255949529,260650865.8,85.49794639581441,58.986012919387704,NaN,NaN,19.190655446459722,4.921491359551403
2019-06-18T09:30:00-04:00,57.65,58.19,57.585,57.79,6887864,9399608.05,62.60522255187606,58.34010312080462,NaN,NaN,79.71822751930438,100.30650992147955,0.29755092896017804,0.7465846765673874,0.4490337476072093,262837393,261927993.2,85.72251566340927,64.21266755093525,NaN,NaN,20.156560109486254,7.097929752399239
2019-06-19T09:30:00-04:00,57.79,57.81,57.17,57.47,7166406,9539342.65,59.563900537826946,59.87235973224752,NaN,NaN,60.11797984447839,86.8232868708379,0.22495317085178546,0.7302252111719412,0.5052720403201557,255670987,261061755.6,84.76373690658218,69.07713924465784,NaN,NaN,20.120120074727325,8.958242655588965
2019-06-20T09:30:00-04:00,58.2,58.36,57.7,58.2,6743781,9611106.85,63.875259140293224,61.95771137051689,NaN,NaN,75.01608238596963,77.47588479654607,0.20963831143143508,0.7673199296094495,0.5576816181780144,262414768,260065851,83.6059567353542,73.61092337919561,NaN,NaN,21.34727807603862,10.728104858510344
2019-06-21T09:30:00-04:00,57.82,57.92,57.61,57.67,5826009,9656273.65,58.960066447692185,62.704984894180214,NaN,NaN,57.53503774847434,69.32953136765822,0.1501420288645262,0.7453591542586722,0.595217125394146,256588759,258692287.2,81.94351518725439,77.47192917952007,NaN,NaN,20.937162224070505,12.186541625018938
2019-06-24T09:30:00-04:00,57.69,58.01,57.44,57.89,4601885,9681849.6,60.32483227411899,62.91135463927795,NaN,NaN,54.94586723238986,65.46663894612331,0.11359362345971014,0.7372091547187836,0.6236155312590734,261190644,259740510.2,82.23384533387673,80.30185563226446,NaN,NaN,20.98832366052038,13.443939058662
2019-06-25T09:30:00-04:00,57.96,58.145,57.73,57.92,5715908,9726342.2,60.51764592877763,62.98649862208124,NaN,NaN,57.62943688654255,61.04888081957095,0.08096017171968961,0.7248157459086855,0.6438555741889959,266906552,260554342,82.46952293859327,82.2441983330106,NaN,NaN,21.082906173085753,14.535220075008251
2019-06-26T09:30:00-04:00,57.89,58.07,57.74,57.82,4184790,9498642.45,59.47999009686051,62.76333540878105,NaN,NaN,52.81321899642416,59.5879286499601,0.04401041565173602,0.6988685937536658,0.6548581781019298,262721762,261964497,82.89298641318764,83.45657222649253,NaN,NaN,20.884240107860517,15.442222936844288
2019-06-27T09:30:00-04:00,57.91,58.11,57.87,58.01,3438991,9446837.9,60.85341058067753,62.47884525978776,NaN,NaN,57.68146096555951,56.12100436587807,0.024699064788867076,0.6857320090880137,0.6610329442991466,266160753,262713694,83.12619742159838,84.02530260021581,NaN,NaN,21.071710963009433,16.246435512010738
2019-06-28T09:30:00-04:00,58.1,58.58,58.04,58.5,5008512,9397675.3,64.22149756111511,62.40367096697866,NaN,NaN,92.80758008475229,63.175512833133666,0.03654446249911225,0.706713522423037,0.6701690599239247,271169265,265629795.2,84.03830308415301,84.25414216938627,NaN,NaN,22.15396845374936,17.09036878940197
2019-07-01T09:30:00-04:00,58.93,58.96,58.46,58.95,5975969,9038702.55,67.02722800356256,62.5537705688047,NaN,NaN,162.8080655460654,84.74795249586877,0.06466135251197636,0.7509957505638951,0.6863343980519188,277145234,268820713.2,84.99415451410917,84.34294296077879,NaN,NaN,23.89707125640407,18.062754856116555
2019-07-02T09:30:00-04:00,58.95,58.95,58.51,58.89,6320099,8465796.45,66.2808900329708,62.5840302424221,NaN,NaN,177.4687343075726,108.71581198007479,0.06880857998446022,0.772345123032494,0.7035365430480338,270825135,269604429.8,85.22813240698929,84.31886602965983,NaN,NaN,25.147530699750366,19.074865690921385
2019-07-03T09:30:00-04:00,58.85,59.19,58.74,59.19,2475774,7604370.55,68.18822457484127,62.63179726013216,NaN,NaN,204.99558609792973,139.1522854003759,0.08053221313112213,0.8042018094619365,0.7236695963308144,273300909,271720259.2,85.86875332852873,84.2537442708091,NaN,NaN,26.756251552549998,20.1722065282969
2019-07-05T09:30:00-04:00,58.62,58.92,58.34,58.92,3810092,6799289.2,64.64411641152458,62.60543802066663,NaN,NaN,126.61569654157258,152.9391325155785,0.05983040077327417,0.7984575972974071,0.7386271965241329,269490817,272386272,86.07348952627484,84.17564684683755,NaN,NaN,27.19438579084452,21.175374994375133
2019-07-08T09:30:00-04:00,58.68,58.81,58.14,58.24,9791824,6128323.8,56.657145432079204,62.37138782672975,NaN,NaN,58.46833862868752,146.07128422436557,-0.006411437180666502,0.7306129000482997,0.7370243372289662,259698993,270092217.6,81.6835879638501,83.9031926731258,NaN,NaN,25.270802956800214,21.76043613186443
2019-07-09T09:30:00-04:00,58.03,58.11,57.535,57.67,5194109,5669898.1,50.97207272663175,61.54044855349802,NaN,NaN,-55.22745348166872,102.46418041881873,-0.09068981833415801,0.6236620643112687,0.7143518826454267,254504884,265564147.6,73.6942120739697,83.04402813102297,NaN,NaN,21.83121046809913,21.77054675132653
2019-07-10T09:30:00-04:00,58.01,58.14,57.48,57.55,7314052,5642168.1,49.838275440045486,60.84576104651363,NaN,NaN,-63.68989228826547,54.23245509965113,-0.152930494177135,0.5231887649240079,0.6761192591011429,247190832,260837287,66.39376144331864,81.73188702650415,NaN,NaN,18.67218019712672,21.327922957869415
2019-07-11T09:30:00-04:00,57.5,57.8098,57.27,57.8,11091468,6019220.55,52.22261937452929,60.013429634673344,NaN,NaN,-79.42840268024415,-2.6523426559836425,-0.17413450905382377,0.45845112278386324,0.632585631837687,258282300,257833565.2,62.17846719865818,80.2013520595973,NaN,NaN,16.66131596722341,20.661264816348556
2019-07-12T09:30:00-04:00,57.96,58.39,57.93,58.37,4405040,5869866.75,57.21602765772512,59.888855435389985,NaN,NaN,26.747566812066207,-22.625968601884914,-0.1476874501596983,0.4479763191380641,0.5956637692977624,262687340,256472869.8,60.31045745200846,78.65613364993688,NaN,NaN,16.33811922874981,20.043672589548734
2019-07-15T09:30:00-04:00,58.34,58.45,58.15,58.41,4538315,5899896.85,57.551308598766184,59.69074660143622,NaN,NaN,40.640900240653984,-26.191456279491625,-0.12624677216000246,0.4378553040977593,0.5641020762577618,267225655,257978202.2,61.68196600579374,77.18814226935952,NaN,NaN,16.169825319101683,19.490265836627728
2019-07-16T09:30:00-04:00,58.45,59.06,58.39,58.55,4526004,5750844.6,58.76918280436461,59.56585637826386,NaN,NaN,86.54761212795336,2.1635568424327856,-0.10239844417238886,0.43610402104227575,0.5385024652146646,271751659,261427557.2,64.69273012537333,75.9183713541295,NaN,NaN,16.3644771596944,19.043724597065825
2019-07-17T09:30:00-04:00,58.56,58.64,58.02,58.03,7167431,5764822.95,52.71904019011389,59.08293138492481,NaN,NaN,8.961871938866642,16.693909687859207,-0.1201774879292048,0.38828060530315867,0.5084580932323635,264584228,264906236.4,67.46882576273407,74.81664559338283,NaN,NaN,14.788904699102815,18.43589318307111
2019-07-18T09:30:00-04:00,57.83,58.33,57.76,58.28,3772791,5595142.2,55.1116451435148,58.67280528227034,NaN,NaN,-16.914618058535293,29.19666661220098,-0.11370224504300969,0.36633028692860137,0.48003253197161105,268357019,266921180.2,68.98975405120153,73.80689963835448,NaN,NaN,14.129468756222877,17.820689693521363
2019-07-19T09:30:00-04:00,58.23,58.71,58.23,58.41,3811197,5448513,56.348647272488606,58.110458833082724,NaN,NaN,42.02393614238242,32.25194047826422,-0.09976329734658534,0.35532841028837936,0.4550917076349647,272168216,268817355.4,70.39259844165545,72.83220644960467,NaN,NaN,13.921299342093828,17.263633929031716
2019-07-22T09:30:00-04:00,58.54,58.62,58.17,58.26,2914317,5302928.4,54.48299657801704,57.21444230268662,NaN,NaN,18.0847030561972,27.74070104137286,-0.09951851187661409,0.3306935677891971,0.4302120796658112,269253899,269223004.2,70.6979907586313,71.81105189564195,NaN,NaN,13.233906366864087,16.68795856300777
2019-07-23T09:30:00-04:00,58.53,59.46,58.53,59.46,4201703,5282919.3,64.58502252630768,57.09330890935354,NaN,NaN,158.80277117447267,42.19173285067672,-0.021489125076064652,0.4033506733207304,0.42483979839679503,273455602,269563792.8,70.96891052563126,70.79253604697352,NaN,NaN,15.801713319647959,16.561352099670653
2019-07-24T09:30:00-04:00,59.28,59.525,59.14,59.42,3764936,5185370.7,64.07453666294572,56.799474058503854,NaN,NaN,170.16131791537646,74.43162204597868,0.022118788435762815,0.45248828394149854,0.4303694955057357,269690666,270585080.4,71.81008247465122,69.78834527169656,NaN,NaN,17.683803261252233,16.72170226561088
2019-07-25T09:30:00-04:00,59.22,59.22,58.38,58.99,6135499,5282906.15,58.70292289843021,56.375103093282824,NaN,NaN,72.86761238267233,92.38806813422022,0.01692668837811273,0.45152785597837664,0.4346011676002639,263555167,269624710,69.76306115121483,68.62331467347799,NaN,NaN,17.657096912455145,16.855330072302916
2019-07-26T09:30:00-04:00,58.84,59.075,58.45,59.06,7637665,5492839.85,59.30108161933449,56.56395567808677,NaN,NaN,64.57643376769943,96.89856765928361,0.013290116255148532,0.4512138129191996,0.43792369666405107,271192832,269429633.2,69.33073225061021,67.74096783681799,NaN,NaN,17.810705281033773,16.991812244978753
2019-07-29T09:30:00-04:00,58.87,58.98,58.67,58.86,2891555,5386992,56.77096778537163,56.97816246799677,NaN,NaN,54.537828938071044,104.18919283565837,-0.006441906068136383,0.4298713140788806,0.43631322014701696,268301277,269239108.8,68.88175677656223,67.39722102986032,NaN,NaN,17.210779517477274,17.023093283907112
2019-07-30T09:30:00-04:00,58.42,59.29,58.33,59.25,4014777,5288932.4,60.325693420952376,57.72726375234726,NaN,NaN,71.99440587385719,86.8275197755353,0.0024392445189365675,0.43936227579568765,0.4369230312767511,272316054,269011199.2,68.31186853675598,67.53422867939157,NaN,NaN,17.72709265542711,17.123664622695685
2019-07-31T09:30:00-04:00,59.08,59.36,57.81,58.34,8102694,5378062.15,49.995214064427806,57.5681633730543,NaN,NaN,-1.1905848503842684,52.55713922238315,-0.05417950952687173,0.3691986443681614,0.42337815389503314,264213360,267915738,65.50650608075264,67.77194574239832,NaN,NaN,14.846100286084319,16.79829828889406
2019-08-01T09:30:00-04:00,58.27,59.16,57.745,58.01,9782922,5743419.55,46.86128220174991,56.8285386976275,NaN,NaN,-30.64804465545064,31.854007814758553,-0.11174655513156317,0.28369495998057914,0.3954415151121423,254430438,266090792.2,61.01138539191533,67.82201202382024,NaN,NaN,11.449794352701359,16.034226298009386
2019-08-02T09:30:00-04:00,57.7,57.77,56.93,57.33,7498021,5927816,41.13870812336713,55.65621009224185,NaN,NaN,-176.34650229767104,-16.330579398315543,-0.1889717011913114,0.15922688862300305,0.34819858981431445,246932417,261238709.2,50.992369844531645,67.05846944087294,NaN,NaN,6.545906169489507,14.678751993935117
2019-08-05T09:30:00-04:00,56.83,57.03,55.86,56.25,10291069,5952778.25,34.03070339786994,53.8891758489208,NaN,NaN,-256.4812691233064,-78.53439901059103,-0.299566254805647,-0.02625922869274433,0.2733070261129027,236641348,254906723.4,41.43071636077702,65.39689702911606,NaN,NaN,-0.4961254215057291,12.510912363157853
2019-08-06T09:30:00-04:00,56.49,56.5,55.64,56.32,11494560,6267800.8,34.81682823078464,52.61044642325443,NaN,NaN,-230.47147647513995,-139.02757548039045,-0.35120547187199785,-0.16569981372709464,0.18550565814490322,248135908,250070694.2,35.894761477827856,63.14160672305133,NaN,NaN,-5.599017451534031,9.923779532487584
2019-08-07T09:30:00-04:00,55.84,57.18,55.79,57.1,23269371,7065566.75,42.97176895250012,51.74331240961053,NaN,NaN,-147.15951925736488,-168.2213623617866,-0.31707460343387067,-0.21083759614743514,0.10623700728643554,271405279,251509078,38.52583677690031,60.965612632029824,NaN,NaN,-7.177963596009987,7.480673371273646
2019-08-08T09:30:00-04:00,57.39,58.21,57.39,58.19,5735116,6797749.15,52.00770969182805,51.43324543956334,NaN,NaN,-26.279107553620957,-167.34757494142065,-0.21046775062402853,-0.15684768099360014,0.053620069630428396,277140395,256051069.4,46.055006845831265,59.2272132323281,NaN,NaN,-5.2122368683857765,5.667400479893729
2019-08-09T09:30:00-04:00,57.96,58.05,57.42,57.73,4624581,6808726.2,48.51415188194482,51.00689938984391,NaN,NaN,-42.10483160115432,-140.4992408021173,-0.16246054262735637,-0.14945560865376706,0.013004933973589303,272515814,261167748.8,53.033606370315425,57.965471490305525,NaN,NaN,-4.895893463795453,4.1583584879381315
2019-08-12T09:30:00-04:00,57.65,57.71,56.72,56.83,22533651,7708493,42.49897961593869,49.42932489624612,NaN,NaN,-91.4929280373451,-107.50157258492504,-0.18140856554788815,-0.2137557729612709,-0.03234720741338275,249982163,263835911.8,56.214548727591385,56.91158850473125,NaN,NaN,-6.8171869063525445,2.5904234316108923
2019-08-13T09:30:00-04:00,56.88,58.15,56.55,57.44,7074260,7835905.8,47.270988712836406,48.229071471238306,NaN,NaN,-57.56656110718486,-72.92058951133403,-0.14455140421658635,-0.2130364626841157,-0.06848505846752934,257056423,265620014.8,58.25069996937497,55.9430611829258,NaN,NaN,-6.648946162065664,1.2705134896570984
2019-08-14T09:30:00-04:00,56.6,56.84,55.57,55.62,9129307,7933999.6,37.31950525575639,46.701684496761615,NaN,NaN,-148.1431299679803,-73.11731165345711,-0.22939620900983831,-0.3552303197298272,-0.1258341107199889,247927116,260924382.2,51.46698213020959,54.63619839571114,NaN,NaN,-10.447715893511262,-0.40351927936695287
2019-08-15T09:30:00-04:00,55.93,55.94,55.24,55.64,8918944,8191307.25,37.47527682964576,45.142698440355275,NaN,NaN,-149.11929940982805,-97.68535002469852,-0.26812640175750463,-0.4609921129168697,-0.19286571115936507,256846060,256865515.2,46.43323950540408,53.00066319962499,NaN,NaN,-13.149753593105789,-2.2244098956153575
2019-08-16T09:30:00-04:00,55.88,56.75,55.81,56.62,5846720,8293083.4,44.72417189867572,44.282213019877,NaN,NaN,-84.98145775005,-106.26067525447766,-0.21404647679009262,-0.46042380714698083,-0.24637733035688822,262692780,254900908.4,44.18080864389438,51.23630976157728,NaN,NaN,-12.756200215409283,-3.7289513698716323
2019-08-19T09:30:00-04:00,57.12,57.28,56.975,57.07,3327984,8313766.75,47.7213693886196,43.38190416042465,NaN,NaN,-34.35435435434394,-94.83296051787742,-0.1379654337048728,-0.41883412248797924,-0.28086868878310645,266020764,258108628.6,48.567765817256685,49.826016710184476,NaN,NaN,-11.39675129286623,-4.82435135887086
2019-08-20T09:30:00-04:00,56.83,56.89,56.36,56.4,4739040,8340633.6,43.90426702997082,42.946836515106284,NaN,NaN,-64.62481203856578,-96.24461070415362,-0.1232441423572272,-0.43492386672964045,-0.31167972437241326,261281724,258953688.8,49.68956161334629,48.6962349625126,NaN,NaN,-11.59186786167362,-5.791139430699825
2019-08-21T09:30:00-04:00,56.78,56.91,56.3954,56.69,3202295,8312501.55,45.92059283933022,42.879644417790594,NaN,NaN,-51.71082441199652,-76.95814959295686,-0.08620781348587142,-0.41943949122975255,-0.3332316777438811,264484019,262265069.4,53.929928546348926,48.190416616400704,NaN,NaN,-11.084559761628459,-6.547342335118201
2019-08-22T09:30:00-04:00,56.8,57.06,56.175,56.31,2607444,8136098.8,43.70382305385736,43.06286691282561,NaN,NaN,-57.034828478909844,-58.54125540677321,-0.07968770668068781,-0.4328413110947409,-0.3531536044140531,261876575,263271172.4,55.16635257612782,48.48855824008616,NaN,NaN,-11.371510623331087,-7.236509233434328
2019-08-23T09:30:00-04:00,56.06,56.3,54.68,54.95,9090627,8208746.9,36.847901203339916,43.264095327502034,NaN,NaN,-138.99892764775092,-69.3447493863134,-0.154996057580434,-0.5468986763895956,-0.39190261880916155,252785948,261289806,52.19545116320372,49.25746786883092,NaN,NaN,-13.968060750226051,-8.19815945011886
2019-08-26T09:30:00-04:00,55.4,55.48,54.87,55.13,7451360,8436737.15,38.22907650508506,43.507827347094924,NaN,NaN,-138.11711444716607,-90.09730140487783,-0.17901264264674,-0.6156684221175865,-0.43665577947084655,260237308,260133114.8,50.486131134164296,50.299708558569236,NaN,NaN,-15.559316144045898,-9.249753263537007
2019-08-27T09:30:00-04:00,55.34,55.675,55.025,55.17,5594946,8515745.6,38.5507017370901,43.19203683170849,NaN,NaN,-121.86305262782595,-101.54494952272987,-0.17814802041192512,-0.659340804985753,-0.48119278457382786,265832254,261043220.8,51.82300269167537,51.249506123910315,NaN,NaN,-16.719582599060352,-10.316871740040343
2019-08-28T09:30:00-04:00,54.99,55.72,54.83,55.6,3772486,8299235.2,42.04416615786319,42.480355150711,NaN,NaN,-106.58709995794881,-112.52020463192032,-0.13643874013308188,-0.6517412097401802,-0.5153024696070984,269604740,262067365,53.349421370987685,51.77053573285006,NaN,NaN,-16.65707397686203,-11.222614916729155
2019-08-29T09:30:00-04:00,56.29,56.56,56.205,56.31,4093442,8014761.2,47.36509906922225,42.39827994980225,NaN,NaN,-9.673856370556106,-103.04801021024957,-0.05313537152186565,-0.5817216840094304,-0.5285863124875647,273698182,264431686.4,56.755792569048516,52.03640617561671,NaN,NaN,-14.976216568850385,-11.758843724175044
2019-08-30T09:30:00-04:00,56.76,56.98,56.505,56.69,5071310,7893425.65,50.01042969270122,42.93481209814244,NaN,NaN,32.805444940951155,-68.68713569250914,0.030932742809843594,-0.48992038397526017,-0.5208531267851038,278769492,269628395.2,63.12860402255358,52.530267268114,NaN,NaN,-12.775599928087678,-11.904094610448277
2019-09-03T09:30:00-04:00,56.25,56.37,55.86,56.24,5807861,7669265.25,46.9981159794624,42.91532118861572,NaN,NaN,-26.91652470185763,-46.44701774344746,0.05803403252775596,-0.44831058612540886,-0.5063446186531648,272961631,272173259.8,65.78754302399261,53.0686132005867,NaN,NaN,-11.798094849890733,-11.888951787511486
2019-09-04T09:30:00-04:00,56.74,56.97,56.56,56.93,5942036,7391639.05,51.79292842027555,43.94913712893852,NaN,NaN,39.680728318114916,-14.138261554259277,0.12062879127168336,-0.35555862956356066,-0.476187420835244,278903667,274787542.4,68.3153302438123,54.2720666372726,NaN,NaN,-9.483058203522317,-11.545252704084461
2019-09-05T09:30:00-04:00,57.34,57.55,56.97,57.02,5824090,6519375,52.397830619513215,45.01503382821477,NaN,NaN,72.5201862333923,21.683195684008947,0.1636233123854699,-0.27165828035340667,-0.43528159273887657,284727757,277812145.8,70.98624921516502,56.025853045112676,NaN,NaN,-7.430856420775747,-10.95748180646893
2019-09-06T09:30:00-04:00,57.13,57.385,56.89,57.24,3952251,6430231.75,53.919961853851,45.67187596787015,NaN,NaN,79.68899339843368,39.5557656378069,0.200002306100295,-0.18527871011350783,-0.38528101621380284,288680008,280808511,73.38026114604901,58.111528223838,NaN,NaN,-5.2823409426463375,-10.146747397351417
2019-09-09T09:30:00-04:00,57.36,57.39,56.83,56.94,6851970,6541601.2,51.50155719778174,45.9418893828103,NaN,NaN,74.29028786414132,47.85273422244494,0.19668673754446225,-0.139422594283225,-0.33610933182768726,281828038,281420220.2,73.85456135681835,59.91772790523527,NaN,NaN,-4.117576776656147,-9.285437308680665
2019-09-10T09:30:00-04:00,56.89,57.51,56.79,57.5,4979542,5663895.75,55.51268961753601,46.771062424779245,NaN,NaN,96.07010923344738,72.45006100950594,0.2231000959739402,-0.05723421186026201,-0.2803343078342022,286807580,284189410,75.94415809784894,61.79305622555688,NaN,NaN,-1.9406189990611475,-8.23617755016359
2019-09-11T09:30:00-04:00,57.63,58.08,57.24,58.05,5408047,5580585.1,59.09129857647626,47.711827120289676,NaN,NaN,147.58907222525772,94.0317297909345,0.2656156711124991,0.05168528105642167,-0.21393039005607745,292215627,286851802,77.78265408573291,63.49682233551289,NaN,NaN,1.0133609962534695,-6.91481490067544
2019-09-12T09:30:00-04:00,58.45,58.735,58.06,58.5,10724170,5660328.25,61.7989217586509,49.00433417063208,NaN,NaN,186.2335697838763,116.77440650103131,0.30900790880535267,0.17232949595061342,-0.13667841285473925,302939797,290494210,80.03117025363377,65.27288074104902,NaN,NaN,4.3512485976797795,-5.305377258053266
2019-09-13T09:30:00-04:00,58.87,59.32,58.81,59.14,5473972,5488079.65,65.31505764466274,51.03770248786941,NaN,NaN,212.6420222927441,143.3650122798934,0.36209599339664794,0.31594157889107066,-0.046154414505577265,308413769,294440962.2,82.14034626936733,67.41180182006072,NaN,NaN,8.348620603235753,-3.3548061350119776
2019-09-16T09:30:00-04:00,58.96,59.1778,58.11,58.17,4733762,5432431.75,56.78417797328888,52.363066878455406,NaN,NaN,135.8580788009407,155.67857046725325,0.31490655310605953,0.34747877687699713,0.03257222377093762,303680007,298811356,84.13825877513263,69.81552522298702,NaN,NaN,9.25500796577613,-1.5534041206136766
2019-09-17T09:30:00-04:00,58.14,58.76,57.96,58.64,4085362,5470300.65,59.54158081346413,53.86241538391069,NaN,NaN,117.05975258523712,159.8764991376112,0.29851855151874546,0.40572041316936946,0.107201861650624,307765369,303002913.8,85.7811454728526,72.24110685021397,NaN,NaN,10.874833427770971,0.2220583862984158
2019-09-18T09:30:00-04:00,58.66,58.76,58.14,58.67,4082305,5437463.9,59.718255281874306,55.124850321340055,NaN,NaN,107.14691231519443,151.78806715559855,0.27353522486793524,0.449120892735543,0.1755856678676078,311847674,306929323.2,87.12627970955236,74.65373958868288,NaN,NaN,12.218077155868134,1.9357753533798039
2019-09-19T09:30:00-04:00,58.81,59.11,58.66,58.77,3266275,5440662.9,60.33995618998844,56.051625829966206,NaN,NaN,113.7485586976584,137.29106493835496,0.24831797661173627,0.48598313863227816,0.2376651620205419,315113949,309364153.6,87.89127249541772,76.87770244056638,NaN,NaN,13.495850777776418,3.5872146997221774
2019-09-20T09:30:00-04:00,58.69,58.8,58.08,58.34,5196979,5570139.65,56.315092560976744,56.501958891985886,NaN,NaN,76.64487588788697,110.09163565738353,0.1898867119265949,0.47502355192878554,0.28513684000219064,309916970,309664793.8,87.98620100269656,78.65324508200516,NaN,NaN,13.456952430151055,4.997177232640588
2019-09-23T09:30:00-04:00,57.94,58.38,57.9329,58.2,3070879,5269152.25,55.02810311491434,57.07552940166103,NaN,NaN,54.672015557157174,93.85442300862682,0.13177494093460307,0.4498555161704445,0.31808057523584143,306846091,310298010.6,88.19610159741472,80.25385640867817,NaN,NaN,13.067444749390742,6.150072592176325
2019-09-24T09:30:00-04:00,58.32,58.45,57.52,57.7,9040451,5348606.8,50.58206303234703,56.98903901680899,NaN,NaN,29.638999453483443,76.37027238227608,0.053635036740335706,0.3851243711612611,0.3314893344209254,297805640,308306064.8,83.26755473071137,81.32187244345668,NaN,NaN,11.456542246464231,6.9081396856460255
2019-09-25T09:30:00-04:00,57.7,58.11,57.45,58,4592896,5298504.3,53.03399483443304,57.03447931787469,NaN,NaN,20.09387068959841,58.959664057156864,0.017969995518374082,0.353951828818893,0.3359818333005189,302398536,306416237.2,78.77016415377001,81.87786636764277,NaN,NaN,10.759002516598924,7.458262947210725
2019-09-26T09:30:00-04:00,58.07,58.1,57.61,57.87,4039301,5311845.05,51.83382200809067,56.885469328891816,NaN,NaN,12.550709302662185,38.72009417815764,-0.01668555676917849,0.31512488733904576,0.33181044410822425,298359235,303065294.4,71.40560725486864,81.73681966112987,NaN,NaN,9.844718100298776,7.7991851119375895
2019-09-27T09:30:00-04:00,57.96,58.21,57.48,57.71,6186066,5416476.25,50.324336935422615,56.80138216729473,NaN,NaN,0.13258188137400406,23.417635376855042,-0.05076817978870973,0.26835021937233705,0.3191183991610468,292173169,299516534.2,64.52528005256964,81.0704424251121,NaN,NaN,8.660682571604752,7.922256177604327
2019-09-30T09:30:00-04:00,57.74,58.31,57.73,58.2,3880267,5356924.1,54.677365497798746,56.74171615874208,NaN,NaN,24.910615399743175,17.465355345372245,-0.0411078419924123,0.2677335966705314,0.3088414386629437,296053436,297358003.2,60.69445672440462,79.98117804129467,NaN,NaN,8.790981446929228,8.046359787507884
2019-10-01T09:30:00-04:00,58.29,58.49,56.82,56.83,7318560,5432459.05,43.262545163148054,55.61109091493292,NaN,NaN,-71.04224383204831,-2.670893311734106,-0.1231438362826554,0.15491164330962448,0.2780554795922799,288734876,295543850.4,57.59932000063132,78.53951132093026,NaN,NaN,5.233844903958612,7.644571947000845
2019-10-02T09:30:00-04:00,56.3,56.38,55.28,55.81,11690823,5719898.4,37.05925040314847,53.84397153239703,NaN,NaN,-244.57962681331185,-55.60559281231616,-0.23573600064433226,-0.016614521213135447,0.2191214794311968,277044053,290472953.8,49.934115495845006,76.38972169537392,NaN,NaN,-0.08682229336671536,6.5400870555197645
2019-10-03T09:30:00-04:00,55.67,56.02,55.1,56.01,8266288,5842008.3,38.90895515582836,51.95782135462315,NaN,NaN,-216.81398064521395,-101.47853080189138,-0.2831830732423174,-0.13485736212169996,0.14832571112061743,285310341,287863175,46.50406190700518,73.84427281234807,NaN,NaN,-3.6960334900790497,5.07778412043422
2019-10-04T09:30:00-04:00,56.05,56.44,56,56.31,6295202,5959155.85,41.6776887504312,50.878786410133316,NaN,NaN,-142.2974951462945,-129.9645462074251,-0.28028401255709035,-0.20202930457574553,0.07825470798134483,291605543,287749649.8,46.35489502706892,71.14546111605779,NaN,NaN,-5.774991132681226,3.5273876557034423
2019-10-07T09:30:00-04:00,56.16,56.69,55.94,56.11,8630537,6048084.2,40.36429655898862,49.50898039195649,NaN,NaN,-128.5353867380813,-160.65374663498997,-0.277250952396799,-0.26830898251465385,0.008941969882145101,282975006,285133963.8,42.93749194847942,68.08520015003113,NaN,NaN,-7.868532738343993,1.8993990279823803
2019-10-08T09:30:00-04:00,55.71,55.75,55.11,55.13,7814977,6189855.95,34.609080556288276,47.71546791155749,NaN,NaN,-169.9643653436679,-180.4381709373139,-0.323438768762208,-0.3953564910706149,-0.0719177223084069,275160029,282418994.4,39.668524014515064,64.69536045752847,NaN,NaN,-11.646057574331923,-0.03566620091966288
2019-10-09T09:30:00-04:00,55.67,55.95,55.36,55.75,9098002,6374353.7,40.398946073606226,46.291110046101615,NaN,NaN,-119.73764689394564,-155.46977495344066,-0.2952105908242565,-0.4409309608387275,-0.14572037001447102,284258031,283861790,42.18747923502368,61.43080379607175,NaN,NaN,-12.957089845761468,-1.8815838644684921
2019-10-10T09:30:00-04:00,55.93,56.525,55.78,56.26,6773677,6176829.05,44.73379388540251,45.463874426417746,NaN,NaN,-76.33334254452359,-127.3736473333026,-0.2281667754351889,-0.43092883930845716,-0.20276206387326826,291031708,285006063.4,44.178109992025206,58.30165443816666,NaN,NaN,-12.641024305390555,-3.4186467846002153
2019-10-11T09:30:00-04:00,56.93,57.88,56.86,57.35,10309247,6418592.8,52.65880901636404,45.29463913366415,NaN,NaN,3.0643174567577507,-98.30128481269213,-0.1027743348141123,-0.3312299823909086,-0.22845564757679632,301340955,286953145.8,47.49124933276734,55.394164990691834,NaN,NaN,-9.620666075680248,-4.304649540468791
2019-10-14T09:30:00-04:00,57.15,57.3,56.91,56.94,4705055,6417157.45,49.76791647071054,45.23648580783297,NaN,NaN,-13.47318104765954,-75.28884367460779,-0.04287563746521933,-0.28205019440832046,-0.23917455694310114,296635900,289685324.6,51.813135299254064,53.14742074558774,NaN,NaN,-8.142892889407713,-4.852970018888637
2019-10-15T09:30:00-04:00,57.23,57.62,57.04,57.34,4915316,6458655.15,52.507274683556766,45.198862939913234,NaN,NaN,10.377010146304551,-39.2205685766133,0.02462289167533202,-0.2083959423489361,-0.23301883402426812,301551216,294963562,58.858261038292376,51.72514195162505,NaN,NaN,-6.04756542748083,-5.0236265058303795
2019-10-16T09:30:00-04:00,57.35,57.875,57.31,57.46,3845503,6446815.05,53.32954685064698,45.30570042866726,NaN,NaN,30.720742592733206,-9.128890679277518,0.07542139729634154,-0.1387420874038412,-0.21416348470018273,305396719,299191299.6,63.46574773880039,51.15800912904875,NaN,NaN,-4.123576676071085,-4.895047958721909
2019-10-17T09:30:00-04:00,57.74,58.05,57.51,57.61,3111853,6439093.95,54.39251276878314,45.59628441676443,NaN,NaN,50.72795894008802,16.283369617644816,0.11483233939722728,-0.07062306045364863,-0.18545539985087592,308508572,302686672.4,66.77837435779642,51.318944436564955,NaN,NaN,-2.239818567327556,-4.515729474237001
2019-10-18T09:30:00-04:00,57.46,57.76,57.28,57.51,3082078,6333348.9,53.51739656588645,45.51342949305642,NaN,NaN,39.474833414573226,23.565472809207904,0.12882364850493871,-0.02442583921970254,-0.15324948772464125,305426494,303503780.2,67.51978980893051,51.8064682283168,NaN,NaN,-0.9347417761449807,-4.004159803080999
2019-10-21T09:30:00-04:00,57.77,57.95,57.325,57.33,2926293,6326119.6,51.8987909909171,46.130304195039926,NaN,NaN,44.86954175410666,35.23401736956115,0.12074994831099092,-0.0023120523359025924,-0.12306200064689352,302500201,304676640.4,68.60292223431112,52.592439816436794,NaN,NaN,-0.27672358925093066,-3.471668915390989
2019-10-22T09:30:00-04:00,57.29,57.48,56.84,57.09,4117236,6079958.85,49.73873881070139,47.035981938436564,NaN,NaN,14.630615536684354,36.084738447637115,0.09516529107589544,-0.0041053868020242135,-0.09927067787791966,298382965,304042990.2,67.29720904708043,53.83266078438218,NaN,NaN,-0.29823279404180547,-3.0183208980553915
2019-10-23T09:30:00-04:00,57.3,57.7,57.24,57.45,3998872,6050257.65,52.905075198112904,48.035704798599745,NaN,NaN,45.986043291999394,39.13779858749035,0.09801999256219025,0.023254312824818157,-0.0747656797373721,302381837,303440013.8,66.00970562361186,55.22592104985409,NaN,NaN,0.5513540484252833,-2.508367334272438
2019-10-24T09:30:00-04:00,57.67,57.99,57.32,57.63,4700694,6083327.3,54.45020436402645,48.94802734242798,NaN,NaN,64.05182808136749,41.80257241574624,0.10683969808640989,0.05878394287064026,-0.04805575521576963,307082531,303154805.6,65.37262609945974,56.584330412167716,NaN,NaN,1.6923892930694844,-1.9082592446521633
2019-10-25T09:30:00-04:00,57.64,58.4,57.58,58.26,4037536,5975900.8,59.463154246451026,50.31223146296101,NaN,NaN,100.74786922546922,54.057179577925446,0.14741024847737588,0.13620705538095024,-0.011203193096425652,311120067,304293520.2,66.75232615318285,58.28538999821796,NaN,NaN,4.171271572372097,-1.0397548422201262
2019-10-28T09:30:00-04:00,58.49,58.7363,58.25,58.44,3404488,5952111.85,60.790886756663845,52.182360477273555,NaN,NaN,131.92549835494273,71.46837089809266,0.17670091153132544,0.20967294631773115,0.03297203478640571,314524555,306698391,69.51490231129459,60.41727416227364,NaN,NaN,6.632167171302636,0.05623401685455409
2019-10-29T09:30:00-04:00,58.18,59.07,58.045,58.8,4145537,5793460.7,63.37467436249799,53.8234839264801,NaN,NaN,132.99121877826394,95.14049154640857,0.20847053713923602,0.29356020621045076,0.08508966907121472,318670092,310755816.4,73.51360666788489,62.6548546931923,NaN,NaN,9.511613216070227,1.4070024738853646
2019-10-30T09:30:00-04:00,58.62,58.935,58.34,58.85,6347197,5526279.4,63.73214783085852,55.180509208298396,NaN,NaN,129.6021365910848,111.86371020622565,0.21986988987242856,0.3599270314117504,0.14005714153932186,325017289,315282906.8,77.11977002965877,65.00783041016612,NaN,NaN,11.999100783396909,2.9201593752441566
2019-10-31T09:30:00-04:00,58.78,58.9,57.87,58.19,7136676,5469798.8,55.96694922429028,55.41680493743598,NaN,NaN,92.10557676380724,117.4744599427136,0.1720923080340365,0.3551725265818675,0.183080218547831,317880613,317442523.2,78.61553415383507,67.23099361167095,NaN,NaN,12.065330196088127,4.226612349650438
2019-11-01T09:30:00-04:00,58.49,59.01,58.43,59.01,4666291,5388353.25,62.13913690556528,56.3004635399256,NaN,NaN,127.65185523205707,122.85525714403119,0.1837862591120241,0.4128130424378611,0.229026783325837,322546904,319727890.6,80.09825050601208,69.25135898358224,NaN,NaN,14.03833871735947,5.628287545037442
2019-11-04T09:30:00-05:00,59.45,59.59,59.155,59.47,3090331,5111342.95,65.09495191841906,57.19958334241577,NaN,NaN,162.1259126468997,128.89534000242253,0.20874955359308722,0.489963725317196,0.2812141717241088,325637235,321950426.6,81.44561093766224,70.86474111925152,NaN,NaN,16.64385294103856,7.2019397444661735
2019-11-05T09:30:00-05:00,59.45,59.9,59.335,59.57,3740520,4907620.1,65.7214730772947,58.08472093003346,NaN,NaN,158.02834626391115,133.90276549955198,0.21727105687002124,0.5528029928116354,0.3355319359416141,329377755,324091959.2,82.66351780853864,72.2360104099471,NaN,NaN,18.936629324787766,8.8783239702264
2019-11-06T09:30:00-05:00,59.52,59.69,59.31,59.53,3994317,4652435.85,65.21721320011908,58.85791381798604,NaN,NaN,133.4511711423922,134.67257240981345,0.20561077504524644,0.5925454047481722,0.38693462970292575,325383438,324165189,82.70532276009536,73.3736495815399,NaN,NaN,20.661208486175372,10.561593186790539
2019-11-07T09:30:00-05:00,59.86,59.99,59.7,59.93,4193862,4523445.1,67.87192010298878,59.88323692777906,NaN,NaN,146.67805424383275,145.58706790581854,0.20952333607849216,0.648838799801041,0.4393154637225488,329577300,326504526.4,84.03014446218859,74.55296062820118,NaN,NaN,22.93581940830854,12.32933978986454
2019-11-08T09:30:00-05:00,59.8,60.18,59.75,60.17,2880141,4151989.8,69.38188412808958,61.13202929471994,NaN,NaN,139.6557958568303,147.9878560307732,0.21230317812851507,0.7046944363831926,0.49239125825467756,332457441,328486633.8,85.07347672439991,75.72942880606467,NaN,NaN,25.2995682809683,14.182229574307932
2019-11-11T09:30:00-05:00,59.85,60.15,59.7428,60.08,4121359,4122805,68.08953998078513,62.44280080686878,NaN,NaN,121.24515662968749,139.81170482733074,0.1926836190032305,0.7332457820087157,0.5405621630054852,328336082,329026403.2,85.35408718380961,77.01920581583103,NaN,NaN,26.91440506204627,16.00111178684198
2019-11-12T09:30:00-05:00,60.27,60.6,60.08,60.39,4960321,4125055.25,70.15184744893585,63.674713110498985,NaN,NaN,132.47932807920205,134.70190119038895,0.1851409394623693,0.7719883373334469,0.5868473978710775,333296403,329810132.8,85.77232359923414,78.43082138551834,NaN,NaN,28.89846999701982,17.843591531153102
2019-11-13T09:30:00-05:00,60.14,60.36,59.925,60.04,5343466,4199953.4,65.0409380795216,64.43119409017721,NaN,NaN,101.14327918180001,128.2403227982705,0.1430215820313645,0.7656243754102832,0.6226027933789187,327952937,330324032.6,86.05355626322434,79.9080306829301,NaN,NaN,29.195090332558294,19.46523421706813
2019-11-14T09:30:00-05:00,59.9,60.46,59.87,60.41,3581184,4223419.95,67.71845225674566,65.02085823376969,NaN,NaN,98.80441489417898,118.66559492833976,0.12706094190882455,0.7814289707649493,0.6543680288561248,331534121,330715396.8,86.27604014420332,81.30258168228872,NaN,NaN,30.21721277596514,21.001231154053418
2019-11-15T09:30:00-05:00,60.71,60.805,60.2,60.36,3410864,4239859.25,66.97197245302631,65.46236435493843,NaN,NaN,101.9824749991995,111.13093075681358,0.1012397457537827,0.7809177110483532,0.6796779652945705,328123257,329848560,83.11341915442763,82.27390431394107,NaN,NaN,30.854679856102624,22.40886668291759
2019-11-18T09:30:00-05:00,60.11,60.39,60.04,60.21,2916562,4239372.7,64.66887516562224,65.55480726944731,NaN,NaN,77.6042552804552,102.40275048696715,0.0639792216371936,0.7596519923410625,0.6956727707038689,325206695,329222682.6,80.81007378889188,82.79508053687013,NaN,NaN,30.770650938810917,23.60340729090235
2019-11-19T09:30:00-05:00,60.47,60.47,59.8829,60.08,3631240,4215072.9,62.65778739407661,65.4780672382486,NaN,NaN,67.57715335466688,89.42231554206012,0.022632538303784533,0.7239634435835995,0.701330905279815,321575455,326878493,72.68510867306308,82.47831901139901,NaN,NaN,30.158933069584474,24.539910973571224
2019-11-20T09:30:00-05:00,59.85,59.96,59.26,59.33,5612973,4295777.95,52.51178238597941,65.23126960694067,NaN,NaN,10.199635616563272,71.23358682901275,-0.05872634470200988,0.6279229744023027,0.6866493191043126,315962482,324480402,65.43681528210566,81.53698194913262,NaN,NaN,26.523782998791518,24.82332126288841
2019-11-21T09:30:00-05:00,59.31,59.4,59.075,59.23,3173638,4219425.15,51.318569380033445,64.45837192654554,NaN,NaN,-26.98178501486595,46.07634684720378,-0.11928380151081852,0.5375445672157895,0.656828368726608,312788844,320731346.6,56.02982921253047,79.81780899959823,NaN,NaN,23.174530754530128,24.58777976169437
2019-11-22T09:30:00-05:00,59.37,59.59,59.26,59.33,2874686,4161282.65,52.481381914194024,63.55740264052947,NaN,NaN,-19.238069852322983,21.832237876899285,-0.1505934007417754,0.4685866177993887,0.6191800185411641,315663530,318239401.2,50.80211882445926,77.62898813436945,NaN,NaN,20.691867372805735,24.031220848995993
2019-11-25T09:30:00-05:00,59.53,59.74,59.45,59.72,3114349,4146775.7,56.81389332773373,62.92114694413226,NaN,NaN,3.562570260084639,7.023900872825169,-0.14307935321041243,0.4403308270281485,0.583410180238561,318777879,316953638,48.29814477980232,75.17431863231685,NaN,NaN,19.703492211943374,23.412973900845618
2019-11-26T09:30:00-05:00,59.68,60.085,59.54,60.02,3936185,4136308.1,59.84665949148021,62.53753596494378,NaN,NaN,30.468170995188032,-0.39789559907059735,-0.11704277777107719,0.4371067080247144,0.5541494857957916,322714064,317181359.8,48.77966959389841,72.75105769187421,NaN,NaN,19.721118395293335,22.885565971481007
2019-11-27T09:30:00-05:00,60.13,60.31,59.81,60.26,5041494,4071022.95,62.13742029711231,62.1279288359526,NaN,NaN,60.080396049095725,9.5782564874359,-0.08432381665114819,0.4487447149818564,0.5330685316330046,327755558,319539975,53.59990836594242,70.5774693992852,NaN,NaN,20.39848046201908,22.530268041557875
2019-11-29T09:30:00-05:00,60.05,60.23,59.84,60.04,3533603,3890869.3,58.8244895911917,61.37382922617417,NaN,NaN,39.337848833127616,22.842183257034613,-0.0782955819743949,0.43519905416501103,0.5134946361394059,324221955,321826597.2,57.75101997899741,68.62586534604216,NaN,NaN,20.02444713023817,22.17229362565506
2019-12-02T09:30:00-05:00,59.94,60.045,59.44,59.44,6973263,4006217.9,50.860145987101,60.14315822662531,NaN,NaN,-50.43477557664697,16.602842112169817,-0.11338484835169443,0.3717635756997879,0.48514842405148234,317248692,322143629.6,58.30794001499348,66.69399769112673,NaN,NaN,17.21224277686599,21.463714932970905
2019-12-03T09:30:00-05:00,58.92,59.125,58.62,59.06,8661001,4284751.4,46.560556313452494,58.45806600266222,NaN,NaN,-183.9457832539913,-20.898828590645373,-0.1581080174408625,0.2875134022504042,0.44562141969126673,308587691,320105592,53.43186710066414,64.38396508408601,NaN,NaN,13.439477474243839,20.317395296009895
2019-12-04T09:30:00-05:00,59.45,59.85,59.06,59.19,5609254,4378188.1,48.174676502043766,57.25333303284238,NaN,NaN,-90.6289339812971,-45.118249585942394,-0.17361769898421575,0.22859929596099704,0.4022169949452128,314196945,318402168.2,49.69145535984777,61.78667216241626,NaN,NaN,10.838958740437816,18.963332930928168
2019-12-05T09:30:00-05:00,59.29,59.53,58.99,59.49,5204645,4438704.5,51.79330411255263,56.115822451114305,NaN,NaN,-91.98024029162801,-75.53037685408715,-0.15875917665388162,0.20376802412786077,0.3625272007817424,319401590,316731374.6,46.270055323933,58.92910181811123,NaN,NaN,9.702083961486663,17.640297363865095
2019-12-06T09:30:00-05:00,59.98,60.195,59.83,60.1,6597180,4558870.4,58.1864188541731,55.48828290833908,NaN,NaN,38.11931249895669,-75.77408412092133,-0.10550004069774632,0.2306521499095595,0.33615219060730583,325998770,317086737.6,47.10426813944204,56.35701960275511,NaN,NaN,10.727544882913618,16.65276129515774
2019-12-09T09:30:00-05:00,60.16,60.31,59.9,59.98,3031046,4566415.65,56.59630113722641,54.91167047773938,NaN,NaN,41.69789577075369,-57.3475498514412,-0.0773105146315271,0.23951404731789694,0.31682456194942404,322967724,318230544,49.80561645843468,54.14241550772247,NaN,NaN,11.069960089664347,15.855218265801543
2019-12-10T09:30:00-05:00,59.88,59.97,59.51,59.62,3550361,4537865.75,52.004777462423235,54.150741196906985,NaN,NaN,-22.34103158706308,-25.026599518055555,-0.08145190891770515,0.21500967580229258,0.29646158471999773,319417363,320396478.4,54.54003366647206,52.84633872153739,NaN,NaN,9.944143783755937,15.010779054080743
2019-12-11T09:30:00-05:00,59.9,60.13,59.78,60.07,3492653,4464482.35,56.73027568173486,54.4520621466038,NaN,NaN,36.43535286558128,0.38625785132012425,-0.053762645926188735,0.22925827731226178,0.2830209232384505,322910016,322139092.6,57.97454138013214,52.313319157110705,NaN,NaN,10.466991584085902,14.361666558367194
2019-12-12T09:30:00-05:00,60.14,60.985,60,60.91,7225379,4558578,63.879443374048925,55.34926743189062,NaN,NaN,144.22669492321873,47.627644894289475,0.017437364298344804,0.3048176286113815,0.2873802643130367,330135395,324285853.6,61.80306261887751,52.72569297184979,NaN,NaN,13.426791164451638,14.228112930664972
2019-12-13T09:30:00-05:00,60.99,61.24,60.42,60.44,5083446,4633691.1,58.09558390684205,55.75028185993691,NaN,NaN,144.48809215831167,68.90140082616047,0.028535762875287196,0.3230499679071457,0.2945142050318585,325051949,324096489.4,61.27280704805313,53.473599273535065,NaN,NaN,13.894582899735791,14.180465783389375
2019-12-16T09:30:00-05:00,60.99,61.045,60.64,60.7,8992999,4912797.85,60.240253475256736,55.99502187047426,NaN,NaN,151.844604285884,90.93074252918652,0.04790369505169639,0.354393823846479,0.3064901287947826,334044948,326311934.2,65.0507927634606,54.67021698665351,NaN,NaN,14.985126191432158,14.29541727025263
2019-12-17T09:30:00-05:00,60.8,61.06,60.59,60.79,5025854,5018262.45,60.98462579910792,56.07630517816197,NaN,NaN,140.0140698154242,123.40176280968399,0.060481326612138564,0.38209178705995583,0.32161046044781727,339070802,330242622,70.54170177530919,56.22464785675428,NaN,NaN,16.082236203028653,14.55067711779206
2019-12-18T09:30:00-05:00,60.85,60.85,60.25,60.71,3673676,5020384.25,59.91092130829932,55.917269536103895,NaN,NaN,99.0964768662001,135.93398760980773,0.05715673704006374,0.3930563817478969,0.3358996447078332,335397126,332740044,73.40112388372815,57.639020393738974,NaN,NaN,16.647067647719048,14.850161479210202
2019-12-19T09:30:00-05:00,60.76,61.01,60.7,60.92,3095601,4894515.65,61.81160481230985,56.13063490904091,NaN,NaN,123.42240403866911,131.77312943289783,0.062416074560124546,0.41391973790798886,0.3515036633478643,338492727,334411510.4,75.1403499213218,58.88111538961929,NaN,NaN,17.68019045801534,15.254451333325221
2019-12-20T09:30:00-05:00,60.61,60.965,60.61,60.88,4257427,4948705.1,61.21625004970462,56.8703566277983,NaN,NaN,103.8128249567103,123.63807599257754,0.056683273305974446,0.42235775498033234,0.3656744816743579,334235300,336248180.6,76.92576144023118,60.21095977713627,NaN,NaN,18.35990823867335,15.69808803408924
2019-12-23T09:30:00-05:00,60.85,61.1,60.7,61.05,3144019,4962171.75,62.853797337672084,58.03415955809971,NaN,NaN,106.81883720418158,114.63292257623706,0.05763385209201288,0.43771679678937403,0.38008294469736115,337379319,336915054.8,77.55605085933922,61.934115759898766,NaN,NaN,19.39330402110258,16.225976032234
2019-12-24T09:30:00-05:00,61.08,61.26,60.98,61.12,1450673,4878987.95,63.536507113964,59.131433173236864,NaN,NaN,112.70889199039084,109.17188701123041,0.05621048750911861,0.4503460540837594,0.39413556657464077,338829992,336866892.8,77.39163188927006,63.91269979771465,NaN,NaN,20.44471326156269,16.828652779280958
2019-12-26T09:30:00-05:00,61.25,61.39,61.04,61.39,2802354,4822296.4,66.12281055905632,60.15496934798713,NaN,NaN,115.48108955518855,112.44880954902808,0.06600921402921867,0.4766470841111641,0.4106378700819454,341632346,338113936.8,78.65352989310718,66.22580512408423,NaN,NaN,22.085211631426162,17.579589758158843
2019-12-27T09:30:00-05:00,61.61,61.61,61.13,61.16,6802737,4910358.55,62.08316016851803,60.433308013297484,NaN,NaN,104.9878916788865,108.76190707707156,0.0502687841489462,0.47347385026812816,0.42320506611918196,334829609,337381313.2,75.970748690746,68.28769659203452,NaN,NaN,22.409185752733524,18.26953204309808
2019-12-30T09:30:00-05:00,61.29,61.3,60.9,60.97,3007741,4884065.45,58.882852271515,60.5966330943181,NaN,NaN,71.3443930740817,102.26822070054584,0.021784178982044378,0.4504352898467374,0.42865111086469304,331821868,336898626.8,74.17561404768493,70.02841070555239,NaN,NaN,21.80780918554544,18.775000206304846
2019-12-31T09:30:00-05:00,60.96,61.48,60.87,61.42,2695032,4670153.9,63.66075636245931,61.42920301574924,NaN,NaN,87.07211698239874,98.31887665618929,0.02759863600553475,0.46314940587161146,0.4355507698660767,334516900,336326143,72.00250728134655,71.275730249472,NaN,NaN,22.644053127558486,19.327722052198222
2020-01-02T09:30:00-05:00,61.83,61.94,60.625,60.7,7357433,4604975.5,53.04066864778543,61.165659656181425,NaN,NaN,66.09718681368766,88.99653562084865,-0.020123292259155046,0.4103966545421329,0.43051994680128797,327159467,333992038,63.796052324874154,71.69155245981072,NaN,NaN,20.004843546103693,19.424453694184717
2020-01-03T09:30:00-05:00,60.08,60.44,59.7,59.72,12423416,4945683.6,42.618989074537566,59.6470557776449,NaN,NaN,-95.61452363409927,46.77741298299107,-0.11544585485296294,0.2862126282350843,0.40165848308804725,314736051,328612779,49.7289660884607,70.82911699335239,NaN,NaN,13.736413757340838,18.611876560349877
2020-01-06T09:30:00-05:00,59.55,59.83,59.41,59.46,15764364,5473669.55,40.35359918692884,58.37977115479396,NaN,NaN,-157.93219101361916,-5.80660355551006,-0.1893947642182795,0.16491502781519785,0.35430979203347734,298971687,321441194.6,37.771233140789505,69.15043314283355,NaN,NaN,7.991309481212376,17.09465269190166
2020-01-07T09:30:00-05:00,59.36,59.8,59.2,59.39,20267054,6157163.25,39.74112283868156,56.91554753789574,NaN,NaN,-155.8569047781605,-51.2468631259585,-0.2335135326891032,0.062417876172098374,0.29593140886120156,278704633,310817747.6,27.299315761074297,66.45389907123453,NaN,NaN,3.323428427054673,15.127334939780663
2020-01-08T09:30:00-05:00,59.4,59.84,59.2,59.6,8079600,6409590.95,42.557843134378444,55.599348776129354,NaN,NaN,-131.15729525262248,-94.89274557296274,-0.23822139756220034,-0.0018453380915488538,0.2363760594706515,286784233,301271214.2,21.52423887344034,62.95265172110104,NaN,NaN,0.38731562342928605,13.02161789458761
2020-01-09T09:30:00-05:00,59.79,59.925,59.625,59.82,3786159,6421380.85,45.43538627056177,54.565381987719526,NaN,NaN,-101.93370759927922,-128.4989244555561,-0.21679934612984728,-0.03462312319165761,0.18217622293818966,290570392,293953399.2,18.324223893493155,59.01858743608425,NaN,NaN,-1.1616578584579655,10.995435644152527
2020-01-10T09:30:00-05:00,59.96,60.11,59.48,59.58,5637370,6528616.7,42.91002719598526,53.21526930083919,NaN,NaN,-104.95517928282793,-130.36705558530184,-0.2089845445044779,-0.07905445769240771,0.1299300868120702,284933022,287992793.4,16.210215724932652,54.80929213634217,NaN,NaN,-3.2235764151209025,8.964148207113466
2020-01-13T09:30:00-05:00,59.63,60.37,59.57,60.35,4409307,6387813.1,52.10735922119491,52.56463424165993,NaN,NaN,-52.3813043585097,-109.25687825427994,-0.14517600975044323,-0.05153992537598384,0.09363608437445939,289342329,286066921.8,15.584612898501433,50.42778152621862,NaN,NaN,-2.086751931426525,7.385448187322039
2020-01-14T09:30:00-05:00,60.29,60.47,59.97,60.1,5505084,6408895,49.32869770821526,51.59855569669873,NaN,NaN,-38.417981496386474,-85.76909359792515,-0.11437976828236167,-0.0493386259784927,0.06504114230386897,283837245,287093444.2,17.41415047344998,46.1319314986551,NaN,NaN,-2.046979944993449,6.037958454134112
2020-01-15T09:30:00-05:00,60.09,60.7881,60.08,60.51,3898548,6154172.45,53.69021756425049,50.89524930029062,NaN,NaN,-4.384633111249583,-60.41456116965056,-0.06350902980942687,-0.014345144957914613,0.049163884851512255,287735793,287283756.2,17.76997229587296,41.87324152769816,NaN,NaN,-0.5937282543293131,5.090574638639337
2020-01-16T09:30:00-05:00,60.72,60.97,60.52,60.87,9399931,6372876.3,57.17574816237332,50.25617341481327,NaN,NaN,34.17912078444849,-33.191995492905015,-0.005768846957530473,0.041952826154599165,0.04772167311212964,297135724,288596822.6,20.320777106251768,37.706616328637075,NaN,NaN,1.7555259112068948,4.614139106148988
2020-01-17T09:30:00-05:00,60.94,61.15,60.78,61.14,5447155,6461550.25,59.62990267410384,50.080940736640834,NaN,NaN,57.57688405080946,-0.6855828261775301,0.047519693377159264,0.10712128983357871,0.05960159645641945,302582879,292126794,26.886930022201014,34.20062928088386,NaN,NaN,4.478280381032232,4.594730716846595
2020-01-21T09:30:00-05:00,60.72,60.83,60.39,60.48,3807403,6497140.35,51.81329704263089,49.575972506006245,NaN,NaN,7.6446545646720985,11.319608958458835,0.03576582274135211,0.10430887488310958,0.06854305214175747,298775476,294013423.4,30.19774892361022,31.059353200592806,NaN,NaN,4.312188415322493,4.55436753091458
2020-01-22T09:30:00-05:00,60.61,60.655,60.21,60.24,2737633,6421150.65,49.283378365663395,48.549016934806545,NaN,NaN,-13.025288348649932,16.398147588006136,0.010582687569926558,0.08177141160416568,0.07118872403423912,296037843,296453543,34.33922905582712,28.369119041627133,NaN,NaN,3.3640262858828507,4.384318781624333
2020-01-23T09:30:00-05:00,59.76,60.225,59.33,60.17,3462637,6437081.55,48.53894277696194,48.227465086890575,NaN,NaN,-60.94169845295991,5.086734519664072,-0.01087262612213287,0.05759794138157304,0.0684705675037059,292575206,297421425.6,35.962229393814624,26.380988832265736,NaN,NaN,2.3815236778216198,4.098205195366802
2020-01-24T09:30:00-05:00,60.26,60.29,59.49,59.74,5246703,6626883.05,44.12925029432304,48.335340888303826,NaN,NaN,-62.68663880644788,-14.286417398515203,-0.051816268593975735,0.003700231761236239,0.055516500355211974,287328503,295459981.4,34.121545206948255,25.266173055014843,NaN,NaN,0.1619698112863972,3.535885854783887
2020-01-27T09:30:00-05:00,58.68,58.87,58.45,58.45,6934583,6833494.5,34.11587588126696,47.8897892236137,NaN,NaN,-186.6255643897066,-63.12690708661842,-0.15759357572449748,-0.14147546930040988,0.0161181064240876,280393920,291022189.6,30.338028326358653,24.73522985398407,NaN,NaN,-5.6347969297663285,2.2257883141338564
2020-01-28T09:30:00-05:00,58.74,59.3,58.612,59.11,4491134,6717914.35,41.43757483213582,48.010964366003286,NaN,NaN,-127.95467625682477,-90.2467732509178,-0.17365871451635237,-0.20095528672135288,-0.0272965722050005,284885054,288244105.2,28.22790052285714,24.80155733696856,NaN,NaN,-7.789809218596018,0.7949886666010173
2020-01-29T09:30:00-05:00,59.31,59.63,59.27,59.3,3569216,6745988.1,43.38802016873046,48.070262725599854,NaN,NaN,-75.77595564898718,-102.79690671098524,-0.16225034174156788,-0.23010949938196035,-0.06785915764039246,288454270,286727390.6,27.11888812356186,25.201175140548667,NaN,NaN,-8.788140645725315,-0.5740298065884588
2020-01-30T09:30:00-05:00,58.52,59.01,58.14,58.93,8699069,7046189.95,40.55535194318267,47.72168884507278,NaN,NaN,-149.14716635161523,-120.43800029071633,-0.1695882403086722,-0.2798444580262327,-0.11025621771756051,279755201,284163389.6,25.308688499709106,25.700065469564095,NaN,NaN,-10.544615673640584,-1.9983992161673336
2020-01-31T09:30:00-05:00,58.39,58.43,57.44,57.63,11020846,7229360.6,32.52151581358977,46.97965231775881,NaN,NaN,-217.8417762420581,-151.46902777783836,-0.24725517525564167,-0.4193251867871126,-0.17207001153147095,268734355,280444560,22.919091015664677,26.17927084747352,NaN,NaN,-15.156942780864421,-3.878191153981203
2020-02-03T09:30:00-05:00,57.85,59.1,57.8,58.84,12160804,7216230,43.70057928581024,46.37916803665991,NaN,NaN,-114.38095964375498,-137.02010682864804,-0.20418567789589845,-0.427302108901344,-0.22311643100544556,280895159,280544807.8,23.12979193146286,26.718212206970765,NaN,NaN,-14.734881938001699,-5.429146980269845
2020-02-04T09:30:00-05:00,59.56,60.2,59.32,59.88,13595070,7107765.3,51.18601402227345,46.51183348766407,NaN,NaN,12.303344947316258,-108.96850258781986,-0.0980823204268163,-0.34571933153896595,-0.24763701111214964,294490229,282465842.8,27.234571117946643,27.419670824434814,NaN,NaN,-11.399182346678204,-6.282009175471039
2020-02-05T09:30:00-05:00,60.4,61.1,59.97,60.99,17150356,6951930.4,57.65698178393809,46.795173789070326,NaN,NaN,95.53695036598141,-74.70592138482614,0.04665811197947614,-0.18931437113780447,-0.2359724831172806,311640585,287103105.8,36.10437466672606,28.729270993781466,NaN,NaN,-6.07842164462043,-6.25292524249238
2020-02-06T09:30:00-05:00,61.29,61.29,60.74,60.96,12375876,7166744.2,57.435372797354226,46.81371840585468,NaN,NaN,113.51263096313414,-22.173961921876263,0.1351695017656261,-0.06701060591024799,-0.20218010767587408,299264709,291005007.4,42.45999666121563,30.31064381913603,NaN,NaN,-2.3068436965052235,-5.689199307351358
2020-02-07T09:30:00-05:00,60.58,60.58,59.8825,60.09,7833262,7369099.35,51.27985067367155,46.21728612010951,NaN,NaN,32.84618018060549,27.963629362656444,0.12988278742097514,-0.03982662339965515,-0.1697094108206303,291431447,295544425.8,48.836149775566255,31.878445230090684,NaN,NaN,-1.4255221421252453,-5.080102569461913
2020-02-10T09:30:00-05:00,60,60.22,59.87,60.06,4525560,7313508.85,51.076571039025126,46.16466283413768,NaN,NaN,18.602505498774207,54.56032239116229,0.11939318534193735,-0.020467929143208607,-0.13986111448514596,286905887,296746571.4,50.403553788195744,33.32171700613251,NaN,NaN,-0.8286478882281555,-4.472751900714234
2020-02-11T09:30:00-05:00,60.38,60.94,60.35,60.39,4058558,7295971.4,53.2709490799085,46.44948931372661,NaN,NaN,62.82200996648755,64.66405539499654,0.12889463405610074,0.021257178084979955,-0.10763745597112077,290964445,296041414.6,49.446650766333285,34.400818556882946,NaN,NaN,0.3569793784355932,-3.7827902894071155
2020-02-12T09:30:00-05:00,60.8,60.84,60.52,60.72,3243470,7182890.7,55.42412313772373,46.94128791092388,NaN,NaN,70.70713383546617,59.69809208889349,0.1501342275307237,0.08003032844228386,-0.07010389908843984,294207915,292554880.6,44.90708300106887,35.03973667168682,NaN,NaN,1.997339877327418,-2.9570574084450394
2020-02-13T09:30:00-05:00,60.64,60.88,60.34,60.5,4117750,7193850.8,53.64932143856693,47.62129299265558,NaN,NaN,59.12363525574711,48.82029294741608,0.14217574677554917,0.10761578438099662,-0.03455996239455254,290090165,290719971.8,42.6859827078061,35.65148220746239,NaN,NaN,2.8055847105941125,-2.133822820010875
2020-02-14T09:30:00-05:00,60.52,60.74,60.345,60.51,3627477,6905228.1,53.72186332946076,49.021720667526566,NaN,NaN,57.3360381675649,53.71826454480796,0.13068769085775167,0.12879965117763703,-0.0018880396801146254,293717642,291177210.8,43.436742836177565,36.58710467244945,NaN,NaN,3.477410397625698,-1.3322180746342218
2020-02-18T09:30:00-05:00,60.42,60.57,60.08,60.36,4708120,6868276.35,52.397166431540214,49.80454863891259,NaN,NaN,44.53283382693955,58.904330210441024,0.10708089858789281,0.1319630835547514,0.02488218496685858,289009522,291597937.8,44.161538512469114,37.725221671707445,NaN,NaN,3.6768725129361144,-0.6166337049813168
2020-02-19T09:30:00-05:00,60.5,60.745,60.46,60.52,6827391,7019275.75,53.70840291104884,50.54171883479248,NaN,NaN,66.72876454788332,59.68568112672018,0.09665524096601316,0.14570123617437503,0.04904599520836187,295836913,292572431.4,45.891011913010615,39.06608765666807,NaN,NaN,4.196163105567682,0.0709086965256831
2020-02-20T09:30:00-05:00,60.3,61.03,60.18,60.62,5180573,7141422.75,54.5510329476643,51.541410335112595,NaN,NaN,67.94869432494328,59.13399322461561,0.09098843670602547,0.1627815410908937,0.07179310438486824,301017486,293934345.6,48.30101659747245,40.708396806508304,NaN,NaN,4.854534258882165,0.7542837768623234
2020-02-21T09:30:00-05:00,60.37,60.56,60.2,60.34,6520483,7294315.05,51.71262961093772,52.91220417778031,NaN,NaN,42.34545492667958,55.7783571588021,0.06414335947918492,0.1519723037338494,0.08782894425466448,294497003,294815713.2,49.85750688425146,42.63256936855022,NaN,NaN,4.6909324227860285,1.3166621548514241
2020-02-24T09:30:00-05:00,58.81,59.0775,58.37,58.64,9294872,7496723.5,38.585476035211805,52.546839659880426,NaN,NaN,-93.95505805878119,25.520137913532906,-0.06533586395653171,0.006159114308999847,0.07149497826553156,285202131,293112611,46.91801444077183,44.33172811921515,NaN,NaN,0.27549992198550655,1.167924693013436
2020-02-25T09:30:00-05:00,58.65,58.7,55.96,56.11,20061986,8153093.65,27.426933369357258,50.84976247038641,NaN,NaN,-206.28450632053833,-24.643330115962673,-0.30517641435398946,-0.30997553967695524,-0.004799125322965808,265140145,288338735.6,39.829410361784085,45.23135949377497,NaN,NaN,-8.776171080524177,-0.25266041749193735
2020-02-26T09:30:00-05:00,56.41,57.16,55.83,55.92,14303558,8643714.85,26.800120188230096,48.64570092783584,NaN,NaN,-202.67579308691515,-78.52424164292236,-0.4515875763548214,-0.5692835957664926,-0.11769601941167117,250836587,279338670.4,30.479817203129457,44.829605389232356,NaN,NaN,-15.696463938167154,-2.458918063302683
2020-02-27T09:30:00-05:00,55,55.64,53.3,53.3,20697213,9500114.7,20.009266057425165,45.97240758926948,NaN,NaN,-244.72054973566742,-141.05809045504452,-0.6858115563352696,-0.9749604648307582,-0.2891489084954886,230139374,265163048,21.799772504913804,43.35387509235365,NaN,NaN,-25.13593940827698,-5.698492541156154
2020-02-28T09:30:00-05:00,51.61,52.81,51.15,52.72,30742154,10602268.95,18.8693917947282,43.65737481220209,NaN,NaN,-244.2551689268877,-198.37821522575797,-0.8310453638906686,-1.3279556133588244,-0.49691024946815576,199397220,246143091.4,15.444486024117168,40.96875625296443,NaN,NaN,-32.56539421775769,-9.53662135209923
2020-03-02T09:30:00-05:00,53.22,54.99,52.625,54.98,16817336,10892093.45,34.521988617460394,42.474904639233195,NaN,NaN,-148.1024399759427,-209.20769160919025,-0.7297521734869707,-1.4091004663268691,-0.6793482928398984,216214556,232345576.4,12.579499574819238,38.2670380948661,NaN,NaN,-32.34335379706655,-12.79472598709456
2020-03-03T09:30:00-05:00,55.16,56.14,53.77,54.5,28390170,11703561.75,33.06296942672759,41.03147752114884,NaN,NaN,-109.75919245391175,-189.90262883586496,-0.6524477392474741,-1.494907966899241,-0.842460227651767,187824386,216882424.6,10.278308899190208,35.46929939007017,NaN,NaN,-32.74472680849688,-15.64472610443775
2020-03-04T09:30:00-05:00,55.46,56.79,54.69,56.76,14080006,11727808.55,44.87592116249059,40.2780345229179,NaN,NaN,-64.6053674746476,-162.28854371341146,-0.41788395957987334,-1.3648151771266086,-0.9469312175467353,201904392,207095985.6,9.138865203398197,32.91442669023655,NaN,NaN,-28.208242240921592,-17.439514123935442
2020-03-05T09:30:00-05:00,55.12,55.74,54.62,54.96,14177315,11579156.5,38.97609681519992,39.22994704982025,NaN,NaN,-79.68321958309495,-129.28107768289695,-0.3551965627727769,-1.3909269210127064,-1.0357303582399295,187727077,198613526.2,8.281864631963657,30.456989684819238,NaN,NaN,-27.002492058105176,-18.805653828816833
2020-03-06T09:30:00-05:00,53.53,53.98,52.49,53.53,18941140,11907419.7,35.03533492432484,37.895195020881964,NaN,NaN,-109.5626485132554,-102.34257360017048,-0.37910202944244253,-1.5096078950429828,-1.1305058656005402,168785937,192491269.6,7.719216980479558,27.90573783798366,NaN,NaN,-27.640725668305578,-20.067806948743797
2020-03-09T09:30:00-04:00,49.68,51.53,48.36,48.52,14245034,12228008.3,25.360782690230494,35.96402475364555,NaN,NaN,-172.12276567301504,-107.14663873958497,-0.6836322475497467,-1.9850461750377235,-1.3014139274879768,154540903,180156539,6.727545446511172,25.23188119041524,NaN,NaN,-32.723052643107046,-21.87569919079569
2020-03-10T09:30:00-04:00,50.34,50.56,48.04,50.49,16718134,12837637,33.174859315557114,34.49734306825329,NaN,NaN,-145.8224166784929,-114.35928358450118,-0.7010832163837346,-2.177767947967645,-1.4766847315839104,171259037,176843469.2,6.486504447358385,22.417273514297225,NaN,NaN,-32.982680775982,-23.462410845822305
2020-03-11T09:30:00-04:00,49.05,49.19,47.42,48.09,14954788,13382448.5,29.16846360676975,32.68430240104654,NaN,NaN,-154.20581628217334,-132.27937334600634,-0.8149689452183437,-2.49539591310684,-1.6804269678884964,156304249,167723440.6,5.863694018345157,19.386036187216707,NaN,NaN,-34.906571589400805,-25.097290952047803
2020-03-12T09:30:00-04:00,44.57,46.51,42.37,43.46,15365799,13988564.95,23.317997838541046,30.656114417303915,NaN,NaN,-197.1728597469911,-155.77730137878558,-1.1237839465127968,-3.0851569010294924,-1.9613729545166956,140938450,158365715.2,5.301246582200832,16.20344616564166,NaN,NaN,-39.167092538930184,-27.107262607316713
2020-03-13T09:30:00-04:00,46.27,46.54,43.2,46.51,12114067,14388380.8,32.87005112705134,30.247869781006735,NaN,NaN,-151.4466326030641,-164.1540981967473,-1.0459072576651938,-3.2687570265981876,-2.222849768932994,153052517,155219031.2,5.123284834635172,13.218108336631898,NaN,NaN,-38.1278751384619,-28.68163582605174
2020-03-16T09:30:00-04:00,37.69,43.23,37.69,41.39,14427131,14928363.5,26.82843148308035,30.205119646272674,NaN,NaN,-188.4302580979184,-167.41559668172798,-1.2487486127988192,-3.7837855349315177,-2.5350369221326985,138625386,152035927.8,4.942533876134675,10.72618858765694,NaN,NaN,-40.052062919231005,-30.30598255364878
2020-03-17T09:30:00-04:00,42.03,44.4,40.83,43.95,11044962,15245205.6,33.418104197195234,30.677832789770182,NaN,NaN,-132.17455367850707,-164.6860240817308,-1.1239395116679747,-3.939961311717667,-2.8160218000496924,149670348,147718190,4.700293099408071,8.884794008819702,NaN,NaN,-38.60223771144384,-31.491161861905216
2020-03-18T09:30:00-04:00,41.1,42.79,38.415,41.14,9875884,15397630.25,30.202815671754152,31.405943476507968,NaN,NaN,-139.7051932506019,-161.7858994754165,-1.1404473207174455,-4.241580950946499,-3.1011336302290538,139794464,144416233,4.517930016283856,7.650376688203278,NaN,NaN,-38.83812912754871,-32.54072861414
2020-03-19T09:30:00-04:00,40.43,42.85,39.57,42.19,8986851,15587944.15,32.80445036309386,32.4013048028198,NaN,NaN,-114.37451317007819,-145.22623016003394,-0.9957289722073339,-4.345794845488221,-3.3500658732808875,148781315,145984806,6.376231228794779,7.002644202823108,NaN,NaN,-38.01742654301017,-33.32311403255002
2020-03-20T09:30:00-04:00,42.55,42.61,40.015,40.68,15248688,16024354.4,31.01409260415258,32.15074080186924,NaN,NaN,-107.77239803230155,-136.49138324588142,-0.9186473182035195,-4.498375021035287,-3.579727702831767,133532627,142080828,6.060104160836957,6.536973101824368,NaN,NaN,-38.031417500521705,-33.995728813688835
2020-03-23T09:30:00-04:00,40.16,40.44,38.16,38.35,18677524,16493487,28.435234055338853,31.820188275341476,NaN,NaN,-118.47259747937389,-122.4998511221725,-0.9382364829190584,-4.75252330648059,-3.814286823561532,114855103,137326771.4,5.69013792691716,6.209246603804867,NaN,NaN,-38.95605443174256,-34.70434675912508
2020-03-24T09:30:00-04:00,40.77,43.14,40.43,42.86,11879257,16084350.55,39.007128673784095,31.40098881186244,NaN,NaN,-72.20216972883415,-110.50537433223792,-0.5787388963558433,-4.537710444006336,-3.958971547650493,126734360,132739573.8,5.350699985943294,5.9386633739866586,NaN,NaN,-35.82801158761125,-34.86487030605168
2020-03-25T09:30:00-04:00,42.7,45.63,42.26,43.86,13576410,16047993.15,41.08531864524126,31.551647514008245,NaN,NaN,-44.72800678862712,-91.50993703984297,-0.22316347273949688,-4.237925888574864,-4.014762415835367,140310770,132842835,5.487378988403947,5.739057256589535,NaN,NaN,-32.711283508424735,-34.55721504924783
2020-03-26T09:30:00-04:00,44.38,46.14,44.29,45.92,13384016,15682333.3,45.22565179617997,32.27952729056933,NaN,NaN,-20.96514390530947,-72.82806318688924,0.17946912220259303,-3.7904260130821257,-3.9698951352847187,153694786,133825529.2,6.865729962588816,5.67809389816877,NaN,NaN,-28.778582077409855,-33.73169605327098
2020-03-27T09:30:00-04:00,44.21,45.21,43.87,44.26,14075592,14849005.2,42.62601858926971,33.51275842621499,NaN,NaN,-30.43861787202149,-57.36130715483322,0.3526788187030059,-3.5290466119059616,-3.8817254306089675,139619194,135042842.6,8.643108845197176,5.814919855217771,NaN,NaN,-26.45478571489001,-32.69213743350227
2020-03-30T09:30:00-04:00,44.81,45.85,44.44,45.67,9754165,14495846.65,45.492061612963774,34.39255859031546,NaN,NaN,-13.33399888136418,-36.33358743523128,0.5681271501671183,-3.1715664929000695,-3.739693643067188,149373359,141946493.8,18.179690673796642,6.650147442820505,NaN,NaN,-23.653740676827738,-31.400937896834478
2020-03-31T09:30:00-04:00,45.53,46.17,44.86,45.04,8508699,13501773.1,44.42425167561794,35.48225773809033,NaN,NaN,-6.363971945363427,-23.16594787853713,0.667272771297732,-2.905602678945023,-3.572875450242755,140864660,144772553.8,21.77933944182719,7.786979258783508,NaN,NaN,-21.729126932054275,-30.01925061615159
2020-04-01T09:30:00-04:00,43.39,44.235,42.89,43.01,10240402,13309792.9,41.07836191220971,36.75085517192381,NaN,NaN,-35.85176683452271,-21.390699887716245,0.5974591504932674,-2.8260515121261705,-3.423510662619438,130624258,142835251.4,21.094224719647528,8.915049125743987,NaN,NaN,-21.104051051290202,-28.74565067831425
2020-04-02T09:30:00-04:00,42.96,44.73,42.87,43.66,11784560,13190155.15,42.569895762125654,37.44370121728626,NaN,NaN,-19.352743389876956,-21.068219784629736,0.5950745042662753,-2.6796675322865937,-3.274742036552869,142408818,140578057.8,20.293236746029038,9.998617119414977,NaN,NaN,-20.158325982422625,-27.51889000747259
2020-04-03T09:30:00-04:00,43.36,44.25,42.42,42.61,9265807,12706388.5,40.77431239593434,38.4398355682044,NaN,NaN,-28.15568987642945,-20.611634185511324,0.5252317164273306,-2.6182023910187056,-3.143434107446036,133143011,139282821.2,19.827966181377235,11.061862284075161,NaN,NaN,-19.87867211408843,-26.42743030841771
2020-04-06T09:30:00-04:00,44.44,46.12,44.44,45.78,10466739,12517473.75,47.91688384855689,39.4754626861588,NaN,NaN,56.596640460547924,-6.625506317128904,0.6848821786409949,-2.2873313841447924,-2.9722135627857873,143609750,138130099.4,19.401629649567568,12.111957751943695,NaN,NaN,-17.46689521774143,-25.147353866892526
2020-04-07T09:30:00-04:00,47.47,48.63,46.77,47,11211302,12242132.15,50.3962694438971,40.91785224131188,NaN,NaN,137.2854489051656,22.104377852976903,0.8539999934584483,-1.904713570962727,-2.7587135644211753,154821052,140921377.8,23.68091143666294,13.48074213911363,NaN,NaN,-14.717501757865048,-23.657374994174315
2020-04-08T09:30:00-04:00,47.5,49.52,46.97,49.3,16463583,12317571.9,54.76792845969382,42.48667210535473,NaN,NaN,176.1152953287384,64.49779028562912,1.087162964359735,-1.3997598589715068,-2.4869228233312417,171284635,149053453.2,34.578879440650496,15.49521701138904,NaN,NaN,-10.998556328195477,-21.84897232760591
2020-04-09T09:30:00-04:00,49.84,51.7,49.79,51.42,30738358,13086199.85,58.40664790097473,44.44328319798488,NaN,NaN,209.4742271811863,110.26318439984178,1.334280366321912,-0.8190723654288519,-2.153352731750764,202022993,160976288.2,46.61517847295077,18.392008033682885,NaN,NaN,-6.6874970236847755,-19.683047284188603
2020-04-13T09:30:00-04:00,51.02,51.16,49.59,50.29,15857274,13273360.2,55.82862772422566,46.399954174333935,NaN,NaN,163.0704653333003,148.50841544178772,1.3667413305183735,-0.44492606860279693,-1.8116673991211705,186165719,171580829.8,54.61349803811982,21.886533755911646,NaN,NaN,-3.875165643224325,-17.424778478336563
2020-04-14T09:30:00-04:00,51.34,51.67,50.42,50.94,8261988,12965103.05,57.004253555271625,47.685463094440195,NaN,NaN,154.90444003892802,168.16997535746376,1.3734385023670148,-0.09486927116240196,-1.4683077735294168,194427707,181744421.2,60.69206452844063,25.839488366090027,NaN,NaN,-1.2185385267956297,-15.109601342402144
2020-04-15T09:30:00-04:00,49.32,49.37,48.21,48.6,5700567,12697883.3,51.67244637111264,48.44168650343101,NaN,NaN,87.25087250873028,158.16306007817667,1.1696911925050237,-0.006193782898137101,-1.1758849754031608,188727140,188525638.8,64.14268643710713,30.02915318385454,NaN,NaN,-0.4495190305994278,-13.01530386928747
2020-04-16T09:30:00-04:00,48.69,48.79,47.52,48.32,4628057,12435491.95,51.057057256827065,48.8582154649058,NaN,NaN,67.61501607928786,136.4630042282866,0.9735205537858207,0.04101571682911498,-0.9325048369567057,184099083,191088528.4,65.3796461221869,34.20871862382583,NaN,NaN,0.003829088735067711,-11.155427732427107
2020-04-17T09:30:00-04:00,49.46,50.42,49.4499,50.26,6304598,12301379.3,55.05131561980834,49.74573668137284,NaN,NaN,98.00477857520951,114.16911450709122,0.9318387782028503,0.23229363579685725,-0.6995451424059931,190403681,188764666,63.249069626303175,38.109144393904835,NaN,NaN,1.5483306483523278,-9.340605106601473
2020-04-20T09:30:00-04:00,49.38,50.18,48.88,49.02,4843185,11781104.15,52.123241092539196,50.21939235848537,NaN,NaN,72.77887120823893,96.11079568207894,0.7841086366316672,0.2805906533835909,-0.5035179832480763,185560496,188643621.4,63.13366180578059,41.32014233190369,NaN,NaN,2.0251432591935514,-7.7169267686307546
2020-04-21T09:30:00-04:00,47.77,48.35,47.59,47.81,5987697,11146612.8,49.364099356864976,50.572238621431595,NaN,NaN,30.964033083291966,71.32271429095172,0.5777810796137451,0.21870836626910517,-0.35907271334463997,179572799,185672639.8,60.22880601218075,44.06653280121465,NaN,NaN,1.6440277026246988,-6.3796475584514045
2020-04-22T09:30:00-04:00,48.79,49.12,48.27,48.75,3832596,10744279.75,51.51147838445788,51.31746122659217,NaN,NaN,46.40130682120835,63.152801153447356,0.48143292654783804,0.2427184448401576,-0.23871448170768045,183405395,184608290.8,59.17830874962945,46.78682451764193,NaN,NaN,1.91792259486969,-5.1942803936912485
2020-04-23T09:30:00-04:00,49.03,50.09,49.03,49.09,6383599,10384639.2,52.29944772980563,52.0124292242836,NaN,NaN,60.669953357446154,61.76378860907901,0.4196805813013545,0.2858862449190127,-0.13379433638234178,189788994,185746273,59.98198713216286,49.62173525950863,NaN,NaN,2.358244821163037,-4.115348220140636
2020-04-24T09:30:00-04:00,49.49,50,48.95,49.86,4145718,9922724.3,54.117933233644145,52.96554499840573,NaN,NaN,61.41070710807807,54.44497431565272,0.4093344366468083,0.3778737094261686,-0.03146072722063971,193934712,186452479.2,60.50168460725763,52.52700086135724,NaN,NaN,3.2198793557311873,-3.0674585664446616
2020-04-27T09:30:00-04:00,50.01,51.38,49.94,51.19,4861081,9461998.75,57.15616155852271,53.62549340626043,NaN,NaN,92.49421908200729,58.3880438904064,0.46655600037559525,0.5517342732488544,0.08517827287325912,198795793,189099538.6,62.46912085847975,55.60325023342239,NaN,NaN,4.802358160449594,-1.9431990340311966
2020-04-28T09:30:00-04:00,52.03,52.45,51.5,52.14,6751954,9311888.2,59.23272755925606,54.25666898592893,NaN,NaN,120.69505437981817,76.33424814971164,0.5378139580400599,0.757445720423334,0.2196317623832741,205547747,194294528.2,66.04387291836147,58.62917605354371,NaN,NaN,6.734024075428128,-0.7035957326798645
2020-04-29T09:30:00-04:00,53.22,53.74,53,53.47,5876320,9180269.25,62.00893285286804,54.773883585441375,NaN,NaN,151.55246860434684,97.36448050633933,0.6371591210560654,1.016080663703356,0.3789215426472905,211424067,199898262.6,69.42668071570556,61.118304716047646,NaN,NaN,9.200079901975036,0.7112150722708355
2020-04-30T09:30:00-04:00,52.63,52.63,51.8,51.88,5406779,8938588.1,57.01059442259371,54.67416547984273,NaN,NaN,104.10816804323404,106.05212344349691,0.5611011697729283,1.080298004863451,0.5191968350905226,206017288,203143921.4,71.21535030947547,62.87545984722799,NaN,NaN,9.9793169167149,2.0352296214771304
2020-05-01T09:30:00-04:00,50.98,51.2,50.32,50.79,5066978,8602709,53.808484625910545,54.5298695442488,NaN,NaN,53.33734549294118,104.43745112046955,0.40972099689999153,1.031348081215512,0.6216270843155205,200950310,204547041,71.97857816525871,64.11582271345219,NaN,NaN,9.744780027431528,3.1365939651849013
2020-05-04T09:30:00-04:00,50.4,51.04,49.9,50.97,5070460,8392941.65,54.26531714643247,54.33423122933171,NaN,NaN,39.805046994568386,93.89961670298176,0.29918050959282105,0.9956027213065468,0.6964222117137258,206020770,205992036.4,72.7790624317189,64.97917970654349,NaN,NaN,9.672666416806123,4.07031860113079
2020-05-05T09:30:00-04:00,51.42,51.79,50.99,51.1,4502805,8094744.95,54.614431825361855,54.544373047492364,NaN,NaN,64.2131122330395,82.60322827362602,0.2161594849159869,0.9666215678587093,0.7504620829427224,210523575,206987202,73.3438353565757,65.63640462936267,NaN,NaN,9.702356114385022,4.874895388738537
2020-05-06T09:30:00-04:00,51.24,51.63,50.17,50.22,3753204,7721840.05,51.735476696337244,54.592831578885956,NaN,NaN,25.52605936967854,57.397946426692364,0.0897907139280244,0.862700475352753,0.7729097614247286,206770371,206056462.8,71.84252760780966,66.09803902119287,NaN,NaN,8.969110881282466,5.459783316244812
2020-05-07T09:30:00-04:00,50.72,51.71,50.65,51.25,4122913,7104806.55,54.74263295986324,54.57078281746131,NaN,NaN,51.22581954929654,46.82147672790483,0.06456396181923152,0.853614713698768,0.7890507518795364,210893284,207031662,72.4781994393617,66.75726257926848,NaN,NaN,9.112700917111702,5.981628687797225
2020-05-08T09:30:00-04:00,51.99,52.55,51.8294,52.48,3783450,5757061.15,58.09996955143581,54.99769199309678,NaN,NaN,107.3998109113248,57.63396981158155,0.1166698741627552,0.9348880945829805,0.8182182204202253,214676734,209776946.8,74.24116667664845,67.55065578433047,NaN,NaN,10.1515618907872,6.577333431081507
2020-05-11T09:30:00-04:00,51.61,51.92,51.15,51.68,4428553,5185625.1,55.230170155715875,55.41669705015756,NaN,NaN,60.99766485053214,61.8724933827743,0.08469915258337068,0.9240921611494386,0.8393930085660679,210248181,210622429,74.7770436951076,68.58981561882524,NaN,NaN,10.268850100836923,7.104692955332281
2020-05-12T09:30:00-04:00,51.85,52.175,50.89,50.89,4200048,4982528.1,52.473785531659,55.485433274957636,NaN,NaN,44.88505521736383,58.006881979639175,0.0021519138870432775,0.842082900924872,0.8399309870378288,206048133,209727340.6,73.0445451603207,69.58026107673176,NaN,NaN,9.616891081841022,7.4635784019763864
2020-05-13T09:30:00-04:00,50.64,50.85,49.36,49.82,5266090,4960804.25,48.91312769931542,55.243553272779764,NaN,NaN,-33.034867728942935,46.29469655991488,-0.12564229376889435,0.6828781198267109,0.8085204135956052,200782043,208529675,70.68469565689097,70.34474025706947,NaN,NaN,8.050751312617576,7.547460246353699
2020-05-14T09:30:00-04:00,48.9,50.43,48.315,50.43,5420950,5000448.9,50.95628564288183,55.017721302011026,NaN,NaN,-59.020536233566325,24.24542540334231,-0.1675972020380213,0.5990239110480786,0.7666211130860999,206202993,207591616.8,68.80959573263486,70.93816248031071,NaN,NaN,7.261997444963512,7.506679846155101
2020-05-15T09:30:00-04:00,50.11,50.91,49.86,50.87,4880615,4929249.75,52.434020755414714,54.680425530360445,NaN,NaN,-8.177016255117657,1.1300599700538172,-0.1640173697405406,0.5615994009104242,0.7256167706509647,211083608,206872991.6,67.33591590962352,71.28579069824956,NaN,NaN,6.983112722580839,7.4318845427873494
2020-05-18T09:30:00-04:00,52.62,53.61,52.49,53.19,4425724,4908376.7,59.383274066784146,54.69117885232674,NaN,NaN,140.8285575641397,17.096238512775326,-0.0117338681947039,0.7109494354075849,0.7226833036022888,215509332,207925221.8,68.40298654638929,71.45429881453725,NaN,NaN,8.754957920578773,7.6208950253289816
2020-05-19T09:30:00-04:00,52.99,53.42,52.63,52.68,4892918,4853637.75,57.39806686914394,54.361831282060734,NaN,NaN,118.34527611740035,31.788282692782627,0.045194014834748386,0.7791758221457243,0.733981807310976,210616414,208838878,69.33959337822142,71.44807829043125,NaN,NaN,9.66862080907333,7.913427280149603
2020-05-20T09:30:00-04:00,53.38,54.1,53.37,53.52,3799366,4851976.25,59.7828390927975,54.55984875850386,NaN,NaN,150.3247417108696,68.46020458074513,0.12542142967841374,0.8907585944089931,0.7653371647305793,214415780,211565625.4,72.00654184378747,71.50459197145354,NaN,NaN,11.135410715246888,8.373710628020643
2020-05-21T09:30:00-04:00,53.36,53.65,52.81,53.01,5245674,4795080,57.67198567339188,54.83581311903824,NaN,NaN,103.96546628895302,101.057405085249,0.12960717905842978,0.9273461385536166,0.7977389594951868,209170106,212159048,72.56582592871641,71.54653824027194,NaN,NaN,11.78361213126797,8.860839414198832
2020-05-22T09:30:00-04:00,52.95,53.03,52.52,52.93,3732571,4774422.65,57.33003125997245,55.05472127000538,NaN,NaN,73.80777353901522,117.45436304407558,0.11305825626226162,0.9390617798230139,0.8260035235607522,205437535,211029833.4,69.71166503823352,71.32743842645156,NaN,NaN,12.229660222430363,9.34209952966048
2020-05-26T09:30:00-04:00,54.13,54.67,53.94,54.38,4114414,4737089.3,61.7561915871568,55.564846967276445,NaN,NaN,148.27329347813193,118.94331022687402,0.1817641075278501,1.0532086579705648,0.8714445504427147,209551949,209838356.8,66.729327648263,70.85497359014352,NaN,NaN,13.883705262144346,9.990900348586747
2020-05-27T09:30:00-04:00,55,55.29,54.23,54.93,6991708,4749077,63.310804861607465,56.39165612193862,NaN,NaN,150.28362644532444,125.33098029245885,0.2424541506574791,1.1745122387645637,0.9320580881070846,216543657,211023805.4,68.18757111831191,70.59390526946511,NaN,NaN,15.726876943620386,10.810325576448696
2020-05-28T09:30:00-04:00,55.7,55.89,54.9,55.44,5484744,4729498.2,64.74203872829119,57.105899391112004,NaN,NaN,163.3603093713428,127.93809382455348,0.29183325958762163,1.2968496625916117,1.00501640300399,222028401,212546329.6,70.0058921864098,70.41731189425425,NaN,NaN,17.695990273810843,11.793991961786146
2020-05-29T09:30:00-04:00,55.45,55.64,54.79,55.45,7386327,4828475.6,64.77105800124355,57.58240570895542,NaN,NaN,133.90446970824692,133.92589450841226,0.29896038066626884,1.3787168788368263,1.0797564981705574,229414728,216595254,74.22509967557659,70.41616425132055,NaN,NaN,19.340834065560855,12.87211226232539
2020-06-01T09:30:00-04:00,55.47,56.03,55.39,55.83,3233448,4736799.1,65.91897441645064,58.34589172757933,NaN,NaN,134.4100839565359,146.0463565919164,0.302162303284214,1.4574593772758249,1.1552970739916109,232648176,222037382.2,78.58541903824445,70.68819106154463,NaN,NaN,21.061011988588294,14.041955080362946
2020-06-02T09:30:00-04:00,56.01,56.92,55.945,56.84,4327098,4699631,68.82647028105515,59.51394063825048,NaN,NaN,148.90630050585509,146.17295799746103,0.34225257667095077,1.5831127948302992,1.2408602181593484,236975274,227522047.2,81.9073429290366,71.32124804502433,NaN,NaN,23.406745670271647,15.37978230749276
2020-06-03T09:30:00-04:00,57.55,58.55,57.48,58.13,4724107,4710696.1,72.10031967926218,61.17016863681811,NaN,NaN,175.3836402862027,151.19296076563668,0.42045103831262587,1.7664240160501308,1.345972977737505,241699381,232553192,84.31150036171394,72.29459123822598,NaN,NaN,26.482396314570998,16.96587002278965
2020-06-04T09:30:00-04:00,57.89,58.5,57.8,58.34,4503652,4748218.5,72.60470560267478,62.716484348231894,NaN,NaN,153.87491438613432,149.295881768595,0.4485543116102164,1.9066658672502754,1.458111555640059,246203033,237388118.4,86.20816419863765,73.53734612865476,NaN,NaN,29.1896061971222,18.7121180476943
2020-06-05T09:30:00-04:00,59.87,60.29,59.64,59.83,5629973,4823571.5,75.9297401788915,64.39475002133737,NaN,NaN,175.47987158042707,157.61096214303103,0.5244499350113414,2.113673974404236,1.5892240393928945,251833006,241871774,87.69394537605733,74.99149109054288,NaN,NaN,32.661922135912086,20.704947203153985
2020-06-08T09:30:00-04:00,60.06,60.245,59.38,59.91,5256465,4897222.25,76.09748617924305,65.58862231508444,NaN,NaN,148.2426017006206,160.37746569184796,0.5351440701053047,2.2581541270245253,1.7230100569192206,257089471,246760033,89.07570596386506,76.46811390607687,NaN,NaN,35.55501333747349,22.826385222342484
2020-06-09T09:30:00-04:00,59.22,59.57,58.83,59.18,6008942,4976241.7,71.22005387844979,66.57590710146343,NaN,NaN,115.54001554002107,153.70420869868116,0.4514985619816352,2.2873832593962646,1.8358846974146295,251080529,249581084,89.78831723867721,77.92873703896656,NaN,NaN,36.70042066055491,24.80839028494426
2020-06-10T09:30:00-04:00,59.43,59.43,58.27,58.51,5192360,5025857.3,66.97695672432985,67.08977264657288,NaN,NaN,93.34104021494193,137.295688684429,0.31590763218278384,2.230769237643109,1.9148616054603254,245888169,250418841.6,89.99699770522777,79.21376960049801,NaN,NaN,36.48388073345447,26.47631749187429
2020-06-11T09:30:00-04:00,56.85,57.02,53.76,53.99,29098418,6217473.7,46.74414585325128,66.30921265941998,NaN,NaN,-12.047780644044185,104.1111496783933,-0.09155180407186791,1.8004218503704905,1.8919736544423584,216789751,244536185.2,77.95092339007991,79.59841941916683,NaN,NaN,28.79340096795729,26.807329417029006
2020-06-12T09:30:00-04:00,55.86,56.09,54,55.04,13931872,6643019.8,50.48606021077877,65.82035758447758,NaN,NaN,-17.835965295543517,65.44798230319918,-0.2923804037166451,1.5264981497965522,1.8188785535131973,230721623,240313908.6,70.64222915827946,79.66488828488441,NaN,NaN,23.945022432106235,26.398428419182896
2020-06-15T09:30:00-04:00,53.59,55.95,53.29,55.62,6885667,6743272.4,52.472585314904414,65.15724285074528,NaN,NaN,-29.86658538168053,29.826144886738952,-0.38249693894373094,1.3407573798335335,1.7232543187772644,237607290,236417472.4,64.62083994670749,79.51428202048758,NaN,NaN,20.786322717744536,25.59669903326313
2020-06-16T09:30:00-04:00,57.54,57.79,55.91,56.78,9502439,6997108.15,56.252920575585755,64.65310825888658,NaN,NaN,27.975673327548783,12.313276444244481,-0.3606112064465261,1.2724903107191068,1.633101517165633,247109729,235623312.4,63.43403388063679,79.17474364636793,NaN,NaN,19.422403909045514,24.714656872660612
2020-06-17T09:30:00-04:00,57.14,57.2,56.15,56.31,4025431,6953733.8,54.36606534087835,63.91196730264279,NaN,NaN,12.890376476454,-3.7768563034530986,-0.37287279478535273,1.1670105236839419,1.5398833184692946,243084298,235062538.2,62.560316857531994,78.64291683716237,NaN,NaN,17.72550874010474,23.716207139438346
2020-06-18T09:30:00-04:00,56.1,56.67,56,56.35,3567611,6942146.05,54.50592586565314,63.17874357867206,NaN,NaN,0.0921901751694465,-1.3488621396103668,-0.3724976284879016,1.0742612828594176,1.4467589113473192,246651909,241034969.8,67.6680501065463,78.17455615366022,NaN,NaN,16.4221942870524,22.67420530338321
2020-06-19T09:30:00-04:00,57.29,57.39,55.78,56.18,7418498,7050787.25,53.751919815171135,62.30966825000923,NaN,NaN,-2.267131645250138,1.764904590448309,-0.3767743679941551,0.9757909513546252,1.3525653193487803,239233411,242737327.4,68.96760787770535,77.48756964219312,NaN,NaN,15.141016281943934,21.5980354431776
2020-06-22T09:30:00-04:00,55.86,56.31,55.37,56.08,3369452,7032631.3,53.28496851907708,61.19956098129652,NaN,NaN,-34.62694982145408,0.8128317024936024,-0.37841665671836866,0.8795444984508194,1.257961155169188,235863959,242388661.2,68.36154276289164,76.5200124874685,NaN,NaN,13.955292514408388,20.506215024781998
2020-06-23T09:30:00-04:00,56.92,56.97,56.19,56.21,3115978,6982709.5,53.84629076007852,59.895701772783404,NaN,NaN,-15.205983223824115,-7.823499607780977,-0.36278108045696955,0.8044848045979762,1.1672658850549458,238979937,240762702.8,65.47209640772482,75.17434077646928,NaN,NaN,13.108396791060873,19.449383848536122
2020-06-24T09:30:00-04:00,55.61,55.67,54.41,54.57,5653098,6915779,46.28971126445949,58.016059320053735,NaN,NaN,-93.54691833270655,-29.110958569613093,-0.4492661293864846,0.6056832233218401,1.0549493527083247,233326839,238811211,62.08053106873641,73.45093841004775,NaN,NaN,10.12085058067502,18.11673623884168
2020-06-25T09:30:00-04:00,54.42,55.31,53.93,55.25,5254695,6904276.55,49.45694901884001,56.12514566576434,NaN,NaN,-93.34377191694205,-47.79815098803539,-0.4461437701626929,0.49726964000495855,0.9434134101676515,238581534,237197136,59.34242122552622,71.42582954215267,NaN,NaN,8.462611358254565,16.737575541614948
2020-06-26T09:30:00-04:00,55.04,55.14,54.16,54.49,8172900,6943605.2,46.17931803327033,53.98813365533772,NaN,NaN,-101.24462711259605,-67.59365008150458,-0.4779014867219764,0.3460365517651809,0.8239380384871573,230408634,235432180.6,56.412438730365785,69.09273902547416,NaN,NaN,6.076433012022185,15.214555180244554
2020-06-29T09:30:00-04:00,54.95,55.79,54.82,55.55,4939074,7028886.5,51.05176099206952,52.547541306310556,NaN,NaN,-61.82866125228568,-73.03399236767089,-0.41261918475763704,0.308164057540111,0.720783242297748,235347708,235328930.4,56.23750736880411,66.6962526061975,NaN,NaN,5.4217331096031005,13.815580598724347
2020-06-30T09:30:00-04:00,55.36,56.68,55.2,56.35,3938883,7009475.75,54.40657602412946,51.649656970581965,NaN,NaN,-27.452802628810332,-75.48335624866813,-0.3055884353093681,0.3387976981610379,0.644386133470406,239286591,235390261.2,56.324145011758326,64.29104884237826,NaN,NaN,5.866382143780155,12.679980819446605
2020-07-01T09:30:00-04:00,56.41,56.66,55.7,56.47,8146083,7180574.55,54.905837181706644,52.23263492261448,NaN,NaN,-14.757759826320884,-59.725524547391004,-0.22070081006376707,0.3685101208906971,0.5892109309544642,247432674,238211428.2,60.22491663988635,63.02490550307872,NaN,NaN,6.372303023466613,11.778883991449463
2020-07-02T09:30:00-04:00,57.26,58,57.14,57.53,8033104,7357047.15,59.16005766268683,52.85220616917934,NaN,NaN,52.775132326563444,-30.501743698689904,-0.09365038989239949,0.47214794358896484,0.5657983334813643,255465778,241588277,64.33133733402133,62.57412751563164,NaN,NaN,8.083172213353263,11.25092516600715
2020-07-06T09:30:00-04:00,58.62,58.68,57.6,58.35,7864167,7468756.85,62.13596388636677,53.54244749571237,NaN,NaN,99.6502670258665,9.677235129002607,0.03806386920897187,0.6133781699925791,0.5753143007836072,263329945,248172539.2,70.68618169055156,63.00736621162049,NaN,NaN,10.453920451148523,11.137067349598775
2020-07-07T09:30:00-04:00,57.93,58.535,57.89,58.37,7448809,7578374.05,62.20829604431185,53.967831457764234,NaN,NaN,115.8423751439044,45.21144240824063,0.11465576677691958,0.7186340092547567,0.6039782424778372,270778754,255258748.4,75.70332466994468,63.88374412514249,NaN,NaN,12.39887585769335,11.317325707898
2020-07-08T09:30:00-04:00,58.47,58.78,56.89,57.54,9166810,7736267.45,57.31495741981836,54.17846660625995,NaN,NaN,94.56292026898566,69.61458698779984,0.0981766242707176,0.7266990228162342,0.6285223985455166,261611944,259723819,78.23152318433283,65.00311600562827,NaN,NaN,12.715021303272392,11.516996507237199
2020-07-09T09:30:00-04:00,57.81,57.89,56.36,57,15729378,8263118.35,54.32113424955583,54.16526720511014,NaN,NaN,61.653702103153584,84.89687937369473,0.04250957893370655,0.6816593722126498,0.6391497932789433,245882566,259413797.4,77.62753502633089,65.71450778561288,NaN,NaN,12.132187225094563,11.604880895502536
2020-07-10T09:30:00-04:00,57.13,58.06,57.09,57.99,4657225,7041058.7,58.59157768019764,54.510957052612035,NaN,NaN,97.45064557684013,93.83198202375006,0.06274261151201255,0.717578057668959,0.6548354461569464,250539791,258428600,75.62927248434653,66.19034097180155,NaN,NaN,12.871237454164664,11.78578897531141
2020-07-13T09:30:00-04:00,58.59,59.17,57.95,57.99,9034618,6796196,58.59157768019764,54.890000564120655,NaN,NaN,128.22049131218066,99.5460268810129,0.0661652032148694,0.7375419501755331,0.6713767469606637,250539791,255870569.2,70.5510968503227,66.34673769233233,NaN,NaN,13.471842951543236,12.026653829058814
2020-07-14T09:30:00-04:00,57.87,59.53,57.8,59.45,9434264,6923625.85,64.29996385431463,55.63669149942323,NaN,NaN,144.2893972255354,105.23543129733909,0.15189490362854818,0.861245376496349,0.7093504728678008,259974055,253709629.4,66.48953851153396,66.41941212831871,NaN,NaN,15.757077473237732,12.559571492512946
2020-07-15T09:30:00-04:00,60.49,60.7,60.04,60.45,8228684,6859938.1,67.59505738096445,57.15850193631644,NaN,NaN,191.8530055507288,124.69344835368773,0.25501668810452127,1.0281213329984524,0.7731046448939312,268202739,255027788.4,67.71065738323244,66.82156400792556,NaN,NaN,18.774951923378083,13.447482982636537
2020-07-16T09:30:00-04:00,60.57,61.11,60.345,60.65,5564350,6936884.05,68.22670665527893,58.49919891034779,NaN,NaN,172.35327744665364,146.83336342238772,0.31199831391628763,1.1631025372892907,0.8511042233730031,273767089,260604693,72.3083185406939,67.74769953043753,NaN,NaN,21.41792954714072,14.586118206137133
2020-07-17T09:30:00-04:00,61.08,61.32,60.8579,61.16,4077811,6962394.05,69.84108499478967,60.1893251218849,NaN,NaN,161.789806552024,159.7011956174245,0.35614547969331345,1.2962860729896448,0.9401405932963314,277844900,266065714.8,75.92354623936976,69.14135006679497,NaN,NaN,24.131421810183067,15.949733006715123
2020-07-20T09:30:00-04:00,61.13,61.29,60.53,60.63,3593164,6771127.35,66.08335517467452,61.263010420642395,NaN,NaN,130.62529027065534,160.18215540911945,0.3227518892261936,1.3435804548290733,1.0208285656028797,274251736,270808103.8,78.54328243686889,70.73461971451387,NaN,NaN,25.359960958059823,17.294051285478652
2020-07-21T09:30:00-04:00,61.01,61.46,61.01,61.16,3777223,6791515.9,67.9409456062271,62.229751105077945,NaN,NaN,128.4817192168852,157.0206198073894,0.3094189089570849,1.4076022017992358,1.0981832928421509,278028959,274419084.6,80.30089899806383,72.44724499924997,NaN,NaN,26.9446226566355,18.67270433850106
2020-07-22T09:30:00-04:00,61.06,61.8882,61.04,61.87,2949481,6783191.05,70.2885659196809,63.32851744350468,NaN,NaN,124.9741784476187,143.6448543867674,0.32014041858355435,1.498358816071594,1.1782183974880396,280978440,276974224.8,81.45830197274266,73.96391538016829,NaN,NaN,29.007797911018308,20.149146277432095
2020-07-23T09:30:00-04:00,61.82,62.285,61.25,61.68,4414116,6721241.95,68.8358792541791,64.0196475571827,NaN,NaN,115.7066210856286,132.31552311456238,0.2872112150049919,1.5372324162442794,1.2500212012392875,276564324,277533671.8,81.71166385729325,75.2053672746877,NaN,NaN,30.31036178035836,21.600748492135846
2020-07-24T09:30:00-04:00,61.46,61.79,61.12,61.47,5863463,6751680.35,67.18316376891727,64.38016183450773,NaN,NaN,94.14816888273376,118.78719558070433,0.2267178275766677,1.533418485710122,1.3067006581334544,270700861,276104864,78.75193086157351,75.78149221547498,NaN,NaN,30.953365805881134,22.936836679813744
2020-07-27T09:30:00-04:00,61.87,62.59,61.67,62.36,3640924,6525081.55,70.42414109799691,64.96700790977096,NaN,NaN,107.73906201297834,114.20994992916894,0.2218016014579549,1.583952659955898,1.362151058497943,274341785,276122873.8,78.76237311496868,75.99999567583384,NaN,NaN,32.45406219537678,24.296440324894178
2020-07-28T09:30:00-04:00,62.17,62.17,60.93,60.99,4570137,6506634.7,60.51653795836016,65.1956922339525,NaN,NaN,70.43310912870572,102.60022791153304,0.10724432909289039,1.496206469864056,1.3889621407711656,269771648,274471411.6,75.11687642385465,75.77752090722826,NaN,NaN,30.782522801886763,25.22302353589312
2020-07-29T09:30:00-04:00,61.19,61.67,61.09,61.49,4111547,6515267.9,62.5853581939043,65.78599394426311,NaN,NaN,66.09667025425559,90.8247262728604,0.049066054374683477,1.45029470873952,1.4012286543648365,273883195,273052362.6,72.03173396696633,75.37782083155936,NaN,NaN,30.00506749203321,25.906172672484562
2020-07-30T09:30:00-04:00,60.57,60.75,59.8,60.3,7021132,6459020.35,55.175416509863474,65.54198243209639,NaN,NaN,16.22754935003827,70.92891192574233,-0.0786888388802145,1.3028676057645683,1.3815564446447828,266862063,271111910.4,67.92356395786192,74.82741307966761,NaN,NaN,26.942282525496452,26.054188365771974
2020-07-31T09:30:00-04:00,60.41,60.51,59.6,60.36,5270659,6320898.1,55.46174477374038,65.31842293877801,NaN,NaN,5.648790289237511,53.22903620704308,-0.16340445854842445,1.177300871459252,1.3407053300076766,272132722,271398282.6,68.2117045007956,74.66031362612996,NaN,NaN,24.58659482541341,25.844532145720752
2020-08-03T09:30:00-04:00,60.67,60.69,60.01,60.02,5539023,6204640.9,53.38086995608407,64.53848766033298,NaN,NaN,5.23893434344893,32.729010673137196,-0.24185759628557868,1.0383833346507032,1.2802409309362819,266593699,269848665.4,64.81860795449424,74.54096144348428,NaN,NaN,22.010340310214833,25.296790454934193
2020-08-04T09:30:00-04:00,59.78,61.01,59.66,60.87,7917484,6228074.65,57.65796450179811,63.82869531182109,NaN,NaN,15.082775007604882,21.658943848917026,-0.23577862622721701,0.9855176481522605,1.2212962743794775,274511183,270796572.4,65.93488790162093,74.4141207662263,NaN,NaN,21.011687102467963,24.6846328331533
2020-08-05T09:30:00-04:00,61.44,62.41,61.27,61.76,5896986,6064583.45,61.627672748368404,63.35733574704177,NaN,NaN,86.34766956225441,25.7091437105168,-0.1739451445821838,1.0038648436517477,1.1778099882339315,280408169,272101567.2,67.465388362586,74.06819718207574,NaN,NaN,21.354912697325446,24.208958528035037
2020-08-06T09:30:00-04:00,61.68,61.84,61.2608,61.5,6969481,5626588.6,59.86201622781134,62.64454512082904,NaN,NaN,64.55942516186742,35.37551887288263,-0.15340108572215705,0.9860586310812351,1.1394597168033922,273438688,273416892.2,68.9782490118873,73.57210452296985,NaN,NaN,21.11387802757315,23.766804170826195
2020-08-07T09:30:00-04:00,61.18,61.72,60.89,61.71,3985810,5593017.85,60.83796349632366,62.26987428666111,NaN,NaN,51.95012663777712,44.635786142590554,-0.1294694565691017,0.977622896092015,1.1070923526611167,277424498,274475247.4,70.17981250853819,72.97471381380338,NaN,NaN,21.193161838887402,23.399140980549223
2020-08-10T09:30:00-04:00,61.77,62.31,61.68,62.31,3339147,5308244.3,63.563920957942635,61.95722966892651,NaN,NaN,109.62517738505973,65.51303475091272,-0.07948512356047432,1.0077359482105237,1.087221071770998,280763645,277309236.6,73.17591559430517,72.46578642782062,NaN,NaN,22.049393192650964,23.206319867992327
2020-08-11T09:30:00-04:00,62.85,63.21,62.075,62.2,4487723,5060917.25,62.702207735025546,61.41534694145112,NaN,NaN,149.6010129213887,92.41668233366947,-0.06092110046718657,1.0110696961870147,1.0719907966542013,276275922,277662184.4,73.53257610479722,71.89966315153879,NaN,NaN,22.519037905867698,23.10813673054595
2020-08-12T09:30:00-04:00,62.95,63.02,62.42,62.57,3964572,4847711.65,64.44806618528324,61.10193172224425,NaN,NaN,154.7636409740176,106.09987661602213,-0.03225254553890666,1.031675114730568,1.0639276602694747,280240494,277628649.4,73.43267001669318,71.30830644863879,NaN,NaN,23.404517758676356,23.150476877421724
2020-08-13T09:30:00-04:00,62.27,62.8,62.189,62.56,8426150,4990801.65,64.36038074892919,60.900304363673676,NaN,NaN,124.4668388809509,118.08135935983883,-0.02293072101105942,1.0352642590056504,1.0581949800167099,271814344,277303780.6,72.40634905372063,70.85505060522073,NaN,NaN,24.116856881365422,23.288531163699396
2020-08-14T09:30:00-04:00,62.28,62.88,62.2,62.63,2590078,4916415,64.7222083487899,60.49302345301604,NaN,NaN,114.81761549820341,130.65485713192408,-0.021066040878078285,1.031862428919112,1.0529284697971903,274404422,276699765.4,70.43524983228517,70.26025608502904,NaN,NaN,24.81294876236834,23.506305106366387
2020-08-17T09:30:00-04:00,63.12,63.36,62.65,62.91,1859961,4829754.85,66.20038084463394,60.89901223060702,NaN,NaN,138.2920418700945,136.38823002893102,-0.010523380826620077,1.0397742437639153,1.0502976245905353,276264383,275799913,67.48767786979491,69.71531333116764,NaN,NaN,25.80173047750347,23.834223016528828
2020-08-18T09:30:00-04:00,63.11,63.23,62.59,62.65,2381966,4759992,63.5380759792946,60.96706350099204,NaN,NaN,108.17266187052238,128.10255981875775,-0.029531748291458992,1.0133829392262115,1.0429146875176705,273882417,275321212,65.90756765592829,69.27787288037919,NaN,NaN,25.991694630413143,24.14243324708373
2020-08-19T09:30:00-04:00,62.89,63.04,62.29,62.47,3104699,4767752.9,61.68844553481807,61.43227985991738,NaN,NaN,77.90031655430353,112.72989493481494,-0.060892955339208354,0.96679849334366,1.0276914486828683,270777718,273428656.8,59.93310842074218,68.70712605629922,NaN,NaN,25.690041065571208,24.363520078296226
2020-08-20T09:30:00-04:00,62,62.29,61.83,62.25,2331186,4663606.4,59.41198650611955,61.71443998365874,NaN,NaN,31.95633353633491,94.22779386589174,-0.10076659581797198,0.9017332039104033,1.0024997997283753,268446532,272755094.4,57.92072257988385,67.97205591909123,NaN,NaN,24.851047768471975,24.433166891178477
2020-08-21T09:30:00-04:00,61.78,62,61.55,61.89,2756316,4508249.05,55.78427840706937,61.88611201587198,NaN,NaN,2.8032601192215276,71.82492279009536,-0.15259022801571898,0.8117620147087266,0.9643522427244455,265690216,271012253.2,52.965092809411104,67.125376265871,NaN,NaN,23.16309593102007,24.25172818258442
2020-08-24T09:30:00-04:00,62.68,62.99,62.47,62.98,3531574,4502781.55,63.12584888842325,62.2766751863452,NaN,NaN,88.26279979109374,61.81907437429521,-0.11630380654772288,0.8189724845397919,0.9352762910875148,269221790,269603734.6,49.294369496722126,65.93676780837824,NaN,NaN,23.614189110986825,24.16065117235619
2020-08-25T09:30:00-04:00,63.2,63.405,62.46,62.73,2877429,4418146.15,60.6389280301314,62.206050563613985,NaN,NaN,83.70089781830193,56.92472156385113,-0.11194449420596853,0.7953456733300541,0.9072901675360227,266344361,268096123.4,45.64773218827881,64.37836379592771,NaN,NaN,23.288984707155063,24.03612739161317
2020-08-26T09:30:00-04:00,62.67,63.5,62.51,63.39,2381422,4331639.9,64.60356041094796,62.54473229098089,NaN,NaN,96.661042363463,60.67686672568302,-0.06949577946961416,0.820420443199005,0.8899162226686191,268725783,267685736.4,44.678816826112154,62.642690068372346,NaN,NaN,24.169744069852435,24.055215488504494
2020-08-27T09:30:00-04:00,63.61,63.74,63.03,63.22,3648806,4163023.6,62.84760136607363,62.68827785310589,NaN,NaN,108.42635412103832,75.9708708426237,-0.05820886302602313,0.8171551438860902,0.8753640069121134,265076977,267011825.4,43.062381571549324,60.70573071573028,NaN,NaN,24.398854644721602,24.10430679653551
2020-08-28T09:30:00-04:00,63.53,64.03,63.24,63.97,2422859,4020633.6,67.0966791974698,62.940617727357825,NaN,NaN,139.86847281971146,103.38391338272167,-0.008200316373175864,0.8651136114456435,0.8733139278188193,267499836,267373749.4,44.22935729293388,58.63811940848948,NaN,NaN,25.890511768695195,24.359478935415467
2020-08-31T09:30:00-04:00,63.86,64.01,62.99,62.99,3052530,3896308.95,57.79525394642722,62.59012102817223,NaN,NaN,98.55037653502893,105.44142873150872,-0.04692920094333797,0.8146524266396469,0.8615816275829848,264447306,266418852.6,41.795390500932946,56.37117757964204,NaN,NaN,24.24570351555781,24.34322530400723
2020-09-01T09:30:00-04:00,62.99,64.83,62.74,64.76,9232915,3962080.5,66.75842916380344,62.75514695520939,NaN,NaN,181.64896520052696,125.03104220795372,0.03635878049157737,0.9070301031974566,0.8706713227058792,273680221,267886024.6,46.653007156834974,54.45834451822359,NaN,NaN,25.96065608782529,24.574286844552667
2020-09-02T09:30:00-04:00,65.03,66.33,64.61,66.23,11455220,4239992.2,72.06463093264396,63.30545053976044,NaN,NaN,294.9318152881991,164.68519679290094,0.17253030790462442,1.0863342075866598,0.9138038996820353,285135441,271167956.2,55.58295119470755,53.256673242579794,NaN,NaN,29.503851774439976,25.27851040596514
2020-09-03T09:30:00-04:00,66.14,66.14,63.72,64.4,14445428,4613789.55,59.361144554797434,62.922517411618124,NaN,NaN,163.77946149528606,175.7558182677505,0.12371835886314808,1.0684518482609704,0.9447334893978223,270690013,272290563.4,58.16274478517035,52.38006573921445,NaN,NaN,27.323706208586913,25.570681234911106
2020-09-04T09:30:00-04:00,64.78,65.12,63.47,64.44,13963050,5112651.55,59.52907809440164,62.44599578660153,NaN,NaN,109.06868584647921,169.59586087310407,0.08057820570565233,1.0454562465298878,0.9648780408242355,284653063,275721208.8,64.87650303827658,52.19355325124885,NaN,NaN,25.8169251535361,25.60585893757182
2020-09-08T09:30:00-04:00,63.8,63.85,62.75,63.23,8232635,5357325.95,52.46614357869605,61.65514347227306,NaN,NaN,7.245756532453388,151.33493687258894,-0.03670123136064107,0.9190015016234341,0.9557027329840752,276420428,278115833.2,68.65731415106033,52.38996371518686,NaN,NaN,21.921208066740146,25.079480241738725
2020-09-09T09:30:00-04:00,64.01,65.285,63.97,64.86,6618223,5463850.95,59.44641339257849,61.49499831925595,NaN,NaN,123.03005698385044,139.61115522925365,-0.012975938605935822,0.9394828097266554,0.9524587483325913,283038651,279987519.2,71.26127802631947,53.199118687013815,NaN,NaN,21.323066586739547,24.542849719595985
2020-09-10T09:30:00-04:00,65.18,65.42,64.13,64.25,7117328,5621488.75,56.12478702001164,61.26019835596252,NaN,NaN,97.79596534068655,100.18398523975114,-0.04503732412810191,0.8961620931724639,0.9411994173005658,275921323,278144695.6,65.49198795248535,53.73992335648534,NaN,NaN,19.642254613392446,23.842764704424052
2020-09-11T09:30:00-04:00,64.76,65.39,64.46,65.07,9722306,5686296.55,59.40824632415031,61.51905320718259,NaN,NaN,110.41818112256365,89.51172916520666,-0.019022099587589714,0.9174217928160786,0.9364438924036683,285643629,281135418.8,69.76949995746426,54.94023815277485,NaN,NaN,19.47494563188866,23.21879055120471
2020-09-14T09:30:00-04:00,65.61,66.2,65.35,66.01,5781433,5845864.3,62.84123489485301,61.49872363621329,NaN,NaN,150.5803849082641,97.81406897756362,0.049732132821615704,0.9986090584306879,0.9488769256090722,291425062,282489818.6,71.49287597845964,56.525845758613244,NaN,NaN,20.55209305463789,22.83783376598088
2020-09-15T09:30:00-04:00,66.34,66.77,66.3,66.33,4305834,5968157.95,63.95871953705016,61.7358516009932,NaN,NaN,161.74982486184848,128.71488264344265,0.10198983573944687,1.0763642202833807,0.9743743845439339,295730896,286351912.2,75.73992647824493,58.67528820789654,NaN,NaN,21.76531320876844,22.684616543521958
2020-09-16T09:30:00-04:00,66.48,67.135,66.19,66.38,9570172,6327568.25,64.14018461073269,61.70275332954925,NaN,NaN,145.20798708963645,133.15046866459986,0.12370517372741707,1.129005851703205,1.005300677975788,305301068,290804395.6,79.52682314985597,61.16443151673538,NaN,NaN,22.769191263251116,22.69669864634041
2020-09-17T09:30:00-04:00,65.68,67.01,65.33,66.87,11613298,6752998.2,65.94955068674777,61.92432113816883,NaN,NaN,120.58145223287086,137.7075660430367,0.15293661814692538,1.1964714506594447,1.0435348325125193,316914366,299003004.2,84.36610622908407,64.11469756370215,NaN,NaN,24.154285218878897,22.904925299560194
2020-09-18T09:30:00-04:00,67.08,67.08,65.65,65.72,9455263,7109202.05,58.49039926264445,61.30958685710988,NaN,NaN,96.83995922529083,134.99192166358216,0.08033710969778074,1.1439562196347453,1.0636191099369645,307459103,303366099,86.2313149379852,67.11483739549153,NaN,NaN,23.027743309855083,22.92247072960232
2020-09-21T09:30:00-04:00,64.09,64.15,62.48,63.21,8035378,7373155.15,46.20638885551579,60.48181077918763,NaN,NaN,-75.33571049236375,89.80870258345658,-0.13925740833370748,0.8895473495198303,1.0288047578535378,299423725,304965831.6,86.8507539574969,70.33307764238896,NaN,NaN,17.52300342261369,22.151118257175373
2020-09-22T09:30:00-04:00,63.26,63.49,62.81,63.33,5863672,7489760.05,46.78183894407159,59.05491147777821,NaN,NaN,-82.27355842281675,41.004025926523546,-0.27131619146396313,0.6896595185235839,0.960975709987547,305287397,306877131.8,87.5702598197579,73.25573854688345,NaN,NaN,13.516404700654922,20.917587749101024
2020-09-23T09:30:00-04:00,63.21,63.27,61.42,61.47,7441852,7717981.2,39.693939509397175,56.74271923326059,NaN,NaN,-145.77314470090647,-17.192200431585057,-0.4673271220556413,0.3768168074179954,0.8441439294736367,297845545,305386027.2,83.72138507661464,75.26562668130539,NaN,NaN,7.442453908946013,18.992568629078878
2020-09-24T09:30:00-04:00,61.44,62.54,60.93,61.91,11004886,8149154.4,41.93512682078936,55.498003680831445,NaN,NaN,-148.38649243594097,-70.98578936534743,-0.5453010430204857,0.16251762569802963,0.7078186687185153,308850431,303773240.2,79.64398158699058,76.80000073857825,NaN,NaN,3.427831960986426,16.769034819351386
2020-09-25T09:30:00-04:00,61.33,62.66,61.111,62.46,4434509,8188439.55,44.70158783013291,54.43889723338368,NaN,NaN,-122.45459034551749,-114.84469927950909,-0.5369413369252914,0.03664199756190101,0.5735833344871925,313284940,304938407.6,80.38714463225163,77.90790370957647,NaN,NaN,1.0820799596438522,14.528041267964596
2020-09-28T09:30:00-04:00,63.35,63.99,63.09,63.47,4285470,8281570.1,49.4632817511466,54.22440710284443,NaN,NaN,-44.575216986901914,-108.69260057841673,-0.44432769228139624,0.018173719135447186,0.4625014114168434,317570410,308567744.6,82.5269911398938,78.89859492306458,NaN,NaN,0.6493878186006581,12.545376489484035
2020-09-29T09:30:00-04:00,63.51,63.71,62.83,63,5666661,8412276.65,47.417096548182066,53.36517018538755,NaN,NaN,-61.62037097896981,-104.56196308964734,-0.39719770127540965,-0.03399571517741862,0.36320198609799104,311903749,309891015,83.244781905582,79.75455948586905,NaN,NaN,-0.3399810779127331,10.704611122713068
2020-09-30T09:30:00-04:00,63.28,64.16,63.14,63.64,6173637,8259312.75,50.424527558669304,52.95800879529166,NaN,NaN,-35.17957090052431,-82.4432483295709,-0.3093037144683707,-0.02342765698747229,0.2858760574808984,318077386,313937383.2,85.2413263553703,81.16522651464653,NaN,NaN,-0.233989911229346,9.141953832149866
2020-10-01T09:30:00-04:00,63.94,64.24,62.53,62.74,14577396,8415421.55,46.40510139109698,52.029212728645,NaN,NaN,-53.671529648562874,-63.50025577209529,-0.2980414293976367,-0.08667572926614753,0.2113657001314892,303499990,312867295,82.44347868044261,82.07051070914498,NaN,NaN,-1.3840398240315943,7.638240452695372
2020-10-02T09:30:00-04:00,62.03,63.79,61.8402,63.3,13926259,8389463.1,49.12264750572896,51.04931362942185,NaN,NaN,-57.989044871890556,-50.6071466773699,-0.241547712086931,-0.09056893997717452,0.15097877210975647,317426249,313695556.8,82.91102288267906,82.88609263087496,NaN,NaN,-1.5119361320421916,6.331072369161435
2020-10-05T09:30:00-04:00,63.81,64.94,63.79,64.51,9320529,8157337.05,54.4920146954291,50.37312042644892,NaN,NaN,15.156491530382018,-38.660804973913116,-0.11763328576213081,0.003937164907092949,0.12157045066922376,326746778,315530830.4,83.93210586531167,83.4712483013797,NaN,NaN,0.06941796337572287,5.436550311192047
2020-10-06T09:30:00-04:00,64.83,65.365,63.58,63.7,15678825,8529646.55,50.639268862471184,49.4087693015731,NaN,NaN,2.7456600702011884,-25.78759876407891,-0.08660023502898102,0.01332015688299748,0.0999203919119785,311067953,315363671.2,83.44306027923571,83.75097952490684,NaN,NaN,0.2043114624162464,4.68908761850979
2020-10-07T09:30:00-04:00,64.51,65.51,64.41,65.34,7138973,8555684.05,57.23245488226699,48.78611960125305,NaN,NaN,46.72142573194335,-9.407399437585376,0.04114042090181508,0.15134591803924735,0.11020549713743227,318206926,315389579.2,83.45914699593753,83.68619672253922,NaN,NaN,2.5109179267988253,4.377920519693938
2020-10-08T09:30:00-04:00,65.84,66.25,65.66,66,6291571,8514396.2,59.5727606440182,48.86343112849402,NaN,NaN,84.09853375569804,18.146613243266806,0.16016407608512107,0.3104105922438336,0.15024651615871254,324498497,319589280.6,85.85782881755487,83.6595191425085,NaN,NaN,5.151909154332899,4.4884903246423615
2020-10-09T09:30:00-04:00,66.55,66.8,66.1,66.51,4773430,8266952.4,61.33353487778744,49.94394155865628,NaN,NaN,98.91661090546235,49.52774439873739,0.25754697149439265,0.4721802305267033,0.2146332590323107,329271927,321958416.2,87.00286342591644,83.67038410453846,NaN,NaN,7.859815435281532,4.970108197590815
2020-10-12T09:30:00-04:00,66.89,66.97,66.365,66.4,4065639,8181162.7,60.719259304250855,50.93947158438338,NaN,NaN,99.49637662379189,66.39572141741937,0.29610693242214026,0.584766924559986,0.28865999213784577,325206288,321650318.2,86.02737340624108,83.5601779321444,NaN,NaN,9.852833904431414,5.667640441425186
2020-10-13T09:30:00-04:00,65.93,66.3,65.56,65.81,5170613,8224401.65,57.39869945163397,52.20409729454314,NaN,NaN,71.42458081131511,80.13150556564214,0.2644690745095935,0.6192463352748376,0.35477726076524413,320035675,323443862.6,86.94501600158216,83.7904372839278,NaN,NaN,10.57976999939273,6.369373235420549
2020-10-14T09:30:00-04:00,65.88,66.4292,65.79,66,4383499,7965068,58.19162857808205,53.365275991492624,NaN,NaN,82.50075978810374,87.28737237687423,0.23966609175692094,0.6543598754613953,0.41469378370447435,324419174,324686312.2,87.55476345976714,84.35549313198327,NaN,NaN,11.402348953523122,7.08836976657806
2020-10-15T09:30:00-04:00,65.08,65.89,65,65.81,4374792,7603142.7,57.048124886708415,54.24717149553373,NaN,NaN,62.81680192670296,83.03102601107521,0.19565032992851816,0.659256696115122,0.4636063661866039,320044382,323795489.2,84.50711917255693,84.64977702771935,NaN,NaN,11.780841500927714,7.758722871485153
2020-10-16T09:30:00-04:00,66.2,66.575,66.01,66.27,10082451,7634502.1,59.141506122142566,54.938473236319155,NaN,NaN,96.65923538044818,82.57955090607238,0.18293530416005355,0.6922754963866709,0.5093401922266173,330126833,323966470.4,84.6177929598974,84.79912001486248,NaN,NaN,12.6745162311978,8.460979065729816
2020-10-19T09:30:00-04:00,66.49,66.715,65.3,65.5,5413798,7503423.1,54.365072496215554,55.434757232607254,NaN,NaN,67.66402346721881,76.21308027475777,0.1115928429613855,0.6488312459283492,0.5372384029669637,324713035,323867819.8,84.24386586674737,84.87048315494573,NaN,NaN,12.145441753572776,8.98733087827881
2020-10-20T09:30:00-04:00,65.89,66.345,65.45,65.65,4199725,7420225.75,55.12539392941428,55.77053340194618,NaN,NaN,60.01627858976086,73.93141983044691,0.06570163879132418,0.6193654514561189,0.5536638126647947,328912760,325643236.8,85.48686757138698,84.88802181323263,NaN,NaN,11.906094478230642,9.404297106843357
2020-10-21T09:30:00-04:00,65.64,66.41,65.4,65.4,3900110,7243138.65,53.524774273654934,56.27908146498603,NaN,NaN,50.660692293764676,67.5634063315791,0.012491669356290647,0.569278399360158,0.5567867300038674,325012650,325761932,85.56883492529639,85.1112615450079,NaN,NaN,11.279113049431059,9.672127955784457
2020-10-22T09:30:00-04:00,65.37,65.84,64.72,65.76,3533288,6869558.75,55.52729562289865,56.736556330498146,NaN,NaN,30.196057486062298,61.03925744345098,-0.0036159019481967203,0.5522668525686214,0.5558827545168181,328545938,327462243.2,86.72542711663874,85.38371899029075,NaN,NaN,11.258202765938917,9.898710071520808
2020-10-23T09:30:00-04:00,66.23,66.48,65.667,66,4116541,6853660.35,56.861773438421636,56.905824812140466,NaN,NaN,60.16301114037085,53.740012595435516,-0.0032739016792466824,0.5517903774177597,0.5550642790970064,332662479,327969372.4,87.05857409372203,85.60703814946292,NaN,NaN,11.585275700756533,10.139648018554483
2020-10-26T09:30:00-04:00,65.17,65.18,63.85,64.35,7416910,7010232.35,46.525455910348526,56.61198102984599,NaN,NaN,-45.554082342249444,31.09639143354186,-0.11324747957964676,0.413504929622448,0.5267524092020948,325245569,328075879.2,87.13161777872473,85.87050654228356,NaN,NaN,8.852314890848923,9.955743286025118
2020-10-27T09:30:00-04:00,64.37,64.46,63.7,63.74,4656605,6959729.55,43.3855197359474,55.62291423368031,NaN,NaN,-85.09850423640987,2.073434868307723,-0.2199712437485049,0.25178835451646364,0.47175959826496855,320588964,326411120,79.57168601601465,85.59283075800336,NaN,NaN,5.567782595617665,9.328891758824053
2020-10-28T09:30:00-04:00,62.18,62.79,61.7,61.94,7712213,7036658.35,35.72396089301186,53.919428537179854,NaN,NaN,-189.52089733063593,-45.9628830565724,-0.3945051125423119,-0.02137179241292131,0.3731333201293906,312876751,323983940.2,70.0312314082605,84.46235951448232,NaN,NaN,-0.09609614759599226,7.982464915049761
2020-10-29T09:30:00-04:00,61.76,63.71,61.54,63.22,7543378,6684957.45,43.38093499440301,52.63709997408097,NaN,NaN,-142.09571838525713,-80.4212382308363,-0.4049341258992114,-0.13303433724462366,0.27189978865458775,320420129,322358778.4,64.4584771773358,82.8520462110123,NaN,NaN,-2.397874321825794,6.499559309781825
2020-10-30T09:30:00-04:00,62.96,63.44,62.18,63.18,7339940,6355641.5,43.20771259404275,51.38627520906611,NaN,NaN,-134.73348117813907,-119.40053669453827,-0.3952750784509657,-0.2221940594091194,0.1730810190418463,313080189,318442320.4,53.42517248471805,80.52331757376064,NaN,NaN,-4.236385093861976,4.965852966404139
2020-11-02T09:30:00-05:00,64.13,65.51,63.96,65.28,7933708,6286300.45,53.66773593925947,51.11977781532507,NaN,NaN,-12.627273589354171,-112.81517494395924,-0.23606085445901584,-0.12199504903192349,0.11406580542709235,321013897,317595986,51.37853696461458,77.98285478540582,NaN,NaN,-2.2736707723759295,3.9316352894355577
2020-11-03T09:30:00-05:00,66.06,66.6436,65.61,66.3,8892068,5946962.6,57.73916546806359,51.08745902175233,NaN,NaN,63.925746895328075,-83.01032471761165,-0.05983966237095342,0.03926622746340058,0.099105889834354,329905965,319459386.2,55.427214408884495,75.6880298531999,NaN,NaN,0.7712441712188601,3.4801508439760296
2020-11-04T09:30:00-05:00,65.99,66.41,64.57,65.17,11096276,6144827.75,52.26021303367204,50.74546531796402,NaN,NaN,10.360259108649489,-43.03409342975456,-0.01926822875406524,0.07502060389177245,0.09428883264583769,318809689,320645973.8,57.83498846220898,73.78287765960361,NaN,NaN,1.3940543637323648,3.1821370610840773
2020-11-05T09:30:00-05:00,66.67,68.3399,66.62,67.83,8852931,6272895.75,61.51740473363153,50.9151723616418,NaN,NaN,143.94873831325637,14.174797909948143,0.17606660469415913,0.3143720885135366,0.13830548381937746,327662620,322094472,60.63078490367417,72.06951994130195,NaN,NaN,5.524942153754971,3.516823502894205
2020-11-06T09:30:00-05:00,68.22,68.61,67.72,68,6075721,6338010.3,62.02422894031193,51.46225496479154,NaN,NaN,163.39666231173302,73.80082660792257,0.2988570898337932,0.511876846111619,0.21301975627782577,333738341,326226102.4,67.29253577079638,70.85871064873402,NaN,NaN,8.781191987588231,4.26887614356478
2020-11-09T09:30:00-05:00,71.26,72.41,69.43,69.53,16434412,6956448.95,66.323081365532,52.262089781657096,NaN,NaN,257.4891786099671,127.82411704778683,0.4558521697702343,0.7828349684906186,0.3269827987203843,350172753,332057873.6,73.98418003420737,70.03709011036405,NaN,NaN,13.059163191546643,5.5246314361336175
2020-11-10T09:30:00-05:00,69.82,70.51,69.73,70.35,9825278,7189182.2,68.38845560043526,53.32378130499855,NaN,NaN,200.57860829199296,155.1546893271198,0.5797065649449868,1.0516160049016179,0.47190943995663104,359998031,338076286.8,78.80377641874314,69.55387164561024,NaN,NaN,17.187888373349725,7.1908109985930615
2020-11-11T09:30:00-05:00,70.4,70.4,68.835,69.3,6417941,7290904.3,63.05570896421418,53.86152511509251,NaN,NaN,141.99664623530313,181.48196675245055,0.5556360690350077,1.1664545262503907,0.610818457215383,353580090,345030367,82.77463159212812,69.27167196528805,NaN,NaN,18.757544279898458,8.843201467350974
2020-11-12T09:30:00-05:00,68.99,69.04,67.4,67.84,5526842,7348506.8,56.46277653300775,53.83302533613438,NaN,NaN,75.36814326676827,167.76584774315293,0.41267928318449454,1.126667561196001,0.7139882780115065,348053248,349108492.6,84.59700104600734,69.09584531902271,NaN,NaN,17.802804772724826,10.123144796690095
2020-11-13T09:30:00-05:00,68.35,69.21,68.33,69.01,5538583,7121313.4,60.06617897341831,54.800219840639365,NaN,NaN,90.9560960804616,153.27773449689863,0.3696007812262503,1.1759892545443194,0.8063884733180691,353591831,353079190.6,86.13507231643953,69.02466350028807,NaN,NaN,18.24407689585399,11.283277953713508
2020-11-16T09:30:00-05:00,70.12,70.455,69.58,70.37,5482213,7124734.15,63.81518490113337,56.25948163815264,NaN,NaN,114.94915305208819,124.76972938532285,0.4026652600866756,1.3097200484264135,0.907054788339738,359074044,354859448.8,86.77280650787317,69.53902924970653,NaN,NaN,19.894327952360523,12.513427953520225
2020-11-17T09:30:00-05:00,69.93,70.27,69.22,70.11,6947182,7262107,62.605132106018736,58.17956529622456,NaN,NaN,93.31693625485059,103.31739497789438,0.37741901860807525,1.378828561599832,1.0014095429917567,352126862,353285215,83.13148880280569,70.47476192074546,NaN,NaN,20.794233830537916,13.696400221665609
2020-11-18T09:30:00-05:00,70.34,70.545,69.5,69.53,4621497,7298176.35,59.87751512600206,59.35789244848164,NaN,NaN,82.9516490346554,91.50839553776483,0.2956663302740101,1.3709924558342692,1.075326125560259,347505365,352070270,80.32977638314865,71.6084261497321,NaN,NaN,20.67848349783567,14.693840689689903
2020-11-19T09:30:00-05:00,69.35,69.93,68.8,69.82,3732751,7308149.5,60.79721278715157,60.61428531941798,NaN,NaN,66.74149124366284,89.78306513314374,0.2376295909226489,1.3723631142135702,1.1347335232909213,351238116,352707243.6,80.69708439968554,73.55641985794406,NaN,NaN,20.857003434046714,15.574292510312304
2020-11-20T09:30:00-05:00,69.8,70.08,69.45,69.76,4429274,7323786.15,60.48827828111111,61.10146691526453,NaN,NaN,67.07838662802308,85.00752324265603,0.1746221424759009,1.3530112013857973,1.1783890589098964,346808842,351350645.8,77.38287218280277,75.41387237352895,NaN,NaN,20.91460223742905,16.33719389990041
2020-11-23T09:30:00-05:00,70.31,70.77,70.015,70.34,4479586,7176919.95,62.473383732964976,61.439625362757475,NaN,NaN,77.66207124750669,77.55010688173974,0.15224741008743492,1.3686983215191901,1.2164509114317552,351288428,349793522.6,73.64419850503776,76.71508552325417,NaN,NaN,21.517067679577494,17.07717586842571
2020-11-24T09:30:00-05:00,70.99,72.3,70.91,72.09,6135765,7250877.95,67.73984418090757,62.54531330184574,NaN,NaN,109.06938010198712,80.70059565116705,0.2308330614046623,1.504992238187583,1.2741591767829208,357424193,350852988.8,74.54533166632172,77.9086814664051,NaN,NaN,23.669636748897197,18.01895599420735
2020-11-25T09:30:00-05:00,71.96,71.99,71.21,71.34,3945279,7062531.25,63.619107257071256,62.69543491066286,NaN,NaN,98.60595691168314,83.8314572265726,0.20850886081844555,1.5347952528059778,1.3262863919875323,353478914,352047698.6,75.56011181312982,78.97506195993763,NaN,NaN,24.25305170109161,18.909541095190814
2020-11-27T09:30:00-05:00,71.66,71.975,71.37,71.71,2297333,6800229,64.7580852585798,62.89071036196771,NaN,NaN,101.95400689716212,90.87396035727245,0.19510714109655214,1.5701703183582225,1.3750631772616704,355776247,352955324.8,76.33207051521937,79.6207430131107,NaN,NaN,25.06555139483676,19.78897113799738
2020-11-30T09:30:00-05:00,71.61,71.67,70.615,70.99,4956840,6681074,60.7710146448071,62.494134167630214,NaN,NaN,79.12908870762193,93.28410077319222,0.1179944576144143,1.5225562492796882,1.404561791665274,350819407,353757437.8,77.02279564069369,79.8377869850026,NaN,NaN,24.60242269670319,20.476607074955353
2020-12-01T09:30:00-05:00,72.2,72.33,71.435,71.77,5237135,6546245.35,63.399997946005946,62.13781576374242,NaN,NaN,111.5771791325778,100.06712235020643,0.10044891311439352,1.5301229330582657,1.4296740199438722,356056542,354711060.6,77.85042546045739,79.76969048798217,NaN,NaN,24.966168935578732,21.11797305504441
2020-12-02T09:30:00-05:00,71.55,71.799,70.72,70.85,5389788,6371131.35,58.42643047020599,61.8071530141704,NaN,NaN,72.23127381894646,92.6995010935983,0.01243969187471694,1.4452236347872685,1.4327839429125515,350666754,353359572.8,73.79367521917376,79.12819360419972,NaN,NaN,23.807826306142733,21.50223780520131
2020-12-03T09:30:00-05:00,71.05,71.285,70.2,70.36,5735116,6103073.35,55.91068599596377,61.767717975810115,NaN,NaN,35.42758485443079,80.06382668214783,-0.08770796516388457,1.3231489864576957,1.4108569516215803,344931638,351650117.6,68.90282265476444,78.0071808619681,NaN,NaN,22.10241580792049,21.58797751987548
2020-12-04T09:30:00-05:00,70.66,71.7881,70.64,71.78,5769338,5948893.7,61.13355294858095,61.84395897403601,NaN,NaN,82.63908852664831,76.20084300804508,-0.06812221084668257,1.3257041880632272,1.3938263989099098,350700976,350635063.4,66.10131556472261,76.57619823684546,NaN,NaN,22.14937383831646,21.668176993938477
2020-12-07T09:30:00-05:00,71.73,71.9425,71.06,71.31,4004367,5845326,58.65676992681811,61.47550076158492,NaN,NaN,78.10358261644213,75.99574178980912,-0.09497671183570544,1.2751055091152779,1.3700822209509833,346696609,349810503.8,63.830910963974596,74.93749141228126,NaN,NaN,21.449986308494857,21.63700689601796
2020-12-08T09:30:00-05:00,70.92,71.88,70.89,71.71,3523309,5199770.85,60.13698652030418,61.299204648319595,NaN,NaN,73.8560378587657,68.4515135350467,-0.09379346917716558,1.2528403844795264,1.346633853656692,350219918,348643179,60.65468181340823,73.33200519875288,NaN,NaN,21.29503644659585,21.588153974671947
2020-12-09T09:30:00-05:00,71.99,72.13,71.07,71.75,6759093,5046461.6,60.29009680915398,61.32867476854473,NaN,NaN,77.16714934886777,69.43868864103095,-0.09785932420269972,1.2243096984033173,1.322169022606017,356979011,349905630.4,62.8100150531677,72.08059367518281,NaN,NaN,21.21038143435964,21.534186468913045
2020-12-10T09:30:00-05:00,71.37,71.92,71.07,71.31,3578276,4904478.35,57.666279744380105,61.10503669406105,NaN,NaN,56.06571971876752,73.5663156138983,-0.13541151056347034,1.1529046344016791,1.2883161449651495,353400735,351599449.8,65.53774967135521,70.99778405173065,NaN,NaN,20.421101763646494,21.375174368160682
2020-12-11T09:30:00-05:00,70.83,71.23,70.37,70.9,3425906,4799431.55,55.25325751855303,60.73110663959262,NaN,NaN,1.824882211346096,57.40347435083786,-0.18976057286799786,1.051115428880152,1.24087600174815,349974829,351454220.4,65.09688182798237,70.12021331210062,NaN,NaN,19.08829873596222,21.048477849275187
2020-12-14T09:30:00-05:00,71.52,71.63,69.97,70,5113215,4778163.15,50.279613955120375,59.86012308403229,NaN,NaN,-36.8616203087137,34.41043376580668,-0.28262667649141937,0.8875926561338758,1.1702193326252952,344861614,351087221.4,63.926591891919024,69.42609855402071,NaN,NaN,16.489349295982382,20.39717377023336
2020-12-15T09:30:00-05:00,70.67,71.45,70.49,71.27,4010819,4704593.45,56.26257138102593,59.04031788404074,NaN,NaN,13.612141245632714,22.361654443180083,-0.2556378269589583,0.8506720489265973,1.1063098758855556,348872433,350817724.4,63.030489367671386,68.60360981840283,NaN,NaN,15.88244722354551,19.752212834992235
2020-12-16T09:30:00-05:00,71.43,71.53,70.77,71.07,4069656,4560717.15,55.13734925861871,58.43447802700841,NaN,NaN,14.033688539560792,9.734962281318683,-0.24817033034827185,0.7960969629502159,1.0442672932984878,344802777,348382477.6,55.46451143007702,67.16820979104192,NaN,NaN,15.061363200475814,19.082091458632746
2020-12-17T09:30:00-05:00,71.74,71.948,71.47,71.89,3795734,4519429,58.77751681553906,58.00729456679121,NaN,NaN,88.65261418197898,16.252341173960968,-0.1876702505927017,0.8096794800576106,0.9973497306503123,348598511,347422032.8,52.7739193931057,65.48548471089094,NaN,NaN,15.402371870010148,18.55641723168666
2020-12-18T09:30:00-05:00,71.96,72.39,71.35,72.21,5453349,4605458.9,60.13685892310321,57.96199772952665,NaN,NaN,112.28014559726446,38.34339385114464,-0.1285829827321654,0.8366210022351055,0.9652039849672709,354051860,348237439,54.77956271400788,63.89668235898481,NaN,NaN,16.07537234880755,18.201982248418215
2020-12-21T09:30:00-05:00,70.58,71.65,70,71.47,5049261,4636458.25,55.57307112331332,57.40293152790574,NaN,NaN,-43.741503703037715,36.96741717227984,-0.14083234723445615,0.7891635509242008,0.9299958981586569,349002599,349065636,56.786949450406816,62.392148358266915,NaN,NaN,15.348782977633515,17.79438235259183
2020-12-22T09:30:00-05:00,71.46,71.55,70.93,71.03,3327111,4578834.5,52.99765733915924,57.01516201854526,NaN,NaN,-31.53054869025031,27.93887918510323,-0.17768571440112046,0.7078887551572564,0.8855744695583768,345675488,348426247,54.76569456178078,61.03300688273884,NaN,NaN,13.996408127167253,17.251814606102602
2020-12-23T09:30:00-05:00,71.42,71.875,71.09,71.13,4109556,4477524.05,53.52480927489728,56.84474225275479,NaN,NaN,11.765071705315066,27.485155818254082,-0.19316195922810853,0.6441220205232412,0.8372839797513497,349785044,349422700.4,57.315567678313315,60.205345812992334,NaN,NaN,13.020763051757067,16.647378669767527
2020-12-24T09:30:00-05:00,71.19,71.585,70.91,71.58,1366264,4348573.3,55.92060153578337,56.47238858041211,NaN,NaN,12.261084950996738,12.206849972057636,-0.1716517100752427,0.6227193421572963,0.794371052232539,351151308,349933259.8,58.603198596668,59.66976602955986,NaN,NaN,12.829200194196158,16.10192460182876
2020-12-28T09:30:00-05:00,72.25,72.34,71.27,71.3,2661307,4366772,54.05344156368617,56.14357941161696,NaN,NaN,72.9441973688613,4.339660326377013,-0.17428231146591666,0.5765181629001432,0.7508004743660599,348490001,348820888,54.729450703326776,59.01966172522788,NaN,NaN,12.164074273873148,15.539374554977957
2020-12-29T09:30:00-05:00,71.68,71.84,70.77,71.13,3426494,4290254.7,52.89858168069044,55.62655049450171,NaN,NaN,-13.272041332876537,10.433552800409245,-0.1844888621580827,0.5201893966684565,0.7046782588265392,345063507,348033069.6,52.1026295367588,58.40880084832434,NaN,NaN,11.295926608545603,14.933167705487621
2020-12-30T09:30:00-05:00,71.37,72.26,71.33,72.11,2827534,4169774.65,58.414408986607924,55.49257279289127,NaN,NaN,130.06306227964797,42.752274994388905,-0.12509802602364106,0.5483057262969879,0.673403752320629,347891041,348476180.2,53.455779354269076,57.74064115554587,NaN,NaN,12.035433475845887,14.51920567268166
2020-12-31T09:30:00-05:00,72.21,72.51,71.62,72.39,3250491,4062809.8,59.86072385549335,55.64931880082793,NaN,NaN,165.69116014843925,73.53749268301374,-0.06958550288692722,0.58642187371197,0.6560073765988972,351141532,348747477.8,54.30692348323048,56.93843928496553,NaN,NaN,13.064044760658138,14.311325542392584
2021-01-04T09:30:00-05:00,73.03,73.395,71.29,71.7,9133224,4232715.2,54.8025208884352,55.61712332724809,NaN,NaN,142.37554966681083,99.56038562617655,-0.08115842386105532,0.554559346772578,0.6357177706336333,342008308,346918877.8,47.94306404711905,55.71316658633244,NaN,NaN,12.55189669926926,14.059978564803538
2021-01-05T09:30:00-05:00,71.58,73.51,71.58,73.31,13405985,4614547.55,62.71856757573506,56.505620014434854,NaN,NaN,216.38016648813723,128.24757945003176,0.012793073343231987,0.6517091123126733,0.6389160389694413,355414293,348303736.2,52.48429789741045,54.89585987243897,NaN,NaN,14.576803274108846,14.133810666132868
2021-01-06T09:30:00-05:00,74.1,76.85,74.02,76.31,24260197,5627339.05,72.41392970264437,57.65928846597905,NaN,NaN,415.30153808664335,213.9622953339357,0.2566375334877533,0.9597129558291329,0.7030754223413795,379674490,355225932.8,67.66736728078254,55.22706543766119,NaN,NaN,20.34520052349904,15.021152074328036
2021-01-07T09:30:00-05:00,76.77,77.39,76.6,76.88,9288879,5915617.55,73.80767611102938,58.99288324115124,NaN,NaN,337.1721581851864,255.3841145150434,0.425987417431138,1.235559694130302,0.809572276699164,388963369,363440398.4,77.04234156076699,56.768339018424754,NaN,NaN,25.305881236595013,16.490399097509034
2021-01-08T09:30:00-05:00,77.02,77.09,75.56,76.51,8494181,6002371.95,71.28980832489091,59.88661834896209,NaN,NaN,214.0105178035239,265.0479860460604,0.47880842797636114,1.4080828116696154,0.9292743836932542,380469188,369305929.6,81.22790931814082,58.800766870212975,NaN,NaN,28.305797489148297,18.1783131534575
2021-01-11T09:30:00-05:00,75.38,76.82,75.1,76.51,6120136,6129464.95,71.28980832489091,60.683257591946926,NaN,NaN,156.32489399891406,267.837854912481,0.47834366791187244,1.5272039685830947,1.0488603006712223,380469188,376998105.6,85.07172785602734,60.9644929517858,NaN,NaN,30.623720379449644,19.956228471456377
2021-01-12T09:30:00-05:00,76.44,77.77,76.19,77.48,8922223,6404280.8,73.98784078574965,61.99859828212095,NaN,NaN,157.57115096323537,256.0760518075006,0.5053176745616954,1.6805073938733415,1.175189719311646,389391411,383793529.2,87.50569326635863,63.15868893863949,NaN,NaN,33.48211147471344,21.88849747192167
2021-01-13T09:30:00-05:00,77.4,77.58,76.37,76.69,4904559,6393848,68.35387435793334,63.0954709263191,NaN,NaN,122.09371498958753,197.43448718808943,0.4346049370951166,1.7184458906805418,1.2838409535854252,384486852,384756001.6,87.80887639253999,65.51891621226515,NaN,NaN,34.08343531339493,23.630631449274993
2021-01-14T09:30:00-05:00,76.94,77.01,76.34,76.43,5537121,6470163.1,66.5575604326242,64.0263817232996,NaN,NaN,96.61098009713955,149.32225157048006,0.339203728728535,1.7078456144960938,1.3686418857675589,378949731,382753274,83.28038180949983,67.3735457930642,NaN,NaN,34.01776642077704,25.114507873775285
2021-01-15T09:30:00-05:00,75.72,75.86,74.55,75.34,9854491,6759404.85,59.498266768856695,64.2819292399477,NaN,NaN,49.57372454339749,116.43489291845478,0.1795875792022914,1.593126359770423,1.4135387805681316,369095240,380478484.4,78.33847469482673,68.7832083715041,NaN,NaN,31.71976742887051,26.05811638164603
2021-01-19T09:30:00-05:00,75.95,76.15,75.28,75.6,4956245,6817430.4,60.572490475210074,64.74757559077084,NaN,NaN,55.61841708564276,96.29359753580052,0.07383462065267876,1.50583205638398,1.4319974357313012,374051485,379194943.8,75.61203523513679,70.27482155234767,NaN,NaN,30.178352660625556,26.646721564357392
2021-01-20T09:30:00-05:00,75.97,76.08,75.53,75.85,5163336,6802929.75,61.62640397335189,65.37099146881808,NaN,NaN,53.904893712594166,75.56034608567228,0.006579350865606681,1.4402216243133097,1.433642273447703,379214821,377159625.8,71.37028101624426,71.65108237231092,NaN,NaN,29.21481543380714,27.01359211713593
2021-01-21T09:30:00-05:00,75.76,75.91,74.71,74.74,6323718,6866652.6,54.64242048469351,65.10156371868133,NaN,NaN,28.949586206809883,56.93152032911676,-0.11982769951649774,1.2838576490520808,1.4036853485685785,372891103,374840476,66.77363754910276,72.60235795765618,NaN,NaN,26.206605564062453,26.898308323839718
2021-01-22T09:30:00-05:00,73.9,74.675,73.78,74.38,6066145,7003604.3,52.561901648508346,64.58021927532528,NaN,NaN,-1.693451985654581,37.27063391255792,-0.22854711412725726,1.118001455909507,1.3465485700367643,366824958,372415521.4,62.25839749683898,73.17032038719965,NaN,NaN,23.094135925995776,26.354855124147726
2021-01-25T09:30:00-05:00,74.08,74.29,72.69,73.99,12074943,7401873.65,50.326353753417,64.2604930513954,NaN,NaN,-27.891569199698537,21.77757516393874,-0.32187463474989886,0.9442052765993907,1.2660799113492895,354750015,369546476.4,57.31984947050644,73.84009077458447,NaN,NaN,19.828868462573745,25.422571315351444
2021-01-26T09:30:00-05:00,74.45,74.73,72.95,72.97,6777550,7672437.95,44.9425317673715,62.99077620794086,NaN,NaN,-37.98654288390944,3.056583170028297,-0.4401339423678414,0.7159124833894879,1.1560464257573293,347972465,364330672.4,49.61471179777495,73.6351203388962,NaN,NaN,15.267690651985102,23.97187407772768
2021-01-27T09:30:00-05:00,71.85,71.85,70.01,70.82,12389723,8158858.75,36.16118949610511,60.40129476461663,NaN,NaN,-134.03377665969677,-34.5311509044299,-0.6389314685752577,0.35738209003825716,0.9963135586135149,335582742,355604256.6,39.940991498795455,71.65466492589714,NaN,NaN,7.862023645416823,21.67046687311184
2021-01-28T09:30:00-05:00,71.53,72.485,71.34,72.04,7241726,8349620.35,42.97058194811434,58.19864518155127,NaN,NaN,-98.19018854368767,-59.9591058545294,-0.6612657139638881,0.16973141615865472,0.8309971301225428,342824468,349590929.6,34.892326210236945,68.64394954371642,NaN,NaN,3.9684963139171927,19.141613936084035
2021-01-29T09:30:00-05:00,71.74,72.11,70.275,70.64,8989311,8657709.2,37.965964309760345,55.81837060904194,NaN,NaN,-128.71994383486282,-85.36440422437106,-0.7375205164281531,-0.09090351541264852,0.6466170010155046,333835157,342992969.4,30.358021011937083,65.0103860932733,NaN,NaN,-1.1056639330496698,16.249145669064934
2021-02-01T09:30:00-05:00,71.37,71.6,70.32,71.47,8005954,8895482.35,42.25949880278351,53.74477707174856,NaN,NaN,-118.57002763662116,-103.50009591175558,-0.6995799279469719,-0.22785790891821023,0.4717220190287616,341841111,340411188.6,28.78188250633248,60.98968285400938,NaN,NaN,-3.705344815178329,13.398504171315896
2021-02-02T09:30:00-05:00,72,72.77,71.6,72.41,7894790,8833560.65,46.75423718473143,51.79951967167583,NaN,NaN,-78.81410414177292,-111.66560816332829,-0.5834383619093964,-0.2575759333579839,0.32586242855141245,349735901,340763875.8,29.32171859896748,56.833684663481435,NaN,NaN,-4.29488458366774,10.870877206318234
2021-02-03T09:30:00-05:00,72.61,72.98,72.28,72.55,6423166,8484419.7,47.410843327108054,50.30358888375974,NaN,NaN,-65.78902488035692,-98.0166578074603,-0.4740946279605698,-0.2667558563992998,0.20733877156127,356159067,344879140.8,35.468347658463514,53.09507546819026,NaN,NaN,-4.543503982756347,8.668822750736151
2021-02-04T09:30:00-05:00,72.34,72.68,71.67,72.29,6497108,7596265.25,46.269683659546,48.854454828539865,NaN,NaN,-71.56828304644152,-92.69227670801108,-0.39919013065510994,-0.29164889175761743,0.10754123889749251,349661959,346246639,37.41607195648457,49.81905333583203,NaN,NaN,-5.088334781565746,6.70351453183588
2021-02-05T09:30:00-05:00,72.99,73.63,72.84,73.53,6287961,7446219.35,52.18121857041497,48.331808528651166,NaN,NaN,-27.675070028009184,-72.48330194664035,-0.2531617664192561,-0.20891096912657758,0.04425079729267849,355949920,350669591.6,43.36960158064585,47.321276684819104,NaN,NaN,-3.6939096870315,5.218168214854826
2021-02-08T09:30:00-05:00,74.16,74.4,73.95,74.14,6317808,7337400.7,54.814932666543555,47.9205543994607,NaN,NaN,6.94679496478442,-47.379937426359234,-0.10983750977348061,-0.09304608992417229,0.016791419849308327,362267728,354754915,48.26507157989631,45.36792213801622,NaN,NaN,-1.713872761804735,4.227876646760603
2021-02-09T09:30:00-05:00,74.18,74.24,73.41,73.59,7256984,7394243.1,52.03227077191327,47.23525917078651,NaN,NaN,-4.839117402764439,-32.58494007855754,-0.04949957786926378,-0.0450830524872714,0.00441652538199238,355010744,355809883.6,49.47960450684601,43.80430238734492,NaN,NaN,-0.9035153115647552,3.494820652714123
2021-02-10T09:30:00-05:00,74.07,74.145,73.04,73.51,5458900,7221076.95,51.621777079830295,47.019498927582,NaN,NaN,-5.561421217708806,-20.53941934602792,-0.01423175914988612,-0.01337317355536527,0.0008585855945208495,349551844,354488439,47.960786126340004,42.46052728571901,NaN,NaN,-0.36585959970414356,2.9432949023686565
2021-02-11T09:30:00-05:00,73.73,74,72.95,73.58,6673023,7309500.15,51.978770098754396,46.97784667402815,NaN,NaN,-0.33140594611798496,-6.292043925963214,0.013078887609998842,0.017207195107019402,0.00412830749702056,356224867,355801020.6,49.6151890642308,41.55744096910414,NaN,NaN,0.17441527064709608,2.5477406692655764
2021-02-12T09:30:00-05:00,73.42,74.38,73.32,74.34,3287893,7197038.75,55.79295330849614,47.36831807081951,NaN,NaN,35.66341935851738,6.375653951342115,0.07797484251358841,0.10159686063900608,0.023622018125417664,359512760,356513588.6,50.534573214422025,41.07277837938382,NaN,NaN,1.7303684824479175,2.430973214005911
2021-02-16T09:30:00-05:00,74.62,74.87,74.09,74.2,6191864,7013907.4,54.92747334133726,48.081528183245645,NaN,NaN,61.19753448782219,17.225801855949666,0.10541296934702976,0.15538822980920486,0.049975260462175104,353320896,354724222.2,48.15814460616612,40.968737865697484,NaN,NaN,2.7946370820452393,2.4829251951543867
2021-02-17T09:30:00-05:00,73.99,74.3,73.2,74.16,5910590,7061624.65,54.66654818023523,49.403339517826375,NaN,NaN,39.30592698551228,26.054810733605006,0.11407641217863412,0.19257077568546777,0.07849436350683364,347410306,353204134.6,46.17174561714318,41.413791731293756,NaN,NaN,3.6162053209072536,2.644822355976225
2021-02-18T09:30:00-05:00,73.97,74.05,73.36,73.7,6058772,7106396.45,51.62913607151416,50.02180766949779,NaN,NaN,37.0463162466003,34.57635822646683,0.08345467279300531,0.18281270449809028,0.09935803170508498,341351534,351564072.6,44.060111527880416,42.06863353969686,NaN,NaN,3.5479064200800132,2.773834365133909
2021-02-19T09:30:00-05:00,74.12,75.38,74.1,75.05,5679711,7074196.1,58.85457508640436,51.51385129640092,NaN,NaN,115.25271265531103,57.69318194675263,0.14513474588222433,0.2807764640578654,0.13564171817564105,347031245,349725348.2,41.75449708618144,42.882667545000025,NaN,NaN,5.577431867622349,3.1743482940608287
2021-02-22T09:30:00-05:00,74.96,75.645,74.71,75.34,6099377,7075857.7,60.22892291663816,52.79738159024769,NaN,NaN,133.72055080597985,77.30460823624512,0.19345692040424772,0.3774628686809507,0.18400594827670297,353130622,348448920.6,40.18253295676575,43.69699972003097,NaN,NaN,7.671663588852427,3.8168219076024856
2021-02-23T09:30:00-05:00,75.3,75.8,73.96,75.6,11011173,7022669.2,61.471483104768105,53.84861344167888,NaN,NaN,115.84971128201295,88.23504359508328,0.22851803728437078,0.46965349488216646,0.24113545759779567,364141795,350613100.4,44.030013338741774,44.74759220144342,NaN,NaN,9.784787988901776,4.669388490645241
2021-02-24T09:30:00-05:00,75.64,76.58,75.36,76.26,7381948,7052889.1,64.50323802599534,55.06949877731366,NaN,NaN,153.56019445238974,111.08589708845878,0.27843564515697805,0.5891800140440182,0.31074436888704016,371523743,355435787.8,51.51418218928159,45.893723239359,NaN,NaN,12.518219382491043,5.790650046623213
2021-02-25T09:30:00-05:00,76.11,76.24,74.2,74.5,10187970,6942801.45,52.61372056545986,55.522644270593226,NaN,NaN,86.8887711534301,121.05438806982474,0.17997489268017508,0.535712984737259,0.35573809205708395,361335773,359432635.6,56.683730542868844,47.26998456695787,NaN,NaN,11.387284903930132,6.5901693119527724
2021-02-26T09:30:00-05:00,74.31,74.54,73.07,73.55,8140116,6987720.95,47.52191018077979,55.18983652847643,NaN,NaN,3.121588427952287,98.62816322435299,0.04495704235313014,0.4119343949984966,0.36697735264536646,353195657,360665518,58.16543589766385,48.3268298753163,NaN,NaN,8.753457361531023,6.8992104618925225
2021-03-01T09:30:00-05:00,74.52,75.81,74.52,75.41,7508109,6913660.85,56.41553747670795,55.30416544348817,NaN,NaN,99.9265515975072,91.86936338265846,0.07332893927702822,0.45863852674165173,0.3853095874646235,360703766,362180146.8,59.976744525469684,49.16337794285726,NaN,NaN,9.48193465449283,7.2681710608354235
2021-03-02T09:30:00-05:00,75.63,76.52,75.58,75.83,7563867,6891556.5,58.140638512908005,55.740477424987795,NaN,NaN,139.08800712436215,96.51702255112829,0.11055849529033884,0.5235077065775471,0.41294921128720824,368267633,363005314.4,60.968251680162226,49.983995598094126,NaN,NaN,10.636251354923369,7.749325388562273
2021-03-03T09:30:00-05:00,75.55,76.09,75.07,75.08,8670449,6930339.45,54.02819490604703,55.91236441257471,NaN,NaN,86.47729379647846,83.10044241994605,0.07646957373325819,0.508536178453781,0.4320666047205228,359597184,360620002.6,56.60298809543602,50.601295738743836,NaN,NaN,10.224485378639029,8.102919672858953
2021-03-04T09:30:00-05:00,74.96,75.26,72.34,73.62,18517353,7535048.8,47.05121773015452,55.56039638624615,NaN,NaN,-49.156272927360384,55.89143360378794,-0.04601822123641275,0.37454382817500687,0.4205620494114196,341079831,356568814.2,50.04875374184913,50.63226464428801,NaN,NaN,7.4506601943240405,8.009739747353965
2021-03-05T09:30:00-05:00,74.38,75.56,72.82,75.31,11756825,7798034.65,54.39293274742511,55.46039491759821,NaN,NaN,9.394818384614517,57.14607959512038,-0.016361179016158467,0.40011057564122154,0.41647175465738,352836656,356497014,49.93838527743934,50.58967979164639,NaN,NaN,7.6879936705893765,7.963776022101881
2021-03-08T09:30:00-05:00,75.56,77.46,75.425,76.32,14836504,8225461.8,58.129470318571485,55.68910898740065,NaN,NaN,153.69074868092292,67.89891901180354,0.06374390750078168,0.49615163903335713,0.43240773153257545,367673160,357890892.8,52.14469201036149,50.87443317766035,NaN,NaN,9.206191839100354,8.141263995958806
2021-03-09T09:30:00-05:00,76.83,77.41,76.27,76.79,7866406,8302891.7,59.78079275272912,56.05441217115022,NaN,NaN,160.3255798989865,72.1464335667284,0.13666278611847454,0.6032362141806686,0.4665734280621941,375539566,359345279.4,54.40277046919127,51.462363524235215,NaN,NaN,10.956168940529619,8.543393273754637
2021-03-10T09:30:00-05:00,77.17,78.67,77.12,78.06,7168259,8298455.45,63.92139667603719,56.932430785759,NaN,NaN,206.9969165153797,96.25035811050864,0.2519976096555495,0.781570440131631,0.5295728304760815,382707825,363967407.6,60.742595859803934,52.65396954794404,NaN,NaN,13.853914698931803,9.302039191637089
2021-03-11T09:30:00-05:00,78.78,79.11,78.43,78.48,4762522,8263636.55,65.19745759308324,57.385493821950355,NaN,NaN,212.2396831480843,148.5295493255976,0.33305251593182217,0.9458884753908592,0.612835959459037,387470347,373245510.8,69.81515304707457,54.65830211657926,NaN,NaN,16.570461586155798,10.340385247996904
2021-03-12T09:30:00-05:00,78.47,78.74,78.26,78.69,4813909,8170680.85,65.84787787177481,57.78684774731725,NaN,NaN,169.31491627159974,180.51356890299465,0.37421159860237774,1.0806004577120092,0.7063888591096315,392284256,381135030.8,75.08747526567763,57.151512281501546,NaN,NaN,18.934940126252144,11.568178802033367
2021-03-15T09:30:00-04:00,78.69,78.83,77.8319,78.78,4646457,8238609.05,66.13994231875664,58.12030911974501,NaN,NaN,138.6272758431786,177.50087433544576,0.3796961012351108,1.18100898565352,0.8013128844184092,396930713,386986541.4,78.13757103312446,59.58776640252888,NaN,NaN,20.9231315692954,12.904600625927943
2021-03-16T09:30:00-04:00,78.71,78.79,77.69,78.13,6577190,8257875.35,62.01504098978104,57.94258076001542,NaN,NaN,108.91718061099782,167.21919447784802,0.31444248609646963,1.1943659920389962,0.8799235059425266,390353523,389949332.8,79.50575772361424,61.587164654981216,NaN,NaN,21.430057075211643,14.122522975825614
2021-03-17T09:30:00-04:00,78.06,79.015,77.87,78.83,5545621,8239626.9,64.57717759361353,58.79711340488354,NaN,NaN,111.03529730981128,148.02687063673437,0.29370945961870965,1.2470603304659136,0.9533508708472039,395899144,392587596.6,80.66605495569443,63.3001878273259,NaN,NaN,22.61236568286967,15.335357648260478
2021-03-18T09:30:00-04:00,78.64,79.54,78.24,78.39,6586787,8266027.65,61.757374620357275,59.813932293424784,NaN,NaN,104.07496557354348,126.39392712182618,0.22854637509220677,1.2390338397124623,1.0104874646202555,389312357,392955998.6,80.82927160154324,64.91903323474585,NaN,NaN,22.799281489193124,16.401632482679428
2021-03-19T09:30:00-04:00,78.24,78.53,77.08,78,8918446,8427964.4,59.28627375255775,60.018984884556914,NaN,NaN,59.32799876383198,104.39654362027264,0.14162132727365062,1.1875141237123188,1.0458927964386682,380393911,390577929.6,76.34870634053111,66.08845907867882,NaN,NaN,22.259029528710073,17.238403489255234
2021-03-22T09:30:00-04:00,77.55,78.04,77.09,77.72,6438349,8444913,57.50716810936667,59.97373699858968,NaN,NaN,43.264173808721665,85.32392321338122,0.05231021647444711,1.1112805670317272,1.05897035055728,373955562,385982899.4,68.45276783648221,66.62306737555882,NaN,NaN,21.312462840900547,17.820411968061705
2021-03-23T09:30:00-04:00,77.37,77.43,75.83,76.1,10235125,8406110.6,48.44840798900808,59.57518079022975,NaN,NaN,-11.460743500734651,61.248338391034736,-0.11944949144788564,0.9096584862474231,1.0291079776953087,363720437,380656282.2,60.62557959566453,66.91039533986086,NaN,NaN,17.64531564857962,17.795398208135694
2021-03-24T09:30:00-04:00,76.44,77.715,76.44,76.65,6735553,8373790.85,51.25579403153254,59.87550766889961,NaN,NaN,8.899108349702185,40.82110059901293,-0.19512587500599154,0.7852006339378192,0.9803265089438108,370455990,375567651.4,54.244362586475894,67.21008168590562,NaN,NaN,15.395104417909625,17.452499095246257
2021-03-25T09:30:00-04:00,76.34,77.9,75.9,77.76,7696726,8249228.65,56.41456675296834,60.019910097866976,NaN,NaN,16.516822348350548,23.30947195397435,-0.17042938814358266,0.7672897737643325,0.9377191619079152,378152716,373335723.2,51.67518789304122,67.33413901559148,NaN,NaN,15.000240921357106,17.102176498976377
2021-03-26T09:30:00-04:00,78.49,79.75,78.23,79.69,7609590,8222702.35,63.62339353019144,60.412333184411274,NaN,NaN,110.50914234832796,33.545700670873536,-0.031396833917183065,0.8984731195114364,0.9298699534286194,385762306,374409402.2,52.83252681584658,67.38327007312613,NaN,NaN,17.078794794916078,17.09883625553919
2021-03-29T09:30:00-04:00,79.4,80.17,78.97,79.42,6490032,8171798.5,62.07656547043918,60.57631694996199,NaN,NaN,115.047362595462,47.902338428221604,0.031683735378864375,0.9694746226522,0.9377908872733356,379272274,375472744.6,54.007322742056104,67.35502380690218,NaN,NaN,18.224522769092218,17.259648614618193
2021-03-30T09:30:00-04:00,79.39,79.61,78.98,79.19,6570587,8122134.5,60.72224395031442,60.34780604098179,NaN,NaN,93.01835845675791,68.79815881972011,0.0463327771876505,0.9957068587578988,0.9493740815702483,372701687,377268994.6,56.000938979159976,67.01633402971333,NaN,NaN,18.732739902971133,17.470090227240043
2021-03-31T09:30:00-04:00,79.34,79.58,78.6,78.8,7087395,8042981.8,58.39577644701632,59.861971673405584,NaN,NaN,73.88887191228967,81.79611153223762,0.019541520881835917,0.9738009826725431,0.9542594617907072,365614292,376300655,54.62626419345521,65.93141339731194,NaN,NaN,18.46461382855928,17.612165027428507
2021-04-01T09:30:00-04:00,78.93,79.545,78.45,79.49,7163125,7475270.4,61.22623208091978,59.53185411691594,NaN,NaN,81.59906727256366,94.81256051708024,0.03705926831990369,1.0005835471905868,0.9635242788706831,372777417,375225595.2,53.068746110391636,64.35864702907723,NaN,NaN,19.073265491884385,17.82089366520792
2021-04-05T09:30:00-04:00,80.31,80.76,79.92,80.47,8730480,7323953.15,64.88071749999852,59.44190948700464,NaN,NaN,161.5053144451855,105.01179493645175,0.09985338856748416,1.0883410145800383,0.9884876260125541,381507897,374374713.4,51.80963678711456,62.478080297219385,NaN,NaN,20.721540369878856,18.235271765875197
2021-04-06T09:30:00-04:00,80.33,80.935,80.26,80.65,6275976,6895926.75,65.52346871216496,59.692511467174924,NaN,NaN,166.16448983872928,115.23522038510521,0.1364523734723,1.159053092852929,1.022600719380629,387783873,376077033.2,54.15326966170325,60.66718829279717,NaN,NaN,22.251801573768876,18.80906173843144
2021-04-07T09:30:00-04:00,80.52,80.655,79.09,79.26,8787902,6942001.55,56.867972112092396,59.141853932780556,NaN,NaN,86.69116515602258,113.96978172495815,0.05420944100833758,1.090362520641051,1.0361530796327134,378995971,377335890,55.86271364166228,58.89552105608059,NaN,NaN,20.960882527207445,19.116464708256583
2021-04-08T09:30:00-04:00,79.44,79.515,78.7,79.36,5414335,6854305.35,57.30493312660566,58.82382239751258,NaN,NaN,43.36303715299152,107.86461477309851,-0.0032452276852510398,1.0320965450261497,1.0353417727114007,384410306,381095092.8,60.588495078529924,57.44975130443678,NaN,NaN,20.050919481628966,19.24995824730978
2021-04-09T09:30:00-04:00,79.55,80.07,79.305,80.05,5308922,6881625.35,60.29398140377211,58.89580151545647,NaN,NaN,84.13332634083814,108.3714665867534,-0.004491406021028377,1.0297275151851153,1.0342189212061437,389719228,384483455,64.29895456053538,56.589054748722766,NaN,NaN,20.147613066433752,19.378194650041777
2021-04-12T09:30:00-04:00,80,80.42,79.98,80.33,4428228,6862341.3,61.472719211042595,59.17905516557618,NaN,NaN,104.09949899014795,96.89030349574588,0.003403129845233277,1.0384728335126852,1.0350697036674519,394147456,387011366.8,66.80953845729687,56.4716812216381,NaN,NaN,20.5653324932735,19.547785770503452
2021-04-13T09:30:00-04:00,80.2,80.38,79.78,80.14,4656138,6862825.35,60.167442243845095,60.016129040921676,NaN,NaN,84.88377515096842,80.63416055819371,-0.013389014742545058,1.0183334352392706,1.0317224499818156,389491318,387352855.8,67.14565210083481,56.937400686293124,NaN,NaN,20.5517249175912,19.691205648658844
2021-04-14T09:30:00-04:00,80.2,81.045,80.17,80.72,4976694,6782800.55,62.76648466198099,60.838321228810855,NaN,NaN,112.26589833299323,85.74910719358785,0.004396097001073018,1.0372175712331568,1.0328214742320838,394468012,390447264,70.10042082666854,58.06997627487831,NaN,NaN,21.26558148687419,19.916116482689606
2021-04-15T09:30:00-04:00,81.12,81.82,80.8,81.67,5431526,6777095.8,66.60954977740002,61.56653430198454,NaN,NaN,147.7452943099466,106.62555862497886,0.06652375421255896,1.1159761669977826,1.0494524127852236,399899538,393545110.4,72.74326431901234,59.57483887673339,NaN,NaN,23.033343000676233,20.361434556687694
2021-04-16T09:30:00-04:00,82.47,82.875,82.3187,82.66,6464137,6770963.3,70.07581868775513,62.02742181323909,NaN,NaN,188.52297723812657,127.50348880443656,0.1555887108738303,1.2439383013775114,1.088349590503681,406363675,396873999.8,75.27261332653012,61.177702198925076,NaN,NaN,25.662729177059525,21.118762359597955
2021-04-19T09:30:00-04:00,82.66,82.81,81.82,82.28,6056450,6627863.5,67.19249226189179,62.3928451554857,NaN,NaN,150.2647900424886,136.7365470149047,0.1690836951923198,1.299704209494081,1.1306205143017611,400307225,398105953.6,76.15451626912053,62.759644593715386,NaN,NaN,26.997869157910266,21.95863475935686
2021-04-20T09:30:00-04:00,82.13,82.285,81.19,81.49,5321588,6572025.45,61.52482677494269,62.450172500102006,NaN,NaN,103.83781970165256,140.5273559250415,0.10795483739391853,1.2655640610441594,1.1576092236502409,394985637,399204817.4,76.94438234460775,64.25560483410452,NaN,NaN,26.450276609583184,22.600297880817763
2021-04-21T09:30:00-04:00,81.51,83.07,81.41,82.97,5404697,6330504.05,67.12023164372707,63.07334787129563,NaN,NaN,136.6947326365759,145.41312278575805,0.14787772275182043,1.3424563770900164,1.194578654338196,400390334,400389281.8,77.79807356056835,65.91073407461259,NaN,NaN,27.755770628241834,23.336793987592632
2021-04-22T09:30:00-04:00,82.87,82.87,81.465,81.57,8050642,6396258.5,58.45945743262071,62.87572111070284,NaN,NaN,97.98494103687294,135.4610521311433,0.06491314436498641,1.275720084794429,1.2108069404294426,392339692,398877312.6,74.02985102635695,67.4079558543244,NaN,NaN,25.959809820514536,23.711510535152904
2021-04-23T09:30:00-04:00,81.93,83.175,81.63,82.91,4685016,6245673,63.33592607493908,62.76537886605574,NaN,NaN,120.40598584655197,121.83765385282841,0.08398667339405952,1.315790282172017,1.2318036087779576,397024708,397009519.2,69.54833443524791,68.67500568633393,NaN,NaN,26.11457072718299,24.05480484830006
2021-04-26T09:30:00-04:00,83.24,83.88,83.07,83.4,4095977,6069992.35,64.95595748450424,62.72484234979425,NaN,NaN,146.39776312614214,121.0642484695591,0.11157940857313631,1.371277869494378,1.2596984609212416,401120685,397172211.2,69.72028041536737,69.78693502588136,NaN,NaN,26.776879163428497,24.44367260760412
2021-04-27T09:30:00-04:00,83.03,83.4221,82.67,83.18,4441654,5967573.45,63.597230493605615,63.20550366275948,NaN,NaN,110.41273305401083,122.37923114003077,0.09750050699680157,1.3815740946672435,1.2840735876704419,396679031,397510890,70.09878944492637,70.80379758325736,NaN,NaN,26.87286831692551,24.790700566078606
2021-04-28T09:30:00-04:00,83.22,83.76,83.06,83.41,3897019,5833895.05,64.43481403772145,63.71478087069632,NaN,NaN,113.1302529927975,117.66633521127508,0.08653639544101521,1.392244081971711,1.3057076865306958,400576050,397548033.2,70.1428701406443,71.48625294483696,NaN,NaN,27.201716328925762,25.135131389342487
2021-04-29T09:30:00-04:00,83.92,83.97,83.065,83.93,5785537,5768802.15,66.32152889371099,64.14531997712052,NaN,NaN,114.59943687702096,120.98923437930469,0.09640921932908642,1.4262192106920537,1.3298099913629673,406361587,400352412.2,73.33869614670127,72.13194877242024,NaN,NaN,28.037565386011703,25.54976481743809
2021-04-30T09:30:00-04:00,83.57,83.96,82.85,83.04,5176277,5669459.75,60.41419492647298,64.06971109965126,NaN,NaN,87.73496333624989,114.45502987724429,0.02862203883723602,1.3655875399095123,1.3369655010722763,401185310,401184532.6,74.22044446707132,72.66129920168984,NaN,NaN,26.97573092849592,25.75347426187492
2021-05-03T09:30:00-04:00,83.75,84.78,83.69,84.28,6202798,5543075.65,65.08095728190405,64.42067645951262,NaN,NaN,124.11636467237926,109.9987501864917,0.051578976654202746,1.4014392218900298,1.349860245235827,407388108,402438017.2,75.53312566544781,73.26040445630507,NaN,NaN,27.50438450095499,26.003604296029216
2021-05-04T09:30:00-04:00,83.73,85.2,83.655,85.2,7811348,5619844.25,68.08699692560214,64.80071304977126,NaN,NaN,131.14208173832898,114.14461992335532,0.10966991786372438,1.4869476425654824,1.377277724701758,415199456,406142102.2,78.94495053378951,73.89215657824228,NaN,NaN,28.916042777757568,26.419666936276123
2021-05-05T09:30:00-04:00,85.54,86.42,85.54,86.28,4827176,5421807.95,71.21923860990191,65.12997653780711,NaN,NaN,180.77649889860334,127.67386910451651,0.19669781489608162,1.62314999332186,1.4264521784257784,420026632,410032218.6,81.81327954813305,74.54001480889374,NaN,NaN,31.149844408912635,27.095406575224196
2021-05-06T09:30:00-04:00,86.45,87.06,85.595,87.01,7387349,5520458.65,73.13836601006953,65.34872991797242,NaN,NaN,182.49252015249266,141.25248575961083,0.2745161926227624,1.7695974192042314,1.495081226581469,427413981,414242697.4,84.3054371109131,75.18521650777825,NaN,NaN,33.621620927745276,28.027722911298635
2021-05-07T09:30:00-04:00,87.03,88.04,86.65,87.87,7544690,5632247.05,75.23356509889234,65.92309226347245,NaN,NaN,196.5860736199717,163.0227078163552,0.3501534724818782,1.9327730671838168,1.5826195947019386,434958671,420997369.6,87.30977012647958,75.98202035473248,NaN,NaN,36.37667016757671,29.220429662195503
2021-05-10T09:30:00-04:00,88.89,89.212,87.472,87.48,9119144,5866792.85,72.47286556409159,66.70509503412595,NaN,NaN,185.91542105360747,175.38251909260083,0.33988850089297107,2.0074802208181524,1.6675917199251813,425839527,424687653.4,88.59434453739452,76.8141605113601,NaN,NaN,37.762127036807726,30.440672144282964
2021-05-11T09:30:00-04:00,86.78,87.89,86.18,87.77,9498522,6108912.05,73.25865963189165,67.14355417613771,NaN,NaN,130.84772793616148,175.32364833216735,0.3189411058224574,2.066268102203253,1.7473269963807956,435338049,428715372,89.8070958540494,77.67194781803732,NaN,NaN,39.12762052677043,31.6816647703526
2021-05-12T09:30:00-04:00,87.44,87.64,85.46,85.56,9134569,6316805.8,59.35357636745278,67.20741981434,NaN,NaN,79.14917328312815,154.9981832090723,0.13212518089065695,1.9124834724941167,1.7803582916034597,426203480,429950741.6,90.15294010344148,78.82359703782906,NaN,NaN,35.77012831749939,32.26573099137357
2021-05-13T09:30:00-04:00,85.69,87.13,85.49,86.87,11065475,6598503.25,63.74627101229362,67.23673016700818,NaN,NaN,79.04506290211009,134.3086917589958,0.07547631095756313,1.8747036803004136,1.7992273693428504,437268955,431921736.4,90.69538340760101,80.33410053585429,NaN,NaN,34.39727497357,32.57023727454449
2021-05-14T09:30:00-04:00,87.26,88.14,87.175,87.91,5556257,6553109.25,66.81266388123288,67.3693520524888,NaN,NaN,109.52361503692387,116.89620004238623,0.08598046170173546,1.9067029464700198,1.8207224847682844,442825212,433495044.6,91.11607669715708,81.86237169883927,NaN,NaN,34.29736404236401,32.81696966994728
2021-05-17T09:30:00-04:00,87.96,88.84,87.515,88.68,7812045,6640889,68.90941134554268,67.74879354191287,NaN,NaN,114.45146035141767,102.60340790194826,0.12059744380186266,1.9714692895206127,1.85087184571875,450637257,438454590.6,92.29822208863513,83.44804545910418,NaN,NaN,34.9101460364335,33.11599486515959
2021-05-18T09:30:00-04:00,88.83,88.88,87.64,87.7,6797364,6714677.8,63.417740126990466,67.6761454054321,NaN,NaN,94.89614972501437,95.41309225971884,0.05655742439950573,1.9215686262181322,1.8650112018186265,443839893,440154959.4,92.65889491410256,85.05633294292262,NaN,NaN,33.60522056305836,33.1858842505737
2021-05-19T09:30:00-04:00,86.48,86.74,85.38,86.36,12480019,7068443.9,56.75718754024927,66.99297816589912,NaN,NaN,25.594098027432594,84.70207720857972,-0.08906507338763969,1.7536798600840768,1.8427449334717165,431359874,441186238.2,92.87677461131875,86.45190997610959,NaN,NaN,30.242851224276034,32.7654509611026
2021-05-20T09:30:00-04:00,86.51,86.79,86.07,86.41,5875101,6959666.85,56.93892075091104,66.74474429621611,NaN,NaN,29.75032728449082,74.84313008505586,-0.18927856612253535,1.6061467258185473,1.7954252919410827,437234975,441179442.2,92.85721622836144,87.78310795905888,NaN,NaN,27.68499485696353,32.03967151765416
2021-05-21T09:30:00-04:00,86.89,87.52,86.55,86.6,6766673,7063749.7,57.66698193722,66.2151746287387,NaN,NaN,43.70351375486769,61.67910982864463,-0.24641134025140166,1.4874111166268307,1.7338224568782323,444001648,441414729.4,92.91286125697413,89.0245176441679,NaN,NaN,25.8388933396408,31.153846063652253
2021-05-24T09:30:00-04:00,87.11,87.705,86.75,87.37,5109226,7114412.15,60.57611880065718,65.67868333409976,NaN,NaN,56.874919613159015,50.163801680992904,-0.2359710938403874,1.4388585895777481,1.6748296834181355,449110874,441109452.8,91.91237129504384,89.9507619842575,NaN,NaN,25.12118670035398,30.29203758318107
2021-05-25T09:30:00-04:00,87.54,87.74,86.53,86.63,4844432,7134551.05,56.553835431167826,64.63115453561876,NaN,NaN,37.54250923646663,38.69307358328335,-0.2795515287402597,1.325390272492811,1.6049418012330707,444266442,441194762.6,91.93849550064168,90.67399169515097,NaN,NaN,23.31009331062291,29.294616972815618
2021-05-26T09:30:00-04:00,86.66,86.93,86.07,86.66,6308159,7255108.05,56.67942098650414,63.455515605364084,NaN,NaN,8.010954009028724,35.176444779602576,-0.3049297660995105,1.2237795936086826,1.528709359708193,450574601,445037708,93.0306066445194,91.29721809040856,NaN,NaN,21.878955285982112,28.235236731839404
2021-05-27T09:30:00-04:00,87.37,87.78,87.12,87.35,5827436,7257203,59.57385153661653,62.3369646366301,NaN,NaN,56.79317883175561,40.58501508905553,-0.2747541947999863,1.1852666162082102,1.4600208110081965,456402037,448871120.4,93.9160172587041,91.76909288556746,NaN,NaN,21.4549265561881,27.266620992460645
2021-05-28T09:30:00-04:00,87.54,87.65,86.91,87.26,5345429,7265660.6,59.01993325761115,61.376040900452914,NaN,NaN,38.880009121413664,39.62031416236472,-0.2604919831903465,1.1344058320202635,1.39489781521061,451056608,450282112.4,94.20770879389897,92.17004747531777,NaN,NaN,20.95420843773267,26.364847770356647
2021-06-01T09:30:00-04:00,88.27,88.62,87.88,88.48,6850366,7298039,63.91758221410022,60.708821084896385,NaN,NaN,122.33299866913106,52.71192997355913,-0.1727567523181146,1.1789518748129666,1.3517086271310812,457906974,452041332.4,94.55803443683976,92.50940023123137,NaN,NaN,21.913623874750876,25.728958642412966
2021-06-02T09:30:00-04:00,88.6,88.62,87.625,87.74,5705299,7192736.55,59.28902266177144,60.70421010591915,NaN,NaN,86.05492330486356,62.41441278723852,-0.16825815565793478,1.1413859325586628,1.3096440882165976,452201675,453628379,94.86005349414626,92.84562261628172,NaN,NaN,21.396204221689427,25.109993725166746
2021-06-03T09:30:00-04:00,87.12,87.76,86.6519,87.72,6264580,7264606.75,59.164322111679304,60.37692804158955,NaN,NaN,15.185341655118696,63.84929031645652,-0.1698342803102011,1.0973512378288461,1.2671855181390472,445937095,452700877.8,91.65849981545638,92.91441664541424,NaN,NaN,20.940265580065624,24.514318275866586
2021-06-04T09:30:00-04:00,88.09,88.22,87.55,87.91,5145886,7152533.6,60.02451550490273,59.89206030042311,NaN,NaN,68.92393182988253,66.2754409160819,-0.16134650345503831,1.0655023888202493,1.2268488922752876,451082981,451637066.6,87.99034866711042,92.69115035755375,NaN,NaN,20.78849238279697,23.982057433999497
2021-06-07T09:30:00-04:00,87.95,87.95,86.45,86.84,6048824,7077740.3,53.22487651137365,58.77173638369675,NaN,NaN,-25.273503018250082,53.444738488149156,-0.2270383264851623,0.9430509841688348,1.1700893106539971,445034157,450432576.4,83.8964107269687,92.09102097457757,NaN,NaN,18.710805847556504,23.22902149307907
2021-06-08T09:30:00-04:00,86.88,87.355,86.225,87,5791036,6911334.9,54.06287245428172,58.103531549931844,NaN,NaN,-45.62218912137376,19.853700930048184,-0.25676761894497235,0.8491297869727816,1.105897405917754,450825193,449016220.2,79.22830705163365,91.13169327011552,NaN,NaN,17.21249960742454,22.369518366556996
2021-06-09T09:30:00-04:00,86.83,87.08,86.3,86.32,9880567,6930437.15,49.96580185074463,57.61843257211007,NaN,NaN,-73.0431270934771,-11.965909149619945,-0.31541944758174245,0.7116230964405759,1.0270425440223183,440944626,446764810.4,72.33811906094161,89.66464644508856,NaN,NaN,14.735935073279064,21.27900646751729
2021-06-10T09:30:00-04:00,86.98,87.1,85.79,85.8,6134576,6780437.5,47.0306254946244,56.910697196661026,NaN,NaN,-112.23034800324574,-37.44904708129284,-0.37819500486224045,0.5542987879445178,0.9324937928067583,434810050,444539401.4,66.20887551425335,87.761193536938,NaN,NaN,11.763463264992497,19.919643152870893
2021-06-11T09:30:00-04:00,86.41,86.73,85.66,86.12,4357987,6445063.1,49.01549018192596,56.29273349985431,NaN,NaN,-114.0548179364099,-74.04479703455134,-0.38579561639849536,0.4502492723086391,0.8360448887071344,439168037,442156412.6,60.31548357197143,85.43280941658067,NaN,NaN,9.786588959114772,18.472063982334305
2021-06-14T09:30:00-04:00,85.88,86.09,84.6,85.06,6187786,6476639.55,43.23596937490452,55.05415139801483,NaN,NaN,-185.46462030260187,-106.08302049142169,-0.44560427406262204,0.27903954612885684,0.7246438201914789,432980251,439745631.4,54.98335259680424,82.79502236670639,NaN,NaN,6.2756645478711475,16.729721205982425
2021-06-15T09:30:00-04:00,85.19,85.24,84.275,84.88,10483674,6610221,42.32334967929703,54.03768813002406,NaN,NaN,-201.0585794143482,-137.17029855001658,-0.47782548850127937,0.1273619595648796,0.605187448066159,422496577,434079908.2,44.93038325409069,79.43730006338133,NaN,NaN,3.1128527300608253,14.784454280850769
2021-06-16T09:30:00-04:00,84.88,84.92,83.745,83.94,8324507,6686578.15,37.83230412074888,52.691465496755825,NaN,NaN,-211.87576833665833,-164.93682679865282,-0.5384787022388634,-0.0679109297324203,0.4705677725064431,414172070,428725397,37.88123791195822,75.49805943962694,NaN,NaN,-1.0682961457984947,12.519775648472303
2021-06-17T09:30:00-04:00,83.7,83.71,81.07,82.07,15161567,6820655.55,30.824763583034198,50.63795921435709,NaN,NaN,-278.2080775596205,-198.13237270992775,-0.6718961260938395,-0.36930238511085633,0.3025937409829832,399010503,421565487.6,30.900068684191012,70.99692025573317,NaN,NaN,-7.405185423354149,9.67335263821138
2021-06-18T09:30:00-04:00,81.22,81.56,80.74,80.74,11765848,7115192.9,26.99493118164915,48.350459066074094,NaN,NaN,-255.1006970527346,-226.34154853319268,-0.8079338597095428,-0.7073235836539453,0.10061027605559747,387244655,411180811.2,23.99343336063599,65.98161486764296,NaN,NaN,-14.22801847131845,6.25887105113569
2021-06-21T09:30:00-04:00,81.33,82.18,81.3,82.06,9007163,7227217.4,35.55324214458115,46.32443477539415,NaN,NaN,-167.36639533529024,-222.72190353973036,-0.7675243761203034,-0.8587951940947818,-0.09127081797447839,396251818,403835124.6,20.502524358451765,60.691935576329534,NaN,NaN,-17.00052083906988,2.9361007811063233
2021-06-22T09:30:00-04:00,82.4,82.745,81.81,82.39,5578435,7250677.85,37.52505468516407,44.76986563420791,NaN,NaN,-123.8199983585711,-207.27418732857495,-0.6800696709130056,-0.9413579066157354,-0.2612882357027298,401830253,399701859.8,18.841390613510498,55.26203108485556,NaN,NaN,-18.50616037466411,-0.1270793840037383
2021-06-23T09:30:00-04:00,82.63,82.84,81.85,81.86,5168413,7266876.9,35.63907262211298,43.08949067066745,NaN,NaN,-110.15523556851961,-186.9300807749472,-0.6210456269111368,-1.0375952693416508,-0.416549642430514,396661840,396199813.8,17.544365929274306,49.96816437869968,NaN,NaN,-20.330782205651307,-3.013322644239105
2021-06-24T09:30:00-04:00,82.47,82.6,81.85,82.12,5270281,7214983,37.3037868679651,41.466581482314766,NaN,NaN,-96.242823972611,-150.5370300575453,-0.5311040654542892,-1.0804297242483756,-0.5493256587940863,401932121,396784137.4,18.551837599422115,45.008270731007656,NaN,NaN,-21.281685141420574,-5.623088715265029
2021-06-25T09:30:00-04:00,82.565,82.9,82.06,82.13,10109544,7429088.4,37.37088416400069,40.33415345750241,NaN,NaN,-80.58432345982798,-115.63375533896397,-0.4412428106593915,-1.1008791721183258,-0.6596363614589342,412041665,401743539.4,26.734126471200298,40.925250427024196,NaN,NaN,-22.023269541362833,-7.965971690421858
2021-06-28T09:30:00-04:00,82.39,82.46,81.485,82.13,5074107,7415522.3,37.37088416400069,39.14186857962519,NaN,NaN,-81.36605953169557,-98.43368817824505,-0.3557750610078887,-1.1043551877187952,-0.7485801267109065,412041665,404901508.8,31.45612104317874,37.51295142642027,NaN,NaN,-22.628188188382023,-10.06057404727331
2021-06-29T09:30:00-04:00,82.49,82.93,81.89,82.09,4920072,7319007.6,37.186265487888726,38.22904455370691,NaN,NaN,-65.72148877268968,-86.81398626106878,-0.27928325915219054,-1.0976842006511447,-0.8184009414989541,407121593,405959776.8,33.01416307425495,34.704097427371224,NaN,NaN,-23.179650869588198,-11.934727879032579
2021-06-30T09:30:00-04:00,81.86,82.43,81.85,82.31,4864261,7276955.7,38.97200750097651,37.653428982732066,NaN,NaN,-62.68121994097774,-77.3191831355604,-0.1951980984984827,-1.0623985646220575,-0.8672004661235748,411985854,409024579.6,37.44860571023506,32.64979244136992,NaN,NaN,-23.188316746946047,-13.542383431591645
2021-07-01T09:30:00-04:00,82.97,83.08,82.34,82.76,7092344,7318343.9,42.568574960407815,37.192935038337914,NaN,NaN,-40.49262554318974,-66.16914344967613,-0.09563849209454456,-0.9867485812417556,-0.891110089147211,419078198,412453795,42.06964002582986,31.346517902359807,NaN,NaN,-22.244271640130737,-14.785510318525802
2021-07-02T09:30:00-04:00,82.87,82.98,82.32,82.88,6170931,7369596.15,43.52438916194225,37.21353645169775,NaN,NaN,-35.151039134281135,-57.082486584566766,-0.012440731557007312,-0.9066610035934701,-0.8942202720364628,425249129,415095287.8,45.41479682351722,30.663049632839297,NaN,NaN,-21.19271086253883,-15.700824681956234
2021-07-06T09:30:00-04:00,82.84,82.87,81.08,81.65,6108325,7372571.2,36.76947461047764,36.81683108963922,NaN,NaN,-63.2003969272343,-53.44935406367451,-0.02998511432217632,-0.9317016649391832,-0.9017165506170068,419140804,416515115.6,47.18033385601655,30.82376039011972,NaN,NaN,-22.062939468559144,-16.609698222899507
2021-07-07T09:30:00-04:00,81.67,82.57,81.475,82.5,6589379,7412488.35,43.316477105526545,37.20855773140905,NaN,NaN,-46.539225247028135,-49.612901358542196,0.023056067607078234,-0.8728964661081591,-0.8959525337152373,425730183,420236833.6,51.59953626759763,31.80363884409396,NaN,NaN,-20.88945051858227,-17.221091407997044
2021-07-08T09:30:00-04:00,81.15,81.82,80.67,81.38,7912788,7314099.4,37.76744651287163,37.70446365496887,NaN,NaN,-89.08004450102513,-54.892666270551686,-0.008214939548606526,-0.9062212081509955,-0.898006268602389,417817395,421403141.8,52.92864196501112,33.37710836415254,NaN,NaN,-21.554877948352615,-17.84020377090498
2021-07-09T09:30:00-04:00,82.43,83.2,82.265,82.98,7490790,7381910.1,48.01319639469385,39.205768313043485,NaN,NaN,5.422703205914989,-45.709600520730746,0.08291085353677241,-0.7943677016814235,-0.8772785552181959,425308185,422649139.2,54.370248012964566,35.546880839318874,NaN,NaN,-18.63363440145141,-17.953551003840186
2021-07-12T09:30:00-04:00,82.48,83.495,82.17,83.25,10113131,7669667.3,49.523431011653976,40.203638946405825,NaN,NaN,35.288720811849025,-31.621648531504707,0.1609091616575814,-0.6761421031462191,-0.8370512648038005,435421316,424683576.6,56.70193492350613,38.13255302253703,NaN,NaN,-15.830730777977267,-17.650290971574055
2021-07-13T09:30:00-04:00,83.1,83.29,82.23,82.49,12354613,7978008.65,45.51528882539905,40.77436995642261,NaN,NaN,25.596965715089834,-13.862176003039881,0.1604916780662703,-0.6364366672209627,-0.796928345287233,423066703,425468756.4,57.60241217408836,40.90119741972118,NaN,NaN,-14.764112943645832,-17.237979824727166
2021-07-14T09:30:00-04:00,82.59,83.245,82.08,82.32,6188296,7763239.75,44.64487846502389,41.41764180234482,NaN,NaN,32.65938909389849,1.977546865145443,0.14823320922984506,-0.6116368337499267,-0.7598700429797718,416878407,423698401.2,54.83339670334067,43.56469961786877,NaN,NaN,-14.179349741698456,-16.80103267000878
2021-07-15T09:30:00-04:00,81.9,82.875,81.85,82.33,6344145,7664221.65,44.71185682594299,41.9467896564861,NaN,NaN,21.241629669615104,24.041881699273493,0.14034497545119518,-0.5844388236657778,-0.724783799116973,423222552,424779432.6,56.21743619480664,46.2550995175391,NaN,NaN,-13.691425271877586,-16.356803041704325
2021-07-16T09:30:00-04:00,82.48,82.54,80.94,81.09,9611083,7386697.45,38.49233085890228,42.02689299183621,NaN,NaN,-121.66480862131843,-1.3756206661731922,0.055517480230590666,-0.6553869488287347,-0.7109044290593254,413611469,422440089.4,52.47041728690355,48.09340600437504,NaN,NaN,-15.172829762783135,-16.18766400185844
2021-07-19T09:30:00-04:00,79.66,79.73,78.68,79.35,11506743,7373742.2,31.806406854226978,41.62943032685238,NaN,NaN,-389.71096823936415,-86.37555847641582,-0.1051226235066911,-0.8423077084426893,-0.7371850849359982,402104726,415776771.4,43.56364512585676,48.958229153137765,NaN,NaN,-18.84606719566248,-16.56743588668759
2021-07-20T09:30:00-04:00,79.14,80.83,78.89,80.25,10615769,7454172.5,37.82229633386767,41.674861101565156,NaN,NaN,-218.78710486814492,-135.25237259306277,-0.1361413536431113,-0.9073617769898874,-0.7712204233467761,412720495,413707529.8,41.22343249046028,49.54460554000957,NaN,NaN,-19.84061823127355,-17.035033364485585
2021-07-21T09:30:00-04:00,80.81,81.39,80.705,81.13,6835617,7517031.6,43.10721507480027,41.97023307112399,NaN,NaN,-87.31115100541102,-159.2464806129247,-0.08525592449288966,-0.8777903289628881,-0.7925344044699985,419556112,414243070.8,42.0904886273929,49.876168605520846,NaN,NaN,-18.861683497259506,-17.295983383453287
2021-07-22T09:30:00-04:00,81.32,81.395,80.49,81.16,4726701,7494946,43.28419784160977,42.02134899120984,NaN,NaN,-81.02669248584957,-179.7001450440176,-0.03975275207687212,-0.8422253445660886,-0.8024725924892164,424282813,414455123,42.45248507715738,49.90351468061567,NaN,NaN,-18.04746737211652,-17.403338238976605
2021-07-23T09:30:00-04:00,81.56,81.81,80.84,81.73,5196385,7491251.2,46.678234964642115,42.2466236914027,NaN,NaN,-36.392310896859804,-162.6456454991259,0.03454371762599617,-0.7592929454567212,-0.7938366630827174,429479198,417628668.8,47.71967921301119,50.0681491370081,NaN,NaN,-16.30853924116381,-17.246938382146205
2021-07-26T09:30:00-04:00,81.93,82.5,81.75,82.42,5910318,7281289.9,50.53702923041232,43.23002044996945,NaN,NaN,32.593391450230875,-78.18477356120688,0.13057191207664332,-0.6306217729869132,-0.7611936850635566,435389516,424285626.8,56.67715170831499,50.74649326931513,NaN,NaN,-13.62997804451273,-16.730229762484278
2021-07-27T09:30:00-04:00,81.91,82.9,81.13,82.53,8432159,7449192.5,51.14403522400254,43.78913174414631,NaN,NaN,28.347451330068104,-28.75786232156427,0.1978753291397055,-0.5138495236389247,-0.7117248527786302,443821675,430505862.8,63.04804572380825,51.56424394475874,NaN,NaN,-11.293307695242545,-15.953526610021173
2021-07-28T09:30:00-04:00,82.56,83.065,81.97,82.77,6107236,7508550.7,52.513301766596626,44.842407119412385,NaN,NaN,63.01562225733168,1.307492330984259,0.251491754286701,-0.39736015992025386,-0.6488519142069549,449928911,436580422.6,67.99752567068722,52.640592780878464,NaN,NaN,-8.960891775780107,-14.954578776558163
2021-07-29T09:30:00-04:00,83.35,83.985,83.15,83.68,6287427,7579709,57.3897066822252,45.512157854236044,NaN,NaN,134.88983304736456,44.490797437627094,0.33590341063690854,-0.2289726509108192,-0.5648760615477277,456216338,442967127.6,72.2118547578041,53.91499326265272,NaN,NaN,-5.4177401187835335,-13.592173254018931
2021-07-30T09:30:00-04:00,83.52,84.54,83.52,84.02,5586187,7504401.15,59.08046182852,46.19480291258362,NaN,NaN,154.20411193896211,82.61008200479148,0.39805026259783105,-0.06731323330043892,-0.46536349589827,461802525,449431793,75.7000736029971,55.27200316833064,NaN,NaN,-1.9601227883198318,-11.93045175891906
2021-08-02T09:30:00-04:00,84.42,84.91,83,83,8504995,7621104.35,52.36722877297678,46.68422719455346,NaN,NaN,115.89261580046922,99.26992687483916,0.3552848659781006,-0.021257413425644245,-0.37654227940374485,453297530,453013395.8,77.39323600903272,56.685633442255245,NaN,NaN,-0.8865778405897603,-10.352755484872018
2021-08-03T09:30:00-04:00,83.08,83.87,82.37,83.86,6565955,7643985.85,56.82207365843364,47.55402685122558,NaN,NaN,87.3019402078082,111.06082465038716,0.36817177909420706,0.083672444464014,-0.28449933463019306,459863485,456221757.8,78.81710366903796,58.39875536837648,NaN,NaN,1.4316214656532034,-8.669273063368415
2021-08-04T09:30:00-04:00,83.51,83.96,83.02,83.06,5269924,7578013.1,51.95436068550161,48.071348555479766,NaN,NaN,78.23708344683817,114.10511688828846,0.3084884686128098,0.1011112511358192,-0.20737721747699062,454593561,457154687.8,79.22682121505038,60.042282869822465,NaN,NaN,1.8865181605585373,-7.161302888521708
2021-08-05T09:30:00-04:00,83.46,84.02,82.86,82.94,6982749,7531511.15,51.24521229391973,48.98226865798102,NaN,NaN,67.45428584588662,100.61800744799288,0.2491411494320135,0.10404921931302624,-0.14509193011898724,447610812,455433582.6,76.29499442463754,61.7440383796606,NaN,NaN,2.039697421770039,-5.846874272765744
2021-08-06T09:30:00-04:00,83.43,84.245,83.35,84.14,7027145,7508328.9,57.493426349677144,50.81705576479889,NaN,NaN,103.08006630430904,90.39319832106227,0.2767869807911497,0.20089179586994987,-0.07589518492119982,454637957,454000669,73.84489435557205,63.906984753211695,NaN,NaN,4.1446436592800815,-4.419514568187769
2021-08-09T09:30:00-04:00,83.99,84.25,83.36,84.04,5371786,7271261.65,56.83970319389268,52.175441969086386,NaN,NaN,94.35814395292739,86.0863039515539,0.2739153769284759,0.2664990362393951,-0.0074163406890808276,449266171,453194397.2,72.43533171929025,66.13640612669955,NaN,NaN,5.634567447958165,-2.983217137309779
2021-08-10T09:30:00-04:00,84.01,85.64,84.01,85.31,8023710,7054716.5,62.6483373003526,53.571236413768695,NaN,NaN,142.87811723024313,97.2015393560409,0.3388724609881061,0.4161742355460518,0.07730177455794571,457289881,452679676.4,71.49706342306393,68.23687575496176,NaN,NaN,8.83366797193909,-1.2950906931313693
2021-08-11T09:30:00-04:00,85.96,86.579,85.57,86.51,8272385,7158920.95,67.1473955055953,55.27575053262488,NaN,NaN,176.7412108517629,116.90236483702583,0.4376984995418236,0.6244248989852252,0.1867263994434016,465562266,454873417.4,73.09655793151532,70.42573810170163,NaN,NaN,13.133499575095623,0.7661364880439154
2021-08-12T09:30:00-04:00,86.52,86.6,85.6,86.37,4806381,7082032.75,66.14636087607516,56.666330954870105,NaN,NaN,150.020752481968,133.41565816424213,0.4660590454450468,0.7693002062497101,0.3032411608046633,460755885,457502432,74.91343941517034,72.36814954471298,NaN,NaN,16.217619694757254,2.9734912318601063
2021-08-13T09:30:00-04:00,86.49,86.63,86.29,86.45,3907987,6796877.95,66.45411636004133,57.803265749843604,NaN,NaN,144.9239948277802,141.78444386893634,0.46174412221981553,0.8804213135794328,0.41867719135961723,464663872,459507615,76.23187631475503,73.76491558803014,NaN,NaN,18.783328040872373,5.232039347433288
2021-08-16T09:30:00-04:00,85.92,86.13,85.11,86.02,6137246,6528403.1,63.13201235410446,58.659549830565176,NaN,NaN,108.6775521166614,144.64832550168316,0.4035756265766647,0.9231467245804481,0.5195710980037834,458526626,461359706,77.41267540588831,74.79096056532157,NaN,NaN,19.98734683614846,7.339940417249741
2021-08-17T09:30:00-04:00,85.55,85.65,84.04,85.03,7462005,6370714.9,56.16982322489112,58.92072993472907,NaN,NaN,61.66234757990145,128.40517157161483,0.2780443214937096,0.8671264998709205,0.5890821783772109,451064621,460114654,74.7251190530757,75.27150294977788,NaN,NaN,18.9409005023916,8.997220429412863
2021-08-18T09:30:00-04:00,84.73,85.24,83.99,84.04,7356372,6396752.65,50.207083391465304,58.4076854139605,NaN,NaN,30.483346966317423,99.15359879452572,0.11623815168019314,0.7343798679774522,0.6181417162972591,443708249,455743850.6,66.05527170380242,74.8317470173492,NaN,NaN,16.128799866109382,10.01601749179808
2021-08-19T09:30:00-04:00,83.09,83.66,82.84,83.29,7968354,6558835.3,46.205369767878125,57.488035981057514,NaN,NaN,-43.50748769441427,60.44795075924924,-0.044770944735864626,0.5621780353774284,0.606948980113293,435739895,450740652.6,57.789808580349906,73.55244237287438,NaN,NaN,12.461524308068546,10.365375608408145
2021-08-20T09:30:00-04:00,83.32,83.96,83.19,83.78,6986844,6648358.25,49.061927587311686,57.25194303922429,NaN,NaN,-29.33548854072074,25.596054085549053,-0.11760414292605659,0.4599438014557222,0.5775479443817788,442726739,446353226,51.68249728621853,71.71596103553051,NaN,NaN,10.295739928328194,10.35542765411101
2021-08-23T09:30:00-04:00,84.25,84.725,84.04,84.5,4047754,6555230.05,53.01038181896485,56.979679336405084,NaN,NaN,14.855142067808547,6.831572075778479,-0.11640625345033995,0.4320401275688539,0.5484463810191939,446774493,444002799.4,48.71246983350138,69.5656300472779,NaN,NaN,9.667840003191795,10.257200846836836
2021-08-24T09:30:00-04:00,84.9,85.29,84.77,85.03,5529793,6410111.75,55.73067408867162,57.249416008060095,NaN,NaN,49.13785916037431,4.326674391873046,-0.08072995051905185,0.44753394287037906,0.5282638933894309,452304286,444250732.4,49.045110363365566,67.40979355787184,NaN,NaN,9.973310437977698,10.216645074142674
2021-08-25T09:30:00-04:00,84.8,85.7,84.47,85.42,4912230,6350361.45,57.67249742854365,57.708507803390376,NaN,NaN,53.762878510543025,8.982580700718165,-0.03406392979088235,0.485683981150828,0.5197479109417104,457216516,446952385.8,52.64900794624399,65.72079452370087,NaN,NaN,10.807207091693453,10.301011076649928
2021-08-26T09:30:00-04:00,85.39,85.5,84.79,84.83,5770877,6324533.95,53.82595406966746,57.446545497675395,NaN,NaN,37.04115677103453,25.092309593807926,-0.04541974872724386,0.4629732250326555,0.5083929737598993,451445639,450093534.6,56.501195778344005,64.48195891104173,NaN,NaN,10.367925987051587,10.31057034956445
2021-08-27T09:30:00-04:00,85.26,86.2,85.17,85.95,5178779,6304163.55,59.36632308076255,57.627018346737536,NaN,NaN,82.48079445381563,47.45556619271521,0.016684484020763612,0.5292485787858539,0.5125640947650902,456624418,452873070.4,59.63085044130732,63.567353105471526,NaN,NaN,11.711130467089703,10.510650366353772
2021-08-30T09:30:00-04:00,86.3,86.46,85.86,85.86,4506359,6104231.75,58.756219219606,57.34900991239849,NaN,NaN,93.55820051195774,63.196177881545054,0.04431904697042266,0.5679629034781186,0.523643856507696,452118059,453941783.6,60.79871632974775,62.80318545594894,NaN,NaN,12.605992273343212,10.80998492449512
2021-08-31T09:30:00-04:00,85.81,85.81,85.195,85.61,5304465,6041157.25,57.0037545691836,56.624464131226226,NaN,NaN,51.171415236012436,63.602889096672676,0.038588200941496176,0.5718791076845662,0.53329090674307,446813594,452843645.2,58.9127528526108,61.79005652174148,NaN,NaN,12.844077020183956,11.100569509593525
2021-09-01T09:30:00-04:00,85.52,85.729,84.65,85.39,7008910,6128106.55,55.43678411288985,55.85949436242727,NaN,NaN,24.689032862911,57.78811996714627,0.014071562977772345,0.5508803604652854,0.5368087974875131,439804684,449361278.8,53.269616932418984,60.24406920154495,NaN,NaN,12.604802560684018,11.315459945463596
2021-09-02T09:30:00-04:00,85.64,86.11,85.61,85.94,5315638,6044751,58.50757903812811,55.291884553719186,NaN,NaN,71.48565473915068,64.6770195607695,0.028173086445664852,0.5720251555445941,0.5438520690989292,445120322,448096215.4,51.34548022505268,58.46646948085193,NaN,NaN,13.26060833780788,11.593338287227064
2021-09-03T09:30:00-04:00,85.85,86.1,85.35,85.37,11440331,6265410.3,54.32923023450745,54.6631144023194,NaN,NaN,40.98144458321556,56.37714958664949,-0.005799495459698378,0.5366026997743063,0.5424021952340047,433679991,443507330,44.996362725646584,56.151018575120375,NaN,NaN,12.636035471467387,11.742295027832824
2021-09-07T09:30:00-04:00,85.07,85.13,84.685,84.81,6932341,6343438.05,50.51251784117618,54.25902116062547,NaN,NaN,-36.16636217824553,30.43223704860883,-0.06747170152086757,0.45806256833292025,0.5255342698537878,426747650,438433248.2,39.22116834227083,53.61502209577717,NaN,NaN,10.985527303292065,11.634185352898431
2021-09-08T09:30:00-04:00,84.56,84.64,83.71,84,6209959,6252750.5,45.530141190026555,53.9249538605227,NaN,NaN,-102.63012454769172,-0.3280709081319998,-0.15907317072031485,0.32669280645339427,0.4857659771737091,420537691,433178067.6,34.30960469418997,51.34747445223343,NaN,NaN,8.018423083001448,11.11764788577029
2021-09-09T09:30:00-04:00,83.76,84.6,83.76,84.03,4935706,6085916.55,45.743597722654286,53.89197014300671,NaN,NaN,-91.18354004422181,-23.502585489558566,-0.21066242430885845,0.22243794678763606,0.4331003710964945,425473397,430311810.2,31.95887365713962,49.50240767200412,NaN,NaN,5.674508705837142,10.34005657435127
2021-09-10T09:30:00-04:00,84.42,85.05,83.955,84.01,8890182,6290106.6,45.61525927762313,53.64577954945753,NaN,NaN,-63.910940238849825,-50.58190448515867,-0.23717914331086337,0.1366264419579153,0.37380558526877866,416583215,424604388.8,27.864825157418494,47.801145377089824,NaN,NaN,3.7094343348009637,9.392824825844082
2021-09-13T09:30:00-04:00,84.75,85,83.46,83.99,7610040,6475209.25,45.477851575307255,53.107741674910564,NaN,NaN,-74.15584237358522,-73.60936187651882,-0.24605025389884816,0.06624276789521844,0.3122930217940666,408973175,419663025.6,24.891734213524217,46.09966426137718,NaN,NaN,2.0316802105726373,8.341232737948161
2021-09-14T09:30:00-04:00,84.28,84.34,82.89,83.07,6043651,6470529.5,39.57260442561464,51.95359384183506,NaN,NaN,-128.19822376831212,-92.01573419453214,-0.30027149984573864,-0.06304635301310668,0.23722514683263193,402929524,414899400.4,22.40941369742643,44.197114499524375,NaN,NaN,-1.21792231352199,6.975639159166711
2021-09-15T09:30:00-04:00,83.28,84.05,83.12,83.95,6325836,6413721.05,46.70165058290509,51.169961924289446,NaN,NaN,-89.9876259233065,-89.48723446965509,-0.26451879038995973,-0.09342334115481776,0.17109544923514197,409255360,412642934.2,21.32458962015386,41.95965604766079,NaN,NaN,-2.0727800233760263,5.683007847374892
2021-09-16T09:30:00-04:00,83.63,83.71,82.44,83.04,5625365,6327170.7,41.278354336368864,50.273704800482406,NaN,NaN,-130.29235866552204,-97.30899819391514,-0.2878770912848404,-0.18875091487090856,0.09912617641393186,403629995,408274253.8,19.369554438290635,39.30739595194269,NaN,NaN,-4.527316126913215,4.224390136762305
2021-09-17T09:30:00-04:00,82.58,82.73,81.07,81.33,9965999,6427052.95,33.423730071028174,48.420662442644236,NaN,NaN,-215.6786770245663,-127.66254555105843,-0.3974585484978202,-0.3976970092083434,-0.00023846071052319173,393663996,403690410,17.551327513242995,36.301715742795245,NaN,NaN,-9.593385956936814,2.2504221233767168
2021-09-20T09:30:00-04:00,79.08,79.79,78.3669,79.42,10077762,6581598.85,27.198330549247217,46.166527537618606,NaN,NaN,-308.1291678595123,-174.45721064824386,-0.5671962129429036,-0.7092337268891526,-0.14203751394624908,383586234,398613021.8,15.783913153036565,33.086372658744445,NaN,NaN,-16.54954822874571,-0.4352879269264869
2021-09-21T09:30:00-04:00,79.91,80.05,78.89,79.23,7614708,6759946.55,26.666247846265932,43.99956277169592,NaN,NaN,-223.84023012752561,-193.58561192008656,-0.6546815571455797,-0.9603894603782237,-0.305707903232644,375971526,393221422.2,14.153982895953632,29.889317661840355,NaN,NaN,-21.96676316974123,-3.5112129616143073
2021-09-22T09:30:00-04:00,79.99,80.85,79.99,80.05,7656112,6866262.5,32.778355062645176,42.3811035538213,NaN,NaN,-146.87865685124393,-204.96381810567405,-0.6200786220537566,-1.08080618079984,-0.46072755874608323,383627638,388095877.8,12.800681635046317,26.998679426313736,NaN,NaN,-24.27321838172433,-6.477213735915739
2021-09-23T09:30:00-04:00,80.65,81.74,80.57,81.19,4758327,6858567.35,40.236010600135316,41.07599152253611,NaN,NaN,-95.71216435187823,-198.0477792429453,-0.4889321247489671,-1.071892714682292,-0.582960589933325,388385965,385047071.8,12.061916147006471,24.192710563596147,NaN,NaN,-23.568513656896084,-8.918828010341503
2021-09-24T09:30:00-04:00,80.82,81.5,80.63,81.07,3625896,6751318.3,39.73627372031895,40.03363748580835,NaN,NaN,-86.9337563711983,-172.29879511227168,-0.3834447903038922,-1.0622665778131903,-0.6788217875092981,384760069,383266286.4,11.639374403366986,21.81006854057618,NaN,NaN,-23.188751984494946,-10.957388578077708
2021-09-27T09:30:00-04:00,81.28,82.16,81.27,81.7,5216513,6753205,43.690420257493834,39.546344801259615,NaN,NaN,-55.59919332125572,-121.79280020462036,-0.25083274631660524,-0.9923627204050547,-0.7415299740884495,389976582,384544356,13.9687376169463,20.00632348876729,NaN,NaN,-21.588733385951343,-12.476152122059656
2021-09-28T09:30:00-04:00,81.5,81.62,80.44,80.69,8285263,6942150.2,39.24468926425792,39.097383949419,NaN,NaN,-74.78566336910217,-91.98188685293567,-0.2122604724518975,-1.0068555646533213,-0.7945950922014238,381691319,385688314.6,16.100689067528478,18.705686658291462,NaN,NaN,-21.66657894477789,-13.789070239590831
2021-09-29T09:30:00-04:00,80.68,80.86,80.2,80.36,6969761,7025415,37.88813420099567,38.53627941215767,NaN,NaN,-80.69553947032693,-78.74526337675226,-0.19077273103196912,-1.0330610059913852,-0.842288274959416,374721558,383907098.6,15.4583346952586,17.527076732442822,NaN,NaN,-22.15412326406348,-14.984077814515494
2021-09-30T09:30:00-04:00,80.6,80.93,79.09,79.11,10729442,7211441.6,33.205905563149884,37.64989700398102,NaN,NaN,-96.86332557975408,-78.97549562232744,-0.23939710754694876,-1.141534659393102,-0.9021375518461532,363992116,379028328.8,13.830713860534715,16.524640211236836,NaN,NaN,-24.118795932952175,-16.289037545720735
2021-10-01T09:30:00-04:00,79.49,80.8,78.89,80.37,9249991,7408159.25,41.10653544331754,37.33766013741032,NaN,NaN,-78.85864227594966,-77.3604728032777,-0.16868946050570854,-1.112999377478289,-0.9443099169725804,373242107,376724736.4,13.127860875737852,15.684363544252093,NaN,NaN,-23.123429610632108,-17.265379269279503
2021-10-04T09:30:00-04:00,80.47,80.97,79.45,80.02,8555819,7263933.65,39.70173286347255,37.34688359725731,NaN,NaN,-68.93708620944011,-80.02805138091459,-0.12925538598522457,-1.1058791494541111,-0.9766237634688866,364686288,371666677.6,11.719563836950286,14.920802839932366,NaN,NaN,-22.784827911070174,-18.053871932392457
2021-10-05T09:30:00-04:00,80.24,81.18,79.7,80.73,6792058,7256919.5,43.89076557740046,37.14610609686412,NaN,NaN,-48.83666454375083,-74.83825161584431,-0.043548857381989436,-1.0310598351963733,-0.9875109778143839,371478346,369624083,11.197177450601004,14.197416256392879,NaN,NaN,-21.154502275159786,-18.496819124216362
2021-10-06T09:30:00-04:00,79.91,80.58,79.055,80.58,7724252,7332634.15,43.207815708337264,37.28392476629044,NaN,NaN,-63.67807676047699,-71.43475907387433,0.011883536913014803,-0.9726565566731153,-0.9845400935861301,363754094,367430590.2,10.648271144748932,13.574467449711326,NaN,NaN,-20.05831350931648,-18.719889750659235
2021-10-07T09:30:00-04:00,81.27,82.52,81.27,81.63,8469289,7509313.3,49.17016104993428,38.40866983621231,NaN,NaN,23.38006457850943,-47.386081042221626,0.12198894422120665,-0.8320539133096219,-0.9540428575308285,372223383,369076843.6,14.053625991216762,13.32463162670945,NaN,NaN,-17.218546096028007,-18.505412085711917
2021-10-08T09:30:00-04:00,81.83,82.03,81.03,81.18,6399037,7384756.05,46.89774217809975,39.81577066684463,NaN,NaN,12.531074054196631,-29.108137776192372,0.16458589629594844,-0.748310487160893,-0.9128963834568414,365824346,367593291.4,13.552363414187298,13.165235216791649,NaN,NaN,-15.561990100429124,-18.084923230671517
2021-10-11T09:30:00-04:00,81.46,82.378,81.18,81.19,4836766,7246092.35,46.95640890306404,41.26506788518736,NaN,NaN,34.2819481300897,-8.464330908286412,0.1916178546767371,-0.6733740651109201,-0.8649919197876572,370661112,368788256.2,16.14674457941537,13.307575337038914,NaN,NaN,-14.216400258964168,-17.53227709185618
2021-10-12T09:30:00-04:00,81.24,81.68,81,81.3,7665740,7327196.8,47.64164809446323,42.32673167317436,NaN,NaN,27.068269030888327,6.716655806641418,0.21342194715833906,-0.5982144858397334,-0.8116364329980724,378326852,370157957.4,19.142167580534178,13.760538618859476,NaN,NaN,-12.916009849670571,-16.87281034297252
2021-10-13T09:30:00-04:00,81.83,82.28,80.93,81.91,7215657,7371687.85,51.39173416792884,43.12356907087389,NaN,NaN,70.54612275546502,33.56149570982983,0.2622287081379123,-0.48385054782568204,-0.7460792559635944,385542509,374515640.4,27.959359234489952,14.896070267965438,NaN,NaN,-10.719706786974998,-15.99379554925859
2021-10-14T09:30:00-04:00,82.71,84.015,82.48,83.9,5687340,7374786.6,61.16404337969953,44.654124046543934,NaN,NaN,211.4907557317199,71.18363394047192,0.41287239134262643,-0.22998876678531133,-0.6428611581279378,391229849,378316933.6,34.65344539890572,16.539932481932492,NaN,NaN,-5.382827617020966,-14.477942987510357
2021-10-15T09:30:00-04:00,84.34,84.575,83.94,84.15,5852546,7169113.95,62.192386284021374,45.97569304843876,NaN,NaN,228.77744149190195,114.43290742801298,0.5074647389504395,-0.008530234439888318,-0.5159949733903278,397082395,384568543.4,43.88797633987506,18.67702096214169,NaN,NaN,-0.7679973318731658,-12.51937932241933
2021-10-18T09:30:00-04:00,83.43,84.25,83.28,84.09,6349897,6982720.7,61.76964469381215,47.58461843626406,NaN,NaN,176.97894449186492,142.97230670036802,0.5410264175597777,0.16028804855939427,-0.3807383690003834,390732498,388582820.6,48.88321095195734,21.01862966817232,NaN,NaN,2.8225779508186974,-10.327671140528183
2021-10-19T09:30:00-04:00,84.47,84.53,83.83,84.53,4795501,6841760.35,63.71734837173861,49.429562305602836,NaN,NaN,174.20160486010727,172.39897386621183,0.5652516198155014,0.32582615576899343,-0.23942546404650802,395527999,392023050,52.76414669182833,23.683330525070158,NaN,NaN,6.437900715780538,-7.932589446769795
2021-10-20T09:30:00-04:00,84.6,85.31,84.4,85.21,4651953,6691552.4,66.5533597480703,51.81152331881142,NaN,NaN,176.2275779838299,193.53526491188478,0.5963828909739074,0.5060531496708762,-0.09032974130303117,400179952,394950538.6,55.83688171124549,26.683771085835215,NaN,NaN,10.427343598154177,-5.309741868923513
2021-10-21T09:30:00-04:00,84.86,85.02,84.11,84.99,6696108,6788441.45,64.7889148225822,53.50312184590175,NaN,NaN,132.36969809923497,177.7110533853878,0.5714156249713433,0.6239397899111481,0.05252416493980469,393483844,395401337.6,56.30821224471231,29.768081897904818,NaN,NaN,13.245980413342732,-2.6589244000283356
2021-10-22T09:30:00-04:00,85.15,85.7325,84.83,84.83,5784213,6896357.3,63.47097590134248,55.20092492003532,NaN,NaN,126.60260348825038,157.27608578465748,0.5151223960601152,0.6964271600149488,0.1813047639548335,387699631,393524784.8,53.737204176717114,32.76934192217387,NaN,NaN,15.240142628259717,-0.10191482455861411
2021-10-25T09:30:00-04:00,85.37,86.04,84.85,85.68,5399652,6905514.25,67.27903993169343,56.87151594534197,NaN,NaN,120.70381608129777,146.02106010254408,0.5054274168788148,0.813089035053352,0.3076616181745372,393099283,393998141.8,54.30399477104268,35.84840030220543,NaN,NaN,18.13837763846691,2.5038412415878892
2021-10-26T09:30:00-04:00,85.83,86.27,85.12,85.92,5776969,6780099.55,68.28438759627768,58.66269965162343,NaN,NaN,112.6942544144665,133.71959001341594,0.4853667984497162,0.9143701162366824,0.4290033177869662,398876252,394667792.4,55.141295801344725,39.02647349196227,NaN,NaN,20.85107039958998,5.124873978445331
2021-10-27T09:30:00-04:00,85.59,85.74,84.63,84.69,5702093,6716716.15,58.38379656244346,59.320816473945506,NaN,NaN,77.76920346555642,114.02791510976124,0.3649425939973171,0.8851815602836126,0.5202389662862955,393174159,393266633.8,52.95487836178187,41.80513437557406,NaN,NaN,20.371675612196665,7.302988497552665
2021-10-28T09:30:00-04:00,84.79,85.6865,84.77,85.53,4151685,6387828.3,62.393910697233366,60.42768565388362,NaN,NaN,80.93614773293457,103.74120503650116,0.3191960600907726,0.9192340413997613,0.6000379813089887,397325844,394035033.8,54.03135003780917,44.696490562975626,NaN,NaN,21.18983442461025,9.286823629989463
2021-10-29T09:30:00-04:00,85.21,85.83,84.81,85.12,4349562,6142806.85,59.385982429004066,61.31551233430791,NaN,NaN,72.58227977174303,92.93714029319969,0.24215456007568537,0.9027311814035954,0.6605766213279101,392976282,395090364,55.536156695297,47.51001999982431,NaN,NaN,20.945695531186864,10.95237675873195
2021-11-01T09:30:00-04:00,85.26,85.8272,85.02,85.32,5520223,5991027.05,60.38914271884695,62.226047664621035,NaN,NaN,72.8460928181927,83.3655956405787,0.18791348002735808,0.8954684713621077,0.7075549913347496,398496505,396169808.4,57.08368284160434,50.220128232757894,NaN,NaN,21.036579143131505,12.392977099360458
2021-11-02T09:30:00-04:00,85.54,86.46,85.38,86.29,6635591,5983203.7,64.91538241371626,63.19202253932013,NaN,NaN,94.28134801851809,79.68301436138901,0.19951797684956019,0.9569524623966998,0.7574344855471397,405132096,397420977.2,58.870518232121384,52.42806816116014,NaN,NaN,22.49618957898143,13.83629316787774
2021-11-03T09:30:00-04:00,86.44,87.56,86.21,87.19,9593688,6076675.5,68.51073353421037,63.716786121785184,NaN,NaN,131.60877971402556,90.45092961108278,0.24686290041965764,1.0660131110717117,0.8191502106520541,414725784,401731302.2,64.37367538375105,54.550941731506235,NaN,NaN,24.90307143274794,15.417261491430626
2021-11-04T09:30:00-04:00,87.32,87.5113,86.77,87.14,5036572,5905039.65,68.09324861220747,64.13827628808419,NaN,NaN,129.8436106042793,100.23242218535174,0.2529379008288064,1.135322586688062,0.8823846858592557,409689212,404203975.8,67.09373675719496,56.20849604702909,NaN,NaN,26.696839957091424,17.028629843667883
2021-11-05T09:30:00-04:00,87.36,88.06,87.27,87.82,5829404,5876558,70.70758212595291,64.77670039037996,NaN,NaN,150.9379224539123,115.90355072178559,0.2788376493188778,1.230931747507853,0.9520940981889752,415518616,408712442.6,71.38382334649415,57.815682646638855,NaN,NaN,29.037418564625057,18.744171089518908
2021-11-08T09:30:00-05:00,88.78,89.23,88.61,88.92,5345020,5901970.7,74.36651551826476,65.5373551865604,NaN,NaN,198.82975576082598,141.10028331031225,0.3419733496212791,1.379560785215574,1.037587435594295,420863636,413185868.8,74.88289726178311,59.39559340163563,NaN,NaN,32.29669929400543,20.680246547302698
2021-11-09T09:30:00-05:00,88.95,89.33,88.59,89.33,7884261,5912896.75,75.59038758081036,66.18285717461326,NaN,NaN,182.79936794228757,158.80388729506615,0.3803245309306549,1.5129930992576135,1.1326685683269586,428747897,417909029,77.9487531828093,60.97501279246161,NaN,NaN,35.357974290216575,22.777064796290393
2021-11-10T09:30:00-05:00,89.24,89.647,88.54,88.72,6436232,5873925.5,70.21868763926936,66.57069809009093,NaN,NaN,150.62178564679394,162.6064884816198,0.3351699699628319,1.5516310307804986,1.2164610608176667,422311665,419426205.2,78.84214479084471,62.58457940289965,NaN,NaN,36.28439021627222,24.706682713430656
2021-11-11T09:30:00-05:00,89.12,89.8,88.93,89.43,4079195,5793518.25,72.6545021061102,67.22666424757433,NaN,NaN,143.2140315073806,165.2805726622401,0.3235181002908898,1.620858686181279,1.2973405858903893,426390860,422766534.8,80.69646039700368,64.51024056149154,NaN,NaN,37.82898977082957,26.581298007344788
2021-11-12T09:30:00-05:00,89.67,90.145,89.46,90.1,4387372,5720259.55,74.75301228394477,67.76051941559228,NaN,NaN,139.99115961986502,163.09122009543063,0.3301858089859533,1.7100728471228308,1.3798870381368775,430778232,425818458,82.22893871663376,66.50487941474805,NaN,NaN,39.79147645135404,28.468466356488968
2021-11-15T09:30:00-05:00,90.13,90.17,89.37,89.69,4314031,5618466.25,71.15451290502439,67.96552836621704,NaN,NaN,117.03457158837591,146.73218326094062,0.27831070501312727,1.7277754194032866,1.4494647143901593,426464201,426938571,82.76960047955126,68.47832974890567,NaN,NaN,40.311505504196624,30.160329091875777
2021-11-16T09:30:00-05:00,89.74,89.99,89.38,89.44,4388136,5598098,68.9741931082072,68.72198526234303,NaN,NaN,99.76705698309927,130.12572106910295,0.20203797871024642,1.7020121877779673,1.4999742090677208,422076065,425604204.6,79.66037249530649,70.38586504415741,NaN,NaN,40.09165782423321,31.57909033935541
2021-11-17T09:30:00-05:00,89.3,89.53,88.775,88.85,5279572,5629478.95,63.99072732320811,68.8360435927698,NaN,NaN,70.16919287788804,114.03520251532177,0.09231314661930878,1.6153656423418568,1.523052495722548,416796493,424501170.2,77.08264525220709,72.03238613090012,NaN,NaN,38.410078706030234,32.55494582030896
2021-11-18T09:30:00-05:00,88.92,89.09,88.29,88.47,5194591,5554403.1,60.93692008159339,68.94682485366903,NaN,NaN,47.40627655629398,94.87365152510444,-0.01943555122716889,1.4987580566885867,1.5181936079157556,411601902,421543378.6,70.49519508230374,73.10088887282917,NaN,NaN,36.09254357047803,33.06031692747597
2021-11-19T09:30:00-05:00,88.16,88.84,88.02,88.31,5213351,5525860,59.646210597656804,68.89375827358403,NaN,NaN,33.52416795126699,73.58025319138483,-0.11251053393080523,1.377555440502249,1.4900659744330542,406388551,416665442.4,61.20544517997038,73.39530046842674,NaN,NaN,33.80720485695723,33.167015203116144
2021-11-22T09:30:00-05:00,88.35,89.395,88.31,88.45,6690035,5590379.15,60.43587454043416,68.57379342549244,NaN,NaN,42.634859766131136,58.70031082693589,-0.16960031594977876,1.2780655794958307,1.4476658954456094,413078586,413988319.4,56.78283680624216,73.24618036657822,NaN,NaN,32.108934086614546,33.01586075790163
2021-11-23T09:30:00-05:00,88.48,89.17,88.09,88.54,7616338,5682347.6,60.96470277260724,68.03479122823508,NaN,NaN,33.03208581971763,45.35331659425957,-0.20394686038317755,1.1927323199666375,1.396679180349815,420694924,413712091.2,56.33054703813043,72.6716711990339,NaN,NaN,30.819940543329892,32.702157870105665
2021-11-24T09:30:00-05:00,88.07,88.27,87.715,87.91,5182620,5656373.95,55.38410259485157,67.12699508413823,NaN,NaN,-4.019684185447985,30.51554118159237,-0.2677217632932023,1.0620269762333123,1.3297487395265146,415512304,413455253.4,55.88481983140137,71.87103427576292,NaN,NaN,28.107153444127615,32.04572866639452
2021-11-26T09:30:00-05:00,85.91,86.81,85.47,86.4,7107505,5804164.95,44.79906353865262,65.27638661361678,NaN,NaN,-103.59263191825555,0.31575948668245246,-0.40214795748719867,0.8270637926675164,1.229211750154715,408404799,412815832.8,54.723867668800914,70.68103744164198,NaN,NaN,22.076672806608862,30.62157782928228
2021-11-29T09:30:00-05:00,87.06,87.2507,86.23,86.8,6140199,5893696.8,47.65314063056833,63.36828840735275,NaN,NaN,-84.43522333847797,-23.27611877126654,-0.4510018546536092,0.6654594318377036,1.1164612864913128,414544998,414447122.2,57.16849614732578,69.4157230763236,NaN,NaN,17.93856403221569,28.809718715415624
2021-11-30T09:30:00-05:00,86.36,86.58,84.49,84.65,12002301,6217800.7,36.676483560218806,60.58872383445335,NaN,NaN,-174.2387540148171,-66.6508415274562,-0.6053668101172983,0.35975277384468995,0.9651195839619883,402542697,412339944.4,53.17454986259902,67.64613712488001,NaN,NaN,9.869819520312701,26.10401883040092
2021-12-01T09:30:00-05:00,85.99,86.73,83.75,83.79,11242869,6448164.6,33.36575067485414,57.95637119413798,NaN,NaN,-186.39000296464974,-110.53525928432967,-0.734067447053288,0.047535275145378364,0.7816027221986663,391299828,406460925.2,43.94916558556027,65.15378146735969,NaN,NaN,2.0880532030759404,22.673166597925924
2021-12-02T09:30:00-05:00,84.07,85.85,83.91,85.5,8978673,6417413.85,44.15941181045565,55.92100760159122,NaN,NaN,-148.42014979093258,-139.41535240542657,-0.6742510020708747,-0.061211030389927146,0.6130399716809476,400278501,403414164.6,40.06935005706807,62.25184501450715,NaN,NaN,-0.6344373383269769,19.34350889274694
2021-12-03T09:30:00-05:00,85.64,86.56,84.55,85.31,9988682,6665019.35,43.319759512670174,53.6757752607859,NaN,NaN,-115.12452448780498,-141.72173091933647,-0.6191281860456455,-0.16087026087610923,0.45825792516953623,390289819,399791168.6,35.99956137799312,58.94974663317567,NaN,NaN,-2.976731770255889,16.154903083746536
2021-12-06T09:30:00-05:00,86.17,87.24,85.86,86.56,8122986,6779698.45,50.04893765046279,52.168234171174355,NaN,NaN,-58.23961496455245,-136.48260924455136,-0.4765283205520653,-0.1374024755205454,0.3391258450315199,398412805,396564730,32.80413788637412,55.3807850193773,NaN,NaN,-2.543975407213356,13.483634727895122
2021-12-07T09:30:00-05:00,87.56,88.43,87.55,87.88,5653471,6795121,55.99079795103519,51.240848802804926,NaN,NaN,6.853090958281169,-100.2642402499317,-0.2810215148465221,-0.012151048526632735,0.26887046631988937,404066276,396869445.8,33.40534874449847,52.07685475146245,NaN,NaN,-0.002206826538900197,11.557085934404547
2021-12-08T09:30:00-05:00,88.18,88.445,87.74,88.25,4608310,6631323.45,57.51629905748857,50.77838964096781,NaN,NaN,18.21075265486158,-59.34408912602945,-0.12258872955828246,0.11563455437203629,0.23822328393031875,408674586,400344397.4,39.998388159835166,49.42797924486445,NaN,NaN,2.4934627749334863,10.262282625908682
2021-12-09T09:30:00-05:00,87.59,88.18,87.4,87.76,3300773,6474550.5,54.806838561742794,50.3405266752642,NaN,NaN,3.9848839890071504,-28.863082370041504,-0.05030231679842945,0.17534538793228194,0.22564770473071138,405373813,401363459.8,41.817564995951145,47.379577095839274,NaN,NaN,3.6041904070298654,9.31112659464028
2021-12-10T09:30:00-05:00,88.43,88.64,87.72,88.3,4792550,6510218.25,57.19971834403513,50.165777228576935,NaN,NaN,28.940115597510445,-0.050154352978421454,0.03004668827598503,0.26320606507569266,0.23315937679970763,410166363,405338768.6,48.39099794358849,46.4642594360977,NaN,NaN,5.281537267529147,8.735470976481547
2021-12-13T09:30:00-05:00,88.25,88.45,87.4809,87.77,4703340,6526016.65,54.168205590887474,49.718086589323605,NaN,NaN,18.98944302518751,15.39565724496957,0.0428837596330687,0.2867640763410435,0.2438803167079748,405463023,406748812.2,50.52611982848904,46.017351080543904,NaN,NaN,5.719567154454894,8.304627573334884
2021-12-14T09:30:00-05:00,87.7,88.42,87.4399,87.68,4536787,6537154.45,53.64824271941663,49.19548229980999,NaN,NaN,22.323295873501277,18.489698228013587,0.04071474968389843,0.29477375381284787,0.25405900412894944,400926236,406120804.2,49.5430213660484,45.53252781825233,NaN,NaN,5.917221307238673,7.963569535321139
2021-12-15T09:30:00-05:00,87.31,87.975,86.36,87.87,7311540,6683324.65,54.63819438892043,49.14220314224348,NaN,NaN,3.996057802753701,15.646759257592018,0.04703007049240426,0.31284659224445477,0.2658165217520505,408237776,406033442.2,49.39902830949129,45.069256995258755,NaN,NaN,6.362048416762282,7.734780804098445
2021-12-16T09:30:00-05:00,88.47,89.34,88.4,88.77,6535634,6746127.75,59.094760193616814,50.16332433188377,NaN,NaN,90.32785054418879,32.91535256862834,0.10353549616535818,0.3952358919587482,0.29170039579339,414773410,407913361.6,52.592116918243036,44.91698908450462,NaN,NaN,8.07612857452118,7.783544771301693
2021-12-17T09:30:00-05:00,88.45,88.709,87.6,87.66,7832733,6878034.85,52.273609663082844,50.493357834206236,NaN,NaN,42.471742887105954,35.62167802654744,0.06002751682652391,0.3667347918265449,0.306707275000021,406940677,407268224.4,51.39356083212424,44.50449370484737,NaN,NaN,7.514190842192689,7.745065638571835
2021-12-20T09:30:00-05:00,85.98,86.03,84.57,85.66,7077762,6971255.4,42.70805509276145,50.924184372245,NaN,NaN,-98.78501325309432,12.06678677089108,-0.10082070267248944,0.1806813966594092,0.2815020993318986,399862915,406148202.8,49.29324727829714,44.227257805968655,NaN,NaN,3.700925255323844,7.167331298107836
2021-12-21T09:30:00-05:00,86.28,87.08,86.21,86.74,4531763,6863341.8,48.21843197749833,51.98509017957672,NaN,NaN,-21.75910846834066,3.2503059025226904,-0.12999538665673907,0.1190078660109748,0.24900325266771386,404394678,406841891.2,50.638749130347676,44.705085202024904,NaN,NaN,2.4126373653917796,6.488089307719828
2021-12-22T09:30:00-05:00,86.64,87.5,86.53,87.43,3095125,6637281.15,51.43241977017351,52.504590748128,NaN,NaN,11.654271900831986,4.781948722138347,-0.0997028674846159,0.12437466831194399,0.2240775357965599,407489803,406692296.6,50.32860074468495,45.43788882256896,NaN,NaN,2.4498435690324163,5.911197059335912
2021-12-23T09:30:00-05:00,87.57,88.595,87.44,88.31,2873018,6521801.05,55.24750741530778,53.356572741173544,NaN,NaN,71.60604695187503,1.0375880036755945,-0.021372842228111838,0.1973614830114201,0.21873432523953193,410362821,405810178.8,48.444407023363006,46.3268063686668,NaN,NaN,3.7540701765697695,5.6030360760836055
2021-12-27T09:30:00-05:00,88.59,89.65,88.4601,89.64,2459779,6289414.75,60.32064156976445,54.09026587826652,NaN,NaN,127.95514599639837,18.13426862553408,0.11172663359143853,0.3583926172288301,0.24666598363739156,412822600,406986563.4,51.07497299803664,47.631866019499846,NaN,NaN,6.6119038206252085,5.747160039589549
2021-12-28T09:30:00-05:00,89.6,90.255,89.58,90.16,4269052,6195857.4,62.1282758987929,54.52865716024922,NaN,NaN,150.99256809666966,68.08978489548687,0.22023029021417573,0.5219538464051112,0.3017235561909355,417091652,410432310.8,57.85778204681502,49.37846839823674,NaN,NaN,9.495758806497307,6.2826741491478
2021-12-29T09:30:00-05:00,90.08,90.69,90,90.53,2576989,5724591.8,63.40572086490064,54.94933014649293,NaN,NaN,160.6307706601176,104.56776072117853,0.2975552239385369,0.6736675861141066,0.3761123621755697,419668641,413487103.4,62.783775254958215,51.00599604788839,NaN,NaN,12.217424893524374,7.130495684058739
2021-12-30T09:30:00-05:00,90.56,91.08,90.135,90.21,3170006,5320948.65,61.47440031720602,55.42558455759745,NaN,NaN,158.21954274476403,133.88081488996494,0.3065720608044265,0.7593274381811028,0.4527553773766763,416498635,415288869.8,65.35598332281481,52.68731164266437,NaN,NaN,13.852430513778435,8.09077208830441
2021-12-31T09:30:00-05:00,90.05,90.84,90.03,90.61,3228878,5033458.9,62.99186238362333,55.83930913185376,NaN,NaN,144.7790027108914,148.51540604176822,0.3175520066280335,0.8496953856617182,0.5321433790336847,419727513,417161808.2,67.84395856005168,54.076808829554594,NaN,NaN,15.65788236658468,9.171787842344449
2022-01-03T09:30:00-05:00,90.72,90.8288,89.22,89.43,7544354,4911242.5,55.98610075256578,55.96915878625935,NaN,NaN,90.90058936829139,141.1044947161468,0.22763113012185787,0.816682291686007,0.5890511615641492,412183159,417033920,67.48756223288564,55.28834042986864,NaN,NaN,15.124388013717677,10.022159295397767
2022-01-04T09:30:00-05:00,89.69,90.87,89.65,90.53,9968869,5003536.65,60.40676248639002,56.45191019818601,NaN,NaN,106.17697500709588,132.14137609823206,0.22416683000046267,0.8692596990647274,0.6450928690642648,422152028,418045995.2,68.88077609993364,56.669608625146154,NaN,NaN,16.04734426946518,10.882900005978826
2022-01-05T09:30:00-05:00,91,92.305,90.49,90.52,10626376,5252181.9,60.34742240161194,56.85971219909255,NaN,NaN,127.688089772854,125.55283992077935,0.20372491296422424,0.8997490102695451,0.6960240973053209,411525652,416417397.4,64.1192881364666,57.721055755644386,NaN,NaN,16.762285805483973,11.72281226305099
2022-01-06T09:30:00-05:00,90.73,90.73,89.25,89.38,8934382,5468485.5,53.85271299709039,56.48528025648352,NaN,NaN,53.0319273613182,104.51531684409017,0.101135063226654,0.8224429263386384,0.7213078631119844,402591270,413635924.4,56.88659134959537,58.02780392931241,NaN,NaN,15.40378929955675,12.248666125408956
2022-01-07T09:30:00-05:00,89.49,89.64,88.91,89.3,8271830,5717038.35,53.418242378368646,56.56703973614679,NaN,NaN,23.936182412056592,80.34675278432321,0.019850626566839003,0.7461211463205331,0.726270519753694,394319440,408554309.8,46.55456707201534,57.68216151787606,NaN,NaN,14.183165817846966,12.525023224328672
2022-01-10T09:30:00-05:00,88.82,89.03,87.545,88.39,8409570,5897889.35,48.61374467930781,56.98887470661439,NaN,NaN,-26.860965432520096,56.7944418241609,-0.09683283000639187,0.6052294822457043,0.7020623122520961,385909870,403299652,38.722651579445454,56.92711896795809,NaN,NaN,11.673793407980936,12.403418964850424
2022-01-11T09:30:00-05:00,88.52,89.39,87.76,89.36,6807416,6003093.15,53.4226697721755,57.36060597766276,NaN,NaN,-2.2952732576663637,35.099992171208456,-0.10938905728045278,0.5653259906515302,0.674715047931983,392717286,397412703.6,32.189153970164895,55.60929074223075,NaN,NaN,10.936839606639506,12.19390762796315
2022-01-12T09:30:00-05:00,90.11,90.45,89.36,90.26,5107848,6031646.2,57.40565289403497,57.78726548651001,NaN,NaN,56.90403177765583,20.94318057216883,-0.0602400530061461,0.5994149816743004,0.6596550346804465,397825134,394672600,29.679048026408665,54.134322690925295,NaN,NaN,11.53279541388694,12.099463025952263
2022-01-13T09:30:00-05:00,90.12,90.59,89.34,89.56,6003074,5966222.9,53.568710485758515,57.667351420113626,NaN,NaN,41.72636241316857,18.682067582538906,-0.07696283988738528,0.5634514848212149,0.6404143247086002,391822060,392518758,27.841230228388397,52.66266720556997,NaN,NaN,10.855687756997117,11.921780844672956
2022-01-14T09:30:00-05:00,88.57,88.97,87.74,88.8,7294381,6004160.25,49.68575220337491,56.907716465371514,NaN,NaN,-33.493287862790844,7.1961735275694165,-0.13774979914382957,0.4682270757788132,0.6059768749226427,384527679,390560405.8,26.24961852138634,50.88942760009495,NaN,NaN,9.082414669588863,11.516157105375228
2022-01-18T09:30:00-05:00,87.84,87.99,86.95,87.63,7790865,6002066.85,44.35541008647079,55.63822605020565,NaN,NaN,-85.8562319948336,-4.6028797848932825,-0.24882005763933812,0.2949518028734701,0.5437718605128082,376736814,388725794.6,24.818230306273847,48.52945961862772,NaN,NaN,5.826144865957032,10.703298214029772
2022-01-19T09:30:00-05:00,88.28,88.5,87.365,87.41,7416432,6019000.35,43.41231036456748,54.21012530018186,NaN,NaN,-89.79408217422251,-22.10264156820451,-0.32439053559401365,0.13828369102029114,0.4626742266143048,369320382,384046413.8,21.585136717346174,45.586699723084,NaN,NaN,2.9192147628252347,9.591286292429125
2022-01-20T09:30:00-05:00,87.63,88.2774,86.04,86.14,8573630,6221093.7,38.34388706926001,52.55794578247143,NaN,NaN,-150.53560580021406,-63.5905690837785,-0.4400181048825124,-0.08734840448883574,0.3526697003936767,360746752,376630737.4,17.659035362713524,42.17977486879106,NaN,NaN,-1.2765700091703989,8.038735392200621
2022-01-21T09:30:00-05:00,85.63,85.95,83.76,84.04,16271249,6879899.9,31.74418390365227,50.32596874818778,NaN,NaN,-247.82049169176165,-121.49993990476453,-0.6266570654377579,-0.4306516314035207,0.19600543403423717,344475503,367161426,14.125803256185563,38.34276377565776,NaN,NaN,-7.447940135835532,5.826353173909743
2022-01-24T09:30:00-05:00,82.46,84.31,80.91,84.09,21229466,7797722.3,32.044093848339145,48.61582539788588,NaN,NaN,-252.3789199176317,-165.2770663157327,-0.7093844121813757,-0.6907250811924825,0.01865933098889322,365704969,363396884,13.011245697618762,34.45159830885298,NaN,NaN,-12.102016104302805,3.2651575627365212
2022-01-25T09:30:00-05:00,82.83,84.04,81.395,83.33,14655685,8407517.6,29.89397188202375,46.436340354716855,NaN,NaN,-201.45944892280673,-188.3977097013273,-0.7727207453968252,-0.9472416007571383,-0.1745208553603131,351049284,358259378,11.659223409123712,30.364344545223698,NaN,NaN,-16.668022325502886,0.4175604358451772
2022-01-26T09:30:00-05:00,84,84.7,81.625,82.46,13460817,8867105.85,27.610091807625864,44.09795959800356,NaN,NaN,-162.70726463430128,-202.98034619334308,-0.8258417278895425,-1.2068230152222412,-0.38098128733269876,337588467,351912995,10.243232048260566,26.516054824637553,NaN,NaN,-21.246688054602693,-2.677332205647376
2022-01-27T09:30:00-05:00,83.37,84.47,81.96,82.74,11587291,9317620.95,29.477506600589777,42.356873426824954,NaN,NaN,-133.79534664321554,-199.63229436194337,-0.7945026630341797,-1.3741096161254234,-0.5796069530912437,349175758,349598796.2,9.77694513468559,23.15108009500114,NaN,NaN,-24.381981333682173,-5.777996366795204
2022-01-28T09:30:00-05:00,82.38,83.25,81.23,83.22,11008194,9709530.35,32.68342644978907,40.875815146212126,NaN,NaN,-124.94425630360959,-175.05704728431297,-0.6972941572851707,-1.451224649697707,-0.7539304924125363,360183952,352740486,15.406821778882417,20.926241145491648,NaN,NaN,-26.04511521526669,-8.673299059433987
2022-01-31T09:30:00-05:00,82.78,84.505,82.64,84.45,7274794,9911826.15,40.18701536258178,40.27390590930312,NaN,NaN,-79.9568187767843,-140.5726270561435,-0.5144432702921561,-1.3969845802777314,-0.8825413099855753,367458746,353091241.4,16.03675759255202,19.30582014642783,NaN,NaN,-25.192528636075544,-11.03318899895421
2022-02-01T09:30:00-05:00,84.88,85.95,84.42,85.75,9304250,9999820.95,46.92128299350652,39.80952113939819,NaN,NaN,-36.9524089879978,-107.67121906918169,-0.2818589868055663,-1.2348650434925332,-0.9530060566869669,376762996,358233983.8,24.87053301574599,18.783061506826478,NaN,NaN,-22.26046541437904,-12.637085629729185
2022-02-02T09:30:00-05:00,85.73,86.4,85.27,86.02,7079560,9855355.5,48.22510767365437,39.153767909371005,NaN,NaN,-18.76217809967891,-78.88220176225722,-0.09538500644753722,-1.0722373147463884,-0.9768523082988512,383842556,367484801.6,37.5903032116289,19.348151162913634,NaN,NaN,-19.498752904785746,-13.617323811880123
2022-02-03T09:30:00-05:00,85.27,85.885,84.38,84.52,7771350,9712604.2,42.045877414002355,38.33070840424556,NaN,NaN,-38.40573908459066,-59.804280250532244,-0.06032720820263171,-1.0522613185521408,-0.9919341103495091,376071206,372863891.2,43.572654507768604,20.471824325726512,NaN,NaN,-18.99778980502318,-14.38596181090056
2022-02-04T09:30:00-05:00,83.38,84.05,82.63,83.12,11688072,9850288.7,37.24862198035697,37.44234195974428,NaN,NaN,-77.75343858432207,-50.36611670667476,-0.11549266290939686,-1.1362999389862551,-1.0208072760768583,364383134,373703727.6,44.46768172541242,21.77311455458551,NaN,NaN,-20.151026289575718,-15.209542450711297
2022-02-07T09:30:00-05:00,83.29,83.49,82.425,82.71,12627744,10068084.4,35.9548221986679,36.842299967758365,NaN,NaN,-81.57343296871744,-50.689439545061376,-0.16087372203905415,-1.221899428625676,-1.0610257065866218,351755390,370563056.4,41.797681627217024,22.98593250608145,NaN,NaN,-21.48492214905148,-16.106025264759893
2022-02-08T09:30:00-05:00,83.04,84.14,82.87,83.99,7750896,10035150.7,42.65191862515229,36.787986272085845,NaN,NaN,-53.35727100024974,-53.97041194751178,-0.08952464586221631,-1.172931513914392,-1.0834068680521758,359506286,367111714.4,39.02464290331874,24.231611519365206,NaN,NaN,-20.44793437478027,-16.726297994762803
2022-02-09T09:30:00-05:00,84.82,85.95,84.79,85.82,10734621,10231510.95,50.60458176352222,37.66375017881886,NaN,NaN,8.98776321312597,-48.42042368495079,0.08655214109087117,-0.9752166916885869,-1.061768832779458,370240907,364391384.6,36.94414352945697,25.609119245561164,NaN,NaN,-16.78050357662459,-16.734041649314488
2022-02-10T09:30:00-05:00,85.51,87.22,84.9,85.32,13310950,10641666.05,48.62068808873529,38.869214763467646,NaN,NaN,29.165551806778016,-34.906165506677056,0.17014756558803112,-0.8490843757944191,-1.0192319413824502,356929957,360563134.8,34.18233379904868,27.04172857005139,NaN,NaN,-14.514468791871286,-16.416959812536888
2022-02-11T09:30:00-05:00,84.89,85.67,83.715,84,12633402,10973182.45,43.74490233165006,39.70498679798986,NaN,NaN,-13.598146268495059,-22.075107043511657,0.13867696842273136,-0.845885730854036,-0.9845626992767673,344296555,356545819,31.519478520902865,28.36374520028597,NaN,NaN,-14.20210061146913,-16.100551355241493
2022-02-14T09:30:00-05:00,84.06,84.14,82.675,83.31,9448367,11080881.75,41.407352794782874,40.527371148901224,NaN,NaN,-55.971986269363065,-16.954817703640778,0.07662401412740305,-0.8887826816175135,-0.9654066957449166,334848188,353164378.6,29.440538095895263,29.63383910648394,NaN,NaN,-14.703733200797068,-15.901005904606574
2022-02-15T09:30:00-05:00,83.89,84.97,83.8,84.84,6675505,11025113.75,48.03786910802562,41.98649809892977,NaN,NaN,9.46719226269569,-4.389925051051691,0.14015612131107602,-0.7902115441060715,-0.9303676654171475,341523693,349567860,27.372569919130726,30.857363240117525,NaN,NaN,-12.924740980274162,-15.475825201130515
2022-02-16T09:30:00-05:00,84.75,85.64,84.59,85.46,7839026,11046243.45,50.48322203473795,43.486906344226064,NaN,NaN,61.32734067557937,6.077990441438992,0.2206785357772304,-0.6545194956956095,-0.8751980314728399,349362719,345392222.4,25.16263540345807,31.956341116458415,NaN,NaN,-10.696527045485379,-14.793068321752639
2022-02-17T09:30:00-05:00,84.58,84.84,83.71,84,6541914,10944657.65,45.100723130168596,44.37385610711033,NaN,NaN,5.343444140730299,1.31356890822945,0.17438531590534467,-0.6572163865911591,-0.8316017024965038,342820805,342570392,23.76621360700642,32.55344053275299,NaN,NaN,-10.545976515478275,-14.186340920856301
2022-02-18T09:30:00-05:00,84.18,84.62,83.39,83.86,8964834,10579336.9,44.60956119792517,44.68975223820628,NaN,NaN,-8.612023825597364,2.3107933968089887,0.13487513716891408,-0.6630077810353612,-0.7978829182042753,333855971,340482275.2,22.759664621892014,33.03364817770584,NaN,NaN,-10.579435575157406,-13.671068728613601
2022-02-22T09:30:00-05:00,83.46,83.82,81.99,82.67,10654414,10050584.3,40.56563618014016,44.23577746582298,NaN,NaN,-87.81389069009042,-4.0575874873364794,0.03437167133509611,-0.7549183290354051,-0.7892900003705012,323201557,338152949,21.65774875213907,32.80416358744821,NaN,NaN,-11.880262920159765,-13.41523932740591
2022-02-23T09:30:00-05:00,83.2,83.5,81.49,81.61,9581100,9796855.05,37.32027136647896,43.45686058673902,NaN,NaN,-125.4392893528833,-31.03888381045228,-0.09087469115727198,-0.9028833643170913,-0.8120086731598193,313620457,332572301.8,19.25275277909347,31.494338556552815,NaN,NaN,-14.011885611853101,-13.500474510898366
2022-02-24T09:30:00-05:00,79.77,81.6,79.38,81.37,15903697,9918999.05,36.60618657977345,43.06831124143695,NaN,NaN,-195.20659870826952,-82.34567168722205,-0.17252619451030904,-1.0276664162977056,-0.8551402217873966,297716760,322243110,15.763580795974363,29.507976148567515,NaN,NaN,-15.942666453073972,-13.84935907406631
2022-02-25T09:30:00-05:00,81.74,84.38,81.67,84.34,11129434,9896106.2,49.486875964651176,43.94247224031511,NaN,NaN,-30.21072948890575,-89.45650641314927,-0.01732505504864812,-0.8767965405982068,-0.8594714855495587,308846194,315448187.8,13.969971329777195,27.329568263164997,NaN,NaN,-13.41242485222272,-13.786939899517225
2022-02-28T09:30:00-05:00,83.04,83.95,82.57,83.38,11230230,9907208,46.21796904401899,44.67555415784019,NaN,NaN,-44.36861001506436,-96.60782365104266,0.02743090064428466,-0.8251828597442028,-0.8526137603884875,297615964,308200186.4,12.35510061060198,25.22652676197821,NaN,NaN,-12.442110637941878,-13.59482143357789
2022-03-01T09:30:00-05:00,83.14,83.79,80.97,81.46,13131963,10200066.45,40.4613491385626,44.51908490879807,NaN,NaN,-109.54035140713691,-100.95311579445197,-0.060711704159614466,-0.9285033905880056,-0.8677916864283911,284484001,300456675.2,10.904781531863705,23.217965235445707,NaN,NaN,-13.594748215342792,-13.594810973830018
2022-03-02T09:30:00-05:00,81.96,83.71,81.77,83.25,9571447,10213426.3,47.07923532882039,44.26727444917651,NaN,NaN,-53.38338025231782,-86.54193397433887,0.00936993600064473,-0.8560792664275851,-0.8654492024282299,294055448,296543673.4,10.249997849097412,21.311240543991453,NaN,NaN,-12.237261017681638,-13.400875265808821
2022-03-03T09:30:00-05:00,83.99,84.29,82.51,83.35,9736032,10346249.9,47.430782389151716,44.18228118492055,NaN,NaN,-17.74026668526443,-51.048667569737844,0.06707646437847026,-0.7816036219551421,-0.8486800863336124,303791480,297758617.4,12.016495370536688,19.727966370526307,NaN,NaN,-11.082906412793713,-13.069736858235235
2022-03-04T09:30:00-05:00,82.33,83.095,81.68,83.06,8664522,10390908.5,46.46677019440792,44.37670031797468,NaN,NaN,-65.99954074664778,-58.20642982128625,0.08895967114435466,-0.737480497403169,-0.8264401685475237,295126958,295014770.2,11.467539836449234,18.295685035922478,NaN,NaN,-10.459521475517002,-12.696848946418344
2022-03-07T09:30:00-05:00,82.83,82.89,80.17,80.18,10913229,10352166.35,38.169772272708876,44.14544456639796,NaN,NaN,-153.66878036728812,-80.066463891731,-0.07824814629499077,-0.9242503514162621,-0.8460022051212713,284213729,292334323.2,10.941673834560149,16.974337588684257,NaN,NaN,-12.704369906870946,-12.697923369340144
2022-03-08T09:30:00-05:00,80.29,81.45,79.29,79.77,12995031,10370530.7,37.152715698885515,43.36793360860224,NaN,NaN,-179.14900977254723,-93.98819556481307,-0.19740127133328123,-1.092753794287873,-0.8953525229545917,271218698,289681262.6,10.431770906030152,15.76428051631993,NaN,NaN,-14.802183859733836,-12.998532010824956
2022-03-09T09:30:00-05:00,81.09,82.73,80.65,82.24,10313262,10498649,46.41588105191303,43.077409252686174,NaN,NaN,-72.05367361344055,-97.72225423703762,-0.09594365322057352,-1.0152820894803085,-0.919338436259735,281531960,287176565,9.959870608582463,14.678368745257387,NaN,NaN,-13.504936095443792,-13.07087545148479
2022-03-10T09:30:00-05:00,81.39,82.565,81.28,82.46,7795020,10351668.95,47.162884169863936,43.22470646980728,NaN,NaN,-52.87489164981009,-104.74917922994675,-0.0049011398300200515,-0.92546486104726,-0.92056372121724,289326980,284283665,9.429310084815,13.654304207958,NaN,NaN,-12.256037946741088,-12.954470093664261
2022-03-11T09:30:00-05:00,82.57,83.28,81.78,81.85,6931465,10032694.7,45.27808030668178,43.272457834718466,NaN,NaN,-34.51521471736217,-98.45231402408963,0.021883298422657793,-0.8932095981889177,-0.9150928966115754,282395515,281737376.4,8.976071944161689,12.669761873834407,NaN,NaN,-11.820879538599677,-12.792528585797891
2022-03-14T09:30:00-04:00,82.38,82.91,81.32,81.73,7815576,9791803.4,44.897953543064936,43.581909074927374,NaN,NaN,-48.76136458420027,-77.47083086747207,0.038208714359319496,-0.8673320036624261,-0.9055407180217456,274579939,279810618.4,8.63773409020449,11.739760826553367,NaN,NaN,-11.582570282131183,-12.619677399559789
2022-03-15T09:30:00-04:00,81.77,82.83,81.22,82.67,9084881,9773629.1,48.542319175484494,44.38348391842777,NaN,NaN,-28.488870829379717,-47.33880307883856,0.11468245071125005,-0.7621876546326831,-0.8768701053439332,283664820,282299842.8,13.190278492786504,11.306726948960014,NaN,NaN,-10.310308705214883,-12.289767586081945
2022-03-16T09:30:00-04:00,83.6,84.76,82.28,83.97,11946590,10037183.35,53.156588233611785,45.56565546513051,NaN,NaN,74.91756221384227,-17.944555913381997,0.24756008387774409,-0.5674200004967531,-0.8149800843744972,295611410,285115732.8,18.15845985501707,11.477789738891634,NaN,NaN,-7.808387855447364,-11.649570481705576
2022-03-17T09:30:00-04:00,83.69,85.62,83.58,85.58,7051478,9997805.95,58.160466611215014,46.185197654170786,NaN,NaN,168.25913861744587,26.282250140069202,0.428044158018122,-0.2799248868518447,-0.7079690448699667,302662888,287782914.4,22.672688709523143,12.099412408873487,NaN,NaN,-4.035386930695316,-10.561829974418396
2022-03-18T09:30:00-04:00,85.16,86.245,84.93,86.1,9621090,10151764.75,59.65933476813309,47.14529520589322,NaN,NaN,203.80074116384372,73.94544131631037,0.5583689008868852,-0.010007918761360202,-0.5683768196482454,312283978,293760607,31.757767160069108,13.485317162406849,NaN,NaN,-0.486807353092408,-9.122541028514684
2022-03-21T09:30:00-04:00,86.13,86.87,85.92,86.49,8879687,10147507.4,60.79376473235833,48.597610605450065,NaN,NaN,211.35934297572155,125.96958282829473,0.6408539763218715,0.232690650754094,-0.40816332556777746,321163665,303077352.2,42.99855954299364,15.77772987748756,NaN,NaN,2.768783998467799,-7.42378031037433
2022-03-22T09:30:00-04:00,87.15,87.51,86.64,86.96,6965948,9963084.1,62.174275575446316,49.67582776592334,NaN,NaN,193.64662830729384,170.39668265562946,0.6926748483252767,0.4576802348388185,-0.23499461348645825,328129613,311970310.8,51.25252357076833,18.706481714749767,NaN,NaN,5.891515509951853,-5.521595193184875
2022-03-23T09:30:00-04:00,86.75,87.15,86.45,86.56,5789395,9773498.85,60.2304920006533,50.59009273817345,NaN,NaN,149.4764618163539,185.30846257613177,0.665459342327331,0.5968295644227055,-0.06862977790462549,322340218,317316072.4,55.430469369529746,21.807479857534986,NaN,NaN,7.985464076058664,-3.592015297578655
2022-03-24T09:30:00-04:00,87.1,88.34,87.03,88.3,5452645,9250946.25,65.31095668850855,51.93610605918064,NaN,NaN,165.8979498200981,184.8362248166622,0.725185131703182,0.837851636724352,0.11266650502117001,327792863,322342067.4,58.989282465053535,25.201890045292433,NaN,NaN,11.424079150838226,-1.4468589478048148
2022-03-25T09:30:00-04:00,88.5,89.34,88.34,89.29,5025018,8945725.45,67.82913557899752,54.05463200962983,NaN,NaN,165.28923395361693,177.13392337461687,0.7867570246469971,1.0961127858299164,0.3093557611829193,332817881,326448848,61.6816714743397,28.826175590990974,NaN,NaN,15.136581580209397,0.9222039847686436
2022-03-28T09:30:00-04:00,88.96,89.02,88.01,88.89,5353431,8651885.5,65.75224172795345,56.09745529742039,NaN,NaN,128.92406120938776,160.6468670213501,0.7557585880610944,1.2540539962592874,0.49829540819819296,327464450,327709005,62.495314318090976,32.545000120423886,NaN,NaN,17.614085242792626,3.306758450200641
2022-03-29T09:30:00-04:00,88.97,89.64,88.3,89.64,7828060,8386690.35,67.74641100487644,57.62106457977492,NaN,NaN,124.66786307831673,146.85111397555468,0.7400316382734753,1.423334956040037,0.6833033177665617,335292510,329141584.4,63.44558177772939,36.36540806107724,NaN,NaN,20.31001952519463,5.735795746628353
2022-03-30T09:30:00-04:00,89.67,89.83,88.91,89.34,4483574,8132296.7,66.08872630792132,58.97291044677902,NaN,NaN,113.14836151506758,139.5854939152974,0.6660057644433864,1.5158105233207948,0.8498047588774084,330808936,330835328,64.58799824222547,40.30531435803521,NaN,NaN,22.09439341727483,8.072738271006422
2022-03-31T09:30:00-04:00,88.97,89.64,88.14,88.15,5299680,7910479.1,59.83444654454206,60.01265089234047,NaN,NaN,85.27994733219695,123.46189341771719,0.5010041304354469,1.476059921921717,0.9750557914862701,325509256,330378606.6,64.00709861724384,44.236101977541075,NaN,NaN,21.875697536759464,10.044589594685428
2022-04-01T09:30:00-04:00,88.66,89.41,88.14,89.08,6242029,7789354.45,62.797520420076665,61.2911913835556,NaN,NaN,82.33245066515398,106.8705367600246,0.4217818682858361,1.5022831268435652,1.0805012585577292,331751285,330165287.4,63.718841254368996,48.1704667749814,NaN,NaN,22.542251395730514,11.829969851977584
2022-04-04T09:30:00-04:00,89.23,89.23,88.31,89.1,5759033,7531644.65,62.86097324664921,62.31395238863879,NaN,NaN,76.35420392089195,96.35656530232545,0.34144201621529846,1.5073037788268522,1.1658617626115537,337510318,332174461,65.30375957757934,51.892858281038016,NaN,NaN,23.102555830585338,13.440339277492978
2022-04-05T09:30:00-04:00,89.05,89.66,88.13,88.39,5728677,7168326.95,59.01293535592803,62.73226289737567,NaN,NaN,67.49248443203834,84.92148957306978,0.2172481182260202,1.4374219103940789,1.2201737921680587,331781641,331472287.2,64.24744460203132,55.18492862011046,NaN,NaN,22.511011834647913,14.736149642800825
2022-04-06T09:30:00-04:00,87.82,87.85,86.61,87.37,8397792,7072553.45,53.90748759199904,62.42847868171738,NaN,NaN,23.593125024752073,67.01044227500668,0.051799175012521514,1.2849227609337106,1.233123585921189,323383849,329987269.8,61.96462961360259,57.99149582754471,NaN,NaN,20.50732333420579,15.560603027287248
2022-04-07T09:30:00-04:00,87.48,88.3,86.87,87.94,5764577,6971031.3,56.18853226010191,62.18056421685801,NaN,NaN,31.25813220825139,56.206079250217556,-0.029482499637479398,1.1962704613743398,1.2257529610118192,329148426,330715103.8,62.66482386627341,60.199142735130735,NaN,NaN,19.43855022728962,16.114595484430446
2022-04-08T09:30:00-04:00,88.45,89.06,87.99,88.48,5155523,6882234.2,58.29426281169378,62.002028365381975,NaN,NaN,53.778226787151986,50.495234474617156,-0.055596174580226254,1.1562577427865364,1.2118539173667626,334303949,331225636.6,63.17689150765635,61.64045216117807,NaN,NaN,19.113009894610997,16.542940400170526
2022-04-11T09:30:00-04:00,88.19,88.98,87.93,88.04,6133097,6798110.25,55.93517765921585,61.55637851422266,NaN,NaN,41.057027543515424,43.43579919914185,-0.10817728971043938,1.0766323052287134,1.1848095949391528,328170852,329357743.4,59.9378015270145,62.26082915805279,NaN,NaN,18.177001536255837,16.77637770532557
2022-04-12T09:30:00-04:00,88.47,89.21,87.7,88.06,7147807,6701256.55,56.02229655288104,61.25579312509607,NaN,NaN,34.88224531092551,36.913751374919286,-0.14498861136793217,1.0035738307292377,1.1485624420971698,335318659,330065147,60.7583642234801,62.6413930761921,NaN,NaN,17.424746255421404,16.869001783910686
2022-04-13T09:30:00-04:00,88.23,89.4,87.88,89.36,8530764,6530465.25,61.36865634484134,60.97420024340555,NaN,NaN,62.40663993620721,44.67645435721032,-0.08796895361917634,1.0386012500731994,1.1265702036923757,343849423,334158261.8,65.19986065648649,63.0850058041516,NaN,NaN,18.232741120857618,17.06382168918882
2022-04-14T09:30:00-04:00,89.46,90.12,89.01,89.06,6332024,6494492.55,59.56892377904607,60.38418511483759,NaN,NaN,96.41865108784881,57.708558133129806,-0.07703468353513032,1.0302768492734629,1.1073115328085932,337517399,335832056.4,66.85209346239225,63.45432166044107,NaN,NaN,18.41306660297994,17.256570962587553
2022-04-18T09:30:00-04:00,89,89.665,88.84,89.14,6221508,6324513.45,59.90659011876457,59.966638571324104,NaN,NaN,81.0981900028145,63.1725507762623,-0.07113274424582294,1.0183956025013146,1.0895283467471375,343738907,337719048,68.65868495589979,63.89456242028456,NaN,NaN,18.652858849776162,17.456040660757353
2022-04-19T09:30:00-04:00,88.89,90.17,88.67,89.98,5060676,6133562.9,63.36620940386842,59.65376702839496,NaN,NaN,116.16408872187895,78.19396301193501,-0.02003081140199492,1.064489832494644,1.0845206438966388,348799583,341844794.2,72.22322065817454,64.52153662603064,NaN,NaN,19.819770296868157,17.793716323058895
2022-04-20T09:30:00-04:00,90.12,90.9,89.95,90.55,8644695,6217500.25,65.53921448194599,59.614516183682426,NaN,NaN,195.07288722619424,110.23209139498877,0.03953763901101848,1.133942692660412,1.0944050536493934,357444278,346269918,75.44852658720109,65.29728865067175,NaN,NaN,21.43939289613324,18.314527262069515
2022-04-21T09:30:00-04:00,91.23,91.49,88.82,89.07,7664344,6311247.7,56.215177046770414,59.35599693384159,NaN,NaN,116.66185095630169,121.08313359900765,-0.029626263093300853,1.0573722247827675,1.0869984878760683,349779934,347456020.2,76.24474123186842,66.17140598028779,NaN,NaN,20.143413199473503,18.575796681698655
2022-04-22T09:30:00-04:00,88.33,88.3531,85.58,85.74,9412122,6509221.55,41.80428714304618,57.85648027119656,NaN,NaN,-237.1666082272785,54.366081735982185,-0.29384657757546684,0.7196902659067348,1.0135368434822016,340367812,348026102.8,76.63691909083971,67.09412582574998,NaN,NaN,13.530387486125594,17.85502393947393
2022-04-25T09:30:00-04:00,84.83,85.72,83.14,85.5,13343899,6925165.6,40.98873188634649,56.29417731688922,NaN,NaN,-298.25074456208995,-21.503705176998704,-0.4686072899909405,0.427777730993526,0.8963850209844665,327023913,344683104,69.40132514170297,67.38680908033025,NaN,NaN,8.182715606168383,16.473265606144565
2022-04-26T09:30:00-04:00,85.88,86.36,84.14,84.18,10540707,7184529.4,36.74298256580287,54.703466403308845,NaN,NaN,-215.9390715456568,-87.92433723050586,-0.6459902377479682,0.08889722379950626,0.7348874615474744,316483206,338219828.6,57.99978199341173,66.94054746542885,NaN,NaN,2.185601062020262,14.432170671269665
2022-04-27T09:30:00-04:00,84.94,86.39,84.665,85.42,13024788,7444365.8,42.742979751605006,53.90600155756642,NaN,NaN,-144.79191388374414,-155.89729745249355,-0.650872482787669,-0.07870314193711181,0.5721693408505572,329507994,332632571.8,50.305901091018725,66.10778114238714,NaN,NaN,-0.7574498954402237,12.262224876025396
2022-04-28T09:30:00-04:00,85.84,87.07,84.39,86.77,10351489,7737761.55,48.473211391588904,53.354907209815494,NaN,NaN,-97.01555371802317,-198.6327783873585,-0.5388752808394144,-0.10142476019871083,0.43745052064070356,339859483,330648481.6,47.87708697006886,65.05151422122967,NaN,NaN,-1.2275767476794954,10.335110358353269
2022-04-29T09:30:00-04:00,87.05,87.77,84.82,85.03,10632858,8004420.45,42.56093463868822,52.23109805460081,NaN,NaN,-93.01260664541047,-169.80197807098492,-0.5554597596712891,-0.2568741789484079,0.2985855807228812,329226625,328420244.2,45.23564620440419,63.7699966995688,NaN,NaN,-3.732051541144062,8.325515801282222
2022-05-02T09:30:00-04:00,85.14,85.5,83.13,84.77,16419088,8513273.4,41.74165639169898,51.21727510692103,NaN,NaN,-134.20027323999355,-136.99188380656562,-0.5560512115897458,-0.39647843376430103,0.15957277782544477,312807537,325576969,42.04779184279392,62.49213886498162,NaN,NaN,-5.9354063290358035,6.28824121123679
2022-05-03T09:30:00-04:00,84.83,86.2,84.66,85.72,11422531,8796448.3,45.843734422477674,50.49023495474936,NaN,NaN,-79.50329723624034,-109.70472894468234,-0.4681008127801981,-0.42555323814980284,0.04254757463039524,324230068,327126341.4,44.349286708717216,61.320061899641416,NaN,NaN,-6.405403056402305,4.47486345871692
2022-05-04T09:30:00-04:00,86.28,88.56,85.49,88.5,14905588,9255293.85,55.6785388502121,50.083797990847266,NaN,NaN,3.4588347378041995,-80.05457922037267,-0.21141138128606768,-0.22171665197718937,-0.010305270691121693,339135656,329051873.8,47.15794815840089,60.03135386406387,NaN,NaN,-3.273214951600815,3.3679951143858147
2022-05-05T09:30:00-04:00,87.88,88.17,84.825,85.76,12271817,9448995.1,46.68058504099816,49.16320236670099,NaN,NaN,-45.64216902960204,-69.77990228268844,-0.21420733225306637,-0.2780644360074547,-0.0638571037543883,326863839,326452745,43.934670720596124,58.39439509679272,NaN,NaN,-3.966340672859623,2.3202328590650376
2022-05-06T09:30:00-04:00,85.08,85.08,83.13,84.53,14357853,9878658.9,43.29789688016014,47.9768671353721,NaN,NaN,-110.19273553181905,-73.21592805997015,-0.28264423130511773,-0.4171623928857855,-0.13451816158066776,312505986,323108617.2,40.133722294569,56.356897763840514,NaN,NaN,-5.7534964758508504,1.1668429540770535
2022-05-09T09:30:00-04:00,82.99,83.74,81.63,81.86,13940872,10317926.35,37.02569873783728,46.09540208779844,NaN,NaN,-154.6855101088735,-77.31297543374615,-0.4798892621267023,-0.7343797392390456,-0.25449047711234335,298565114,320260132.6,37.182896874005124,53.8540174935427,NaN,NaN,-9.66385720808912,-0.3803999262323996
2022-05-10T09:30:00-04:00,83.22,83.44,80.38,81.35,17015214,10862032.2,35.95430892777445,43.98219454821476,NaN,NaN,-157.037173457,-92.81975067789809,-0.6085889055194668,-1.0152266090116768,-0.40663770349221007,281549900,311724099,30.05212974938503,50.611417719412984,NaN,NaN,-12.997505462915948,-2.1828435743300494
2022-05-11T09:30:00-04:00,81.58,83.57,81.21,81.39,16918208,11350552.25,36.110461268821446,42.54614342121841,NaN,NaN,-131.37996396461676,-119.78751041838227,-0.6510921677236738,-1.2205029131468024,-0.5694107454231285,298468108,303590589.4,25.110645081408535,46.95898228009442,NaN,NaN,-15.482808699690354,-4.082838592238664
2022-05-12T09:30:00-04:00,80.54,82.05,79.76,81.24,13229117,11585469.9,35.75837241423943,42.114292369160786,NaN,NaN,-146.57617874837885,-139.97431236213762,-0.6479825022349349,-1.3793888732167972,-0.7314063709818622,285238991,295265619.8,21.25773749188194,43.00332645159744,NaN,NaN,-17.551207802035552,-6.006891336495363
2022-05-13T09:30:00-04:00,81.89,83.305,81.885,82.49,8647669,11701252.15,40.92739907153743,42.109911453817276,NaN,NaN,-91.49812181664888,-136.23538961910361,-0.5256249386002165,-1.3884375442321328,-0.8628126056319163,293886660,291541754.6,19.794636725930644,39.45999156475656,NaN,NaN,-17.725905280716734,-7.681036185669845
2022-05-16T09:30:00-04:00,82.14,83,81.385,82.34,8346281,11807490.8,40.50620742602574,42.37871322954748,NaN,NaN,-91.56569463792512,-123.61142652491392,-0.42308601208196683,-1.391670120734375,-0.9685841086524081,285540379,288936807.6,18.818882049028232,36.66135585444346,NaN,NaN,-17.98864752748494,-9.15355209164343
2022-05-17T09:30:00-04:00,84.19,84.8,83.34,84.67,7568398,11932876.9,49.24401038925765,42.84307256080838,NaN,NaN,-22.09177593894408,-96.62234702130274,-0.17911217845230554,-1.19247433171779,-1.0133621532654844,293108777,291248583,22.471352757152133,34.67317383059584,NaN,NaN,-15.459920254612266,-10.054461829210407
2022-05-18T09:30:00-04:00,83.86,84.05,81.69,82.04,6966247,11848954.5,41.784208660691164,42.36528665145854,NaN,NaN,-72.9260561456481,-84.93156545750901,-0.17540657625146872,-1.2326203735798202,-1.0572137973283515,286142530,288783467.4,21.367377663628062,32.779623165850076,NaN,NaN,-15.679942047188913,-10.858101860350194
2022-05-19T09:30:00-04:00,81.5,83.59,81.4,82.62,8097544,11870614.5,43.805929963484836,42.454214888944016,NaN,NaN,-67.00318673364619,-69.01696705456247,-0.11723621260856043,-1.203759063089052,-1.0865228504804916,294240074,290583684,24.29248109423004,31.283682800837635,NaN,NaN,-15.200326059546294,-11.478419603092494
2022-05-20T09:30:00-04:00,83.43,83.75,80.62,82.42,8057183,11802867.55,43.248185765408856,42.561824129923295,NaN,NaN,-69.60754297930946,-64.63885128709458,-0.07748835097045248,-1.1833832891935572,-1.1058949382231047,286182891,289042930.2,23.487172427802363,29.957924271195377,NaN,NaN,-14.988291423547736,-11.979829863157528
2022-05-23T09:30:00-04:00,83.47,84.13,82.9,83.93,6380142,11454679.7,48.57211701768997,42.75670860100988,NaN,NaN,-9.72097526626087,-48.269907412761754,0.057933811481270636,-1.0334776738715163,-1.091411485352787,292563033,290447461,25.89873655757306,28.64002783182794,NaN,NaN,-13.144438508501999,-12.146202526778167
2022-05-24T09:30:00-04:00,83.65,83.74,82.02,83.45,7029807,11279134.7,47.060781807436335,42.1411545265259,NaN,NaN,-30.885678089769506,-50.028687842926836,0.1190945247611983,-0.942543329401289,-1.0616378541624873,285533226,288932350.8,24.983942828131575,27.056170308237274,NaN,NaN,-12.087381810654268,-12.137799567331895
2022-05-25T09:30:00-04:00,83.13,84.175,82.84,83.82,5535806,10904685.6,48.393754348686635,42.26352376278937,NaN,NaN,-3.942146439925741,-36.23190590178236,0.18447702846289338,-0.8310415685838706,-1.015518597046764,291069032,289917651.2,26.794846613243877,25.831897157712113,NaN,NaN,-10.831769443480981,-11.951223835353193
2022-05-26T09:30:00-04:00,84.4,85.79,84.24,85.36,5536633,10663942.8,53.62744863674809,43.00134888825994,NaN,NaN,70.04852366885675,-8.821563821281766,0.3233244159307217,-0.6113630771333618,-0.9346874930640835,296605665,290390769.4,27.69741608470423,24.9435895712932,NaN,NaN,-8.142319765906885,-11.40709468257515
2022-05-27T09:30:00-04:00,86.08,87.39,85.94,87.36,6794375,10472018.65,59.38788811108587,44.59864812920626,NaN,NaN,144.99413744846706,34.098772264273535,0.5295587634167599,-0.27273903879313366,-0.8022978022098936,303400040,293834199.2,34.068832809209766,24.72115642380782,NaN,NaN,-3.896766946707807,-10.334190720308387
2022-05-31T09:30:00-04:00,86.54,86.86,85.74,86.03,9245419,10113335.2,54.5362722768241,45.925931225566956,NaN,NaN,102.56763341313139,56.556494000151986,0.5534990146051777,-0.11042403395342149,-0.6639230485585992,294154621,294152516.8,34.64220115353922,25.04901866696169,NaN,NaN,-1.8194245251733325,-9.117795549574808
2022-06-01T09:30:00-04:00,86.17,86.435,84.34,85.17,7175029,9900960.1,51.600809794719424,47.032384691702525,NaN,NaN,65.62442156821017,75.85851393174792,0.4906586361097409,-0.05059975342142309,-0.541258389531164,286979592,294441790,35.19376018808448,25.769241174581403,NaN,NaN,-1.009625671237985,-7.959485566955262
2022-06-02T09:30:00-04:00,86.08,87.52,85.885,87.52,6525394,9481950.4,58.21879958400045,48.636700918114016,NaN,NaN,140.61625260831485,104.77019374139604,0.5804564272011576,0.1843121444702831,-0.39614428273087454,293504986,294928980.8,36.170749676489315,26.83445633062479,NaN,NaN,1.896798455869032,-6.551444992266077
2022-06-03T09:30:00-04:00,86.74,87.36,86.36,86.67,5325675,9134643.3,55.27471517302188,49.661509211077195,NaN,NaN,128.89012271860295,116.53851355134529,0.5556780154756451,0.29845323661368184,-0.25722477886196327,288179311,293243710,34.24740953601375,27.86679724563072,NaN,NaN,3.3243040447406536,-5.140623701265116
2022-06-06T09:30:00-04:00,87.31,87.84,87.02,87.49,5592117,8696356.5,57.50716803303449,50.87586354014925,NaN,NaN,133.51332851656215,114.24235176496431,0.5656933807975711,0.4498919471350007,-0.11580143366257048,293771428,291317987.6,32.1440757508299,28.81859679575941,NaN,NaN,5.1938556550722295,-3.664269507502638
2022-06-07T09:30:00-04:00,86.75,88.225,86.52,88.12,6205867,8309606.25,59.192481714923616,51.58646863483967,NaN,NaN,120.90832137205228,117.91048935674849,0.5835771037373565,0.6136699460091251,0.030092842271768616,299977295,292482522.4,34.75371070297153,29.69590807760365,NaN,NaN,7.240989435112594,-2.1063753728433197
2022-06-08T09:30:00-04:00,87.21,87.95,86.095,86.29,4237813,7670736.2,52.65915763064238,52.3632507041219,NaN,NaN,81.17681958574128,121.0209689602547,0.4471335232322772,0.5890097463121151,0.14187622307983794,295739482,294234500.4,38.580703861550774,30.925431377455272,NaN,NaN,6.9994565663928725,-0.8055422386667208
2022-06-09T09:30:00-04:00,85.63,85.92,84.22,84.25,5406431,7095147.35,46.49795781982868,52.55553840814646,NaN,NaN,7.646444157601041,94.42700727011194,0.20669235955010318,0.4002416725174669,0.19354931296736372,290333051,293600113.4,37.71800176256764,31.884397139479386,NaN,NaN,4.767749526797325,-0.00935770074328568
2022-06-10T09:30:00-04:00,82.62,82.76,81.56,81.67,8334179,6850400.45,40.10674823404703,52.33115001304919,NaN,NaN,-100.13899418751416,48.621183888888524,-0.12126078354760969,0.0419733335328516,0.1632341170804613,281998872,292364025.6,36.027541137315886,32.78013776158749,NaN,NaN,0.5849947060885405,0.0755497859469752
2022-06-13T09:30:00-04:00,79.58,79.76,78.02,78.48,10410240,6938529,33.90192758513055,51.28327933929495,NaN,NaN,-194.78935066415713,-17.03935194725533,-0.5255252913506846,-0.4936724971078945,0.03185279424279011,271588632,287927466.4,30.707839349790802,33.12364510388876,NaN,NaN,-5.379169745849522,-0.7036958614525244
2022-06-14T09:30:00-04:00,78.46,78.93,77.27,77.88,7850368,6913733.35,32.87182414737721,50.26978236357644,NaN,NaN,-191.41659892460208,-79.5043360065862,-0.7899425429102356,-0.9555753843950043,-0.16563284148476878,263738264,280679660.2,24.37565056141537,33.08019565626618,NaN,NaN,-10.332333413023136,-2.0792155116768973
2022-06-15T09:30:00-04:00,78.87,78.97,76.44,77.86,10429713,7056799.1,32.83600871194567,49.15851481809494,NaN,NaN,-165.09416037999398,-128.75853199973326,-0.9140303704338831,-1.3081708045271228,-0.3941404340932396,253308551,272193474,19.34555297610335,32.548103253613284,NaN,NaN,-14.162471794262736,-3.805394980617731
2022-06-16T09:30:00-04:00,75.73,75.98,74.41,75.05,9284671,7172720.3,28.188874876973102,47.34147383525387,NaN,NaN,-194.51590722971497,-169.19100227719645,-1.1196255665880743,-1.7936723923283324,-0.6740468257402581,244023880,262931639.8,15.569318679974714,31.681810581846886,NaN,NaN,-19.163224293541322,-5.999370596749673
2022-06-17T09:30:00-04:00,74.94,75.46,73.6191,74.92,12509811,7393333.65,27.991504136809397,45.09887497994841,NaN,NaN,-168.8132902057564,-182.92586148084493,-1.1919471702528348,-2.1639807885563016,-0.9720336183034668,231514069,252834679.2,12.66653890684536,30.153075303106572,NaN,NaN,-23.1242474727865,-8.445781579040649
2022-06-21T09:30:00-04:00,75.57,75.88,74.95,75.53,5616590,7271304,30.452209036756955,43.378584748515046,NaN,NaN,-129.5365621557909,-169.87530377917167,-1.127002490181681,-2.380786731030568,-1.253784240848887,237130659,245943084.6,11.139890138063095,28.47433880200114,NaN,NaN,-25.620106911913982,-10.899256626593981
2022-06-22T09:30:00-04:00,73.9,75.29,73.69,74.56,8032413,7353917.55,28.768673768605183,41.74771788950689,NaN,NaN,-122.97898981838291,-156.18778195792783,-1.077689712387621,-2.6008963813334134,-1.5232066689457924,229098246,239015081,9.854097089971447,26.664362866421634,NaN,NaN,-28.22291410402015,-13.374064837654862
2022-06-23T09:30:00-04:00,74.26,74.68,72.77,73.54,9467396,7475797,27.07369570955204,39.52306761276058,NaN,NaN,-116.4109247131527,-146.45113482455957,-1.0414943757401807,-2.825074638621018,-1.7835802628808375,219630850,232279540.8,8.791645076823002,24.70871253787404,NaN,NaN,-30.931340984391305,-15.882247144331496
2022-06-24T09:30:00-04:00,74.04,76.48,73.96,76.46,11247565,7761384.95,38.2838246227054,38.30943257345226,NaN,NaN,-78.41591836943167,-123.23113705250293,-0.7616028446368277,-2.735583818676872,-1.9739809740400445,230878415,229650447.8,8.41046457921962,22.8632164695316,NaN,NaN,-29.83063388994874,-17.874873822276815
2022-06-27T09:30:00-04:00,76.4,76.66,75.6,75.83,6791861,7824146.35,36.96361403948729,36.84203585962746,NaN,NaN,-65.80104347803143,-102.62868770695795,-0.5684564962009757,-2.684551594291264,-2.1160950980902884,224086554,228164944.8,8.194280542573296,21.152516811798986,NaN,NaN,-29.342550215088504,-19.5131133069642
2022-06-28T09:30:00-04:00,76.28,76.99,74.9,75.02,4923194,7730587.3,35.2791003441408,35.133937190285835,NaN,NaN,-64.5940732667011,-89.64018992913999,-0.44999695061729517,-2.6785912863619075,-2.2285943357446123,219163360,224571485,7.680012537583991,19.21868122855702,NaN,NaN,-29.441275817003238,-20.931422236969777
2022-06-29T09:30:00-04:00,75.16,75.29,73.71,74.48,5297410,7533186.85,34.16139048119901,33.81266810818273,NaN,NaN,-73.6295552243491,-79.77030301033324,-0.3663030879558886,-2.686473195689473,-2.3201701077335843,213865950,221525025.8,7.263804844408327,16.9817598701897,NaN,NaN,-29.84646034587184,-22.204999109670073
2022-06-30T09:30:00-04:00,73.32,74.275,72.58,73.6,6930162,7520943.5,32.36201918466632,32.80295820567113,NaN,NaN,-81.50566217143886,-72.78925050199045,-0.3296501792702915,-2.732232831821449,-2.4025826525511573,206935788,218986013.4,6.926874864850504,14.782393663209904,NaN,NaN,-30.707376302960803,-23.41962442299732
2022-07-01T09:30:00-04:00,72.99,74.23,72.19,74.12,8217101,7605528.85,34.555646207170525,32.406450918037095,NaN,NaN,-77.37264508248471,-72.58059584460108,-0.23430696645671345,-2.6954663606220493,-2.461159394165336,215152889,215840908.2,6.5232354390091984,12.674943256187998,NaN,NaN,-30.80933983339292,-24.475298053053834
2022-07-05T09:30:00-04:00,72.17,72.64,71.11,72.63,9706810,7824585.6,31.411988903093246,32.22859815503443,NaN,NaN,-95.16470335599962,-78.45332782019472,-0.2349153281002483,-2.754803554290646,-2.519888226190398,205446079,212112813.2,6.071592397478881,10.915211331022858,NaN,NaN,-31.806367498035964,-25.52259368805128
2022-07-06T09:30:00-04:00,72.55,73.3,71.76,73.09,8300960,7960027.75,33.4256184048113,32.26815488770829,NaN,NaN,-82.50038126541655,-82.03458941993782,-0.17065252240429762,-2.73320387919577,-2.5625513567914724,213747039,211029549,5.94283910436134,9.598581941233286,NaN,NaN,-32.06925359408651,-26.457830817484886
2022-07-07T09:30:00-04:00,73.99,74.5,73.53,73.74,4948661,7897167.45,36.272682235477056,32.51363156796054,NaN,NaN,-57.466443698721065,-78.80196711481219,-0.05658418050378611,-2.633281582421205,-2.5766974019174187,218695700,211995499,7.81998255601124,8.775326911226706,NaN,NaN,-31.497878639393534,-27.17783764918612
2022-07-08T09:30:00-04:00,73.85,73.97,72.63,73.02,4091297,7889841.65,34.5120654517316,32.96528803758615,NaN,NaN,-75.48882992291547,-77.59860066510751,-0.004579577012278513,-2.582421873182767,-2.5778422961704885,214604403,213529222,10.861889932489177,8.439082000692025,NaN,NaN,-31.489499731307806,-27.793789375203502
2022-07-11T09:30:00-04:00,72.28,73.15,72.15,72.82,4143790,7826709.6,34.01812149445641,33.3957607059895,NaN,NaN,-91.79548329596726,-80.48316830780402,0.03899413333787205,-2.5290996294981483,-2.5680937628360203,210460613,212590766.8,10.630724255438352,8.293666668448669,NaN,NaN,-31.613480256197494,-28.339459501059785
2022-07-12T09:30:00-04:00,72.51,73.64,72.42,72.68,6803456,7750173.45,33.65501068174001,33.624532252059716,NaN,NaN,-81.90628623775247,-77.83148488415459,0.07873950161334076,-2.469669385819344,-2.548408887432685,203657157,212232982.4,10.538637965036045,8.250720084661024,NaN,NaN,-31.811122057970593,-28.835411294904187
2022-07-13T09:30:00-04:00,71.49,72.68,71.13,72.26,9999380,7729630.45,32.53309511328658,33.893419490965535,NaN,NaN,-116.12865368935664,-84.5571393689426,0.09595341224212373,-2.42846712213003,-2.5244205343721537,193657777,208215130,9.539313525146483,8.228235544316385,NaN,NaN,-32.267735691229994,-29.32574335152216
2022-07-14T09:30:00-04:00,70.91,70.985,69.98,70.93,7506167,7712420.4,29.21215480658573,34.04616656932508,NaN,NaN,-170.44120997997163,-107.15209262519268,0.03984988877507423,-2.474608173403311,-2.5144580621783854,186151610,201706312,8.185229225575739,8.18492012637015,NaN,NaN,-33.5835470058143,-29.93400101642104
2022-07-15T09:30:00-04:00,72.08,72.29,71.16,72.04,5167017,7449285.6,35.16094163790666,33.82310349898231,NaN,NaN,-104.27613432188936,-112.90955350498746,0.09635773117610791,-2.3940108982082506,-2.4903686293843585,191318627,197049156.8,7.378211713164816,8.11118777879481,NaN,NaN,-33.101354158232674,-30.386480036679846
2022-07-18T09:30:00-04:00,72.98,73.32,71.94,72.21,3766700,7173387.05,36.04736014787759,33.757656792438766,NaN,NaN,-61.9107825712466,-106.93261336004332,0.16027773883598284,-2.29002145583938,-2.4502991946753627,195085327,193974099.6,6.894827264704503,8.018369687518469,NaN,NaN,-32.45912112694206,-30.682571621003017
2022-07-19T09:30:00-04:00,73.01,74.58,72.93,74.41,5642414,6830017.2,46.28215499516041,34.54358926751159,NaN,NaN,24.89302634211184,-85.57275084407046,0.35467730782046036,-2.006952559899787,-2.3616298677202474,200727741,193388216.4,6.80337208350754,7.955752512227292,NaN,NaN,-28.765501423117485,-30.408704449876513
2022-07-20T09:30:00-04:00,74.31,74.87,73.99,74.54,4691708,6783773.1,46.8237118281911,35.448040792296744,NaN,NaN,59.42184701970063,-50.462650702259,0.4877572459668791,-1.7519333102616486,-2.2396905562285276,205419449,195740550.8,11.858565058433769,8.283949670371966,NaN,NaN,-25.597511692932912,-29.72139119888457
2022-07-21T09:30:00-04:00,74.41,75.62,74.07,75.6,4700916,6617198.25,51.14836933883598,36.78992294616601,NaN,NaN,93.66851774447306,2.359294842629913,0.6336656871245765,-1.447608447322807,-2.0812741344473835,210120365,200534301.8,21.234887489318524,9.305950572119682,NaN,NaN,-21.540828227945667,-28.5527393458933
2022-07-22T09:30:00-04:00,76.06,76.45,74.72,75.06,5403743,6414015.6,48.96372507497998,37.819071436723824,NaN,NaN,98.67311780661446,42.949145268330675,0.6764135094659878,-1.2357572476148988,-1.9121707570808866,204716622,203213900.8,25.97521748013841,10.695377860771769,NaN,NaN,-18.73036937017756,-27.149543635076768
2022-07-25T09:30:00-04:00,75.26,75.465,74.76,75.37,3864919,6044883.3,50.27671492013957,39.16655186651285,NaN,NaN,90.00722133026775,73.33274604863354,0.7049646740346247,-1.0309649145376056,-1.7359295885722303,208581541,205913143.6,30.51193485619558,12.441116607822963,NaN,NaN,-16.009420004516066,-25.558097402139524
2022-07-26T09:30:00-04:00,74.98,75.3,74.57,74.86,3851874,5897883.95,48.0849945899913,40.213650165454276,NaN,NaN,81.18346753819891,84.59083428785098,0.6691837078987168,-0.8994499536988343,-1.5686336615975511,204729667,206713528.8,31.845761039892707,14.291325317503775,NaN,NaN,-14.275249278656412,-23.94626195592765
2022-07-27T09:30:00-04:00,74.33,76.06,73.97,75.76,5851612,5944304.85,52.0569208989845,41.34109578427623,NaN,NaN,105.10354453959218,93.72717379182927,0.6834140068784158,-0.7143661529995313,-1.3977801598779471,210581279,207745894.8,33.615761281280015,16.13388094073726,NaN,NaN,-11.621847862462422,-22.185631371146904
2022-07-28T09:30:00-04:00,76.12,77.18,75.95,77.1,5915993,5975234,57.29566531872294,42.96849577477561,NaN,NaN,168.6367218282115,108.72081460857696,0.7547665554840655,-0.4543219655228654,-1.2090885210069309,216497272,209021276.2,35.83285592434487,17.917521368726952,NaN,NaN,-7.665941034846091,-20.1113898945325
2022-07-29T09:30:00-04:00,77.65,78.34,77.35,78.13,4629139,5860182.85,60.83795265333497,44.8841980004098,NaN,NaN,189.3781382773273,126.86181870271953,0.8366780635739683,-0.16324094153947044,-0.9999190051134388,221126411,212303234,41.268693968208986,20.105947776781996,NaN,NaN,-3.1495199828806575,-17.68826562143938
2022-08-01T09:30:00-04:00,77.76,77.82,76.935,77.5,5205845,5709620.05,57.686064860068086,46.60070187029037,NaN,NaN,140.35471445261004,136.931317327188,0.8130695058143701,0.016417877154523808,-0.7966516286598463,215920566,213771039,43.57106700443515,22.465406993881935,NaN,NaN,-0.27564759532921307,-15.200748760566501
2022-08-02T09:30:00-04:00,77.11,77.785,76.28,76.71,5683689,5508464,53.91408291614225,48.127915284780066,NaN,NaN,106.63160378948886,142.020944577446,0.7124966385711116,0.09396916955404322,-0.6185274690170683,210236877,214872481,45.30383671933287,25.020015793466676,NaN,NaN,1.0630075953285378,-12.877354995438639
2022-08-03T09:30:00-04:00,77.13,77.32,76.14,76.79,4798734,5333352.7,54.24039155370208,49.91564648100267,NaN,NaN,89.93729471484137,138.98769461249583,0.6228536726384286,0.16003962178096742,-0.4628140508574612,215035611,215763347.4,46.72868319480467,27.7731196484116,NaN,NaN,2.2459993849495854,-10.71687579824032
2022-08-04T09:30:00-04:00,76.91,77.5,76.45,76.84,3449446,5258391.95,54.45743293418217,51.29396728787948,NaN,NaN,87.03643842736142,122.6676379323258,0.5414264500771999,0.2139690117390387,-0.3274574383381612,218485057,216160904.4,47.38736066186773,30.630916001890377,NaN,NaN,3.2820237942762414,-8.717032999309383
2022-08-05T09:30:00-04:00,76.23,77.4405,76.12,77.11,2945981,5201126.15,55.679906164776085,52.69629200337223,NaN,NaN,78.34445135895523,100.4609005486514,0.48222311149541214,0.27532145103110395,-0.2069016604643082,221431038,216221829.8,47.49450464871453,33.53089295789109,NaN,NaN,4.486775133654334,-6.830774694600281
2022-08-08T09:30:00-04:00,78.05,78.64,77.49,77.54,4707123,5229292.8,57.63049020051098,53.50688737518299,NaN,NaN,107.24293349032511,93.8385443561944,0.44916455187710425,0.35455402938207214,-0.09461052249503213,226138161,218265348.8,51.09217245512235,36.69437869872072,NaN,NaN,6.046808018317846,-4.991120021326263
2022-08-09T09:30:00-04:00,77.67,77.7,76.885,77.16,6993653,5238802.65,55.31364971429735,54.11331150990486,NaN,NaN,75.76587488832061,87.66539857596077,0.3815099729637614,0.3822769437096696,0.0007669707459082159,219144508,220046875,54.04825479582985,39.707927965677584,NaN,NaN,6.791480078204276,-3.307891435679043
2022-08-10T09:30:00-04:00,78.66,79.8,78.64,79.35,4264148,4952041.05,64.23691815709552,55.04820785406626,NaN,NaN,138.21149136236343,97.32023790546516,0.45885970182457,0.5743415980266207,0.1154818962020507,223408656,221721484,56.697700391689054,42.240986030132625,NaN,NaN,10.240824311314203,-1.3723606146800083
2022-08-11T09:30:00-04:00,80.08,80.63,79.52,79.62,3064578,4729961.6,65.16060345143782,56.20512773809896,NaN,NaN,153.21885964668897,110.55672214933068,0.49946477238856174,0.7398128616877528,0.2403480892991911,226473234,223319119.4,59.11939433061418,44.608427233738034,NaN,NaN,13.34531432770882,0.7301643770898245
2022-08-12T09:30:00-04:00,79.87,81.14,79.72,81.12,3723637,4657792.6,69.82363352591308,57.60133620993992,NaN,NaN,173.16742585881974,129.52131704930358,0.5922677633468866,0.9806827934827993,0.3884150301359127,230196871,225072286,61.653716209659144,46.83284018755687,NaN,NaN,17.642013379689317,3.146142806032609
2022-08-15T09:30:00-04:00,80.26,81.19,79.99,81.07,3190138,4628964.5,69.48976011531856,59.13024803317759,NaN,NaN,164.88000676881381,141.04873170500133,0.6126552364774092,1.1542340757326741,0.541578839255265,227006733,225246000.4,61.90571680872827,48.97997988533083,NaN,NaN,20.978822494947522,5.693668475877597
2022-08-16T09:30:00-04:00,80.84,81.87,80.83,81.52,2605776,4477132.6,70.84113902398312,60.47197789924892,NaN,NaN,164.55215193916945,158.8059871151711,0.6170977876224588,1.3129510737833385,0.6958532861608797,229612509,227339600.6,64.89958805014788,51.21453894024996,NaN,NaN,24.180241765077103,8.334607517191811
2022-08-17T09:30:00-04:00,80.61,80.79,79.975,80.4,4079918,4446543.1,63.32342032438261,60.9025318282246,NaN,NaN,107.25183513909577,152.61405587051757,0.5097132618217328,1.3329948634380457,0.8232816016163129,225532591,227764387.6,65.49217629578911,53.333061823924545,NaN,NaN,24.75535483803812,10.680428563026998
2022-08-18T09:30:00-04:00,80.72,80.845,80.13,80.65,2281370,4325565.8,64.23575927054821,61.14523230088269,NaN,NaN,99.81586566005845,141.93345707319145,0.4241354247309822,1.3534508825300406,0.9293154577990584,227813961,228032533,65.88372540267926,55.09127835495814,NaN,NaN,25.490130334339657,12.796100244643092
2022-08-19T09:30:00-04:00,80.21,80.21,78.88,79.17,3317259,4221241.6,55.44308186749402,60.98501922998455,NaN,NaN,49.7810948328921,117.25619086800593,0.24534048045756385,1.2359910583710132,0.9906505779134493,224496702,226892499.2,62.62998404195159,56.452629571923595,NaN,NaN,23.386452037427777,14.309007643612333
2022-08-22T09:30:00-04:00,77.94,78.34,77.63,77.91,3515962,4203793.75,49.260920794217775,60.652650506989936,NaN,NaN,-12.341390367901296,81.8119114406629,0.030972291198594126,1.029365941911692,0.9983936507130979,220980740,225687300.6,59.29605571165186,57.452073785660666,NaN,NaN,19.507905776394182,15.051707376866883
2022-08-23T09:30:00-04:00,77.92,79.07,77.92,78.68,4920222,4257211.15,52.72977082584062,60.544749026428406,NaN,NaN,5.060229164445337,49.913526885718085,-0.06497571870826291,0.9171740023277692,0.9821497210360322,225900962,224944991.2,57.273777910305604,58.205294836767884,NaN,NaN,17.370923996459954,15.38302403680875
2022-08-24T09:30:00-04:00,78.58,79.135,78.36,78.85,2889093,4109085.2,53.48585622840415,60.475350690301404,NaN,NaN,7.980035776812661,30.05916701326147,-0.11981300663587269,0.8323834627411912,0.9521964693770639,228790055,225596484,58.60803761204616,59.00677176178062,NaN,NaN,15.887633964871634,15.455111169389163
2022-08-25T09:30:00-04:00,79.39,80.665,79.39,80.64,3065481,3966559.6,60.62703714352714,60.82871718878362,NaN,NaN,71.31858305211934,24.359710491673646,-0.04235053576402925,0.8992582996720273,0.9416088354360566,231855536,226404799,60.26596038589108,59.91901860015038,NaN,NaN,16.851830370585354,15.65464248384576
2022-08-26T09:30:00-04:00,80.82,80.89,78.1136,78.17,4333003,3951752.8,49.36466645982432,60.238301207306,NaN,NaN,10.55882431245296,16.515256387585822,-0.157792572298308,0.7443681200631715,0.9021606923614796,227522533,227009965.2,61.50900336692072,60.66307795099312,NaN,NaN,13.635219635129046,15.366153505457659
2022-08-29T09:30:00-04:00,77.31,78.26,77.12,77.62,3599498,3871435.45,47.2594230909987,59.66299930564181,NaN,NaN,-61.19822030185108,6.743890400795844,-0.26520219885900576,0.5706579437877224,0.8358601426467281,223923035,227598424.2,62.729985247400755,61.28320155467675,NaN,NaN,10.389891114237756,14.655258878140529
2022-08-30T09:30:00-04:00,77.82,77.87,75.9,76.35,3701287,3772315.35,42.7280965277141,58.12665490354315,NaN,NaN,-108.87354816272958,-16.042865064639138,-0.40729094484425277,0.3267464615914122,0.734037406435665,220221748,226462581.4,58.849554428828995,61.43690541447246,NaN,NaN,6.101724872266874,13.433325448730008
2022-08-31T09:30:00-04:00,76.48,76.48,75.38,75.41,5025373,3783647.3,39.694381378496125,56.307639041190164,NaN,NaN,-148.94895849766894,-47.42866391953545,-0.5416792366739205,0.05693836059326429,0.5986175972671848,215196375,223743845.4,50.75621941722583,60.83953577780187,NaN,NaN,1.5686736216938284,11.73837518772484
2022-09-01T09:30:00-04:00,74.5,74.63,73.51,74.42,5898010,3906075.5,36.73605683362021,53.94424070602639,NaN,NaN,-197.46608837853375,-101.18559820566608,-0.6661524633376918,-0.2340729819049301,0.43207948143276176,209298365,219232411.2,40.743076200457665,59.345918634287486,NaN,NaN,-3.161680237790264,9.609795841222683
2022-09-02T09:30:00-04:00,75.52,76.115,74.02,74.35,7067100,4112131.45,36.5287568821192,51.58988333222644,NaN,NaN,-153.13454126969935,-133.92427132209656,-0.7176554800932392,-0.4649898686837872,0.252665611409452,202231265,214174157.6,32.904938333557055,57.27443445748954,NaN,NaN,-6.918208627745267,7.248652345655833
2022-09-06T09:30:00-04:00,74.78,75.05,73.79,74.12,6275601,4190555.35,35.81365198736806,49.08791997246822,NaN,NaN,-147.2924594335375,-151.14311914843384,-0.7292974539080977,-0.6589562059756702,0.07034124793242755,195955664,208580683.4,26.77157460217616,54.55100492549156,NaN,NaN,-10.17053507226292,4.760197000238868
2022-09-07T09:30:00-04:00,73.92,76.3,73.75,76.17,6096201,4145682.75,45.9669089769708,47.848169161938806,NaN,NaN,-98.63047086056939,-149.0945036880018,-0.5681785168161995,-0.6398818980878218,-0.07170338127162235,202051865,204946706.8,23.682991008350626,51.56463454781739,NaN,NaN,-9.903273546027886,2.665415493629332
2022-09-08T09:30:00-04:00,75.41,76.965,75.14,76.91,4398295,4152390.1,49.09707920941081,46.766834871857554,NaN,NaN,-59.81458095912682,-131.26762818029334,-0.38952865445237084,-0.5586141993370859,-0.16908554488471506,206450160,203197463.8,22.34655337852668,48.45483654609221,NaN,NaN,-8.682833494751268,1.0442370667178178
2022-09-09T09:30:00-04:00,77.68,78.285,77.47,78.07,3648273,4181574.85,53.63169330546329,46.637449974569655,NaN,NaN,-3.5724113288164983,-92.4888927703499,-0.18156463534811068,-0.3960413390698534,-0.2144767037217427,210098433,203357477.4,22.7758492591378,45.608112633034075,NaN,NaN,-6.174974660471406,0.012921105690785861
2022-09-12T09:30:00-04:00,78.87,79.1799,78.32,78.8,4049539,4197869.95,56.27172723620848,47.13822186328327,NaN,NaN,29.558315708193412,-55.95032137477135,0.006843338854889108,-0.20592253015313133,-0.21276586900802044,214147972,205740818.8,29.06604558235223,43.448826195226964,NaN,NaN,-3.264008612723337,-0.4552117112255174
2022-09-13T09:30:00-04:00,76.79,77.6637,75.795,75.99,4702010,4273463.55,45.52639841259943,46.62369526233747,NaN,NaN,-46.607183418404944,-35.81326617174485,-0.05281282162785875,-0.27878189604284387,-0.22596907441498512,209445962,208438878.4,35.473682643378964,41.89167653330363,NaN,NaN,-4.283902681635542,-1.002167564141235
2022-09-14T09:30:00-04:00,75.65,75.73,74.33,75.06,5781206,4432235.05,42.62532649657641,45.84794313863549,NaN,NaN,-89.58076334298752,-34.00332466822847,-0.14472592234046022,-0.4068764773405604,-0.2621505550001002,203664756,208761456.6,36.21555075126436,40.292213186104924,NaN,NaN,-6.096140907154299,-1.7298780417145299
2022-09-15T09:30:00-04:00,74.77,75.545,73.935,74.07,5208715,4488674.9,39.72344897416411,44.3548296979667,NaN,NaN,-98.41860897953357,-41.724130272309814,-0.2555380118268012,-0.5815730697836017,-0.3260350579568005,198456041,207162632.8,34.12158628090049,38.424757892891314,NaN,NaN,-8.547983019472234,-2.7038930385370588
2022-09-16T09:30:00-04:00,73.07,73.1805,72.11,72.9,8132679,4781240.35,36.55602851318081,43.439926987492164,NaN,NaN,-150.24201182157296,-71.05805037086111,-0.383291425171297,-0.8051493394209217,-0.4218579142496247,190323362,203207618.6,29.56732106945607,36.14320915735813,NaN,NaN,-11.639781596314076,-3.9804485467909183
2022-09-19T09:30:00-04:00,71.7,73.79,71.61,73.69,5161722,4873463.5,40.03296878766786,42.92375168011139,NaN,NaN,-125.3851275085253,-102.04673901420486,-0.38901006729961685,-0.9081204983741458,-0.5191104310745289,195485084,199475041,26.035486997160277,33.52217356805524,NaN,NaN,-13.033736333938345,-5.273775373526265
2022-09-20T09:30:00-04:00,72.69,72.69,71.745,72.29,4774909,4936410.85,36.24235998447132,42.46048478416547,NaN,NaN,-134.73070199682158,-119.67144272988817,-0.4568139494947172,-1.0901278679429254,-0.6333139184482082,190710175,195727883.6,23.05777017271791,30.96561754976159,NaN,NaN,-15.461751964877418,-6.729200600862144
2022-09-21T09:30:00-04:00,72.81,72.96,70.68,70.71,8883557,5134577.6,32.501987739508806,41.94674238138066,NaN,NaN,-144.07963882502654,-130.57121782629596,-0.5704232739197446,-1.3463430108478889,-0.7759197369281443,181826618,191360256,20.163075193436967,28.7803929623481,NaN,NaN,-18.78498077163309,-8.451454910972279
2022-09-22T09:30:00-04:00,71,71.2,69.81,69.86,5876457,5283945.8,30.668263347605176,41.51332856095102,NaN,NaN,-161.68714735362147,-143.22492550111355,-0.6588999690058138,-1.5995446981854116,-0.9406447291795977,175950161,186859080,17.697279508991926,27.134264627243407,NaN,NaN,-22.08814784167558,-10.39955390107275
2022-09-23T09:30:00-04:00,68.66,68.75,67.41,68.43,7005140,5480928.75,27.82414441294077,40.891570527438276,NaN,NaN,-200.63622163335677,-153.30376746347034,-0.7624984030680804,-1.8937677330146983,-1.1312693299466179,168945021,182583411.8,15.729494011933596,25.907447175698874,NaN,NaN,-25.8259033387021,-12.603318106448372
2022-09-26T09:30:00-04:00,67.94,68.81,66.98,67.32,7489042,5638730.7,25.822322258987484,40.17790411826824,NaN,NaN,-182.81634787462698,-164.79001153669066,-0.847984508542198,-2.1912499656243654,-1.3432654570821674,161455979,175777590.8,13.211354431950184,24.938860020682732,NaN,NaN,-29.580109209467594,-15.02857397830826
2022-09-27T09:30:00-04:00,68.18,68.57,66.85,67.47,7078923,5812701.95,26.59093280957137,38.793905820596855,NaN,NaN,-154.17131977247615,-168.67813509182156,-0.835293849808489,-2.3873827693427785,-1.5520889195342895,168534902,171342536.2,11.87698969008656,24.0955742122353,NaN,NaN,-32.31525490557936,-17.498099825061274
2022-09-28T09:30:00-04:00,67.83,69.53,67.565,69.21,6753934,5965334.3,35.00413814053796,37.78726717282022,NaN,NaN,-109.43969901042243,-161.75014712890075,-0.6583592734540691,-2.375038011351876,-1.7166787378978068,175288836,170034979.8,11.507951443446004,23.321388359729536,NaN,NaN,-32.056138706486195,-19.577819665264833
2022-09-29T09:30:00-04:00,68.55,68.55,67.2,68.19,5727267,6000429,32.64241151779299,36.2880327594152,NaN,NaN,-112.76760052925812,-151.9662377640281,-0.5623912125116148,-2.4196677535373254,-1.8572765410257106,169561569,168757261.4,11.143576098303427,22.490511705384225,NaN,NaN,-32.575428610231114,-21.43462094311716
2022-09-30T09:30:00-04:00,68.14,69.27,67.8,68.01,5410398,5976048.4,32.22915832576899,34.57070640866953,NaN,NaN,-91.82897833860098,-130.20478910507694,-0.4673135582414272,-2.4414184888274946,-1.9741049305860674,164151171,167798491.4,10.86556180777093,21.190477150056996,NaN,NaN,-33.11345675981494,-23.10302605978827
2022-10-03T09:30:00-04:00,69.1,70.735,68.71,70.22,9929166,6119151.7,41.94687122733425,34.3150258954363,NaN,NaN,-52.97128104488735,-104.23577573912901,-0.22418880271733155,-2.254340933982732,-2.0301521312654005,174080337,170323363,16.755460646725552,19.853461293153178,NaN,NaN,-30.48214265813095,-24.157185573837225
2022-10-04T09:30:00-04:00,71.63,72.88,71.51,72.8,15125156,6561629.45,50.81385798510599,34.89992100175984,NaN,NaN,3.0764182833672575,-72.78622812796031,0.12310751353723282,-1.8762677393438594,-1.9993752528810922,189205493,174457481.2,25.442681447209893,19.083970628577855,NaN,NaN,-25.040290184541675,-24.28334337536643
2022-10-05T09:30:00-04:00,71.78,72.57,71.17,71.98,9214856,6717562.2,48.28932862411071,35.5117695481846,NaN,NaN,-4.10005926689234,-51.7183001792543,0.3002300552356343,-1.6240876838365494,-1.9243177390721837,179990637,175397841.4,27.301122724862367,18.59679466028942,NaN,NaN,-21.503656305897838,-23.886245222585202
2022-10-06T09:30:00-04:00,71.42,72.18,71.04,71.22,11976774,7096486.15,46.007858937170056,36.18690029275526,NaN,NaN,-9.004177737367606,-30.965615620876196,0.36455069034201726,-1.468629376144662,-1.8331800664866793,168013863,175088300.2,27.061996448569317,18.417842901654655,NaN,NaN,-19.359928407164332,-23.239628534667936
2022-10-07T09:30:00-04:00,70.63,70.78,69.01,69.46,5091921,7168668.55,41.15827521561245,36.26727932332273,NaN,NaN,-46.08837614722202,-21.817495182600396,0.29014893317355717,-1.4704939000197328,-1.76064283319329,162921942,174842454.4,26.86076576697137,18.476791385212586,NaN,NaN,-19.09115514280048,-22.646989478686873
2022-10-10T09:30:00-04:00,69.73,70.015,69.145,69.61,5195637,7225973.45,41.722094142172395,36.658688906015676,NaN,NaN,-42.72207628356809,-19.767654230336547,0.25392936086234585,-1.4432311321153577,-1.6971604929777035,168117579,173649902.8,25.856378648539405,18.676691990628406,NaN,NaN,-18.706005357052465,-22.083991747024815
2022-10-11T09:30:00-04:00,69.03,70.2,68.575,69.07,6959440,7338844.95,40.227695068787725,37.21052514382131,NaN,NaN,-45.96377214520024,-29.57569231605005,0.1989273877261455,-1.4485012583200216,-1.6474286460461671,161158139,168040432,21.738753736578403,18.789240457995653,NaN,NaN,-18.832742482298002,-21.619527566349557
2022-10-12T09:30:00-04:00,69.09,69.155,68.51,68.55,8014642,7450516.75,38.78697160138567,37.7904328762342,NaN,NaN,-59.76420483059041,-40.708521428789666,0.13585922146752538,-1.4776046192117605,-1.6134638406792858,153143497,162671004,18.673322997881442,18.858957850059195,NaN,NaN,-19.355150190459067,-21.296045084079488
2022-10-13T09:30:00-04:00,67.21,70.88,66.86,70.56,9723179,7676239.95,46.72887732745044,39.14077094155632,NaN,NaN,-26.729922104942553,-44.253670302304656,0.2321904979298426,-1.3232257182669827,-1.5554162161968252,162866676,161641566.6,18.14503436891188,19.031496446986214,NaN,NaN,-17.384117004863715,-20.73719821562009
2022-10-14T09:30:00-04:00,71.02,71.17,68.06,68.18,8297731,7684492.55,40.095403330029,40.160276732345,NaN,NaN,-35.112540711358456,-42.05850321513194,0.14269165904559622,-1.37705164238983,-1.5197433014354262,154568945,159970967.2,17.290153563240295,19.322839242078366,NaN,NaN,-17.778165732646844,-20.314479289481056
2022-10-17T09:30:00-04:00,69.56,70.35,69.47,69.88,5735735,7713193.2,45.99284472577999,41.54612758350276,NaN,NaN,10.819506729065262,-31.350186612605267,0.20146062623540528,-1.2679175186411697,-1.469378144876575,160304680,158408387.4,16.5067872482297,19.653539067660017,NaN,NaN,-16.14553671444511,-19.71891606447592
2022-10-18T09:30:00-04:00,71.56,72,70.46,71.25,7979441,7873419.8,50.24398472137127,42.63468805356228,NaN,NaN,92.48019500304966,-3.661393182955288,0.3285612168981653,-1.0586766237538683,-1.3872378406520336,168284121,159833583.8,20.06412396937786,20.26469424808372,NaN,NaN,-13.377513378873159,-18.813001395104095
2022-10-19T09:30:00-04:00,70.73,71.32,69.98,70.41,4345205,7646502.2,47.76156041853708,43.714627260758284,NaN,NaN,58.539913345860995,19.99943045233499,0.3500420278524867,-0.9496853058364252,-1.299727333688912,163938916,161992667.6,25.259413659327606,21.27296835958545,NaN,NaN,-11.925049847035913,-17.82900831680864
2022-10-20T09:30:00-04:00,70.51,71.78,69.73,69.9,5708283,7638093.5,46.266915399890465,44.717324194624105,NaN,NaN,51.41401145336817,35.628217163997135,0.32445835994727057,-0.8941543837548238,-1.2186127437020944,158230633,161065459,24.522320748382455,22.248451141057703,NaN,NaN,-11.210235612773301,-16.883469359089304
2022-10-21T09:30:00-04:00,69.77,72.42,69.7,72.32,8340468,7704859.9,53.67498411409533,45.55504654367847,NaN,NaN,100.32554010062383,62.71583332639359,0.4569629753822244,-0.6474090244743138,-1.1043719998565382,166571101,163465890.2,30.20096766429606,23.208844499455598,NaN,NaN,-8.142820436445728,-15.63480522728308
2022-10-24T09:30:00-04:00,72.61,73,71.76,71.9,6737390,7667277.3,52.3266280673289,45.663101549551534,NaN,NaN,126.16600038073763,85.78513205672807,0.49932447694404714,-0.48021640367647933,-0.9795408806205265,159833711,163371696.4,30.105251271679393,23.541885201203417,NaN,NaN,-6.110214641106019,-14.274149429257786
2022-10-25T09:30:00-04:00,71.95,73.73,71.8597,73.68,6001296,7613395.95,57.23032891693195,46.301744427610195,NaN,NaN,152.14694908923417,97.71848287396497,0.6222261600945165,-0.20175818050238092,-0.8239843405968974,165835007,162881873.6,29.580240128150677,23.704679301438297,NaN,NaN,-2.774950467999597,-12.631406720506616
2022-10-26T09:30:00-04:00,74.1,74.97,73.575,74.2,6765334,7613965.95,58.5709950081908,47.199111289825964,NaN,NaN,180.8036996487443,122.17124013454163,0.7073377237334766,0.06018781406994833,-0.6471499096635283,172600341,164614158.6,33.96613307490931,24.197831917605438,NaN,NaN,0.3381011980159891,-10.778619875003386
2022-10-27T09:30:00-04:00,74.31,74.89,73.8725,74.01,4976977,7576451.45,57.85735655574736,48.39190281412131,NaN,NaN,155.98720545530523,143.08587893492904,0.7173787767101111,0.24957356122411056,-0.4678052154860005,167623364,166492704.8,38.443518624463394,25.025171407426296,NaN,NaN,2.6475531069646174,-8.860595163293672
2022-10-28T09:30:00-04:00,73.78,74.895,73.42,74.75,4627403,7537301.7,59.90632068507914,49.690776138614645,NaN,NaN,141.9053265163923,151.40183621808274,0.7375560953794815,0.45413990373835134,-0.28341619164113013,172250767,167628638,41.046568262782415,26.1101849513008,NaN,NaN,5.193163400884092,-6.852915368411134
2022-10-31T09:30:00-04:00,74.34,74.95,73.97,74.08,4791730,7280429.9,57.19489554078593,50.90271902947166,NaN,NaN,123.7970904022026,150.92805422237572,0.6713649551103399,0.5557900022467948,-0.11557495286354513,167459037,169153703.2,44.443330636306406,27.731940444138512,NaN,NaN,6.58587311484303,-4.933088442231968
2022-11-01T09:30:00-04:00,75.19,75.27,73.65,74.27,11659040,7107124.1,57.77850465319975,52.25925710460124,NaN,NaN,114.8021657796385,143.4590975604566,0.6078626013095388,0.6442532987733784,0.036390697463839605,179118077,171810317.2,49.862621116266176,29.959747452594566,NaN,NaN,7.899928225988489,-3.099800346771903
2022-11-02T09:30:00-04:00,74.57,75.21,72.31,72.34,15733311,7433046.85,50.279466617172844,52.5128706252957,NaN,NaN,64.98493830194838,120.29534529109742,0.4126955359757665,0.5522601174335477,0.13956458145778122,163384766,169967202.2,46.47544015179385,31.98334786565756,NaN,NaN,6.919990191219741,-1.6684016984873826
2022-11-03T09:30:00-04:00,71.44,73.39,71.27,72.89,8729456,7270680.95,52.18405894220905,53.376346026165706,NaN,NaN,33.09371968413002,95.71664813686239,0.30256174994713825,0.517766768891704,0.21520501894456578,172114222,170865373.8,48.31788764521767,34.199614585798805,NaN,NaN,6.6384914102366395,-0.48170268295537944
2022-11-04T09:30:00-04:00,74.75,75.98,74.13,75.42,9639840,7498076.9,59.81049189806831,54.363320824186296,NaN,NaN,115.33280412247184,90.4021436580783,0.37716794599855935,0.686664951442765,0.3094970054442056,181754062,172766032.8,52.077243017482694,36.740361426459735,NaN,NaN,8.759011603981104,0.8383993580355469
2022-11-07T09:30:00-05:00,75.89,76.06,75.1,76.01,5576569,7517123.5,61.35831381631769,55.15720147382533,NaN,NaN,120.79671119341906,89.8020678163216,0.43898869388322753,0.85823287279824,0.4192441789150125,187330631,176740351.6,58.822203462128755,39.50879567594194,NaN,NaN,10.96803916510173,2.2854907590450013
2022-11-08T09:30:00-05:00,76.45,78.08,76.24,77.32,6156793,7476991.15,64.61675529103107,56.361143964717755,NaN,NaN,152.69341980278054,97.38031862094999,0.5345031987112826,1.0873731773041158,0.5528699785928332,193487424,179614221,62.88964847786109,42.196669591551476,NaN,NaN,13.877103762856915,3.941435473875275
2022-11-09T09:30:00-05:00,76.96,77.65,75.895,76.07,6603912,7406454.65,59.46408889377486,57.30379921428092,NaN,NaN,119.54451979951571,108.29223492046347,0.48153780917962596,1.1547922400673656,0.6732544308877396,186883512,184313970.2,68.38875924475266,45.32998662700647,NaN,NaN,14.760748975524773,5.487051688396631
2022-11-10T09:30:00-05:00,79.16,80.34,78.78,80.28,8718280,7356209.7,68.55805041816552,58.36687537885738,NaN,NaN,199.43537239526944,141.56056546269136,0.6856315540095111,1.5302938733996285,0.8446623193901174,195601792,189011484.2,72.73730693609679,48.36829657499224,NaN,NaN,18.88528473485605,7.401084980747977
2022-11-11T09:30:00-05:00,81.18,82.18,81.01,81.25,6491167,7265881.5,70.21599710336285,59.6446874528598,NaN,NaN,220.56975634064213,162.60795590632543,0.8318141290714778,1.8844299807294647,1.0526158516579869,202092959,193079263.6,75.83705598586076,51.63485405457662,NaN,NaN,22.714223968134654,9.588676264660359
2022-11-14T09:30:00-05:00,80.98,82.255,80.9,81.14,6366926,7297441.05,69.76671923154359,60.54014390390349,NaN,NaN,183.2276743206087,175.09414853176335,0.8632170231267902,2.1316371305664745,1.2684201074396844,195726033,194758344,76.99955553409,55.02194801214372,NaN,NaN,25.526316808992995,11.865482056707878
2022-11-15T09:30:00-05:00,82.03,82.08,80.22,81.02,7227533,7259845.65,69.24618647225869,61.30265757990834,NaN,NaN,146.21909650837057,173.79928387288135,0.8184264223371174,2.291453135361081,1.4730267130239638,188498500,193760559.2,74.69964183718906,57.931484352306555,NaN,NaN,27.60105172501783,14.113420580752155
2022-11-16T09:30:00-05:00,80.71,80.97,80.07,80.23,6398898,7362530.3,65.76729961413389,61.867653512650236,NaN,NaN,111.81031709833151,172.25244333264453,0.6836040182732905,2.327531735865577,1.6439277175922864,182099602,192803777.2,72.46447838417392,60.361552906571596,NaN,NaN,28.310370288772695,16.141556253326517
2022-11-17T09:30:00-05:00,79,79.51,78.48,79.46,4679361,7311084.2,62.472841280519226,62.05097641232453,NaN,NaN,71.70205877689095,146.7057806089688,0.49913731876739953,2.2678493660515358,1.7687120472841362,177420241,189167467,64.55815636556694,62.04095205677049,NaN,NaN,27.941793533595288,17.827304436222054
2022-11-18T09:30:00-05:00,80.27,80.27,79.25,79.99,3745567,7081339.15,63.81639689411146,62.52394079470492,NaN,NaN,78.1430439535774,118.22043813155585,0.3750499139015149,2.23752443966103,1.862474525759515,181165808,184982036.8,56.867282846386246,62.92837721463333,NaN,NaN,28.011256533063385,19.282154735770817
2022-11-21T09:30:00-05:00,79.42,80.53,79.24,80.26,3619112,6925425.25,64.51341923378797,63.005006121889785,NaN,NaN,73.12350800825885,96.19960486908587,0.2778645407712772,2.2098052017236114,1.9319406609523342,184784920,182793814.2,53.29267697243092,63.17338120435939,NaN,NaN,28.25870794647381,20.56451948015696
2022-11-22T09:30:00-05:00,80.86,82.1,80.675,82.08,3607061,6805713.5,68.86701371602634,64.33268805752218,NaN,NaN,99.0870220319524,86.77318997380226,0.3009195272274279,2.308090069986619,2.0071705427591913,188391981,182772510.4,53.257577761149875,63.65781960502767,NaN,NaN,29.751721564684676,21.876976920803777
2022-11-23T09:30:00-05:00,82,82.48,81.79,82.4,4248200,6679856.8,69.57381064782335,65.57481317935178,NaN,NaN,100.74830027598635,84.56078660933322,0.30171790894406136,2.384317928939268,2.0826000199952066,192640181,184880626.2,56.32309490215305,64.2296201233802,NaN,NaN,31.186144018904155,23.206857934818117
2022-11-25T09:30:00-05:00,82.28,82.43,82.1,82.37,1228285,6492422.2,69.41470656398658,66.26082851263166,NaN,NaN,93.01180000447842,88.82273485485072,0.2655005710212932,2.4144757337718232,2.14897516275053,191411896,187678957.2,60.06691286887125,64.80031082705081,NaN,NaN,32.323638936884045,24.509255220827537
2022-11-28T09:30:00-05:00,81.77,81.8,80.37,80.53,3232049,6422654.5,60.305624637700205,66.1856364284447,NaN,NaN,56.565621248674844,84.5072503138702,0.09186596882583542,2.2638076237828244,2.171941654956989,188179847,189081765,61.83308759981309,65.01537397974255,NaN,NaN,30.727938899315994,25.397638603468746
2022-11-29T09:30:00-05:00,80.83,81.24,80.58,80.8,2836552,6324895.6,61.112058390251924,65.9353009355319,NaN,NaN,51.66546729345649,80.21564217090973,-0.024351010106528737,2.141502892323828,2.165853902430357,191016399,190328060.8,63.38260298520909,65.0505850159817,NaN,NaN,29.628539274229265,26.002052985005964
2022-11-30T09:30:00-05:00,80.83,82.78,80.08,82.75,7312524,6107569.8,66.41841512789688,66.43203852368347,NaN,NaN,73.02772877736766,75.00378351999278,0.008781727024699926,2.1768310612112316,2.1680493341865317,198328923,192315449.2,65.76916467269461,64.86347111797754,NaN,NaN,30.193360403597968,26.600811187661964
2022-12-01T09:30:00-05:00,83.32,83.41,82.125,82.85,4107946,5526301.55,66.66958771869443,66.29714833086412,NaN,NaN,97.18896595760046,74.2919166563156,0.01570440657518679,2.1876798424055153,2.1719754358303285,202436869,194274786.8,67.98458214060926,64.52399077544273,NaN,NaN,30.722459698742703,27.189618117816355
2022-12-02T09:30:00-05:00,81.77,83.98,81.77,83.76,3412524,5260454.95,68.94582302816882,66.20642161120739,NaN,NaN,110.6195509320107,77.81346684182206,0.05749274567908014,2.2438413679291784,2.1863486222500983,205849393,197162286.2,70.96674352512557,64.17611131396164,NaN,NaN,31.835017165084217,27.853246553140334
2022-12-05T09:30:00-05:00,83.13,83.455,81.97,82.1,4726244,5014775.15,60.79012916516031,65.56523660646573,NaN,NaN,83.25014336993775,83.15037126607464,-0.04519884266518748,2.129850068918614,2.1750489115838016,201123149,199750946.6,73.36230070032178,63.9163073972639,NaN,NaN,30.34917599776184,28.209807902371978
2022-12-06T09:30:00-05:00,82.15,82.65,80.775,81.37,4747806,4973337,57.565254505154996,64.73088432310118,NaN,NaN,38.99520297106428,80.6163184015962,-0.17361094308618075,1.9580352327260755,2.1316461758122562,196375343,200822735.4,74.30752641171698,63.88829915258732,NaN,NaN,28.126392169853197,28.19789136915501
2022-12-07T09:30:00-05:00,81.24,81.99,80.99,81.19,4083604,4869677.55,56.765605544761634,64.08790617528888,NaN,NaN,20.766299962206322,70.16403263856392,-0.2759171781358356,1.786749703142462,2.0626668812782976,192291739,199615298.6,71.24058033630311,63.80087786345369,NaN,NaN,26.08127307375085,27.895517326954415
2022-12-08T09:30:00-05:00,81.72,82.21,81.525,81.79,2761894,4677576.65,58.81912105881605,63.82692615945293,NaN,NaN,41.54146238600034,59.0345319242439,-0.30609105179200435,1.6800530665382922,1.9861441183302966,195053633,198138651.4,67.56767823226656,64.01584371107509,NaN,NaN,24.915680443776196,27.46982634364324
2022-12-09T09:30:00-05:00,81.59,82.29,80.96,80.98,3936193,4438472.3,55.019799410362246,63.19859776775657,NaN,NaN,1.1727680294550213,37.14517534373277,-0.37875725700580065,1.5126975470730457,1.8914548040788464,191117440,195192260.8,60.82877482974697,64.2988074241723,NaN,NaN,22.815386724923055,26.804906398111786
2022-12-12T09:30:00-05:00,81.03,81.7,80.74,81.68,3193055,4273566.7,57.57046491799431,62.70267245948559,NaN,NaN,-1.623437069471957,20.170459255850822,-0.37701961310602794,1.4201802876963114,1.7971999008023394,194310495,193829730,57.950399897218325,64.63150191879996,NaN,NaN,21.730350277684398,26.0799698094793
2022-12-13T09:30:00-05:00,84.2,84.36,82.22,82.81,6288031,4269621.95,61.37790466893164,62.16773609897883,NaN,NaN,132.96478708077808,38.96437607779357,-0.30043726878542354,1.42165331482056,1.7220905836059834,200598526,194674366.6,59.238060436341705,65.05867925274224,NaN,NaN,21.881842151648804,25.480237286932088
2022-12-14T09:30:00-05:00,82.47,83,81.2901,81.92,7817603,4299125.45,57.03665223373602,61.27222478368687,NaN,NaN,43.52480008181829,43.51607610171595,-0.30918521286336675,1.335609067526775,1.6447942803901419,192780923,194772203.4,59.393176068000734,65.2779707645885,NaN,NaN,20.730199488641855,24.80166045860491
2022-12-15T09:30:00-05:00,80.53,80.61,79.22,79.42,5229295,4240645.3,46.9838665992205,59.670021929060724,NaN,NaN,-133.0224999533587,8.603283633844143,-0.47299969000782593,1.0535446678803595,1.5265443578881854,187551628,193271802.4,55.88116431947766,64.9789887253461,NaN,NaN,16.32114857050055,23.590158760304288
2022-12-16T09:30:00-05:00,78.79,79.32,78.3,79.08,7285260,4370940.25,45.80154369600469,58.63401614751104,NaN,NaN,-193.95868089125577,-30.423006150298015,-0.5864952245402502,0.7934253272128728,1.379920551753123,180266368,191101588,51.168146568512064,64.21720722311031,NaN,NaN,12.424582770559422,21.995076476055022
2022-12-19T09:30:00-05:00,78.42,78.87,77.18,77.55,3229958,4345159.8,40.82313140827426,57.18480707736978,NaN,NaN,-234.5429096937061,-77.00690067514485,-0.7371084759111963,0.4585349568641277,1.195643432775324,177036410,187646771,44.704313270856446,62.88304367208512,NaN,NaN,7.401223641021939,19.910240356764582
2022-12-20T09:30:00-05:00,77.69,78.515,77.66,78.06,2820943,4305251.35,43.04543167013498,55.51530825895822,NaN,NaN,-188.55707241127172,-141.31127257355482,-0.7712229440870462,0.2316147526665162,1.0028376967535624,179857353,183498536.4,38.427297137114,60.93005313382936,NaN,NaN,4.0078879034480295,17.638475720576505
2022-12-21T09:30:00-05:00,78.47,79.065,78.28,78.74,2877745,4268785.55,45.95946055765184,54.036013461740886,NaN,NaN,-126.24112503656819,-175.2644575972321,-0.7179231191784904,0.10543379778044937,0.8233569169589398,182735098,181489371.4,35.804985528675545,58.631510518691236,NaN,NaN,2.0714336320922446,15.414612565078754
2022-12-22T09:30:00-05:00,78.18,78.18,76.66,77.98,3315583,4222154.7,43.29336336510511,52.20369491437919,NaN,NaN,-150.8694305676344,-178.83384372008726,-0.7028889176443133,-0.055254230096451806,0.6476346875478615,179419515,179862948.8,33.79453489986531,55.97635275974408,NaN,NaN,-0.3633995896963165,13.160610828682316
2022-12-23T09:30:00-05:00,77.98,78.54,77.55,78.52,3101174,4315799.15,45.70347915557236,51.12607705655148,NaN,NaN,-105.33786576096925,-161.10968069402992,-0.6280619962140557,-0.13744280771970807,0.49061918849434755,182520689,180313813,34.88602834365693,53.22804759141087,NaN,NaN,-1.682986113511573,11.040096979797475
2022-12-27T09:30:00-05:00,78.71,79.11,78.25,78.59,2434272,4275910.3,46.02373408196084,50.301682740609046,NaN,NaN,-76.20957208172166,-129.44301317163303,-0.5482435288584595,-0.19468522257872678,0.35355830627973267,184954961,181897523.2,38.708482698217914,50.685258754732374,NaN,NaN,-2.6687337032542877,9.081692596504366
2022-12-28T09:30:00-05:00,78.57,78.87,77.33,77.39,2523225,4260243.95,41.50429302295771,49.21158898905162,NaN,NaN,-93.64325953363249,-110.4602505961052,-0.5492795483196197,-0.3330411291197919,0.21623841919982775,182431736,182412399.8,39.942851548924025,48.449706698491006,NaN,NaN,-4.862573172602546,7.089654629489093
2022-12-29T09:30:00-05:00,77.82,78.555,77.82,78.23,3223061,4055770.8,45.53605335100633,48.26279843849379,NaN,NaN,-73.06556977962397,-99.82513954471636,-0.46949933046722825,-0.3706357438842076,0.09886358658302066,185654797,182996339.6,41.38465322280948,46.57949062638693,NaN,NaN,-5.571763823433113,5.280880564785921
2022-12-30T09:30:00-05:00,77.66,77.95,77.025,77.68,2909431,3995845.05,43.425558891818035,47.43463840145491,NaN,NaN,-87.71021057232623,-87.19329554565475,-0.4308837403502584,-0.43974108885480234,-0.008857348504543935,182745366,183661509.8,43.06151068868677,45.31040033059691,NaN,NaN,-6.776821895509939,3.5583516418865124
2023-01-03T09:30:00-05:00,77.81,78.32,76.89,77.6,5342010,4092319.35,43.112558696465285,46.401930814202835,NaN,NaN,-79.78834485153746,-82.0833913637684,-0.3891172612522761,-0.4952539250698891,-0.10613666381761297,177403356,182638043.2,41.11262832452925,44.10770236111913,NaN,NaN,-7.852888407526723,1.928174491970336
2023-01-04T09:30:00-05:00,77.99,79.165,77.945,78.95,4871150,4099564.65,49.70105803536772,45.567870340376835,NaN,NaN,-34.068883195599994,-73.65525358654406,-0.2554191976260275,-0.42541066085014734,-0.16999146322411984,182274506,182101952.2,40.089163586141325,42.73992401467624,NaN,NaN,-6.904405917470113,0.6663772906217005
2023-01-05T09:30:00-05:00,77.72,78.14,77.14,77.7,4106319,4067490.3,44.55550132787894,44.67635956138705,NaN,NaN,-70.86300379819525,-69.09920243945662,-0.23645264515762543,-0.46555726967115163,-0.2291046245135262,178168187,181249242.4,38.44956876804145,41.24395206467915,NaN,NaN,-7.607459547468083,-0.5155994005339828
2023-01-06T09:30:00-05:00,78.42,80.55,78.42,80.37,4364591,4081539.65,55.21992684069664,45.26464957863534,NaN,NaN,24.325633583738608,-49.620961766784106,-0.03968767361234207,-0.2787142165289538,-0.2390265429166117,182532778,180624838.6,37.248233600652,39.913028441905894,NaN,NaN,-4.612953796613686,-1.100935742831083
2023-01-09T09:30:00-05:00,81.03,81.96,80.61,80.88,8395719,4363230.9,56.924263230040474,46.059129545352185,NaN,NaN,91.1193283878462,-13.855053974749623,0.12044745992544079,-0.08846721800981072,-0.2089146779352515,190928497,182261464.8,42.33405146098571,39.28202164851115,NaN,NaN,-1.6648727553193088,-1.181498173186544
2023-01-10T09:30:00-05:00,80.91,81.745,80.46,81.69,4024487,4367645.6,59.557033970485364,47.39726544265299,NaN,NaN,98.8601329787761,21.874641591313086,0.26809994734731823,0.12621025624889626,-0.14188969109842195,194952984,185771390.4,51.42626172641399,39.76216082390812,NaN,NaN,1.6222638465034622,-0.7809607418022574
2023-01-11T09:30:00-05:00,82.55,83.01,82.06,82.97,4922865,4454136.1,63.36732855370623,48.84882950576522,NaN,NaN,151.90901690845985,59.07022161212505,0.42957161462121146,0.3950748271780924,-0.03449678744311907,199875849,189291659,58.4945983725241,41.19553948358027,NaN,NaN,5.6860920079718795,0.14290393673690494
2023-01-12T09:30:00-05:00,83.16,83.52,82.33,83.28,3893799,4334424.5,64.24590143788058,50.155003854352984,NaN,NaN,168.93002129398207,107.02882663056053,0.5283580499803077,0.6259507750322655,0.09759272505195785,203769648,194411951.2,66.19914388014728,43.36655079439968,NaN,NaN,9.21594782518186,1.4390530636576127
2023-01-13T09:30:00-05:00,82.8,83.955,82.73,83.79,3482568,4117672.75,65.70322393046715,51.75570818045027,NaN,NaN,174.9575277649072,137.15520546679426,0.5942353461033767,0.8403869076811787,0.24615156157780205,207252216,199355838.8,71.66780648287022,46.071784478900035,NaN,NaN,12.57499622899371,3.029902087277055
2023-01-17T09:30:00-05:00,83.93,84.09,82.865,82.95,3471562,4029786.1,61.273313028826564,52.867839171396994,NaN,NaN,139.17441295893687,146.76622238101237,0.5485242058803708,0.9318068189282656,0.3832826130478948,203780654,201926270.2,74.02120037695853,48.86715390985014,NaN,NaN,14.113821203865978,4.613319103932615
2023-01-18T09:30:00-05:00,83.71,83.83,81.74,81.78,4722548,3901650.5,55.645618165606,53.55511660594308,NaN,NaN,93.53248177865184,145.70069214098754,0.41295782240739654,0.8994798910571404,0.4865220686497439,199058106,202747294.6,74.74286148119927,51.44103810863453,NaN,NaN,13.72460959143586,5.914932030718793
2023-01-19T09:30:00-05:00,81.16,81.49,80.5125,81.15,4079890,3944147.1,52.8318127449747,54.364225157515726,NaN,NaN,40.6681653023418,123.45252181976392,0.26169885113666047,0.8136456325705694,0.551946781433909,194978216,201767768,72.16714191088981,53.74277313448922,NaN,NaN,12.547192240009682,6.862397774903206
2023-01-20T09:30:00-05:00,81.36,82.84,80.93,82.78,3448710,3975535.45,58.65684629383672,55.301424653432186,NaN,NaN,70.3975913672258,103.74603583441267,0.25216477067778253,0.8671527447811371,0.6149879741033546,198426926,200699223.6,69.35916374002927,55.74095245714778,NaN,NaN,13.335140832360121,7.787075354539908
2023-01-23T09:30:00-05:00,82.67,83.4,82.27,83.05,6248750,4144085.7,59.54799491869981,56.453027226780875,NaN,NaN,84.26648569166348,85.60782741976392,0.2445941410522685,0.9207306504186903,0.6761365093664218,204675676,200183915.6,67.9853478326514,57.52122653885954,NaN,NaN,14.239594870924973,8.708863856880631
2023-01-24T09:30:00-05:00,82.59,83.22,81.895,83.1,4680555,4212334.3,59.72114177626043,57.63935458962339,NaN,NaN,71.90931848774753,72.15480852552605,0.22405366372193547,0.9562035890188412,0.7321499252969057,209356231,201299031,69.39792810201719,59.54160509439439,NaN,NaN,15.01923658042875,9.610345674530363
2023-01-25T09:30:00-05:00,82.19,83.3,81.91,83.27,3602041,4237377.65,60.34267109569221,58.399469808217994,NaN,NaN,68.85310856566409,67.21893388292851,0.20360815891821438,0.9866601239446737,0.7830519650264594,212958272,204079064.2,72.63915014136963,61.866604134053546,NaN,NaN,15.836651757587127,10.4998179721099
2023-01-26T09:30:00-05:00,82.57,83.705,82.31,83.67,5753117,4403319.9,61.83493696683184,59.633715211000336,NaN,NaN,76.51834088284919,74.38896899902998,0.19850796669884385,1.0311869234000142,0.8326789567011703,218711389,208825698.8,77.09910883562307,64.62728556745223,NaN,NaN,16.93993505284608,11.419834697929355
2023-01-27T09:30:00-05:00,83.1,83.99,83.02,83.4,3419779,4448147.6,60.18857522109439,59.98861866674304,NaN,NaN,79.72717657587543,76.25488604075991,0.16008300505507334,1.032782713020012,0.8726997079649387,215291610,212198635.6,79.63896015338418,67.65519460693311,NaN,NaN,17.441787930394273,12.280113731138629
2023-01-30T09:30:00-05:00,82.89,83.88,82.72,82.83,5210919,4547540.5,56.75317543000842,59.976398109597895,NaN,NaN,62.7953532689762,71.96065955622245,0.08327486283246965,0.9767932865055258,0.8935184236730561,210080691,213279638.6,80.38962351842218,70.37344975389286,NaN,NaN,16.96193013796819,12.948944646399994
2023-01-31T09:30:00-05:00,82.89,84.68,82.89,84.65,3871370,4595637.45,63.848479415923194,60.28292992712917,NaN,NaN,95.27717164935233,76.63423018854341,0.13876971263064342,1.0669805644613604,0.9282108518307169,213952061,214198804.6,81.03004130936962,72.48800543838969,NaN,NaN,18.607682799109682,13.757335811072807
2023-02-01T09:30:00-05:00,84.16,85.9,83.61,85.21,7223630,4689718.45,65.71251311326714,60.450443109954946,NaN,NaN,132.36381738742648,89.33637195289593,0.19355384230966244,1.170153154717795,0.9765993124081326,221175691,215842288.4,82.15235566772182,74.17784524518952,NaN,NaN,20.547505467312835,14.727360047678525
2023-02-02T09:30:00-05:00,84.84,85.185,83.67,84.94,6163992,4754360.55,63.99910234044225,60.43281460299506,NaN,NaN,117.40225120208983,97.51315401674405,0.1916108224554769,1.2161128404774786,1.0245020180220017,215011699,215102350.4,79.8614874045222,75.15372692550201,NaN,NaN,21.668007496126478,15.718881111742519
2023-02-03T09:30:00-05:00,84.01,84.68,83.29,83.41,5937876,4845938.4,55.213508682913925,59.68354922816983,NaN,NaN,72.23573296275183,96.01486529411935,0.07336720433932276,1.116211023446155,1.0428438191068323,209073823,213858793,76.02451276863817,75.4649202316283,NaN,NaN,20.000547832262626,16.330547786102535
2023-02-06T09:30:00-05:00,82.67,83,82.05,82.49,6262343,4940826,50.705989607808796,58.92874041238285,NaN,NaN,-37.50569123459024,75.95465639340605,-0.0728112935710532,0.9518297021430158,1.024640995714069,202811480,212404950.8,71.68806132805156,75.29826744242065,NaN,NaN,17.160077456185917,16.449052024685876
2023-02-07T09:30:00-05:00,82.38,83.81,82.34,83.6,7553022,4898691.15,55.43338286655618,58.913580748164996,NaN,NaN,19.91522820811785,60.88226770515915,-0.09912010532279092,0.9007408640605803,0.9998609693833712,210364502,211687439,69.57868758793128,74.92939787861579,NaN,NaN,16.18663431641788,16.41156378064759
2023-02-08T09:30:00-05:00,83.16,83.96,82.87,82.93,5265933,4960763.45,52.18047251849314,58.867056446273466,NaN,NaN,12.195064685022976,36.848517164678455,-0.16228729549222387,0.7970018500180913,0.9592891455103152,205098569,208472014.6,60.92683247258556,74.12651863302264,NaN,NaN,14.357085940356965,16.118066946320358
2023-02-09T09:30:00-05:00,83.57,83.75,81.36,81.73,8330587,5131149.55,46.874900686525045,58.02548890289406,NaN,NaN,-91.85704484161919,-5.0033420440633565,-0.2786987509504828,0.6109157068222117,0.8896144577726945,196767982,204823271.2,52.88981751290408,72.95013675965654,NaN,NaN,11.0589970567824,15.395342676386363
2023-02-10T09:30:00-05:00,81.55,82.15,81.06,82.03,3507964,5111857.8,48.290432989445605,57.221377336518756,NaN,NaN,-127.90662293166879,-45.031813222947484,-0.3260184929681488,0.48209134156250855,0.8081098345306573,200275946,203063695.8,49.49879958438351,71.6296690276374,NaN,NaN,8.827512207462016,14.457081180825742
2023-02-13T09:30:00-05:00,82.17,82.625,81.64,82.46,2749275,5075193.15,50.33319664679806,56.55080982727145,NaN,NaN,-71.5985086109999,-51.85037669822941,-0.31851295007291136,0.40996864693951807,0.7284815970124294,203025221,203106444,49.58337155516084,70.21434356000482,NaN,NaN,7.5851461319124995,13.475376173838136
2023-02-14T09:30:00-05:00,82.11,82.875,81.7,82.65,4107474,5106988.75,51.249617737795944,55.90130601599314,NaN,NaN,-50.8779609903232,-66.00901453791764,-0.29162771757190475,0.3639469500475485,0.6555746676194533,207132695,202460082.6,48.26718047396079,68.47348858376132,NaN,NaN,6.82625760822492,12.525502093036248
2023-02-15T09:30:00-05:00,82.1,83.025,81.88,83.01,3978425,5069782.6,53.01846232457236,55.27155782726032,NaN,NaN,-30.64151864737948,-74.57633120439813,-0.2424913579788428,0.35246047014589976,0.5949518281247426,211111120,203662592.8,50.879599440191434,66.60066648408764,NaN,NaN,6.6805041925263,11.690502392963399
2023-02-16T09:30:00-05:00,81.86,83.03,81.66,82.07,4336900,5082633.1,48.10988120949205,54.408793969288716,NaN,NaN,-78.7525164636451,-71.95542552880332,-0.26439450827148825,0.26445869278538225,0.5288532010568705,206774220,205663840.4,54.95628848428897,64.8376185077237,NaN,NaN,5.131591749951566,10.753515158247422
2023-02-17T09:30:00-05:00,81.5,81.58,80.855,81.3,3726224,5096508.8,44.47730400098576,53.531946010072815,NaN,NaN,-166.38027373556628,-79.6501556895828,-0.3182240363500185,0.1310731556193474,0.4492971919693659,203047996,206218250.4,56.04464796212749,63.09869168227408,NaN,NaN,2.7160960182831135,9.605312423966808
2023-02-21T09:30:00-05:00,80.88,81.16,79.84,79.96,5900310,5079086.8,38.9636561168187,51.75445863156535,NaN,NaN,-207.96334214795675,-106.92312239697416,-0.424893338124208,-0.08181948068589406,0.3430738574383139,197147686,205042743.4,53.11424045332618,61.1047059068424,NaN,NaN,-1.188537971397623,8.063333796057604
2023-02-22T09:30:00-05:00,80.32,80.96,79.91,80.56,5934386,5141778.35,42.40640911668793,50.08973691752398,NaN,NaN,-163.34901676921407,-129.41733355275235,-0.4343151196416907,-0.19982004211379945,0.23449507752789125,203082072,204232618.8,51.13005871534869,58.88882755310146,NaN,NaN,-3.4047398978943635,6.425037554064466
2023-02-23T09:30:00-05:00,80.86,81.2,79.46,80.65,5596333,5241492.95,42.9264389597738,48.58454667604766,NaN,NaN,-142.06634040239442,-151.70229790375532,-0.4138472506403521,-0.2828139857725489,0.13103326486780323,208678405,203746075.8,49.923822413524114,56.750422910887316,NaN,NaN,-5.044530396767651,4.786527846802735
2023-02-24T09:30:00-05:00,79.29,81.3,78.87,81.19,9324084,5420041.3,46.07272716417978,47.93163371042379,NaN,NaN,-123.77745465676973,-160.70728554238025,-0.34605689695230846,-0.30153785632258234,0.044519040629726114,218002489,205991729.6,55.17961204093551,55.26150143033713,NaN,NaN,-5.536447429110678,3.311817093100819
2023-02-27T09:30:00-05:00,81.71,82.23,81.375,81.46,6469774,5572541.05,47.62734209326232,47.711730316527614,NaN,NaN,-43.39397709013701,-136.1100262132944,-0.26860144457260987,-0.29123276508603624,-0.022631320513426353,224472263,210276583,63.131046145325286,54.65028606014239,NaN,NaN,-5.510234444143046,2.0515240163516957
2023-02-28T09:30:00-05:00,81.44,82.3612,81.29,81.83,8546757,5739332.95,49.76455256730921,47.30681386658141,NaN,NaN,-31.151018510446935,-100.74756148579245,-0.18215447497342419,-0.25032441423020657,-0.0681699392567824,233019020,217450849.8,72.06657530068293,54.82799232533894,NaN,NaN,-4.893082656129807,1.0594373488543383
2023-03-01T09:30:00-05:00,82.01,83.27,82,82.47,7740826,5932805.75,53.31347997083598,47.387742970320176,NaN,NaN,22.813615597942444,-63.51503501236114,-0.07695755344364653,-0.16436688106134056,-0.08740932761769403,240759846,224986404.6,78.0767466788633,56.05298619721593,NaN,NaN,-3.3459757820466,0.43009261586849
2023-03-02T09:30:00-05:00,82.04,83.61,81.845,83.41,6335119,5888380.2,58.006004982782216,48.182821848624265,NaN,NaN,59.85056577953286,-23.131653775975682,0.05379757922953708,-0.020162353580772674,-0.07395993281030976,247094965,232669716.6,82.26639540949088,58.151313189829274,NaN,NaN,-0.5683905548547917,0.2874521629080212
2023-03-03T09:30:00-05:00,83.96,84.645,83.31,84.6,5997380,5880049.6,63.066974996832066,49.23828913486616,NaN,NaN,155.45712507101382,32.715262169581024,0.20954950377447296,0.18797694690778144,-0.02157255686669151,253092345,239687687.8,85.072519752194,60.69229320181574,NaN,NaN,3.524279081439323,0.7498560084124928
2023-03-06T09:30:00-05:00,84.27,84.27,83.09,83.23,5481423,5857226.95,54.868584220641544,49.56224539014069,NaN,NaN,108.26023704809316,63.046104997227076,0.20895333486396706,0.23961911171326733,0.03066577684930026,247610922,244315419.6,86.58047457701538,63.33494341766248,NaN,NaN,4.530803584843097,1.2899913764740076
2023-03-07T09:30:00-05:00,82.92,82.92,81.3,81.59,6760305,5882125.05,46.993233438976056,49.25821794022499,NaN,NaN,-11.470249482622396,66.98225880279199,0.09268544595305751,0.14652258429062215,0.053837138337564636,240850617,245881739,87.05705030304239,66.10564840545403,NaN,NaN,2.7037299929782233,1.4919540359746097
2023-03-08T09:30:00-05:00,81.63,82.19,81.35,81.99,5795189,5794233.4,48.91901166128906,48.965400035704754,NaN,NaN,-13.993071552732,59.620921372657094,0.039988504048169574,0.1038227683977766,0.06383426434960703,246645806,247058931,87.41868691270264,68.71558322491911,NaN,NaN,1.8901340090024417,1.5488368892643
2023-03-09T09:30:00-05:00,82.05,82.32,79.63,79.88,6425969,5852235.2,40.55001930880192,48.425409899941165,NaN,NaN,-103.72220569719602,26.906367077311312,-0.1303744171469347,-0.09913375708406136,0.031240660062873342,240219837,245683905.4,84.45051141997983,70.82231343461132,NaN,NaN,-1.8490386326939694,1.0634261004131187
2023-03-10T09:30:00-05:00,79.91,79.93,77.76,78.18,13062550,6088833.35,35.30882866770769,47.77051880470702,NaN,NaN,-210.44892438549104,-46.27484281398966,-0.33909499691793255,-0.39262808608454236,-0.05353308916660981,227157287,240496893.8,74.21378707493253,72.12010908552597,NaN,NaN,-6.954153540832636,-0.08194241976484617
2023-03-13T09:30:00-04:00,77.4,78.435,76.8,77.38,20352540,6931062.15,33.13816237603193,47.35441210893653,NaN,NaN,-215.6850757273044,-111.06390536906918,-0.502707172761231,-0.6819170551181486,-0.17920988235691757,206804747,232335658.8,61.56821128690458,72.72396414506727,NaN,NaN,-11.754631593613876,-1.7494694446004218
2023-03-14T09:30:00-04:00,78.51,79.28,77.52,78.37,8238644,7205530.6,38.20129191367581,47.05404659443567,NaN,NaN,-142.71625170288306,-137.3131058131213,-0.51409006473609,-0.8218224632770301,-0.3077323985409401,215043391,227174213.6,55.166057748961165,73.01224979032531,NaN,NaN,-13.889081652799923,-3.483699760057493
2023-03-15T09:30:00-04:00,76.35,76.52,74.77,75.83,14262218,7713267.8,31.591419506370215,46.24440234776398,NaN,NaN,-217.58336880237172,-178.03116526304925,-0.6535665187759565,-1.1246905470108857,-0.4711240282349292,200781173,218001287,46.009392651279256,72.73264766445068,NaN,NaN,-18.26271364631816,-5.594987458094732
2023-03-16T09:30:00-04:00,75.11,76.8,74.88,76.7,10806414,8054667.25,35.69559541300384,45.50317865125142,NaN,NaN,-170.03543659150137,-191.29381144191032,-0.6469101058213678,-1.2797616605116389,-0.6328515546902711,211587587,212274837,41.39059163353089,71.74771763535036,NaN,NaN,-20.210210558972662,-7.682876472505864
2023-03-17T09:30:00-04:00,76.43,76.45,75.38,75.51,9443543,8309999.4,32.79715760094092,44.44387975894274,NaN,NaN,-153.30494705674187,-179.86501597616046,-0.6789993315418016,-1.4816007191175231,-0.8026013875757215,202144044,207272188.4,37.81877302644403,69.93969812685883,NaN,NaN,-22.805208491203256,-9.843209618034063
2023-03-20T09:30:00-04:00,75.77,76.77,75.77,76.73,7393833,8493379.85,38.326173088440946,43.6268526533093,NaN,NaN,-110.99353808078192,-158.926708446856,-0.5783432560941708,-1.525530457693435,-0.9471872015992642,209537877,207818814.4,38.443850968864375,67.53807496030036,NaN,NaN,-22.99514447885111,-11.72205745529364
2023-03-21T09:30:00-04:00,77.63,77.99,77.14,77.66,4749016,8435815.15,42.228146171433494,42.83504309620912,NaN,NaN,-66.92145438077131,-143.76774898243363,-0.4169505166191576,-1.468375347373211,-1.0514248307540535,214286893,207667514.8,38.32900002889519,64.69895019958837,NaN,NaN,-21.8223562266248,-13.16495727976952
2023-03-22T09:30:00-04:00,77.53,78.11,76.26,76.28,7327553,8505473.5,38.35076721192191,41.43109754114767,NaN,NaN,-77.42344615765587,-115.73576445349048,-0.3724181757396461,-1.5169475504286112,-1.144529374688965,206959340,208903148.2,39.907924712483265,61.6733451498021,NaN,NaN,-22.147381222851656,-14.448160700209826
2023-03-23T09:30:00-04:00,76.62,77.725,75.6,76.19,6719770,8561645.35,38.105032405756575,39.64810164178514,NaN,NaN,-78.25706687712199,-97.3800905106146,-0.32029252495302063,-1.544895030880241,-1.2246025059272203,200239570,206633544.8,37.984261125274564,58.30989810502215,NaN,NaN,-22.476754498798872,-15.595102671436832
2023-03-24T09:30:00-04:00,75.61,76.99,75.06,76.81,6732620,8432072.15,40.9137798486991,38.65132990093211,NaN,NaN,-75.66115989371089,-81.8513330780084,-0.22009949460783873,-1.4997268741870187,-1.27962737957918,206972190,207599174,39.324337670288514,54.93445975454165,NaN,NaN,-21.883928067000024,-16.49350629937443
2023-03-27T09:30:00-04:00,77.61,77.925,76.82,77.38,5306963,8373931.6,43.454311982309086,38.398549796884474,NaN,NaN,-44.470232296159764,-68.54667192108397,-0.09772027810818296,-1.4017777272144087,-1.3040574491062258,212279153,208147429.2,40.115560348245204,51.58149618634185,NaN,NaN,-20.630157523254308,-17.084456474214413
2023-03-28T09:30:00-04:00,77.37,77.88,77.29,77.75,5124020,8202794.75,45.104327931796625,38.126072387635006,NaN,NaN,-34.068965974092706,-61.976174239748254,0.019608680821307845,-1.279546598079591,-1.2991552789008989,217403173,208770685.2,41.05655703157123,48.26991548054675,NaN,NaN,-19.115352973176584,-17.374584545494724
2023-03-29T09:30:00-04:00,78.75,78.88,78.48,78.83,4135132,8022510.05,49.71664944132036,38.78083168281489,NaN,NaN,-0.0956142479946047,-46.510607857816,0.17288750740211833,-1.0830458946482509,-1.2559334020503692,221538305,211686478.2,45.38065471988764,45.47921143054016,NaN,NaN,-16.42118603714293,-17.238384758587326
2023-03-30T09:30:00-04:00,79.65,79.7,79.085,79.37,4216883,7916598.25,51.893074686016234,39.96542068412265,NaN,NaN,27.1252613695763,-25.434142208476334,0.3058083011290098,-0.873673025639107,-1.1794813267681168,225755188,216789601.8,52.01542285849602,43.89361398650898,NaN,NaN,-13.524164296208971,-16.707781835390417
2023-03-31T09:30:00-04:00,79.38,80.7,79.38,80.66,6763231,7954890.8,56.713173358894856,41.64935004004143,NaN,NaN,69.66844019044598,3.6317778083550394,0.46616739550166053,-0.5967720823910412,-1.0629394778927017,232518419,221898847.6,57.57233787252621,43.60819445691053,NaN,NaN,-9.494580538085701,-15.677324507204029
2023-04-03T09:30:00-04:00,80.82,81.38,80.57,81.17,8064265,8084032.9,58.48420701808977,43.098129690356714,NaN,NaN,112.00904586118551,34.9276334398241,0.5844777288749045,-0.3323423167990711,-0.9168200456739756,240582684,227559553.8,62.72308832299534,44.147982355055824,NaN,NaN,-5.610160002229046,-14.239158149350459
2023-04-04T09:30:00-04:00,80.97,81.01,79.69,80,8748670,8183451.15,53.11524171235842,44.63554556221301,NaN,NaN,88.15933649723176,59.373293934088984,0.5616848721141333,-0.2147139555313089,-0.7763988276454422,231834014,230445722,65.05263566573745,45.5082139989457,NaN,NaN,-3.7989647334054384,-12.7477019470726
2023-04-05T09:30:00-04:00,79.4,79.93,79.1,79.82,9280508,8357717.1,52.31947332559874,45.82296541311265,NaN,NaN,72.41875904852387,73.87616859339269,0.5135454023540134,-0.13446707470292552,-0.6480124770569389,222553506,230648762.2,65.21731526264543,47.210122829596735,NaN,NaN,-2.5490697593049765,-11.290754491677225
2023-04-06T09:30:00-04:00,79.29,79.705,79.035,79.63,9515693,8512203.3,51.443355358979204,47.154836681543955,NaN,NaN,70.8166077526807,82.61443787001357,0.45023406667322763,-0.08521989371540428,-0.5354539603886319,213037813,228105287.2,61.31922282452758,48.8887263866027,NaN,NaN,-1.7542355345503142,-9.928394640659095
2023-04-10T09:30:00-04:00,79.32,80.15,79.24,80.01,4633567,8090754.15,53.13369740481163,48.21251698985615,NaN,NaN,80.69797797064211,84.8203454260528,0.41608207805978364,-0.01535136281390237,-0.431433440873686,217671380,225135879.4,57.033296085209216,50.216543894913045,NaN,NaN,-0.6198832488596495,-8.598607298973459
2023-04-11T09:30:00-04:00,80.37,81.07,80.34,80.63,3857665,7266010.4,55.83513892607915,49.1844450437594,NaN,NaN,106.00615012709004,83.6197662792337,0.4163648110499223,0.08902257293871685,-0.32734223811120544,221529045,221325151.6,52.0092727379407,51.19370623127344,NaN,NaN,1.1064618119134813,-7.212168854561039
2023-04-12T09:30:00-04:00,81.19,81.37,80.545,80.69,5944024,7151279.4,56.098866087526595,50.45216639201688,NaN,NaN,100.7641633728586,86.14073165435907,0.4015288677350144,0.17456884655756255,-0.22696002117745184,227473069,220452962.6,50.90401746081918,51.979141427583144,NaN,NaN,2.6163520749253295,-5.808094436062986
2023-04-13T09:30:00-04:00,80.74,81.79,80.57,81.52,9001499,6888243.45,59.68522505366864,51.9936087240106,NaN,NaN,107.14640691780122,93.08626122821454,0.42621899130242935,0.3058137179505849,-0.12040527335184449,236474568,223237175,54.24659634411306,53.140736800357324,NaN,NaN,4.946913879872784,-4.27166467664359
2023-04-14T09:30:00-04:00,81.32,81.885,80.515,80.93,4413156,6568580.55,56.17237655301821,53.08350848860482,NaN,NaN,91.92950378383782,97.30884043444597,0.3827964688511275,0.35809031271206493,-0.0247061561390626,232061412,227041894.8,58.41332226945627,54.504235700297876,NaN,NaN,6.030806368838484,-2.79988309871758
2023-04-17T09:30:00-04:00,80.97,81.42,80.75,81.4,3683093,6280558.05,58.278958026658316,54.14241177748691,NaN,NaN,89.0952872377019,98.98830228785792,0.3657327928781924,0.4324598349586779,0.0667270420804855,235744505,230656519.8,61.95787579941901,56.064401089667435,NaN,NaN,7.53928864099493,-1.3228585644729356
2023-04-18T09:30:00-04:00,81.71,82.01,81.36,81.74,3383010,6080016.9,59.78482311405109,55.19101857621938,NaN,NaN,105.5823402771453,98.90354031786897,0.35695496200165844,0.5129207445825585,0.1559657825809001,239127515,234176213.8,65.07906119682048,57.780294244328104,NaN,NaN,9.235675862375253,0.185503496505377
2023-04-19T09:30:00-04:00,81.19,81.585,81,81.51,3654785,6025305.35,58.253088671893615,55.800764235546026,NaN,NaN,83.65380880239196,95.48146940377565,0.31664104576825,0.5517670897912126,0.2351260440229626,235472730,235776146,66.42746597999314,59.283637905764216,NaN,NaN,10.281017522148291,1.627719785882936
2023-04-20T09:30:00-04:00,80.93,81.68,80.91,81.42,4026012,5860228.3,57.63086429872875,56.21060635073978,NaN,NaN,77.08473786278351,89.46913559277212,0.266887028234464,0.5687348293160426,0.3018478010815786,231446718,234770576,64.73557340110057,60.19222008737882,NaN,NaN,11.008771435629175,2.96787002156097
2023-04-21T09:30:00-04:00,81.1,81.185,80.25,80.7,5422069,5795343.25,52.77434023926426,55.92926112790902,NaN,NaN,40.22776326252232,79.128787488509,0.17301090817632014,0.5181114363019788,0.3451005281256586,226024649,233563223.4,62.67160790030054,60.556453660791284,NaN,NaN,10.38072573120965,4.026849408653638