time,open,high,low,close,Volume,Volume MA,RSI,RSI-based MA,Upper Bollinger Band,Lower Bollinger Band,CCI,Smoothing Line,Histogram,MACD,Signal,OnBalanceVolume,Smoothing Line,RSI,RSI-based MA,Upper Bollinger Band,Lower Bollinger Band,True Strength Index,Signal
2015-10-08T09:30:00-04:00,30.01,30.21,30.01,30.21,2000,NaN,NaN,NaN,NaN,NaN,NaN,NaN,NaN,NaN,NaN,NaN,NaN,NaN,NaN,NaN,NaN,NaN,NaN
2015-10-09T09:30:00-04:00,30.2,30.2,30.06,30.16,4335,NaN,NaN,NaN,NaN,NaN,NaN,NaN,NaN,NaN,NaN,-4335,NaN,NaN,NaN,NaN,NaN,NaN,NaN
2015-10-12T09:30:00-04:00,30.4199,30.42,30.27,30.3499,2250,NaN,NaN,NaN,NaN,NaN,NaN,NaN,NaN,NaN,NaN,-2085,NaN,NaN,NaN,NaN,NaN,NaN,NaN
2015-10-13T09:30:00-04:00,30.16,30.16,30.16,30.16,508,NaN,NaN,NaN,NaN,NaN,NaN,NaN,NaN,NaN,NaN,-2593,NaN,NaN,NaN,NaN,NaN,NaN,NaN
2015-10-15T09:30:00-04:00,30.03,30.07,30.03,30.07,2515,NaN,NaN,NaN,NaN,NaN,NaN,NaN,NaN,NaN,NaN,-5108,NaN,NaN,NaN,NaN,NaN,NaN,NaN
2015-10-16T09:30:00-04:00,30.5958,30.66,30.5958,30.642,400,NaN,NaN,NaN,NaN,NaN,NaN,NaN,NaN,NaN,NaN,-4708,-3765.8,NaN,NaN,NaN,NaN,NaN,NaN
2015-10-19T09:30:00-04:00,30.7,31.01,30.7,30.9999,2001,NaN,NaN,NaN,NaN,NaN,NaN,NaN,NaN,NaN,NaN,-2707,-3440.2,NaN,NaN,NaN,NaN,NaN,NaN
2015-10-20T09:30:00-04:00,31.36,31.36,30.99,31.03,3240,NaN,NaN,NaN,NaN,NaN,NaN,NaN,NaN,NaN,NaN,533,-2916.6,NaN,NaN,NaN,NaN,NaN,NaN
2015-10-21T09:30:00-04:00,31.055,31.055,31.055,31.055,400,NaN,NaN,NaN,NaN,NaN,NaN,NaN,NaN,NaN,NaN,933,-2211.4,NaN,NaN,NaN,NaN,NaN,NaN
2015-10-22T09:30:00-04:00,31.18,31.4625,31.177,31.4475,2180,NaN,NaN,NaN,NaN,NaN,NaN,NaN,NaN,NaN,NaN,3113,-567.2,NaN,NaN,NaN,NaN,NaN,NaN
2015-10-23T09:30:00-04:00,31.0526,31.07,30.94,31.07,3548,NaN,NaN,NaN,NaN,NaN,NaN,NaN,NaN,NaN,NaN,-435,287.4,NaN,NaN,NaN,NaN,NaN,NaN
2015-10-26T09:30:00-04:00,31.028,31.12,31.028,31.11,576,NaN,NaN,NaN,NaN,NaN,NaN,NaN,NaN,NaN,NaN,141,857,NaN,NaN,NaN,NaN,NaN,NaN
2015-10-27T09:30:00-04:00,31.06,31.12,31,31.1183,3350,NaN,NaN,NaN,NaN,NaN,NaN,NaN,NaN,NaN,NaN,3491,1448.6,NaN,NaN,NaN,NaN,NaN,NaN
2015-10-28T09:30:00-04:00,31.24,31.33,31.005,31.005,3210,NaN,NaN,NaN,NaN,NaN,NaN,NaN,NaN,NaN,NaN,281,1318.2,NaN,NaN,NaN,NaN,NaN,NaN
2015-10-29T09:30:00-04:00,31.03,31.146,31.01,31.146,3906,NaN,68.15783347559548,NaN,NaN,NaN,NaN,NaN,NaN,NaN,NaN,4187,1533,NaN,NaN,NaN,NaN,NaN,NaN
2015-10-30T09:30:00-04:00,30.95,30.95,30.95,30.95,211,NaN,62.9985489735228,NaN,NaN,NaN,NaN,NaN,NaN,NaN,NaN,3976,2415.2,NaN,NaN,NaN,NaN,NaN,NaN
2015-11-03T09:30:00-05:00,31.6,31.6,31.32,31.35,520,NaN,68.27627123022788,NaN,NaN,NaN,NaN,NaN,NaN,NaN,NaN,4496,3286.2,NaN,NaN,NaN,NaN,NaN,NaN
2015-11-04T09:30:00-05:00,31.52,31.52,31.22,31.22,1850,NaN,65.0298236366225,NaN,NaN,NaN,NaN,NaN,NaN,NaN,NaN,2646,3117.2,NaN,NaN,NaN,NaN,NaN,NaN
2015-11-05T09:30:00-05:00,31.28,31.28,30.95,31.1,23810,NaN,62.094768971769014,NaN,NaN,NaN,NaN,NaN,NaN,NaN,NaN,-21164,-1171.8,NaN,NaN,NaN,NaN,NaN,NaN
2015-11-06T09:30:00-05:00,30.38,30.38,29.95,29.95,9031,3492.05,42.362207048764425,NaN,NaN,NaN,-116.5508202166691,NaN,NaN,NaN,NaN,-30195,-8048.2,38.51731090994895,NaN,NaN,NaN,NaN,NaN
2015-11-09T09:30:00-05:00,30.0601,30.1036,29.6,29.71,45453,5664.7,39.53833557316977,NaN,NaN,NaN,-152.49732517696808,NaN,NaN,NaN,NaN,-75648,-23973,20.064259817328832,NaN,NaN,NaN,NaN,NaN
2015-11-10T09:30:00-05:00,30.11,30.11,29.85,30.03,27240,6809.95,44.820007319852955,NaN,NaN,NaN,-119.23067981831933,NaN,NaN,NaN,NaN,-48408,-34553.8,14.942100520079507,NaN,NaN,NaN,NaN,NaN
2015-11-11T09:30:00-05:00,30.105,30.26,29.99,30.1339,27147,8054.8,46.455528588605105,NaN,NaN,NaN,-94.73719452992086,NaN,NaN,NaN,NaN,-21261,-39335.2,13.29088049777316,NaN,NaN,NaN,NaN,NaN
2015-11-12T09:30:00-05:00,29.86,30.08,29.86,29.95,63887,11223.75,43.971282820729755,NaN,NaN,NaN,-114.1549347900096,-119.4341909063774,NaN,NaN,NaN,-85148,-52132,10.080220521794828,NaN,NaN,NaN,NaN,NaN
2015-11-13T09:30:00-05:00,29.82,29.87,29.556,29.56,47674,13481.7,39.185528281949125,NaN,NaN,NaN,-146.1804801117497,-125.36012288539351,NaN,NaN,NaN,-132822,-72657.4,7.11242878012645,NaN,NaN,NaN,NaN,NaN
2015-11-16T09:30:00-05:00,29.53,29.62,29.53,29.53,4200,13671.7,38.835381458810204,NaN,NaN,NaN,-133.83826528749225,-121.62831090749833,NaN,-0.410749418120826,NaN,-137022,-84932.2,5.978769214051113,NaN,NaN,NaN,NaN,NaN
2015-11-17T09:30:00-05:00,30,30.18,29.93,29.99,25680,14855.65,46.699925686959794,NaN,NaN,NaN,-68.98667899271143,-111.57951074237675,NaN,-0.39455369348334557,NaN,-111342,-97519,5.083921465576324,NaN,NaN,NaN,NaN,NaN
2015-11-18T09:30:00-05:00,29.64,30.3448,26.7,30.3448,28556,16121.45,51.84321801031673,51.447761505492544,NaN,NaN,-143.91693224140653,-121.4154582846739,NaN,-0.34906526314362907,NaN,-82786,-109824,4.391870806920352,NaN,NaN,NaN,NaN,NaN
2015-11-19T09:30:00-05:00,30.41,30.55,30.41,30.51,3517,16277.3,54.06581403622466,50.441188688394625,NaN,NaN,-3.318979759887911,-99.24826727864956,NaN,-0.2962698802490493,NaN,-79269,-108648.2,5.712646357646406,NaN,NaN,NaN,NaN,NaN
2015-11-20T09:30:00-05:00,30.71,30.77,30.71,30.76,597,16198.15,57.27916014895055,50.03266091521089,NaN,NaN,28.199927243063712,-64.37218580768688,NaN,-0.2315866613971842,NaN,-78672,-97818.2,17.07571477610081,NaN,NaN,NaN,NaN,NaN
2015-11-23T09:30:00-05:00,30.97,31.012,30.92,30.92,2392,16140.35,59.24421812736916,49.38751426500669,NaN,NaN,51.405327699123376,-27.32346721036376,NaN,-0.16550622883350385,NaN,-76280,-85669.8,27.61404479062155,NaN,NaN,NaN,NaN,NaN
2015-11-24T09:30:00-05:00,31.02,31.02,30.45,30.45,2524,16237.75,51.71855872636975,48.436709628560074,NaN,NaN,20.102095381427752,-9.505712335535925,NaN,-0.14934057678123835,NaN,-78804,-79162.2,32.55834389005935,NaN,NaN,NaN,NaN,NaN
2015-11-30T09:30:00-05:00,31,31,30.7223,30.75,1627,16151.6,55.59586478111078,47.9725021863702,NaN,NaN,43.54549832276512,27.986773777298406,NaN,-0.11104166902768142,NaN,-77177,-78040.4,33.40281647766008,16.84466634469198,NaN,NaN,NaN,NaN
2015-12-01T09:30:00-05:00,30.98,31.2586,30.98,31.2586,5557,16268.95,61.273846665478224,49.32333358756404,NaN,NaN,82.87489091294457,45.22554791186489,0.1993922520072119,-0.03919789037144383,-0.23859014237865572,-71620,-76510.6,34.60536702709767,16.565241781631176,NaN,NaN,NaN,NaN
2015-12-02T09:30:00-05:00,31.11,31.22,30.62,30.62,4397,16293.5,52.24109449045977,50.23067351022762,NaN,NaN,45.21662584033681,48.62888763131952,0.16414748979254973,-0.03340578013796858,-0.1975532699305183,-76017,-75979.6,35.04380945433863,17.635209612846158,NaN,NaN,NaN,NaN
2015-12-03T09:30:00-05:00,30.37,30.37,30.01,30.01,776,16321.75,45.36211727816936,50.269395650107356,NaN,NaN,-32.707279293706954,31.806366232753454,0.09632415350870241,-0.0771480780446403,-0.1734722315533427,-76793,-76082.2,34.99498764904682,19.06755869348668,NaN,NaN,NaN,NaN
2015-12-04T09:30:00-05:00,30.31,30.83,30.31,30.62,4378,16514.65,52.147863586766995,50.67599100711892,NaN,NaN,30.063737206594933,33.79869459778689,0.08927461713823182,-0.06187896013055294,-0.15115357726878476,-72415,-74804.4,36.187353385489025,20.703021042609244,NaN,NaN,NaN,NaN
2015-12-08T09:30:00-05:00,30.28,30.76,29.92,30.72,4645,16654.4,53.174556363458656,51.333367688742406,NaN,NaN,21.734579760847325,29.436510885403333,0.08793598605678749,-0.04123359469780041,-0.1291695807545879,-67770,-72923,37.990874327989616,22.696639171623158,NaN,NaN,11.855369008167667,NaN
2015-12-09T09:30:00-05:00,30.51,30.55,30.51,30.55,643,15496.05,51.164797116494185,52.18902974835277,NaN,NaN,38.238649675559266,20.50926263792627,0.07281581989454318,-0.03814980588640893,-0.1109656257809521,-68413,-72281.6,38.62769821268831,24.947729845377577,NaN,NaN,10.847001664956148,NaN
2015-12-10T09:30:00-05:00,30.3,30.3,30.3,30.3,660,15077.5,48.2751829407835,52.86330128277944,NaN,NaN,0.5092930340231235,11.56779607666353,0.04457890354339003,-0.05524199635171456,-0.09982089989510459,-69073,-70892.8,40.06303533435726,27.382320282542302,NaN,NaN,9.029819342167823,NaN
2015-12-11T09:30:00-05:00,30.18,30.18,30.1382,30.1382,330,12821.35,46.446879257964746,52.84522653785122,NaN,NaN,-26.430517711171557,12.823148393170618,0.015128001712086211,-0.08091089775499682,-0.09603889946708304,-69403,-69414.8,41.62765244127708,29.99258678080664,NaN,NaN,6.961757579061224,NaN
2015-12-14T09:30:00-05:00,30.1,30.27,30.09,30.2312,628,11490.75,47.67356872671534,52.547394446165406,NaN,NaN,-21.255254853421164,2.5593499811674,0.0026863232046941687,-0.09268099546121533,-0.0953673186659095,-68775,-68686.8,42.42489359081884,32.70923126537082,NaN,NaN,5.660019359054915,NaN
2015-12-15T09:30:00-05:00,30.723,30.79,30.58,30.58,4147,10340.75,52.1047592622298,52.407319105165776,NaN,NaN,49.655379194701865,8.14350986793831,0.017876345430160506,-0.07302188687820887,-0.09089823230836938,-64628,-68058.4,43.14671144150985,35.38309305707535,NaN,NaN,5.86626901393961,NaN
2015-12-16T09:30:00-05:00,30.86,31.13,30.86,31.13,1618,7227.3,58.12634743602233,52.46783248281377,NaN,NaN,104.20947811276729,21.33767555537991,0.06238846644746465,-0.012912649249038566,-0.07530111569650322,-63010,-66977.8,44.43672470961442,37.337450909469176,NaN,NaN,7.954598252559762,NaN
2015-12-17T09:30:00-05:00,31.46,31.46,31.0578,31.09,2420,4964.6,57.559562680945895,52.3474999509264,NaN,NaN,123.97403073468885,46.03062309551306,0.0851510944001764,0.031137752303717292,-0.05401334209645911,-65430,-66249.2,45.337337794953065,38.603400409778565,NaN,NaN,9.431545522285337,NaN
2015-12-18T09:30:00-05:00,30.5626,30.59,30.35,30.35,1372,4823.2,48.196516081860146,52.095925476318556,NaN,NaN,-18.592166987236087,47.59829324030015,0.048221865646165506,0.006263989961247773,-0.04195787568491773,-66802,-65729,46.01020285089167,39.564247478409456,NaN,NaN,7.611613299897692,NaN
2015-12-21T09:30:00-05:00,30.456,30.456,30.4,30.4,485,3563.45,48.802514235674934,51.61068615164457,NaN,NaN,-26.185857719730965,46.612172667038195,0.0261208757556256,-0.009306780990385732,-0.03542765674601133,-66317,-65237.4,46.67819027460303,40.51248846390537,NaN,NaN,6.366697192947646,NaN
2015-12-22T09:30:00-05:00,30.68,30.68,30.68,30.68,201,2145.7,52.17637775628203,50.96086694384485,NaN,NaN,15.594440786482345,39.79998498539429,0.029091037042706075,0.0009361395573712628,-0.028154897485334812,-66116,-65535,46.304693086704674,41.34815461102016,NaN,NaN,6.3441387657168,NaN
2015-12-23T09:30:00-05:00,30.75,30.98,30.75,30.98,4493,2194.5,55.555795793559504,51.19763132263768,NaN,NaN,67.97349063782582,32.552787490406,0.04882965833479751,0.032882175433162075,-0.015947482901635432,-61623,-65257.6,46.73254500858189,42.18306429346611,NaN,NaN,7.351919729576137,NaN
2015-12-24T09:30:00-05:00,30.8557,31.01,30.8557,31.01,330,2181.15,55.89146136840211,51.94972732908288,NaN,NaN,76.35075074175762,23.02813149181975,0.06070163245498298,0.05992955766709329,-0.0007720747878896869,-61293,-64430.2,48.06188802868585,43.11641432058319,NaN,NaN,8.257917130137766,7.964512758497579
2015-12-28T09:30:00-05:00,31.03,31.03,30.92,30.9272,2126,2167.85,54.66433440532131,52.129475244693914,NaN,NaN,76.23885755904577,41.99433640107612,0.0596836122515388,0.07383244052653382,0.014148828274995013,-63419,-63753.6,49.1788056417364,44.04437519602943,NaN,NaN,8.65710537961356,8.063454561514147
2015-12-29T09:30:00-05:00,31.25,31.49,31.25,31.44,3457,2214.5,60.455110386460355,52.649514817765464,NaN,NaN,153.56627532150227,77.94476300932277,0.08851352917271728,0.12479073974089161,0.03627721056817433,-59962,-62482.6,51.29757558151087,44.99485385699523,NaN,NaN,10.737640866550388,8.445481176519325
2015-12-30T09:30:00-05:00,31.57,31.59,31.4399,31.4399,2037,2235,60.45348874513251,53.31299279123964,NaN,NaN,149.45908337776658,104.7176915275796,0.10160642293927982,0.16328523924227412,0.06167881630299429,-61999,-61659.2,52.67411198980332,45.99816912678916,NaN,NaN,12.41352071244422,9.012343967365737
2015-12-31T09:30:00-05:00,31.32,31.39,31.184,31.184,36795,3796.9,56.29222565263422,53.88563869922898,NaN,NaN,100.89883254567022,111.30275990914849,0.08759316434780218,0.17117027173774702,0.08357710738994484,-98794,-69093.4,41.31892691746968,46.08787566844005,NaN,NaN,12.666173088950877,9.534319556163615
2016-01-04T09:30:00-05:00,30.98,30.98,30.3612,30.46,1937,3673.9,46.53295426506399,53.89178691402177,NaN,NaN,-22.538542503516673,91.52490126009363,0.027252201790046462,0.11764235962750291,0.09039015783745645,-100731,-76981,33.15285425947911,45.48253294116876,NaN,NaN,9.742815766043789,9.56410472900364
2016-01-05T09:30:00-05:00,30.93,31.383,30.93,31.383,1518,3711,56.81251787636982,54.54456899613995,NaN,NaN,88.05170039740597,93.88746982776567,0.046082683896248755,0.1479935127077674,0.10191082881151864,-99213,-84139.8,27.785477257205415,44.43686034591066,NaN,NaN,10.610724141096636,9.713621787874068
2016-01-06T09:30:00-05:00,30.82,31.1849,30.82,31.08,3724,3678.3,53.196760452330565,54.62256908114715,NaN,NaN,44.34136763325046,72.0424882901153,0.03520368112552644,0.14591543021842668,0.11071174909290024,-102937,-92734.8,22.975926203389236,42.9960899717592,NaN,NaN,10.044047520793825,9.760825464005462
2016-01-07T09:30:00-05:00,30.7208,30.7495,30.507,30.51,1547,3523.4,47.12117329331688,53.836485213811045,NaN,NaN,-40.9004686723183,33.97057788009833,-0.010845908445316146,0.09715436353625506,0.10800027198157121,-104484,-101231.8,19.40066542207667,41.20780002264935,NaN,NaN,7.398548481290542,9.423357323617616
2016-01-08T09:30:00-05:00,30.51,30.519,30.08,30.11,3993,3690.9,43.37718681372278,52.82345836615225,NaN,NaN,-101.63759515119949,-6.536707659275609,-0.06565202200808719,0.025935244471462227,0.09158726647954941,-108477,-103168.4,18.686938868189387,39.304200099309085,NaN,NaN,3.926725437552603,8.6381241970369
2016-01-11T09:30:00-05:00,30.2899,30.2899,30.2899,30.2899,477,3681.75,45.475478660745644,52.62909855035836,NaN,NaN,-91.50492238429864,-20.329983635432008,-0.0859160306451111,-0.015807771826839456,0.07010825881827164,-108000,-104622.2,18.14721136798238,37.313986421958425,NaN,NaN,1.8711566437267992,7.671414546564028
2016-01-12T09:30:00-05:00,30.04,30.11,29.96,29.96,2269,3778.7,42.37439291057688,52.16994702713707,NaN,NaN,-139.16596454035414,-65.77351662298403,-0.11580586929039115,-0.0746490777947173,0.04115679149567385,-110269,-106833.4,17.327465079943835,35.21750605091134,NaN,NaN,-0.8465146477905497,6.454567518799089
2016-01-13T09:30:00-05:00,30.24,30.29,29.65,29.65,3338,3914.2,39.6389791973208,51.27441855863983,NaN,NaN,-155.65801447328408,-105.77339304429093,-0.14862820045792693,-0.14462845907673483,0.003999741381192107,-113607,-108967.4,16.550448303079747,33.09220285208099,NaN,NaN,-3.9820809065069547,4.963617743755369
2016-01-14T09:30:00-05:00,29.8284,29.8284,29.5001,29.75,3706,3892.15,40.96291648809147,50.23207003682069,NaN,NaN,-157.33806064576538,-129.06091143898033,-0.15506396439197856,-0.1898302141087811,-0.03476624971680253,-109901,-110050.8,16.154384744433585,30.908048547498964,NaN,NaN,-6.097868935523305,3.3834053610012726
2016-01-15T09:30:00-05:00,29.146,29.3,29.146,29.25,1414,3881.95,36.63604398265376,48.8566830806958,NaN,NaN,-190.48078733418802,-146.82954987557804,-0.18256094194635225,-0.26296742714974286,-0.08040648520339061,-111315,-110618.4,15.939176335139962,28.613569140817116,NaN,NaN,-9.328365009734474,1.5674381651818803
2016-01-19T09:30:00-05:00,29.5099,29.5099,29.355,29.45,4705,3996.2,39.39373390161271,47.76592590185948,NaN,NaN,-140.5170320471706,-156.63197180815246,-0.17672878518708876,-0.30131746668725157,-0.1245886815001628,-106610,-110340.4,16.525731052663033,26.28120667016902,NaN,NaN,-11.145491253805506,-0.24869460895917483
2016-01-20T09:30:00-05:00,28.66,28.89,28.1199,28.66,4609,4158.05,33.23991356763035,45.82198327194305,NaN,NaN,-201.57119045053335,-169.1130169901883,-0.21308899055665997,-0.3909499196959878,-0.17786092913932783,-111219,-110530.4,16.441291812427934,23.79147211523453,NaN,NaN,-14.866003053375682,-2.336881529590104
2016-01-21T09:30:00-05:00,28.88,28.88,28.88,28.88,101,4138.85,36.227571643883,44.091560621853795,NaN,NaN,-139.778073215576,-165.9370287386467,-0.2090469756900406,-0.4391696487518786,-0.23012267306183798,-111118,-110032.6,17.628822618924318,21.288237160171736,NaN,NaN,-16.921349161552644,-4.420376905584753
2016-01-22T09:30:00-05:00,29.465,29.48,29.4574,29.48,330,4145.3,43.63604487655292,43.187547709276565,NaN,NaN,-75.23725282158345,-149.51686717381028,-0.15516634840471183,-0.4240806085677278,-0.26891426016301595,-110788,-110210,17.533191869420477,19.58925608531108,NaN,NaN,-16.260817564857053,-6.111868428337939
2016-01-26T09:30:00-05:00,29.59,29.8559,29.59,29.7422,529,3947.1,46.55781528105366,43.189323496132964,NaN,NaN,-46.84702684212292,-120.79011507539727,-0.09407630724818372,-0.38650964422324563,-0.2924333369750619,-110259,-109998.8,18.102789719916373,18.514251475342313,NaN,NaN,-14.780880375276764,-7.350298706472056
2016-01-27T09:30:00-05:00,29.48,29.48,29.48,29.48,930,3977.1,44.096144731734874,42.28101112865904,NaN,NaN,-62.63412424259588,-105.21353351448231,-0.06492155002276273,-0.3735852745035153,-0.3086637244807526,-111189,-110914.6,17.537150400042762,17.78222812840212,NaN,NaN,-14.332757413545147,-8.347792807482499
2016-01-28T09:30:00-05:00,29.48,29.4899,29.16,29.16,1652,3953.4,41.23089751103327,41.426306632852096,NaN,NaN,-74.29174194473514,-79.75764381332269,-0.06085224224968566,-0.3847290272928596,-0.32387678504317396,-112841,-111239,17.330578128629327,17.378988980204987,NaN,NaN,-14.84645775441122,-9.276173514186603
2016-01-29T09:30:00-05:00,29.01,29.2,29.01,29.19,553,3808.2,41.61392217497463,41.03293155297051,NaN,NaN,-80.46229545495514,-67.8944882611985,-0.0502444511396859,-0.3866823489677813,-0.3364378978280954,-112288,-111473,17.173436983209342,17.219901234571605,NaN,NaN,-15.14545413916642,-10.114642174898005
2016-02-01T09:30:00-05:00,29.607,29.8101,29.607,29.81,744,3743.55,49.01024302000331,41.435292710561974,NaN,NaN,-15.627050518262596,-55.97244780053434,0.0016723956358680736,-0.3343474032832603,-0.33601979891912837,-111544,-111624.2,17.06575994200601,17.10410273984422,NaN,NaN,-13.115599349933849,-10.543350342760268
2016-02-02T09:30:00-05:00,29.68,29.68,29.43,29.43,1094,1958.5,45.22847427332255,41.41764954003175,NaN,NaN,-34.982593362780335,-53.59956110466582,0.012937915771089936,-0.3198474042052659,-0.33278531997635585,-112638,-112100,16.71068704118268,17.001493859358526,NaN,NaN,-12.563719326824286,-10.831974483340842
2016-02-03T09:30:00-05:00,29.68,29.68,29.0465,29.46,3781,2050.7,45.58545556078101,41.64701115790348,NaN,NaN,-45.13558796804585,-50.0998538497558,0.02426916877247426,-0.302448859010763,-0.3267180277832373,-108857,-111633.6,18.500733825162456,17.08529876973129,NaN,NaN,-12.017161990662974,-11.00128698438686
2016-02-04T09:30:00-05:00,29.4439,29.645,29.4439,29.6365,1506,2050.1,47.74339829111998,42.22589823603199,NaN,NaN,-12.676509303552635,-37.7768073215193,0.04434159225907358,-0.2712910374593953,-0.3156326297184689,-107351,-110535.6,22.712027226819217,17.525411549998392,NaN,NaN,-10.937835121156212,-10.992222432496767
2016-02-05T09:30:00-05:00,29.21,29.21,29.098,29.098,221,1874.95,42.23951157824232,42.3170835996142,NaN,NaN,-77.40969829160989,-37.16628788885025,0.023109889366151437,-0.2867452680107796,-0.30985515737693103,-107572,-109592.4,26.238012910383617,18.24567070470911,NaN,NaN,-11.624559338122843,-11.082556276157636
2016-02-08T09:30:00-05:00,28.1,28.1,27.556,27.556,718,1833.5,31.16157437524005,41.9260500562275,NaN,NaN,-279.3786638715091,-89.91661055949956,-0.08699113655172164,-0.4185940780665831,-0.33160294151486147,-108290,-108941.6,28.656541484788676,19.154053929684018,NaN,NaN,-16.406870536375102,-11.843172599045845
2016-02-09T09:30:00-05:00,27.42,27.55,27.0707,27.34,1359,1701.8,29.9756350649006,41.253328710748065,NaN,NaN,-264.5388092106793,-135.82785372907932,-0.1622015621258906,-0.5343548941722247,-0.3721533320463341,-109649,-108343.8,30.897857916631935,20.18063441996751,NaN,NaN,-20.52284442906705,-13.083125717620302
2016-02-10T09:30:00-05:00,27.92,27.92,27.92,27.92,293,1692.6,36.91800020297304,41.51604918470112,NaN,NaN,-152.4183100115589,-157.28439813778195,-0.16043202999099743,-0.5726933695350809,-0.41226133954408345,-109356,-108443.6,30.72432149771005,21.200850826059092,NaN,NaN,-21.54535359721421,-14.292015414705146
2016-02-11T09:30:00-05:00,27.2999,27.2999,27.22,27.22,810,1619.65,32.7038338895494,41.264353630820146,NaN,NaN,-183.254400817746,-191.39997644062063,-0.1918266661503943,-0.6520446722320763,-0.460218006081682,-110166,-109006.6,29.710560358504964,22.063832093171992,NaN,NaN,-23.900407357704285,-15.664642835133595
2016-02-12T09:30:00-05:00,27.22,27.5079,27.22,27.49,1823,1543.9,35.75029105055964,40.70108550039205,NaN,NaN,-137.95626089177935,-203.50928896065452,-0.18002185611745747,-0.6852453262285039,-0.5052234701110464,-108343,-109160.8,29.42419623403616,22.9131895477874,NaN,NaN,-24.727476154080826,-16.959333309268914
2016-02-17T09:30:00-05:00,28.4,28.45,28.328,28.35,2640,1490.6,44.386176571979824,40.54596844974392,NaN,NaN,-41.65949484077943,-155.9654551545086,-0.10369656989476939,-0.6348441824795081,-0.5311476125847387,-105703,-108643.4,31.79951533421891,23.891527091666156,NaN,NaN,-22.392287768841154,-17.735469660636376
2016-02-18T09:30:00-05:00,28.4808,28.7,28.4808,28.7,3898,1614.8,47.48012904948768,40.787681615297686,NaN,NaN,-15.8327385531871,-106.22424102301015,-0.023242859879596622,-0.5602011874342345,-0.5369583275546379,-101805,-107074.6,38.55250591799027,25.392623914376692,NaN,NaN,-19.473566349050902,-17.98376918755274
2016-02-19T09:30:00-05:00,28.66,28.66,28.66,28.66,200,1389.55,47.1572380964612,41.21099165711397,NaN,NaN,-9.439428845784812,-77.62846478985533,0.030745036055723984,-0.49852703248498287,-0.5292720685407069,-102005,-105604.4,44.13516052665439,27.307236942807055,NaN,NaN,-17.31065416037684,-17.88760989795618
2016-02-22T09:30:00-05:00,29.1,29.1552,29.075,29.1,827,1200.45,51.09688985903831,41.88834649168995,NaN,NaN,30.820933742159124,-34.813397877874316,0.09587694221434384,-0.409425890772777,-0.5053028329871209,-101178,-103806.8,50.104168657243044,29.659432062380887,NaN,NaN,-14.239320507840192,-17.366425699368182
2016-02-23T09:30:00-05:00,28.95,28.95,28.95,28.95,328,1211.8,49.7355623362769,41.94015501428091,NaN,NaN,15.179948508885351,-4.186155997741368,0.1267084313417267,-0.3469172938099625,-0.4736257251516892,-101506,-102439.4,54.11998944887598,32.30616274144303,NaN,NaN,-12.16102520712408,-16.622797057619024
2016-02-24T09:30:00-05:00,28.919,28.974,28.91,28.974,751,1232.85,49.96525362645454,42.27849639664749,NaN,NaN,18.44446942922206,7.834636856258927,0.14524032533552222,-0.2920753184822864,-0.43731564381780863,-100755,-101449.8,56.8280626147764,35.17168956812829,NaN,NaN,-10.418558073593994,-15.736477202758305
2016-02-25T09:30:00-05:00,29.16,29.16,29.16,29.16,125,1212.65,51.803426074087014,42.72263714759792,NaN,NaN,42.93185985801253,19.587556538498852,0.16509902833460677,-0.23094185839955017,-0.39604088673415694,-100630,-101214.8,57.47004726431517,37.9552119566392,NaN,NaN,-8.433723958936676,-14.693226739355215
2016-02-26T09:30:00-05:00,29.5,29.505,29.37,29.37,2504,1291.35,53.864260359347576,43.15984158104275,NaN,NaN,69.32593271817225,35.34062885129027,0.18590365333742903,-0.16366132006237066,-0.3495649733997997,-98126,-100439,59.60560262908526,40.590467342515346,NaN,NaN,-6.169367120060751,-13.475532508027435
2016-02-29T09:30:00-05:00,29.627,29.65,29.33,29.33,732,1245.35,53.39592131228187,43.95672799061699,NaN,NaN,69.96905529000375,43.17025316085919,0.18983242312116516,-0.11227444449834323,-0.3021068676195084,-98858,-99975,60.8711147215805,43.064260329029416,NaN,NaN,-4.407466039079869,-12.180094441034925
2016-03-01T09:30:00-05:00,29.8,30.04,29.79,30.03,951,1265.25,59.95743823778351,46.0135754093701,NaN,NaN,112.23421153879875,62.58110576684187,0.22977018592280377,-0.01489413521600369,-0.24466432113880746,-97907,-99255.2,62.817216753157794,45.50430856248435,NaN,NaN,-0.8375526563220542,-10.559731328933086
2016-03-02T09:30:00-05:00,30.23,30.36,30.19,30.36,1305,1293.3,62.62871531466168,48.34593828435303,NaN,NaN,138.60434299670607,86.61308048033868,0.2660478560738718,0.08789549895353233,-0.1781523571203395,-96602,-98424.6,64.98157669017236,47.93885990345152,NaN,NaN,3.0231936253888008,-8.619313478315673
2016-03-03T09:30:00-05:00,30.3639,30.4184,30.3639,30.402,1080,1292.6,62.96732718242737,50.20660449717119,NaN,NaN,136.3097865394575,105.28866581662767,0.27914385158458693,0.17077745736039418,-0.10836639422419277,-95522,-97403,67.48827058938713,50.56485626714274,NaN,NaN,6.28544878673918,-6.49006172616498
2016-03-04T09:30:00-05:00,30.5,30.53,30.4404,30.49,1703,1188.7,63.70928252650806,52.4212793998111,NaN,NaN,131.97999677259355,117.81947862751194,0.27932289604247396,0.24078722582889966,-0.03853567021357428,-93819,-96541.6,69.47255465422171,53.40499871683679,NaN,NaN,9.225855880333823,-4.244930639522293
2016-03-07T09:30:00-05:00,30.61,30.63,30.47,30.47,1542,1190.5,63.39839522667753,54.39614398381951,NaN,NaN,124.98760845096926,128.82318925970503,0.26386751894343474,0.29129872846571914,0.027431209522284408,-95361,-95842.2,71.01916229600893,56.37606772126342,NaN,NaN,11.607403462638146,-1.9803114820708019
2016-03-08T09:30:00-05:00,30.445,30.445,30.424,30.424,611,1210,62.64126031339455,55.70007853677771,NaN,NaN,104.37376824356086,127.25110060065745,0.237162318998082,0.3238841082698869,0.0867217892718049,-95972,-95455.2,71.86844721912315,59.23813428447086,NaN,NaN,13.445994659979643,0.22344653822211846
2016-03-09T09:30:00-05:00,30.45,30.517,30.2501,30.3312,3688,1358.5,61.057075539048654,56.66986042888921,NaN,NaN,90.43083731337161,117.61639946399058,0.20127867118266152,0.3383201282501318,0.13704145706747028,-99660,-96066.8,68.45428379333975,61.37397556128154,NaN,NaN,14.649233706433723,2.284273276538062
2016-03-10T09:30:00-05:00,30.6499,30.6499,30.1884,30.1884,1001,1340.6,58.60114345417523,57.4872822401545,NaN,NaN,80.35054417337155,106.42455099077338,0.15787359217477057,0.3343834472859335,0.17650985511116293,-100661,-97094.6,63.03486525271975,62.72395447028621,NaN,NaN,15.098825394599451,4.11492357911826
2016-03-11T09:30:00-05:00,30.78,30.89,30.78,30.89,410,1346.45,65.8658145116235,58.54220542962486,NaN,NaN,108.72143629644076,101.7728388955428,0.16555740125138854,0.3834566066753986,0.21789920542401006,-100251,-98381,56.95699744407228,63.21344224077401,NaN,NaN,17.586789287771378,6.039475823211562
2016-03-14T09:30:00-04:00,31.039,31.098,30.9901,30.9901,3010,1456.45,66.76198747204097,59.758378653608005,NaN,NaN,111.52401814004143,99.08012083335726,0.16609627406185246,0.42551954800132563,0.2594232739394732,-97241,-98757,55.27924072234478,63.29624590316464,NaN,NaN,19.92332479917331,8.022882819777527
2016-03-15T09:30:00-04:00,31,31.195,31,31.195,2258,1478.2,68.58041224300011,61.08803284050412,NaN,NaN,112.46267112828575,100.69790141030224,0.16843811479962384,0.469970917439003,0.30153280263937915,-94983,-98559.2,56.01329214563119,63.23804801251141,NaN,NaN,22.45115150901041,10.084064061096509
2016-03-16T09:30:00-04:00,31.2,31.205,30.9601,30.9601,1537,1423.05,64.24130496296542,61.97645276113828,NaN,NaN,98.16436403431621,102.24460675449116,0.143336344661594,0.48070323346637167,0.33736688880477766,-96520,-97931.2,58.35074364323137,63.30095489671971,NaN,NaN,23.4468255592655,11.993029989406365
2016-03-17T09:30:00-04:00,31.99,32.046,31.9799,31.9956,1050,1280.65,72.50107246368552,63.30765362573385,NaN,NaN,169.83391089317573,120.14128009845199,0.1830965947575599,0.5662376322517275,0.3831410374941676,-95470,-96893,61.950523173108735,63.468449221292815,NaN,NaN,27.176851925966023,14.162147408914887
2016-03-18T09:30:00-04:00,31.6899,31.78,31.43,31.47,136356,8088.45,64.37312827799855,64.09173983757076,NaN,NaN,123.93263973962749,123.18352078708934,0.16138373537748008,0.5848707067160177,0.42348697133853763,-231826,-123208,18.4417208495,60.437778230429934,NaN,NaN,27.60260923114004,16.08221338351848
2016-03-21T09:30:00-04:00,31.62,31.62,31.255,31.31,3413,8217.75,62.09113079785784,64.24414644900465,NaN,NaN,101.89915024544133,121.2585472081693,0.1252428575915953,0.5800405433280318,0.4547976857364365,-235239,-150807.6,10.28390075089564,56.685398515982634,NaN,NaN,27.194406033361624,17.669669476353214
2016-03-22T09:30:00-04:00,31.22,31.41,31.2138,31.2552,1576,8280.15,61.289741397303054,64.14850545490759,NaN,NaN,83.57077537109672,115.48016805673151,0.08838150634675884,0.565274568669885,0.47689306232312617,-236815,-179174,6.903709326481803,52.536979418576166,NaN,NaN,26.62253008952594,18.948649563949317
2016-03-23T09:30:00-04:00,31.265,31.3365,31.14,31.14,2642,8374.7,59.549736491279404,63.904391834111316,NaN,NaN,65.8507056337344,109.01743637661517,0.04894488301320521,0.5380741660896327,0.48912928307642745,-239457,-207761.4,5.088495062634394,48.07985259523668,NaN,NaN,25.635148258444513,19.903863663162916
2016-03-24T09:30:00-04:00,31.01,31.19,30.9767,31.19,2197,8478.3,60.0794745088583,63.64511983285062,NaN,NaN,49.15670747505871,84.88199569299175,0.020392584760585142,0.5146200140271588,0.4942274292665737,-237260,-236119.4,3.972635097390679,43.40128691260589,NaN,NaN,24.972572741376666,20.627964960050594
2016-03-28T09:30:00-04:00,31.01,31.4699,31.01,31.39,2583,8482.25,62.21127566250788,63.56032557826707,NaN,NaN,63.84447564932055,72.86436287493035,0.009685300006099684,0.5063340542741983,0.4966487542680986,-234677,-236689.6,3.953860183892928,38.610908190311896,NaN,NaN,24.994851906138614,21.25180595234888
2016-03-29T09:30:00-04:00,31.72,32.07,31.51,32.07,17268,9309.05,68.39166296217566,63.97106862460858,NaN,NaN,134.6748702861811,79.4195068830783,0.04133462143129418,0.5483170310572163,0.5069824096259221,-217409,-233123.6,6.916711094920458,33.97149846715456,NaN,NaN,26.925021399797426,22.06226530198439
2016-03-30T09:30:00-04:00,32.33,32.33,31.995,32,4165,9469.75,67.17372077072538,64.40797185544263,NaN,NaN,154.61770157357702,93.62889212357436,0.04991567547232967,0.5693770039663342,0.5194613284940045,-221574,-230075.4,9.48703283197004,29.75955196991387,NaN,NaN,28.125142812196174,22.92839066058607
2016-03-31T09:30:00-04:00,32,32.16,32,32.16,11342,9971.6,68.55226136344143,65.11876599181879,NaN,NaN,138.87333638469477,108.23341827376643,0.058152448147989366,0.5921518886789912,0.5339994405310018,-210232,-224230.4,14.36982608139472,26.283477743390648,NaN,NaN,29.530631441713375,23.87156791503283
2016-04-01T09:30:00-04:00,32.0228,32.227,32.0228,32.227,658,9950.5,69.13675394600122,65.35240452284577,NaN,NaN,129.42667264437569,124.28741130762982,0.05967406277198373,0.6085920189959815,0.5489179562239977,-209574,-218693.2,18.836738155455507,23.560602079918024,NaN,NaN,30.857215051064575,24.869517505894507
2016-04-04T09:30:00-04:00,32.2715,32.2715,32.1,32.1799,5325,10131.6,68.17743934138716,65.45350822779906,NaN,NaN,117.8311422510141,135.08474462796852,0.04948937616901605,0.6107796764352678,0.5612903002662517,-214899,-214737.6,21.96828263353879,21.1812479307176,NaN,NaN,31.704900363208655,25.8460007712251
2016-04-05T09:30:00-04:00,31.9,31.9,31.8756,31.8916,310,10070,62.464088463139326,65.016627957809,NaN,NaN,69.73856761846034,122.09748409442436,0.016995688035071566,0.5825349103100912,0.5655392222750196,-215209,-214297.6,22.327281098341913,18.775104284482655,NaN,NaN,30.867725705130404,26.563390047497286
2016-04-06T09:30:00-04:00,31.93,31.98,31.85,31.98,588,10068.85,63.4748178824939,64.96187888063247,NaN,NaN,67.87984003757,104.74991178722296,-0.003776099886845463,0.5608190974164629,0.5645951973033083,-214621,-212907,23.524783446131224,16.2875356989755,NaN,NaN,30.43088631208563,27.11588951386705
2016-04-07T09:30:00-04:00,32.0328,32.0328,31.7202,31.7202,2124,9990.65,58.4900864074837,63.96109416233235,NaN,NaN,45.62572755774503,86.10039002183302,-0.03832464044603212,0.5166893967457682,0.5550140371918003,-216745,-214209.6,23.164516320575316,13.517106638080259,NaN,NaN,28.64393346340232,27.334181506657803
2016-04-08T09:30:00-04:00,32.19,32.2499,32.02,32.02,1897,10035.45,62.18095069888018,63.80451004953818,NaN,NaN,79.0852435481997,76.03210420259782,-0.04389737679312067,0.5001423162003995,0.5440396929935202,-214848,-215264.4,22.859232092457958,13.832643155434399,NaN,NaN,28.098192384112046,27.443325917722696
2016-04-11T09:30:00-04:00,32.0561,32.204,31.9936,32,3141,10172,61.78626513493108,63.78273393075769,NaN,NaN,67.74863285659681,66.01560232371438,-0.05132534625450247,0.47988301017539214,0.5312083564298946,-217989,-215882.4,22.67071557978521,14.717415643212224,NaN,NaN,27.540091518615245,27.45714957499306
2016-04-12T09:30:00-04:00,32.0894,32.1899,32.0894,32.14,1322,10087.6,63.5312723196638,63.94284328235489,NaN,NaN,74.51926933573606,66.97174266716952,-0.04919894639979372,0.46970967343015246,0.5189086198299462,-216667,-216174,22.576109165053026,15.836872774538744,NaN,NaN,27.5309260818851,27.46768907597764
2016-04-13T09:30:00-04:00,32.14,32.16,31.9488,32.0165,2847,10117.05,60.889801036428736,64.03856217843699,NaN,NaN,52.76950575356108,63.94967581036774,-0.0578993424159272,0.4465344418100372,0.5044337842259644,-219514,-217152.6,22.2406762172443,17.062028571296597,NaN,NaN,26.806069181262597,27.373171948161204
2016-04-14T09:30:00-04:00,31.97,31.97,31.8447,31.89,3616,10221,58.2196479163433,63.905717421828776,NaN,NaN,20.280932589510265,58.88071681672078,-0.07298916387638144,0.4131973293804876,0.486186493256869,-223130,-218429.6,21.78579253783853,18.334396959900012,NaN,NaN,25.456723034117584,27.099393531869257
2016-04-15T09:30:00-04:00,31.89,32.11,31.89,32.11,731,10205.05,61.390679777852036,63.84710343006764,NaN,NaN,49.83296676509293,53.030261460099425,-0.06901354246440611,0.3999195651763614,0.4689331076407675,-222399,-219939.8,21.232714839608605,19.568600863879706,NaN,NaN,25.121507420992383,26.816838373172562
2016-04-18T09:30:00-04:00,32.13,32.23,31.8501,32.23,959,3435.2,63.03854183879244,63.46473763554026,NaN,NaN,60.636916187551684,51.60791812629041,-0.0595209500213047,0.3945319201141366,0.4540528701354413,-221440,-220630,20.970685106488332,20.572456150420265,NaN,NaN,25.281960973802946,26.597570173262618
2016-04-19T09:30:00-04:00,32.41,32.41,32.045,32.12,32759,4902.5,60.489906303984526,62.987322316487344,NaN,NaN,78.3495688611738,52.373978031377966,-0.06161044679212713,0.37703981164528244,0.43865025843740957,-254199,-228136.4,18.322378150077554,21.2035522445708,NaN,NaN,24.728828644267022,26.330607097691818
2016-04-20T09:30:00-04:00,32.0099,32.02,31.76,31.8,1880,4917.7,53.68952710192997,61.925698440665094,NaN,NaN,-13.757969466513835,39.068482987362984,-0.08411112455738445,0.333511352740679,0.41762247729806345,-256079,-235449.4,16.17875100925771,21.332761167989588,NaN,NaN,22.260824838587826,25.749209632105533
2016-04-21T09:30:00-04:00,31.63,31.6562,31.0101,31.0636,1293,4850.25,41.99049994744149,59.98668029791083,NaN,NaN,-196.23101259604903,-4.233906049748889,-0.14460758137748508,0.23686300057620713,0.3814705819536922,-257372,-242297.8,14.471282667589477,21.0209429188563,NaN,NaN,15.836337338417794,24.33308501872157
2016-04-22T09:30:00-04:00,31.39,31.6,31.32,31.4601,2431,4861.95,48.497789543314546,58.58099102661993,NaN,NaN,-151.0434559034907,-44.409190583465616,-0.1531191109083349,0.19007169331827356,0.34319080422660847,-254941,-248806.2,13.060566965499874,20.384677513996376,NaN,NaN,12.555707124337772,22.650602462381027
2016-04-25T09:30:00-04:00,31.505,31.6807,31.505,31.6807,2284,4847,51.741358282227885,57.81508172798339,NaN,NaN,-114.66451334247955,-79.46947648947187,-0.13947784432599214,0.1688434988191183,0.30832134314511045,-252657,-255049.6,11.865605287142571,19.63741495605357,NaN,NaN,10.976637378889082,20.98289316473932
2016-04-26T09:30:00-04:00,31.9764,31.9764,31.77,31.77,2547,4110.95,53.03091362051098,57.06908856641318,NaN,NaN,-35.895720410809346,-102.31853434386849,-0.12072809308482746,0.15741122678907615,0.2781393198739036,-250110,-254231.8,12.988602609241227,18.88483061056143,NaN,NaN,10.132416646701845,19.432825090733967
2016-04-27T09:30:00-04:00,31.62,31.6499,31.5059,31.6499,1161,3960.75,51.05494985963881,56.538007384424255,NaN,NaN,-104.67049261125608,-120.50103897281694,-0.11284759062835895,0.13707983158845494,0.24992742221681388,-251271,-253270.2,14.370227398994444,18.256667116162795,NaN,NaN,8.836343428072148,17.919041996067993
2016-04-28T09:30:00-04:00,33.1499,33.1499,31.6824,31.6824,1111,3449.2,51.58071678114276,55.78084781887158,NaN,NaN,83.37525340718459,-64.57978577217023,-0.10219705371413845,0.12218110507414082,0.22437815878827927,-250160,-251827.8,16.51171447925347,17.803273000933903,NaN,NaN,7.942264949424279,16.49378813226175
2016-04-29T09:30:00-04:00,31.65,31.65,31.0895,31.38,20059,4419.25,46.56818747004724,54.69384227137988,NaN,NaN,-152.68221433573066,-64.90753745861821,-0.11150823946529095,0.08499285945666557,0.19650109892195652,-270219,-254883.4,15.620502258959334,17.299686335160626,NaN,NaN,5.643533375274855,14.943751738406478
2016-05-02T09:30:00-04:00,31.19,31.8088,31.19,31.71,3766,4341.3,52.044914079988075,53.87338811140304,NaN,NaN,-82.46567832874824,-58.46777045587195,-0.092230498085354,0.08121297631526403,0.17344347440061803,-266453,-257642.6,14.841501013237846,16.747214324316683,NaN,NaN,5.324915612910512,13.569632291907055
2016-05-03T09:30:00-04:00,31.605,31.8699,31.605,31.8699,4691,4560.35,54.47961856206305,53.41551793466264,NaN,NaN,-18.021084091390186,-54.89284319198812,-0.06668951475123555,0.09008158096157359,0.15677109571280914,-261762,-259973,14.197499349608478,16.172701690914128,NaN,NaN,5.8063411315805755,12.460590697574702
2016-05-04T09:30:00-04:00,31.6747,32.33,31.6747,32.3299,1663,4614.1,60.666456084478426,53.590289946672286,NaN,NaN,73.66237056151232,-19.22627055743444,-0.019258073444547052,0.13269850390712534,0.1519565773516724,-260099,-261738.6,13.712034713362002,15.596004703451516,NaN,NaN,8.264479826632325,11.861146287440077
2016-05-05T09:30:00-04:00,32.34,32.37,32.3047,32.3599,2650,4640.4,61.038374762345974,53.56512530270758,NaN,NaN,122.13182231995363,-11.47495677488063,0.01200974590395848,0.1669687597316205,0.15495901382766203,-257449,-263196.4,13.307430629767921,15.029912974177181,NaN,NaN,10.327184908162224,11.642008947543241
2016-05-06T09:30:00-04:00,32.256,32.668,32.2348,32.53,3761,4733.6,63.16510353798399,53.574165424078394,NaN,NaN,142.29062270752252,47.51961063377,0.04042089145321656,0.20548512814418274,0.16506423669096618,-253688,-259890.2,19.135217234656295,14.898808126189179,NaN,NaN,12.706764357883724,11.794116863306167
2016-05-09T09:30:00-04:00,32.78,32.9012,32.75,32.858,5211,4837.1,66.91531890403553,54.03312346693919,NaN,NaN,193.6741306765926,102.74757243483819,0.07553685174007138,0.2594853013660554,0.18394844962598403,-248477,-256295,25.036548039726625,15.37839168973554,NaN,NaN,15.97683712497637,12.391648329259054
2016-05-10T09:30:00-04:00,33.19,33.19,32.9132,32.9799,7663,5154.15,68.2106848413238,55.07034901975303,NaN,NaN,197.0447811242028,145.7607454779568,0.09968943906852379,0.30856024846163876,0.20887080939311498,-240814,-252105.4,31.3260565837422,16.460342087913006,NaN,NaN,19.06734812375052,13.34531972847212
2016-05-11T09:30:00-04:00,33.09,33.09,32.2401,32.38,7140,5368.8,56.489017750367076,56.10595743424771,NaN,NaN,98.671939825322,150.76265933071872,0.06941347594413996,0.2956376543232899,0.22622417837914996,-247954,-249676.4,34.74446632586108,17.908426634932404,NaN,NaN,18.076747724287046,14.021238013588539
2016-05-12T09:30:00-04:00,32.47,32.605,32.1799,32.4899,3557,5365.85,57.91580592568842,56.77867289013155,NaN,NaN,66.41870395637488,139.62003565800296,0.05174943829300524,0.2909109762454065,0.23916153795240128,-244397,-247066,38.29904589464801,19.711175129871556,NaN,NaN,17.736242334654897,14.551952916598019
2016-05-13T09:30:00-04:00,32.43,32.995,31.91,32.021,3660,5512.3,50.33223044172734,56.67802090152437,NaN,NaN,43.1087267865378,119.78365647380602,0.005860677981636336,0.2464873854294467,0.24062670744781037,-248057,-245939.8,39.822051215059695,21.708064124722778,NaN,NaN,14.893409879288768,14.600732482696698
2016-05-16T09:30:00-04:00,32.12,32.4999,32.12,32.4575,6986,5813.65,56.09556699719626,56.89692471414475,NaN,NaN,47.933293734862225,90.63548908545995,0.0024539281035849403,0.24369411757729154,0.2412401894737066,-241071,-244458.6,41.8549020431417,23.769942655715674,NaN,NaN,14.425002435234088,14.575628190202039
2016-05-17T09:30:00-04:00,32,32.1,31.92,31.92,2381,4294.75,48.61479099547898,56.72262765241906,NaN,NaN,-10.945017941010205,49.03752927241735,-0.03631133074710477,0.19585102603982563,0.2321623567869304,-243452,-244986.2,41.31947695988085,25.694889052921845,NaN,NaN,11.343903136554474,14.1139531825381
2016-05-18T09:30:00-04:00,31.94,31.94,31.133,31.133,5739,4487.7,40.16820061905149,55.90744792655539,NaN,NaN,-94.86384294087934,10.330372719177074,-0.1110462253428956,0.09335457510831091,0.2044008004512065,-249191,-245233.6,41.05426672851012,27.44792849929732,NaN,NaN,5.372284811249154,12.865143415211108
2016-05-19T09:30:00-04:00,31.04,31.158,30.9852,31.0701,2971,4571.6,39.576353707639946,55.40803122924058,NaN,NaN,-141.1446107609422,-31.182290224286344,-0.15794499692753958,0.006969554291782032,0.1649145512193216,-252162,-246786.6,39.346991894528365,29.14267775898082,NaN,NaN,0.7079342565630498,11.128399249689958
2016-05-20T09:30:00-04:00,31.25,31.3,31.2239,31.2816,2660,4583.05,42.63693397478064,54.73603265029719,NaN,NaN,-107.93385188893214,-61.39080595938033,-0.167066559232543,-0.043918647821357126,0.12314791141118586,-249502,-247075.6,39.02178232877805,30.869840710090834,NaN,NaN,-1.9676407543780237,9.25753639196596
2016-05-23T09:30:00-04:00,31.41,31.42,31.3499,31.38,4170,4677.35,44.0566922087435,53.99153791077436,NaN,NaN,-87.13088431111726,-88.40364156857622,-0.15886893055373283,-0.07543825178098018,0.08343067877275265,-245332,-247927.8,38.023771311874015,32.57171727882409,NaN,NaN,-3.62665584886143,7.41693750041919
2016-05-24T09:30:00-04:00,31.7,31.72,31.5901,31.5901,3454,4722.7,47.06905533140829,53.02029499984078,NaN,NaN,-48.976435011639545,-96.00992498270209,-0.13275517425899402,-0.08251328905098987,0.05024188520800414,-241878,-247613,38.647987352874416,34.352856753074974,NaN,NaN,-4.05331355070521,5.778330207401419
2016-05-25T09:30:00-04:00,31.9,31.9,31.47,31.8044,5621,4945.7,50.02497741313073,52.23362376061112,NaN,NaN,-37.578392724170925,-84.55283493936041,-0.09621025243978186,-0.07002093034172319,0.026189322098058673,-236257,-245026.2,43.668774295781674,36.52152415779024,NaN,NaN,-3.497247215283679,4.453247718446406
2016-05-26T09:30:00-04:00,31.68,31.7899,31.68,31.78,1045,4942.4,49.68475818419619,51.27074194962628,NaN,NaN,-30.923868406780823,-62.50868646852814,-0.07005701707110726,-0.061381949240825406,0.008675067830281855,-237302,-242054.2,48.848123408682305,38.643874598792095,NaN,NaN,-3.148237111954107,3.3673213141034752
2016-05-27T09:30:00-04:00,31.99,32.02,31.864,31.9053,1464,4012.65,51.50858153188704,50.170260708758526,NaN,NaN,-10.11320105364948,-42.94455630147161,-0.042074906876919574,-0.04391856576586761,-0.0018436588889480382,-235838,-239321.4,53.11674329830194,40.64960283154748,NaN,NaN,-2.3358760474010993,2.552578833888536
2016-05-31T09:30:00-04:00,32.01,32.01,31.7217,31.92,2523,3950.5,51.72964381819537,48.99304349282079,NaN,NaN,-19.902943196118635,-29.498968078471883,-0.021375698222502015,-0.028563281667075557,-0.007187583444573542,-233315,-236918,56.55082291050234,42.45137185488749,NaN,NaN,-1.6069311297206186,1.9583631248015139
2016-06-01T09:30:00-04:00,31.75,31.81,31.634,31.8,2506,3841.25,49.73634578825038,48.510709781241026,NaN,NaN,-40.38106201979202,-27.77989348010238,-0.014873877657574797,-0.025779930516542038,-0.01090605285896724,-235821,-235706.6,58.21227385526867,44.12764382127374,NaN,NaN,-1.5097166579608183,1.4629231558354665
2016-06-02T09:30:00-04:00,31.832,31.9,31.832,31.9,790,3797.6,51.416409660245996,48.04646719085228,NaN,NaN,-18.815522946959966,-24.027319524660193,-0.00353775446004935,-0.015328245934028928,-0.011790491473979578,-235031,-235461.4,58.55770961729561,45.57469123003428,NaN,NaN,-0.9823042839898811,1.1136049501461311
2016-06-03T09:30:00-04:00,31.91,32.1599,31.91,32.0443,2421,3786.15,53.81535502869398,48.295261804207044,NaN,NaN,8.53791022094784,-16.134963799114466,0.013069343426666335,0.0045461878093533414,-0.008523155617312993,-232610,-234523,59.923124490252654,47.01048217826236,NaN,NaN,0.1148788536657043,0.9709297935060701
2016-06-06T09:30:00-04:00,32.09,32.09,31.9,32.0599,3111,3753.65,54.07934158380879,48.1512457032508,NaN,NaN,9.377981639111807,-12.236727260562208,0.02386649360901024,0.021309961393949806,-0.0025565322150604333,-229499,-233255.2,61.75639734815937,48.43201755719219,NaN,NaN,1.106571417951753,0.9903071684268819
2016-06-07T09:30:00-04:00,32.06,32.2384,32,32.086,2454,3615.8,54.54744636773706,48.57500680126923,NaN,NaN,34.72840098184822,-1.310458424968823,0.03107176557709345,0.03628317475630638,0.00521140917921293,-227045,-232001.2,63.53329045843978,50.01871852137497,NaN,NaN,2.070175074744667,1.1445740121865655
2016-06-08T09:30:00-04:00,32.07,32.25,32.05,32.24,2712,3368.25,57.31248225025589,49.79959834635526,NaN,NaN,64.15370691252788,19.59649536149516,0.043739465967369544,0.05988574163842486,0.016146275671055317,-224333,-229703.6,66.59572055195818,51.84310808019268,NaN,NaN,3.6387936002050245,1.5008910961892026
2016-06-09T09:30:00-04:00,32.26,32.3084,32.142,32.3084,6067,3314.6,58.5194807550433,51.15267884974122,NaN,NaN,87.05789195847264,40.77117834258168,0.05360436576769664,0.08315173288067612,0.029547367112979478,-218266,-226350.6,70.49043980175836,54.067640073566245,NaN,NaN,5.3066248659260475,2.044567349008752
2016-06-10T09:30:00-04:00,32.1199,32.2,32.1199,32.15,1647,3219.1,54.66472589917093,52.011806844340526,NaN,NaN,70.93563308800013,53.25072291599213,0.04659936876251976,0.08779657806612917,0.041197209303609414,-219913,-223811.2,73.05296034414427,56.49843850323526,NaN,NaN,5.82729469595482,2.5849569700010475
2016-06-13T09:30:00-04:00,32.35,32.388,32.14,32.14,5787,3325.45,54.42100522776283,52.75211491712763,NaN,NaN,88.46899959558955,69.06892650728769,0.03875219270514242,0.08963745018503744,0.050885257479895016,-225700,-223051.4,73.78643245712306,59.052914299324485,NaN,NaN,6.2094401331353755,3.102740279020237
2016-06-14T09:30:00-04:00,32.0284,32.1,31.95,31.99,4927,3222.5,50.76485302612364,53.01610046675015,NaN,NaN,45.18426587716755,71.16009948635154,0.021765720048920842,0.07809240754104607,0.05632668749212523,-230627,-223767.8,71.80193892307017,61.4210536971956,NaN,NaN,5.624612658251893,3.4630077617676163
2016-06-15T09:30:00-04:00,32.2309,32.42,32.2309,32.32,8624,3534.65,57.52556832726424,53.551856960616824,NaN,NaN,112.45415428180405,80.82018896020678,0.030524242461332993,0.09448199056879147,0.06395774810745848,-222003,-223301.8,72.32337529685066,63.467810911557685,NaN,NaN,6.946847612749421,3.960699169050731
2016-06-16T09:30:00-04:00,32.1844,32.52,32.1825,32.4858,7185,3606.95,60.463054260340634,54.32173525177001,NaN,NaN,120.53573052012905,87.51575667253806,0.04441166147984496,0.11947232495726468,0.07506066347741971,-214818,-222612.2,73.11565327277818,65.20120590185024,NaN,NaN,8.940315829336816,4.672072977663029
2016-06-17T09:30:00-04:00,32.02,32.2,31.898,32.17,6835,3800.15,52.951364274576854,54.42479116196214,NaN,NaN,39.5874079060842,81.24611163615488,0.029949962020341725,0.11249811600284687,0.08254815398250515,-221653,-222960.2,71.9956040398753,66.54969595481977,NaN,NaN,8.51020313790128,5.220377286268493
2016-06-20T09:30:00-04:00,32.49,32.49,32.2,32.2,4897,3912,53.54184180402416,54.55423387523562,NaN,NaN,94.71977668485431,82.49626705400783,0.020477576621455912,0.10814512475932503,0.08766754813786912,-216756,-221171.4,74.18472950932878,67.8092607118788,NaN,NaN,8.328552279701116,5.664402285330296
2016-06-21T09:30:00-04:00,32.37,32.46,32.37,32.46,3150,3861,58.41318550255754,55.174008140543265,NaN,NaN,130.67597004174166,99.59460788692266,0.02926034485043083,0.12424297920090766,0.09498263435047682,-213606,-217767.2,77.74943356393976,69.20477211964102,NaN,NaN,9.624071144594783,6.2300692652252225
2016-06-22T09:30:00-04:00,32.39,32.47,32.3271,32.43,2712,3823.9,57.66189434046945,55.62011418913066,NaN,NaN,113.97756583288222,99.89929019713828,0.030450869737054465,0.1330462215217949,0.10259535178474044,-216318,-216630.2,78.80228231138574,70.65081302636175,NaN,NaN,10.468165028001952,6.835511517050469
2016-06-23T09:30:00-04:00,32.5307,32.57,32.5307,32.57,5305,3808.1,60.23239817129765,56.07847441360235,NaN,NaN,149.57988146497937,105.70812038610833,0.03759991345837825,0.14959524360771326,0.111995330149335,-211013,-215869.2,79.50141198549238,72.04926213316458,NaN,NaN,11.93461007664442,7.563954168421033
2016-06-24T09:30:00-04:00,32,32.25,31.85,32.16,5710,4041.35,50.55251521673612,55.826558244525735,NaN,NaN,-24.9004873691784,92.81054133105583,0.012923463756322057,0.12814965984473758,0.11522619608841553,-216723,-214883.2,80.40325215972558,73.38118033399074,NaN,NaN,10.261919006790531,7.949377716759533
2016-06-27T09:30:00-04:00,32,32.21,31.885,32.1101,3438,4140.05,49.50964295190653,55.46671514339498,NaN,NaN,-36.13422438807516,66.63974111646993,-0.007455722839262768,0.10590654253933707,0.11336226537859984,-220161,-215564.2,77.85554185943121,74.40419829120442,NaN,NaN,8.59369507214537,8.041423053243223
2016-06-28T09:30:00-04:00,32.58,32.7005,32.4899,32.7,8564,4442.1,60.01188101488508,55.659529340868495,NaN,NaN,164.54962573993734,73.41447225610906,0.01677437687584246,0.13433023647340292,0.11755585959756046,-211597,-215162.4,78.29259262752072,75.23968915374459,NaN,NaN,10.583208225550184,8.404535220715646
2016-06-29T09:30:00-04:00,33.24,33.34,33.176,33.32,7580,4695.8,67.63236225505048,56.310449448011866,NaN,NaN,312.4782808350089,113.11461525653439,0.06957721064249406,0.20452737290067802,0.13495016225818396,-204017,-212702.2,80.79229077129096,75.97553565156834,NaN,NaN,15.298515759477155,9.389389583395861
2016-06-30T09:30:00-04:00,33.54,33.6,33.2306,33.59,11927,5252.65,70.28783853887232,57.42638606513339,NaN,NaN,275.56999511109854,138.31263798575824,0.11502610589495937,0.27873279462688316,0.1637066887319238,-192090,-208917.6,83.86952778058395,76.74814761131404,NaN,NaN,20.030252189519075,10.909512812842035
2016-07-01T09:30:00-04:00,33.83,33.83,33.53,33.5701,4917,5377.45,69.8330948221094,58.527249607586725,NaN,NaN,235.90003163555616,190.47274178670517,0.13472028026286337,0.332107039060503,0.19738675879763962,-197007,-204974.4,86.32735531701266,77.64392781559187,NaN,NaN,23.43818282204233,12.699322814156362
2016-07-05T09:30:00-04:00,33.61,33.8399,33.61,33.815,2279,5335.85,72.21546904056842,60.05943646576135,NaN,NaN,195.03725659384523,236.70703798308924,0.15383135597781608,0.3896759537699097,0.23584459779209363,-194728,-199887.8,88.7159061062514,78.85206832867625,NaN,NaN,27.05751324649597,14.750492875919162
2016-07-06T09:30:00-04:00,33.99,33.99,33.5801,33.77,8300,5628.15,71.10429151752005,61.02934526506534,NaN,NaN,158.70792667193356,235.5386981694885,0.15272376906717233,0.426749309126059,0.2740255400588867,-203028,-198174,89.3885335645387,80.07100820493967,NaN,NaN,29.549739955954802,16.86467103020997
2016-07-07T09:30:00-04:00,33.9,33.9,33.3283,33.35,3427,5663.9,61.580348014127054,61.109151961764375,NaN,NaN,104.982238387955,194.0394896800777,0.11472186536527129,0.4174278717654758,0.3027060064002045,-206455,-198661.6,87.78522334305927,81.11883463853118,NaN,NaN,28.5865975789918,18.53923196575023
2016-07-08T09:30:00-04:00,33.7299,34,33.6008,33.928,17851,6253.1,67.9438427385024,62.1800432806162,NaN,NaN,120.41090145827357,163.00767094951271,0.11901599540054447,0.4514760006508851,0.33246000525034064,-188604,-197964.4,88.11352067468036,82.27011439816012,NaN,NaN,29.987950076825697,20.174763124475295
2016-07-11T09:30:00-04:00,34.22,34.22,33.86,34.19,6137,6477.6,70.34181915236147,63.38004166264029,NaN,NaN,125.22751806223252,140.87316823484798,0.1291577112854151,0.4939071443571095,0.3647494330716944,-182467,-195056.4,89.3939541763988,83.35648758866512,NaN,NaN,31.95525613512789,21.857690697425664
2016-07-12T09:30:00-04:00,34.26,34.26,33.97,34.26,918950,52135.75,70.96671981398046,64.27672268488479,NaN,NaN,115.11969764235423,124.88965644454979,0.12988556718624367,0.5271063920544989,0.3972208248682553,736483,-8814.2,98.74182630941564,84.85594421334197,NaN,NaN,33.68702649840179,23.547595811850826
2016-07-13T09:30:00-04:00,34.32,34.4199,34.2111,34.4199,27767,53277.75,72.39742822508398,65.3292608195001,NaN,NaN,117.74870845230042,116.69781280062315,0.13011601511324294,0.559865843759809,0.429749828646566,764250,184641.4,99.36645695497619,86.32481383074128,NaN,NaN,35.55098389760162,25.262365538386653
2016-07-14T09:30:00-04:00,34.48,34.48,34.0856,34.229,8375,53265.3,68.08381636334315,65.89007640464622,NaN,NaN,99.23169344916934,115.54770381286603,0.10733881971206477,0.563923353286647,0.45658453357458223,755875,377107.4,99.58643649632877,87.75945843865817,NaN,NaN,35.74131975048299,26.759358997257557
2016-07-15T09:30:00-04:00,34.04,34.179,33.967,34.179,304434,68127.75,66.95850569017654,67.06193286703481,NaN,NaN,78.34643544477613,107.13481061016655,0.08008215937474783,0.556687232793017,0.4766050734182692,451441,505116.4,99.66880498898819,89.13556935503406,NaN,NaN,35.557839759722455,28.01628482046683
2016-07-18T09:30:00-04:00,34.22,34.22,34.07,34.19,6692,68120.6,67.08738946315307,68.31748618926672,NaN,NaN,77.44912196935958,97.57913139159196,0.05515705042419139,0.5455513864485084,0.49039433602431703,458133,633236.4,99.72733841848914,90.69784053782392,NaN,NaN,35.44516143337646,29.07755290802535
2016-07-19T09:30:00-04:00,34.1049,34.29,34.1049,34.288,7246,68238.05,68.2746948626901,68.90768717839565,NaN,NaN,78.89994662983128,90.33518118908736,0.038426350788278496,0.5384272745096652,0.5000009237213867,465379,579015.6,92.29331216208065,91.69789193314963,NaN,NaN,35.6749698893094,30.020041048208785
2016-07-20T09:30:00-04:00,34.3299,34.3299,34.171,34.2403,9433,68552.2,67.00762281594243,68.86306293274507,NaN,NaN,76.3323725254558,82.05191400371844,0.018322984035251566,0.5229046537654511,0.5045816697301996,455946,517354.8,84.57243546454441,91.967902268382,NaN,NaN,35.527391674785534,30.806805423434035
2016-07-21T09:30:00-04:00,34.26,34.3599,34.1095,34.34,8293,68831.25,68.33057217937757,68.72325819278116,NaN,NaN,74.46183924734179,77.09794316335292,0.006524508436809073,0.512737305276211,0.5062127968394019,464239,459027.6,77.931122116955,91.54373043526566,NaN,NaN,35.74803562356071,31.51269545202356
2016-07-22T09:30:00-04:00,34.5,34.72,34.4645,34.6,10860,69109,71.53601601914289,68.8448954211407,NaN,NaN,107.21931395736227,82.87251886587015,0.010764974143988026,0.519669014519387,0.5089040403753989,475099,463759.2,78.08149091275885,90.9547401206761,NaN,NaN,36.837118850984666,32.27332736616086
2016-07-25T09:30:00-04:00,34.65,34.65,34.4,34.55,22813,69964.15,70.06727732315638,68.69145315561127,NaN,NaN,97.80256184799696,86.94320684159763,0.005028033979112445,0.5151890828492895,0.5101610488701771,452286,462589.8,77.94014656758463,90.18504301077134,NaN,NaN,37.35338088322765,32.9990492971704
2016-07-26T09:30:00-04:00,34.65,34.65,34.321,34.3553,8534,70218.95,64.5127633594588,68.22062971574975,NaN,NaN,82.49334402939121,87.66188632150961,-0.015907686869527815,0.49027644028326733,0.5061841271527951,443752,458264.4,77.38216597679043,89.32744532593219,NaN,NaN,36.26706232876099,33.46590830168334
2016-07-27T09:30:00-04:00,34.57,34.57,33.98,34.1,8401,70210.8,58.01800283322695,67.96617648854262,NaN,NaN,36.91232719053918,79.7778772545263,-0.04910331751109637,0.4448049802639247,0.49390829777502104,435351,454145.4,76.81817512496106,88.54408473892518,NaN,NaN,33.39420108506898,33.45566441359558
2016-07-28T09:30:00-04:00,34.16,34.4204,33.9853,34.31,10622,70362.9,61.45543262247587,67.50271862311214,NaN,NaN,36.970945518267534,72.27969850871145,-0.0584367769179886,0.4208623266275353,0.4792991035455239,445973,450492.2,76.28710890858417,87.69934104134687,NaN,NaN,31.883628214971495,33.231087813792136
2016-07-29T09:30:00-04:00,34.36,34.77,34.36,34.678,17521,70642.6,66.61419785157013,67.2364599587699,NaN,NaN,129.02653669977371,76.64114305719372,-0.04210823419881715,0.42666381079700244,0.4687720449958196,463494,448171.2,75.92796144509025,86.73748441768198,NaN,NaN,32.12180611711854,33.07261899998162
2016-08-01T09:30:00-04:00,34.71,34.82,34.595,34.79,30670,71930.25,68.01718645116645,67.02577900428318,NaN,NaN,157.45778578967727,88.57218784552978,-0.0267925636475721,0.43528134043635447,0.46207390408392657,494164,456546.8,76.36046144626177,85.13881549888528,NaN,NaN,32.74644190152648,33.026022271630886
2016-08-02T09:30:00-04:00,34.75,34.75,34.193,34.26,90128,76322.7,56.02003291909186,65.85596505385517,NaN,NaN,52.60817206405556,82.59515345246265,-0.05382448900562942,0.3947932928268898,0.4486177818325192,404036,448603.6,74.9844915062983,83.39724653826542,NaN,NaN,29.264006602784743,32.48859146179572
2016-08-03T09:30:00-04:00,34.28,34.28,33.9113,34,21960,77005.7,51.24483059779008,64.65318035631567,NaN,NaN,-66.4158223447064,61.92952354541353,-0.0886285627461817,0.3378320783997921,0.4264606411459738,382076,437948.6,73.08212492501512,81.50408142602873,NaN,NaN,24.743710030180093,31.382179828707773
2016-08-04T09:30:00-04:00,34.16,34.16,33.82,33.94,234053,88537,50.18177249935612,63.45484227125707,NaN,NaN,-117.05941715660101,31.123451010439815,-0.11351404627911393,0.2845680832970814,0.3980821295761953,148023,378358.6,63.39524228540068,78.91311266148675,NaN,NaN,20.84000224991414,29.876154460308683
2016-08-05T09:30:00-04:00,33.98,34.03,33.88,33.94,21511,88720,50.18177249935612,62.24729820241443,NaN,NaN,-130.98922280570656,-20.87970089065624,-0.12679043015476144,0.2395940918827435,0.36638452203750493,148023,315264.4,55.07180155178999,75.72343145672254,NaN,NaN,17.751927369564026,28.144122018773732
2016-08-08T09:30:00-04:00,33.94,34.0678,33.93,33.93,45060,90666.15,49.98135617596288,60.940631153362496,NaN,NaN,-115.75513899929012,-75.52228584844971,-0.13244368089070668,0.20082992092412155,0.33327360181482824,102963,237024.2,46.85621417589863,72.47792445770953,NaN,NaN,15.189410896169427,26.293449001258832
2016-08-09T09:30:00-04:00,34.1,34.16,33.83,34.16,204328,54935.05,54.48396327872997,60.046084043561606,NaN,NaN,-83.08186728628155,-102.66029371851714,-0.11740444145858425,0.18651804999159793,0.3039224914501822,307291,217675.2,45.06573589014802,69.65601734525265,NaN,NaN,14.217923939219752,24.568373992396108
2016-08-10T09:30:00-04:00,34.24,34.24,34.02,34.09,12323,54162.85,52.92251535436348,58.945508556060595,NaN,NaN,-53.30095726008159,-100.03732070159217,-0.1090616425262072,0.16759543829242318,0.2766570808186304,294968,200253.6,43.455602576747296,67.19348023523781,NaN,NaN,12.96771765754797,22.91113737313209
2016-08-11T09:30:00-04:00,34.2152,34.2152,33.6201,33.77,19380,54713.1,46.37892487661557,57.148573474451496,NaN,NaN,-128.8699735293237,-102.3994319761367,-0.12105922848351741,0.1253330452142336,0.24639227369775102,275588,225766.6,46.47177644777773,64.93564348773916,NaN,NaN,9.861669182365084,21.046927631593945
2016-08-12T09:30:00-04:00,34.11,34.11,33.7945,33.88,11588,40070.8,48.725861677982294,55.62418664265335,NaN,NaN,-100.69681243717159,-96.3409499024297,-0.11745932643891038,0.09956811564911305,0.21702744208802344,287176,253597.2,49.62823222610243,62.913363891919005,NaN,NaN,7.951416121794323,19.176140273051143
2016-08-15T09:30:00-04:00,34.09,34.09,33.83,33.8401,14936,40483,47.90677899623604,54.43804490242315,NaN,NaN,-93.86511126875699,-91.96294435632308,-0.11357048814373241,0.07506433190835793,0.18863482005209034,272240,287452.6,53.24047578589064,61.18895744971188,NaN,NaN,6.147556632023062,17.31491403861856
2016-08-16T09:30:00-04:00,33.63,33.63,33.4299,33.43,18638,41052.6,40.39128630957797,53.1789937221625,NaN,NaN,-184.84067088784417,-112.31470507663562,-0.13307085856362424,0.02229624684756004,0.1553671054111843,253602,276714.8,51.96757564511992,59.41391462972323,NaN,NaN,2.1162470177037216,15.143675892773583
2016-08-17T09:30:00-04:00,33.6,33.6,33.2595,33.57,18267,41494.3,43.64171896538832,51.906585603799115,NaN,NaN,-161.50076194089888,-133.9546660127991,-0.13079949797137583,-0.008132267053035491,0.12266723091834034,271869,272095,51.39820780920634,57.63613597976767,NaN,NaN,-0.26126750661415804,12.942969692861048
2016-08-18T09:30:00-04:00,33.59,33.59,33.4,33.5,11678,41663.55,42.396860970019034,50.176775826545466,NaN,NaN,-137.5009739726227,-135.6808661014589,-0.1281046975325481,-0.03746364099734478,0.09064105653520331,260191,269015.6,50.99712524535372,55.85536196550078,NaN,NaN,-2.580248845495039,10.725367044524464
2016-08-19T09:30:00-04:00,33.44,33.44,33.13,33.24,20856,42163.35,38.05487643618806,48.03661082547558,NaN,NaN,-169.37235047778827,-149.41597370958223,-0.13711913869999423,-0.08075786683978947,0.05636127186020475,239335,259447.4,49.69939120126331,53.95099980514374,NaN,NaN,-5.955811667863804,8.342341514183284
2016-08-22T09:30:00-04:00,33.12,33.4,33.12,33.4,56283,43836.85,41.99195529816246,47.03460528112347,NaN,NaN,-145.04447731307147,-159.6518469184451,-0.12588421270201616,-0.10099399401731546,0.024890218684700705,295618,264123,50.36409435855311,52.19240000887622,NaN,NaN,-7.61853279251029,6.06221661322706
2016-08-23T09:30:00-04:00,33.54,33.54,33.38,33.38,60598,46440.05,41.63572746926406,46.34824077194305,NaN,NaN,-104.60893518656431,-143.60549977818914,-0.11374659294850535,-0.11729302250093099,-0.0035464295524256367,235020,260406.6,49.8007676761028,50.52944591966819,NaN,NaN,-9.066960027261082,3.900905664585897
2016-08-24T09:30:00-04:00,33.55,33.55,33.14,33.29,58657,48952.85,39.99162822346724,45.62037332366526,NaN,NaN,-109.52845329443582,-133.21103804889654,-0.10588744129439934,-0.13590573117042481,-0.030018289876025478,176363,241305.4,46.89734393166481,49.351024608687055,NaN,NaN,-10.751920392515514,1.8076447992856952
2016-08-25T09:30:00-04:00,33.13,33.6399,33.13,33.43,24408,49642.15,43.71490632298798,45.158454311067544,NaN,NaN,-83.49239631467916,-122.40932251730783,-0.08620253869803493,-0.13777146324856915,-0.05156892455053422,200771,229421.4,45.13428187793141,48.64120177484001,NaN,NaN,-11.151123673257375,-0.043607839649029145
2016-08-26T09:30:00-04:00,33.54,33.58,32.9,33.1,33688,50450.5,37.766614397151116,44.28597275543813,NaN,NaN,-108.98022230876732,-110.33089688350364,-0.08993522860742134,-0.1639879603098109,-0.07405273170238955,167083,214971,43.016615700831096,48.36694474090662,NaN,NaN,-13.318727203847622,-1.940053463105971
2016-08-29T09:30:00-04:00,33.13,33.48,33.0693,33.43,22878,50060.9,45.720562356810014,43.66001554672956,NaN,NaN,-76.11015126886977,-96.5440316746633,-0.06582529935454728,-0.15633435589557365,-0.09050905654102637,189961,193839.6,40.056827726017296,48.00916558632586,NaN,NaN,-12.687295409727458,-3.4753737411947547
2016-08-30T09:30:00-04:00,33.49,33.49,33.16,33.33,38604,47484.7,43.889955028716294,43.01483266632619,NaN,NaN,-69.76231075965214,-89.57470678928087,-0.05281960441241482,-0.1565335620565449,-0.10371395764413008,151357,177107,37.83679901331055,47.6078224746518,NaN,NaN,-12.737062979659243,-4.798472203832539
2016-08-31T09:30:00-04:00,33.43,33.46,33.19,33.38,143354,53554.4,45.07412836599148,42.92163291556733,NaN,NaN,-60.826640467736325,-79.83434422394097,-0.03776257229583428,-0.15091717301392293,-0.11315460071808865,294711,200776.6,42.67658612211514,47.336737451390185,NaN,NaN,-12.422862251349002,-5.8876707820491765
2016-09-01T09:30:00-04:00,33.51,33.51,33.16,33.37,69541,45328.8,44.870167413942745,42.64622618242164,NaN,NaN,-55.66123704180244,-74.26811236936562,-0.02595210757165324,-0.1455947351826552,-0.11964262761100196,225170,205656.4,43.65062828036961,46.90976574098069,NaN,NaN,-12.224519276991565,-6.792934852755232
2016-09-02T09:30:00-04:00,33.4,33.89,33.4,33.59,48854,46695.95,50.20824066848382,42.81061630186792,NaN,NaN,17.014248677911723,-49.069218172029814,-0.002058439688481531,-0.12221567722160387,-0.12015723753312234,274024,227044.6,47.83456794865988,46.52362946689278,NaN,NaN,-10.474626979100973,-7.318890870804623
2016-09-06T09:30:00-04:00,33.76,33.89,33.5,33.87,169454,52915.65,56.042086637847206,43.928530611030006,NaN,NaN,56.135233309249486,-22.620141256405965,0.031989951720840876,-0.08016979788207124,-0.11215974960291211,443478,277748,56.14724240943471,46.82217709291526,NaN,NaN,-7.084348519928017,-7.285384820679393
2016-09-07T09:30:00-04:00,33.8,33.86,33.57,33.86,555945,70496.5,55.79067478269232,44.79631316940886,NaN,NaN,68.12821578887053,4.9579640532985705,0.05203822008869194,-0.04711197449204718,-0.09915019458073912,-112467,224983.2,47.63945472430566,46.55369472970807,NaN,NaN,-4.431844346477843,-6.877736181507744
2016-09-08T09:30:00-04:00,33.82,33.9,33.43,33.43,322533,86007,46.19419417521247,45.06755125549411,NaN,NaN,27.368442823348268,22.596980711515492,0.035338494772322954,-0.05497707611533542,-0.09031557088765838,-435000,79041,32.82432892072093,45.25563784937715,NaN,NaN,-4.980625785397562,-6.6067204106348605
2016-09-09T09:30:00-04:00,33.22,33.22,32.12,32.16,906748,130375.4,29.858482577377686,44.48209455129337,NaN,NaN,-301.8344249220097,-26.637656864525933,-0.05720611504696864,-0.16182321469636918,-0.10461709964940054,-1341748,-234342.6,19.09336370446043,43.06949302817695,NaN,NaN,-12.608894971095411,-7.464173919272082
2016-09-12T09:30:00-04:00,32.15,32.68,32,32.29,5085946,384093.3,32.49021482831425,43.803398803447074,NaN,NaN,-294.9455464661499,-89.02961589333825,-0.10296237409113645,-0.2333200672633211,-0.13035769317218465,3744198,459692.2,59.4998696476503,43.72204840596961,NaN,NaN,-17.091998625873085,-8.83957744878651
2016-09-13T09:30:00-04:00,32.21,32.34,31.66,31.72,926654,429679.2,27.60034552646482,42.80087152181856,NaN,NaN,-289.46047714574667,-158.1487579843375,-0.16143167519737314,-0.3321472871689011,-0.17071561197152793,2817544,934505.4,70.39364315009207,45.19296808268313,NaN,NaN,-22.792360633326364,-10.832832189435061
2016-09-14T09:30:00-04:00,32.21,32.21,31.65,31.78,532081,455351.35,28.814839089989434,42.00252944085586,NaN,NaN,-210.89743277600405,-213.95388769731238,-0.18423114374845906,-0.40100454165710175,-0.2167733979086427,3349625,1626923.8,79.18603791423419,47.49930336715237,NaN,NaN,-26.50367626128025,-13.07152419969866
2016-09-15T09:30:00-04:00,31.83,32.05,31.67,32.02,1512794,530077.7,33.612089601557074,41.28089967503936,NaN,NaN,-158.93438948840705,-251.21445415966346,-0.1715711869477759,-0.43123738159336256,-0.25966619464558666,4862419,2686407.6,86.02493903354718,50.420064592553494,NaN,NaN,-27.728892108621743,-15.165433900973385
2016-09-16T09:30:00-04:00,32.05,32.05,31.72,31.91,2119519,635469.75,32.5300243711675,40.90685753032624,NaN,NaN,-131.67551779489665,-217.18267273424084,-0.15929474205074945,-0.4587846222090235,-0.29948988015827405,2742900,3503337.2,89.02055939645642,53.70606057081245,NaN,NaN,-29.043732924308774,-17.148048047164156
2016-09-19T09:30:00-04:00,31.99,32.27,31.95,32.24,4242426,846548.25,38.88629634532098,40.418695672362745,NaN,NaN,-87.4889940953408,-175.69136226007905,-0.11945938949352425,-0.44881411702517937,-0.3293547275316551,6985326,4151562.8,90.72033499685404,57.32488251872935,NaN,NaN,-27.992645432180858,-18.697276245023684
2016-09-20T09:30:00-04:00,32.47,32.47,32.18,32.18,3387204,1013094.3,38.181972689787955,40.01098264815358,NaN,NaN,-65.71045805033658,-130.94135844099702,-0.08905549930158518,-0.44067410165863663,-0.35161860235705145,3598122,4307678.4,91.0785562321509,61.12786517721796,NaN,NaN,-27.389154784134647,-19.938973179182394
2016-09-21T09:30:00-04:00,32.14,32.64,31.83,32.55,2247929,1122460.85,44.819365770701694,39.9927853199186,NaN,NaN,-52.86977876298637,-99.33582763839347,-0.038512318227741205,-0.39975900014172794,-0.36124668191398673,5846051,4806963.6,92.12551220001058,64.65993132563905,NaN,NaN,-24.689664835220988,-20.617643415759336
2016-09-22T09:30:00-04:00,32.77,33.2499,32.77,33.19,1728163,1205936.15,54.01640874076403,40.64608827183441,NaN,NaN,23.209986262122534,-62.90695248828754,0.03932276973169213,-0.31209321974937154,-0.3514159894810637,7574214,5349322.6,93.0760512456074,68.1903186802989,NaN,NaN,-18.966763531885988,-20.381803432348857
2016-09-23T09:30:00-04:00,33.07,33.45,32.84,33.32,19150981,2162264.8,55.633967919409486,41.0336402183291,NaN,NaN,38.591060377919256,-28.853636853724346,0.0975470191742901,-0.22948221551320103,-0.3270292346874911,26725195,10145781.6,96.7790366429921,71.68635215846548,NaN,NaN,-13.939720851132828,-19.461505920746568
2016-09-26T09:30:00-04:00,33.15,33.44,33.13,33.39,2998968,2310528.8,56.52087367261341,41.067839292240976,NaN,NaN,49.74527103120551,-1.4067838284150853,0.13637597437533266,-0.15655926671832532,-0.292935241093658,29724163,14693549,97.91669727096763,74.66988464857498,NaN,NaN,-9.691668511633912,-18.065814862301902
2016-09-27T09:30:00-04:00,33.37,33.44,33.06,33.1,3562518,2487510.8,51.892620310022465,40.789406829907406,NaN,NaN,38.23870392767586,19.383048567187394,0.13772766949562587,-0.12077565422412562,-0.2585033237197515,26161645,19206253.6,98.48755690292428,78.30189194704774,NaN,NaN,-7.540807420642801,-16.562242370636316
2016-09-28T09:30:00-04:00,33.11,33.35,33.06,33.33,4122681,2691714.65,55.03729152254554,41.42105664043119,NaN,NaN,43.81494060552546,38.719992440889754,0.1483897619276667,-0.0730161213101681,-0.2214058832378348,30284326,24093908.6,98.85387428575007,83.01828804454983,NaN,NaN,-4.756075597188383,-14.875647117286611
2016-09-29T09:30:00-04:00,33.18,33.29,32.81,32.92,2674449,2818269.4,48.900799094167404,42.78122210591617,NaN,NaN,20.71336234081675,38.2206676566286,0.12314699139188795,-0.06747214399797485,-0.1906191353898628,27609877,28101041.2,99.05578801357606,88.72988978091522,NaN,NaN,-4.3051904389561,-13.36558187752511
2016-09-30T09:30:00-04:00,33.01,33.28,32.73,32.77,2058021,2917693.4,46.84301377805022,43.806422030897316,NaN,NaN,14.774464495294062,33.45734848010356,0.09303493177298211,-0.07432547067363515,-0.16736040244661726,25551856,27866373.4,97.96731103067948,91.47756416541732,NaN,NaN,-4.583302744872217,-12.11097057286041
2016-10-03T09:30:00-04:00,32.66,32.7,32.09,32.14,2344817,3032491.55,39.3528071444006,44.64588357503559,NaN,NaN,-48.205665531565074,13.867161167549444,0.030604895952602684,-0.12910428250586392,-0.1597091784584666,23207039,26562948.6,91.92516820183222,93.01553024054161,NaN,NaN,-7.384203360134188,-11.43571811389952
2016-10-04T09:30:00-04:00,32.15,32.15,31.4725,31.65,3262713,3187154.5,34.7046872772476,45.0665870169826,NaN,NaN,-102.57291602904878,-14.295162823795483,-0.039944017423303835,-0.2096392002375964,-0.16969518281429258,19944326,25319484.8,86.44751938885466,93.5342074887288,NaN,NaN,-11.407327503810885,-11.431662312458286
2016-10-05T09:30:00-04:00,31.66,31.85,30.955,31.06,4848671,3401790.8,30.095321213636154,44.81538927498825,NaN,NaN,-146.98247381460646,-52.454645707821896,-0.11817412123272245,-0.3174128343551956,-0.19923871312247318,15095655,22281750.6,74.7318573416597,92.7275587964511,NaN,NaN,-16.533251718895624,-12.160460799092192
2016-10-06T09:30:00-04:00,30.98,31.33,30.63,31.12,2438750,3507601.65,31.097560870180914,44.71307045348921,NaN,NaN,-165.00233572444745,-89.59778532087473,-0.15536687087772744,-0.3934473017196325,-0.23808043084190506,17534405,20266656.2,68.13530776875206,91.23575510875794,NaN,NaN,-20.113188581929826,-13.296564768068997
2016-10-07T09:30:00-04:00,31.19,31.6,30.9,31.04,1711450,3547836.75,30.47027552759357,44.111926109365825,NaN,NaN,-129.200583833109,-118.39279498655533,-0.17346885697190778,-0.4549165020567898,-0.281447645084882,15822955,18320876,62.40698690722389,89.21337310235579,NaN,NaN,-23.136989503786413,-14.702339730314343
2016-10-10T09:30:00-04:00,31.05,31.315,31,31.16,2404051,3413742,32.6643913324683,43.717813155271564,NaN,NaN,-114.529368986644,-131.65753567757113,-0.16549728292109156,-0.48831924873624644,-0.3228219658151549,18227006,17324869.4,59.64280698160286,86.96796244160235,NaN,NaN,-24.933356497269443,-16.16391355416507
2016-10-11T09:30:00-04:00,31.08,31.2,30.8234,30.92,1770422,3455930.4,30.585555970576507,42.70111245526262,NaN,NaN,-119.54573537541086,-135.05209954684352,-0.16419834677427075,-0.5280698992829933,-0.36387155250872255,16456584,16627321,57.71476348158325,84.51005181885753,NaN,NaN,-27.08052148449988,-17.72342897278433
2016-10-12T09:30:00-04:00,30.97,31.36,30.93,31.36,1411699,3499911.3,38.33404631721712,41.58094371072355,NaN,NaN,-89.01366082089052,-123.45833694810035,-0.12337953053217088,-0.5180959656739361,-0.39471643514176524,17868283,17181846.6,58.853500870768336,82.06558393494046,NaN,NaN,-26.555690701523055,-18.985180648318433
2016-10-13T09:30:00-04:00,31.27,31.54,31.12,31.46,3299281,3589235.65,39.974026006211915,40.46237643120944,NaN,NaN,-69.24997383669664,-104.3078645705502,-0.08134700766178032,-0.49640019471899066,-0.41505318705721034,21167564,17908478.4,60.359923341316396,79.46421869910648,NaN,NaN,-25.635927357825235,-19.93528732110512
2016-10-14T09:30:00-04:00,31.56,31.7299,31.35,31.42,2381432,3602331.3,39.52126550262947,39.248118704782016,NaN,NaN,-54.5590295239568,-89.37955370871975,-0.04950623794370351,-0.4769359844868397,-0.4274297465431362,18786132,18501113.8,61.59490528672772,76.8698049859465,NaN,NaN,-25.016475922852493,-20.66117140706903
2016-10-17T09:30:00-04:00,31.42,31.61,31.4,31.45,1148299,3447624.95,40.06952268152002,38.403611731317554,NaN,NaN,-50.78130285258394,-76.62994048190774,-0.0211425362198302,-0.453857916817924,-0.4327153805980938,19934431,18842598.8,62.323301514323454,74.28664388676073,NaN,NaN,-24.35580684556481,-21.188976469711285
2016-10-18T09:30:00-04:00,31.65,31.81,31.5442,31.61,4753162,3515922.85,43.03550978568142,37.54634160725583,NaN,NaN,-33.7039947238757,-59.461592351600714,0.011899418947152463,-0.4178411069141532,-0.4297405258613057,24687593,20488800.6,65.70054371178014,71.91854884576288,NaN,NaN,-22.97508626797597,-21.444135012320526
2016-10-19T09:30:00-04:00,31.76,31.76,31.44,31.73,1515634,3479308.1,45.22503318891095,37.283786899737514,NaN,NaN,-31.762377252692588,-48.01133563796113,0.043561671114855705,-0.37528843696773606,-0.41885010808259177,26203227,22155789.4,68.75480956267216,69.75419324212689,NaN,NaN,-21.200049875496983,-21.40926570706002
2016-10-20T09:30:00-04:00,31.57,31.83,31.465,31.62,1977109,3491755.4,43.57175274214429,37.050125397172806,NaN,NaN,-28.14737673982364,-39.79081621858653,0.05792201605573061,-0.3464475880129285,-0.4043696040686591,24226118,22767500.2,69.81694747235777,67.74345298796105,NaN,NaN,-20.109787667386765,-21.223625987106697
2016-10-21T09:30:00-04:00,31.4,31.61,31.35,31.6,1295726,2598992.65,43.26208421576652,37.32935947369895,NaN,NaN,-34.58957150232396,-35.796924614259964,0.0662966414819039,-0.32149880221627924,-0.38779544369818314,22930392,23596352.2,71.2433795732725,66.26618237163535,NaN,NaN,-19.27106696880168,-20.944688984491695
2016-10-24T09:30:00-04:00,31.65,31.96,31.541,31.64,1108723,2504480.4,44.117510249212486,38.00170397169644,NaN,NaN,-9.043424329641391,-27.449348909671453,0.07415847854835422,-0.29509734551274036,-0.3692558240610946,24039115,24417289,72.62339805724223,65.27874513366304,NaN,NaN,-18.339123925120447,-20.572465404581518
2016-10-25T09:30:00-04:00,31.53,31.63,31.41,31.6,1402869,2396497.95,43.41263874699911,38.952940938365224,NaN,NaN,-22.95107499097416,-25.29876496309115,0.0760123440364614,-0.2742403940155178,-0.3502527380519792,22636246,24007019.6,70.79490569147632,64.99753430150709,NaN,NaN,-17.706628206039408,-20.163060090504075
2016-10-26T09:30:00-04:00,31.4,31.5,30.99,31.19,1481903,2264459.05,36.90411745624567,39.36769498022699,NaN,NaN,-67.0578816325462,-32.357865839061866,0.05021756352044904,-0.28748078365141794,-0.337698347171867,21154343,22997242.8,66.36593555274831,64.87115057179253,NaN,NaN,-18.857314305096768,-19.976524978303033
2016-10-27T09:30:00-04:00,31.11,31.11,30.3553,30.45,1409067,2201189.95,28.57669360104127,39.2324391283304,NaN,NaN,-171.0060172462017,-60.92959394033748,-0.012728932694223871,-0.35360951303964683,-0.34088058034542296,19745276,22101074.4,62.62160761566171,64.88648062239524,NaN,NaN,-22.74456205053579,-20.371958845764855
2016-10-28T09:30:00-04:00,30.55,30.7847,30.43,30.53,2338168,2215197.3,30.40503222998177,39.07105633529566,NaN,NaN,-172.73187447878726,-88.55805453563013,-0.04330214907185498,-0.3950082666852417,-0.3517061176133867,22083444,21931684.8,61.91059802942135,65.04846569723942,NaN,NaN,-25.308119286959812,-21.07712462307842
2016-10-31T09:30:00-04:00,30.6,30.98,30.522,30.95,1071353,2151524.1,39.20406991345978,39.686664474073034,NaN,NaN,-111.93745677227902,-109.13686102415768,-0.03018502224505465,-0.389437395419705,-0.35925237317465036,23154797,21754821.2,61.13015156457694,65.29242198888183,NaN,NaN,-24.742649222313144,-21.600770994397664
2016-11-01T09:30:00-04:00,30.87,30.901,30.205,30.34,3438594,2160318.15,32.731354094118515,39.28647217242314,NaN,NaN,-165.49156883358197,-137.64495979267923,-0.05603465214430342,-0.4292956883550296,-0.3732610362107262,19716203,21170812.6,58.507416021950206,65.26770164253767,NaN,NaN,-26.498583024203988,-22.300458427227138
2016-11-02T09:30:00-04:00,30.25,30.32,29.87,29.87,1699336,2002851.4,28.787570261955324,38.48743961926194,NaN,NaN,-209.7090299174158,-166.17518944965315,-0.09589062269275395,-0.4931243145766686,-0.39723369188391466,18016867,20543317.4,55.740197953039505,64.93772125766074,NaN,NaN,-29.40579776142387,-23.315506903540957
2016-11-03T09:30:00-04:00,29.82,29.92,29.68,29.74,1922500,1977038.9,27.79016770956376,37.649504062614405,NaN,NaN,-198.71371610099726,-171.71672922061228,-0.1205196205533901,-0.5478832175756523,-0.4273635970222622,16094367,19813135.6,52.62131251715696,64.29675034554855,NaN,NaN,-32.008431545749055,-24.557353280999255
2016-11-04T09:30:00-04:00,29.77,30.05,29.67,29.94,1757687,1979350.75,31.710225501056883,37.05241140686703,NaN,NaN,-149.4596352484106,-167.06228137453692,-0.11297903650976077,-0.5685873926594631,-0.45560835614970235,17852054,18966857.6,49.186200364842904,63.3583859777285,NaN,NaN,-32.82165446785388,-25.737967736264203
2016-11-07T09:30:00-05:00,30.14,30.51,30.13,30.49,2997634,2009029.9,41.168716105378955,36.91906900113115,NaN,NaN,-76.42596491548734,-159.9599830031786,-0.06307678721900134,-0.5344543401734541,-0.4713775529544527,20849688,18505835.8,47.37196455658285,62.04920175235726,NaN,NaN,-30.25138757531983,-26.382741998986436
2016-11-08T09:30:00-05:00,30.38,30.77,30.36,30.68,1513363,1996176.95,44.05161434403839,36.83525336935453,NaN,NaN,-44.818431680497945,-135.8253555725618,-0.012069619417716837,-0.48646457722659875,-0.4743949578088819,22363051,19035205.4,49.667687947843255,60.68583592272663,NaN,NaN,-27.23186144536074,-26.50404477703991
2016-11-09T09:30:00-05:00,29.68,30.2437,29.48,29.99,4760945,2163639.25,36.967011593192524,36.36348614442941,NaN,NaN,-110.82689200401833,-116.0489279898823,-0.019175825176814487,-0.4983647392799,-0.4791889141030855,17602106,18952253.2,49.3047397320582,59.22067822699095,NaN,NaN,-27.044553582571183,-26.58126032068723
2016-11-10T09:30:00-05:00,29.85,29.87,29.0735,29.54,5345003,2265925.35,33.215218379596664,35.64585287041727,NaN,NaN,-136.57598995420122,-103.6213827605231,-0.04697390369139631,-0.5379062937173309,-0.4909323900259346,12257103,18184800.4,45.95858642965796,57.414621573875614,NaN,NaN,-28.232588824284854,-26.81716439262975
2016-11-11T09:30:00-05:00,29.47,29.91,29.47,29.57,3702644,2331985.95,33.69832443164985,34.90162531201994,NaN,NaN,-108.62835959066673,-95.45512762897432,-0.05554448431020764,-0.5603629954136942,-0.5048185111034865,15959747,17806339,44.3597613059282,55.39579037735319,NaN,NaN,-28.977564434927995,-27.125792970100928
2016-11-14T09:30:00-05:00,29.41,30.27,29.2,30.15,4315165,2490329.25,42.37697918492521,34.82764962901466,NaN,NaN,-79.4347683966666,-96.05688832521017,-0.01638804553328188,-0.5253035680200888,-0.5089155224868069,20274912,17691383.8,43.8606458289595,53.4719146728877,NaN,NaN,-26.631775777021442,-27.05521908537529
2016-11-15T09:30:00-05:00,30.17,30.52,29.79,29.95,3161108,2410726.55,40.412573850831805,35.07825365719938,NaN,NaN,-52.527690384864385,-97.59874006608347,0.0008896930441929518,-0.5078034061815657,-0.5086930992257587,17113804,16641534.4,39.49057604974167,51.55224613695866,NaN,NaN,-25.407850081322064,-26.81988065622483
2016-11-16T09:30:00-05:00,29.82,30.09,29.7,29.93,2058960,2437892.85,40.21183120502415,35.90933491462673,NaN,NaN,-65.61631447136483,-88.55662455955276,0.015033710287934321,-0.4899009613658407,-0.504934671653775,15054844,16132082,37.53612808028985,49.76042617014638,NaN,NaN,-24.512133924385076,-26.490202551676294
2016-11-17T09:30:00-05:00,29.86,30.09,29.6,29.65,1573611,2417717.95,37.410110481613465,36.40969764688614,NaN,NaN,-73.41286317175893,-75.9239992030643,0.009845261494823121,-0.49262809478524616,-0.5024733562800693,13481233,16376908,39.09609150769651,48.13081856145175,NaN,NaN,-24.61437970145239,-26.222227858787164
2016-11-18T09:30:00-05:00,29.6,29.81,29.5,29.71,1276875,2416775.4,38.400544990820215,36.352303009554745,NaN,NaN,-79.58000811278883,-70.11432890748871,0.014487150936723925,-0.4843644176091644,-0.4988515685458883,14758108,16136580.2,38.09047349468863,46.485127270745444,NaN,NaN,-24.407230510173704,-25.962942523270957
2016-11-21T09:30:00-05:00,29.75,29.98,29.61,29.63,1584938,2440586.15,37.54739611424539,36.69630601099238,NaN,NaN,-66.50727042061173,-67.52882931227774,0.016079678342220294,-0.4787519706181129,-0.4948316489603332,13173170,14716231.8,32.731928792358374,44.64402104006031,NaN,NaN,-24.476448193852708,-25.75058619049692
2016-11-22T09:30:00-05:00,29.71,30.19,29.67,30.14,2567156,2498800.5,45.81255128497158,37.912376084064974,NaN,NaN,-21.87071956667965,-61.397435148640795,0.05329321459403019,-0.4282151307177955,-0.4815083453118257,15740326,14441536.2,31.800174316967755,42.93401935176947,NaN,NaN,-22.039629968937632,-25.220449587417022
2016-11-23T09:30:00-05:00,29.87,30.02,29.71,29.93,1666247,2508017.7,43.273031593058356,39.018294932886015,NaN,NaN,-36.23342208511448,-55.52085667139072,0.06481233006942844,-0.40049293272504016,-0.4653052627944686,14074079,14245383.2,31.11896133199788,41.398137124258106,NaN,NaN,-20.743421888159958,-24.58087420180887
2016-11-25T09:30:00-05:00,29.94,30.23,29.94,30.06,789980,2477063.35,45.29467902337925,39.98861304162333,NaN,NaN,10.845350354370323,-38.669213966164875,0.08117311460576027,-0.3638388695372683,-0.44501198414302856,14864059,14521948.4,33.28885800129987,40.26261266971932,NaN,NaN,-19.077726351873157,-23.794710223246625
2016-11-28T09:30:00-05:00,30,30.385,30,30.17,1957301,2458020,47.01535804389707,40.40623032294605,NaN,NaN,45.298192033271505,-13.693573936952806,0.09824954092628896,-0.3222000579851674,-0.42044959891145633,16821360,14934598.8,36.50297840737237,39.48625651620428,NaN,NaN,-17.198397244297116,-22.85237979768241
2016-11-29T09:30:00-05:00,30.11,30.55,30.11,30.38,1769153,2492910,50.23359387128652,40.84780028917806,NaN,NaN,104.6001273159748,20.527905610364503,0.12103717897184318,-0.26915312519665235,-0.39019030416849554,18590513,16018067.4,44.1161995125885,39.089721627971805,NaN,NaN,-14.65984971873624,-21.682018357832956
2016-11-30T09:30:00-05:00,30.1,30.255,29.9,30.01,2233892,2432674.9,45.04251522995957,41.42462197751856,NaN,NaN,28.80181464202179,30.662412452104792,0.10891981501252435,-0.2540405354028401,-0.36296035041536445,16356621,16141326.4,44.92521143264611,38.7768981780138,NaN,NaN,-13.911666856853461,-20.571968143407314
2016-12-01T09:30:00-05:00,29.82,29.9143,29.41,29.55,2486750,2472045.6,39.5679714324841,41.87839005272481,NaN,NaN,-99.40937786428486,18.02722129627071,0.06956804422633595,-0.2760002951324445,-0.34556833935878045,13869871,16100484.8,44.69432936494671,38.686594101962996,NaN,NaN,-14.947490328902429,-19.768471312763758
2016-12-02T09:30:00-05:00,29.64,30.121,29.55,29.83,2399152,2495878.2,44.027461369678534,42.61618554829829,NaN,NaN,-36.05606698913036,8.646937827570573,0.06227567128964551,-0.26772375024672357,-0.3299994215363691,16269023,16381477.6,46.72302439061002,38.85539860801169,NaN,NaN,-14.441078238979607,-19.007415159366023
2016-12-05T09:30:00-05:00,29.83,30.105,29.765,30.07,1608834,2488435.55,47.59699979490662,42.98904416329697,NaN,NaN,8.195596337469333,1.2264186884101391,0.07276514066604262,-0.23904299570381582,-0.31180813636985844,17877857,16592777,48.25998042825729,39.169636793675814,NaN,NaN,-12.914383246295577,-18.136982028927388
2016-12-06T09:30:00-05:00,30.11,30.38,30.06,30.2,1340990,2405603.35,49.47652045247642,43.6364689205573,NaN,NaN,87.66147358077068,-2.1613120586306875,0.08666425950061679,-0.20347781199408743,-0.2901420714947042,19218847,16718443.8,49.19863168931875,39.86306933935989,NaN,NaN,-11.095763120117038,-17.13109361338305
2016-12-07T09:30:00-05:00,30.23,30.88,30.23,30.83,2068428,2433356.6,57.44265068041027,44.867241740227726,NaN,NaN,226.24226849322233,37.326778711609414,0.13368317231423066,-0.1230381061019159,-0.25672127841614656,21287275,17704574.6,55.95175849892777,41.17847151211975,NaN,NaN,-6.809510612468203,-15.656581756109501
2016-12-08T09:30:00-05:00,30.51,31.12,30.51,30.99,1703922,2280505.45,59.202019658500305,46.42380668143393,NaN,NaN,232.33733446011175,103.67612117648873,0.1686971282667818,-0.04584986808266933,-0.21454699634945112,22991197,19528839.8,65.1745831548495,43.04122091548782,NaN,NaN,-2.774500489117826,-13.816284432253548
2016-12-09T09:30:00-05:00,30.94,31.26,30.93,30.97,1664619,2096486.25,58.874374794516356,47.88622309598366,NaN,NaN,226.03991590171503,156.09531775465783,0.18247944603820643,0.01355231119830691,-0.16892713483989952,21326578,20540350.8,69.04480801673392,45.252244809919624,NaN,NaN,0.3474177227905556,-11.79289841010439
2016-12-12T09:30:00-05:00,30.85,31.304,30.79,31.29,2744787,2048593.4,62.45473470129867,49.665318709344604,NaN,NaN,191.6052854270408,192.7772555725721,0.20351379057979546,0.08546510338484481,-0.11804868719495065,24071365,21779052.4,73.00172281339185,48.128658668564874,NaN,NaN,4.152432466502629,-9.51499399916053
2016-12-13T09:30:00-05:00,31.41,31.48,31.1468,31.37,2182056,1941937.95,63.31460328898281,50.915465281059696,NaN,NaN,182.74282396881173,211.79352565018036,0.2122108214957656,0.14721483967475635,-0.06499598182100924,26253421,23185967.2,76.65223856753404,51.332377543605325,NaN,NaN,7.523154303067288,-7.080972813127985
2016-12-14T09:30:00-05:00,31.34,31.4,30.73,30.82,3364030,1952084.05,54.13520746004464,51.69133498584443,NaN,NaN,106.23272162502519,187.79161627654088,0.17203035091975152,0.15004195682868016,-0.02198839409107136,22889391,23506390.4,77.40167577190257,54.63828571788423,NaN,NaN,7.763769204590437,-4.960295382025354
2016-12-15T09:30:00-05:00,30.73,30.925,30.51,30.57,3224742,2010373.15,50.547848115110256,52.06656134953949,NaN,NaN,52.80172413793081,151.8844942121047,0.1220739431631814,0.1306040348629054,0.008530091699723994,19664649,22841080.8,72.2181987879155,57.418952916928205,NaN,NaN,6.841605509425193,-3.2743095403895617
2016-12-16T09:30:00-05:00,30.13,30.61,30.09,30.44,3455591,2104472.15,48.73917020465513,52.18969078959365,NaN,NaN,6.957797624653844,108.06807055669246,0.07598885326549813,0.10351615828159666,0.02752730501609853,16209058,21817576.8,65.00589530758448,59.45487555265765,NaN,NaN,5.535332834381759,-2.015789201136516
2016-12-19T09:30:00-05:00,30.53,30.81,30.45,30.71,2260027,2153629.75,52.537674900731616,52.354268005982576,NaN,NaN,42.63371932297008,78.27375733587833,0.06009995852582091,0.10265225317337467,0.042552294647553765,18469085,20697120.8,58.158428313455644,60.45789189557673,NaN,NaN,5.554180116382606,-0.9343650129194987
2016-12-20T09:30:00-05:00,30.66,30.87,30.555,30.73,1764229,2162594.3,52.816586966926096,52.909558844337326,NaN,NaN,45.7456302799804,50.874318598112076,0.047878980114208027,0.1024010197903138,0.05452203967610577,20233314,19493099.4,51.83925796903943,60.95175236246197,NaN,NaN,5.648788619300491,0.006085505969071203
2016-12-21T09:30:00-05:00,30.75,30.94,30.32,30.34,1871788,2127825.9,47.01467629242864,53.44146633433336,NaN,NaN,12.409144806640755,32.1096032344352,0.01232325643437851,0.06992611021907891,0.0576028537847004,18361526,18587526.4,47.646033639950026,61.16258838210506,NaN,NaN,3.9836078763214475,0.574302987447982
2016-12-22T09:30:00-05:00,30.24,30.3236,30.0058,30.3,1399843,2114505.7,46.45106915167456,53.614581175904505,NaN,NaN,-45.97656300805108,12.3539458052388,-0.013686248580054516,0.04049504305963225,0.05418129163968677,16961683,18046933.2,45.290814881408345,61.06028770287637,NaN,NaN,2.464561726351339,0.8443399501484616
2016-12-23T09:30:00-05:00,30.32,30.43,30.23,30.33,931571,2121585.25,46.964586292205624,53.56940878285444,NaN,NaN,-28.259833259362296,5.3104196284355725,-0.027850477248285002,0.01936819507933052,0.04721867232761552,17893254,18383772.4,47.04724075443807,60.973663440460705,NaN,NaN,1.3498016253109761,0.9165487608859637
2016-12-27T09:30:00-05:00,30.4,30.52,30.28,30.41,1143637,2080902.05,48.38601456900782,53.49151550546382,NaN,NaN,-17.583402228985634,-6.7330046819555704,-0.03059344384968391,0.008976867515510634,0.039570311365194545,19036891,18497333.6,47.65736348238387,60.86357285425107,NaN,NaN,0.7810658667350308,0.8971940617215447
2016-12-28T09:30:00-05:00,30.39,30.46,30.115,30.18,2570460,2120967.4,44.678521757204926,52.579792010949156,NaN,NaN,-44.14488749899279,-24.71110823775021,-0.045747740948950025,-0.01761436482099299,0.028133376127957035,16466431,17743957,44.03267633113026,60.012209842265534,NaN,NaN,-0.7477143560869891,0.6622071448917541
2016-12-29T09:30:00-05:00,30.21,30.569,30.13,30.46,1526206,2085583.1,49.728581166275106,51.90311783293306,NaN,NaN,-23.682757061932158,-31.929488611464784,-0.03523552935916948,-0.015911035571004817,0.019324493788164664,17992637,17670179.2,43.6822923889052,58.47704621612666,NaN,NaN,-0.692910601960321,0.46861889534145773
2016-12-30T09:30:00-05:00,30.43,30.82,30.38,30.75,1853291,2053910.15,54.37414446332555,51.58167280927658,NaN,NaN,19.048029415145386,-18.924570126825493,-0.008468629331141713,0.008738707124237521,0.017207336455379234,19845928,18247028.2,47.21876108728211,56.91804286402295,NaN,NaN,0.7165586441682389,0.5040388594595693
2017-01-03T09:30:00-05:00,30.86,30.979,30.6339,30.85,2682334,2068069.25,55.8879199273282,51.11261461113583,NaN,NaN,49.812061840815225,-3.3101911067899907,0.014977174968580323,0.03592880516610464,0.020951630197524315,22528262,19174029.8,52.39248646222189,55.4459545532251,NaN,NaN,2.3277851217543843,0.7645740397873999
2017-01-04T09:30:00-05:00,30.87,31.295,30.86,31.24,1838041,2079529.6,61.28303854058326,50.96750284339301,NaN,NaN,114.65272740625942,23.13703482025902,0.05358529949816547,0.08793325457023116,0.034347955072065686,24366303,20239912.2,57.54549714399755,54.08118730868678,NaN,NaN,5.435569695905654,1.431859133518579
2017-01-05T09:30:00-05:00,31.08,31.42,30.8341,31.4,2198849,2122422.55,63.26789600259431,51.619837739289416,NaN,NaN,119.26522955007349,55.81905823007228,0.08487277650532023,0.14043892570371597,0.05556614919839574,26565152,22259656.4,65.22632303165832,53.2115192558122,NaN,NaN,8.641481500877541,2.461805185998431
2017-01-06T09:30:00-05:00,31.25,31.55,31.24,31.4,1747489,2106375.6,63.26789600259431,52.52841258839542,NaN,NaN,136.34874858634623,87.82535935972795,0.09952740378862962,0.17997540393418276,0.08044800014555314,26565152,23974159.4,70.16135354832029,53.06460173869825,NaN,NaN,11.234384286097072,3.7150307717268083
2017-01-09T09:30:00-05:00,31.44,31.47,31.1601,31.2,2125447,2127451.85,58.89109250286096,53.253549895410124,NaN,NaN,99.4648442308837,103.9087223228756,0.08999828746997474,0.19294585948302156,0.10294757201304683,24439705,24892914.8,72.42015177299453,53.59419148622754,NaN,NaN,12.251765870494355,4.934564357265029
2017-01-10T09:30:00-05:00,31.15,31.2,30.78,30.81,1582728,2123357.3,51.42088750639444,53.173779367243185,NaN,NaN,32.41383590556956,100.42907713582647,0.053480320774835555,0.16979797298159127,0.11631765220675572,22856977,24958657.8,72.58010697620034,54.6243113907093,NaN,NaN,10.90622148870397,5.787658233184878
2017-01-11T09:30:00-05:00,30.76,30.8643,30.62,30.64,2192526,2095744.25,48.53106148787528,52.86767040445384,NaN,NaN,-8.868299329689588,75.72487178863669,0.015878591252761254,0.13616589127270728,0.12028730001994603,20664451,24218287.4,67.81044802503834,55.765110680423504,NaN,NaN,8.896388320527103,6.231762531376624
2017-01-12T09:30:00-05:00,30.54,30.795,30.39,30.76,1481143,2060698.6,50.639815450066635,53.126608915713696,NaN,NaN,-16.151291724236724,48.64156753377464,-0.001960343032058637,0.11783687122987274,0.11979721426193138,22145594,23334375.8,62.5273999597048,56.82806541754885,NaN,NaN,7.831928900659594,6.460357726988477
2017-01-13T09:30:00-05:00,30.67,30.83,30.63,30.69,1469619,1965978.05,49.36913115710468,53.33504191610156,NaN,NaN,3.823562576239706,22.136530331753335,-0.018598081825529106,0.09654961198001999,0.1151476938055491,20675975,22156540.4,56.239705380118984,57.61012902459962,NaN,NaN,6.585453258793724,6.478228517246369
2017-01-17T09:30:00-05:00,30.67,30.96,30.6,30.94,1759098,1892695.85,53.825437035702,53.82510268349416,NaN,NaN,31.00005571481065,8.443572628538725,-0.013146715583794391,0.09871429932580611,0.1118610149096005,22435073,21755614,54.24026878885028,58.12391674134334,NaN,NaN,6.774662108913933,6.5205761731988785
2017-01-18T09:30:00-05:00,30.98,31.14,30.8901,31.01,1575728,1798702.7,55.01923053059199,54.29890382360731,NaN,NaN,67.40103660190431,15.44101276780567,-0.005593311332478784,0.10486937574400201,0.1104626870764808,24010801,21986378.8,55.22693669273812,58.66460054208294,NaN,NaN,7.268865735001598,6.627474682027838
2017-01-19T09:30:00-05:00,30.88,30.91,30.645,30.71,1631067,1767254.7,49.15390237607539,54.61857386781235,NaN,NaN,2.1126390902648113,17.637200451796545,-0.02071813963685802,0.08456501253040827,0.10528315216726629,22379734,22329435.4,56.720922360626226,59.570903829904076,NaN,NaN,5.976335045102103,6.53445473389559
2017-01-20T09:30:00-05:00,30.69,30.93,30.65,30.9,1605060,1759296.25,52.60033730852608,54.82369930654456,NaN,NaN,18.557478227550547,24.578954442154004,-0.017946500162729903,0.0828500269638539,0.10079652712658381,23984794,22697275.4,58.32662867795864,60.616927850550745,NaN,NaN,5.884777986931295,6.441643770043548
2017-01-23T09:30:00-05:00,30.84,31.15,30.84,31.09,3551466,1843280.15,55.824926685559795,54.92732660813272,NaN,NaN,61.559707388142336,36.12618340453453,-0.004062091614304625,0.09571891260870302,0.09978100422300765,27536260,24069332.4,63.73182752153378,61.79643259585445,NaN,NaN,6.765008326315443,6.487838706653819
2017-01-24T09:30:00-05:00,31.02,31.21,30.97,31.1,1890180,1867797,55.99460882685286,54.93494724381305,NaN,NaN,71.57248686976979,44.24066963552636,0.004581820502059644,0.1055082798505822,0.10092645934852255,29426440,25467605.8,68.2512623402731,62.929202301429534,NaN,NaN,7.527804340354757,6.636405225753953
2017-01-25T09:30:00-05:00,31.25,31.25,30.8233,30.91,1630775,1902757.2,51.914377444646796,54.265757165531866,NaN,NaN,39.08454674928801,38.5773716650031,-0.003286012835699681,0.09681894330389795,0.10010495613959763,27795665,26224578.6,70.40156718402434,63.847493018574305,NaN,NaN,7.027311916466881,6.6922490387129425
2017-01-26T09:30:00-05:00,30.91,31.1,30.8601,30.89,1486031,1919876.9,51.489058618605696,53.42441163810411,NaN,NaN,20.63977746870661,42.282799340691454,-0.01023415117694379,0.08731226716841789,0.09754641834536168,26309634,27010558.6,72.48535452925157,64.3659952684024,NaN,NaN,6.497513880420655,6.664429730385473
2017-01-27T09:30:00-05:00,30.97,31,30.52,30.63,1649797,1873843.75,46.191048183768515,52.204636793902274,NaN,NaN,-63.15261971752067,25.940779751677212,-0.03153452323427526,0.05812826430251761,0.08966278753679287,24659837,27145567.2,72.83907794561986,64.55726129678094,NaN,NaN,4.490825675112771,6.353914865346516
2017-01-30T09:30:00-05:00,30.51,30.66,30.37,30.46,2281063,1911586.6,43.07045219503398,51.07459105762892,NaN,NaN,-142.8874202698212,-14.948645779915495,-0.0548985333346146,0.021039620868524622,0.07593815420313922,22378774,26114070,65.87139974396959,64.08949329470774,NaN,NaN,1.8417829162832033,5.7093245869089
2017-01-31T09:30:00-05:00,30.52,30.88,30.51,30.71,1712211,1904532.6,48.57280388748881,50.871156513421376,NaN,NaN,-74.45275917902836,-44.153694989675124,-0.05140266809862572,0.011684819079857078,0.0630874871784828,24090985,25046979,59.52745954027061,63.15716133499846,NaN,NaN,1.1272499292851514,5.05474249296265
2017-02-01T09:30:00-05:00,30.67,30.87,30.35,30.37,1835919,1862211.85,42.54957423804285,50.44390742414762,NaN,NaN,-119.72831154187912,-75.91626664790854,-0.06879007697053298,-0.022900109034683425,0.045889967935849554,22255066,23938859.2,53.73949681480999,62.15209339141072,NaN,NaN,-1.4203549948599834,4.129728566130845
2017-02-02T09:30:00-05:00,30.32,30.77,30.32,30.73,2040588,1872339.2,49.6666322315893,50.37439433711353,NaN,NaN,-86.14165299725411,-97.2725527411007,-0.053526089600038074,-0.021017644064198038,0.032508445535840036,24295654,23536063.2,51.769063230704326,61.383640767910684,NaN,NaN,-1.3258866401668372,3.3503549652311766
2017-02-03T09:30:00-05:00,30.91,31.02,30.81,30.93,1745164,1849654.95,53.13978367369471,50.64372665972711,NaN,NaN,22.252051656108268,-80.1916184663749,-0.028685832493386566,-0.0033488450808931702,0.025336987412493395,26040818,23812259.4,53.040540294209244,61.15512897605999,NaN,NaN,-0.11185650185072112,2.85575332707662
2017-02-06T09:30:00-05:00,30.87,30.95,30.7,30.74,1362610,1830411,49.63573238812665,50.344462042043155,NaN,NaN,-12.662437959870562,-54.14662200438478,-0.02396903043748399,-0.004624300634361589,0.0193447298031224,24678208,24272146.2,55.16019200493784,61.2208377772091,NaN,NaN,-0.2288186770823197,2.415100183625343
2017-02-07T09:30:00-05:00,30.8,30.87,30.645,30.68,1496677,1798972.5,48.54706311189795,49.88216436927929,NaN,NaN,-32.62658905585435,-45.78138797974998,-0.023761556144099843,-0.010357215377002404,0.013404340767097438,23181531,24090255.4,54.1196940771645,61.14174901895384,NaN,NaN,-0.6556958447331047,1.9764150367169935
2017-02-08T09:30:00-05:00,30.64,31.005,30.64,30.94,1379123,1788792.25,53.32452328743816,50.18006586294806,NaN,NaN,32.2051433638773,-15.394696998598693,-0.005915507462783718,0.006009956438617792,0.01192546390140151,24560654,24551373,56.366773525181365,61.11645267356492,NaN,NaN,0.4675603961304631,1.7608643737760605
2017-02-09T09:30:00-05:00,30.9,31.09,30.89,31.07,1821565,1770244.2,55.54702656575255,50.390543667035665,NaN,NaN,96.29020575164945,21.091674751182026,0.013767724909636288,0.02913512003844687,0.015367395128810583,26382219,24968686,58.354668101334575,61.11845548952034,NaN,NaN,2.079364528169923,1.8063643958323266
2017-02-10T09:30:00-05:00,31.02,31.3,30.98,31.28,1524535,1772413.8,58.94760482999157,50.61359210592365,NaN,NaN,153.14041813571484,47.26934804710334,0.0386446745369386,0.06367323829998384,0.025028563763045235,27906754,25341873.2,60.1050910854422,60.85940288694237,NaN,NaN,4.508610247874733,2.1923995175526705
2017-02-13T09:30:00-05:00,31.34,31.48,31.18,31.43,1896700,1793767.85,61.22907487127686,50.987482537668214,NaN,NaN,190.20347325842175,87.8425302907618,0.06155571585456037,0.1019732085812457,0.04041749272668533,29803454,26366922.4,64.51675720938138,60.5926525204501,NaN,NaN,7.242197906228408,2.9137992873634904
2017-02-14T09:30:00-05:00,31.35,31.372,30.99,31.27,2444835,1828054.7,57.554803316368535,51.39037009993405,NaN,NaN,113.96474401669508,117.1607969052717,0.06210975557372688,0.11805468719384393,0.05594493162011705,27358619,27202340,67.65598402328536,60.39653943754018,NaN,NaN,8.454146244783951,3.705277424137842
2017-02-15T09:30:00-05:00,31.05,31.25,30.9,31.18,3360343,1917285.45,55.535993944639344,51.67943690893646,NaN,NaN,74.56942328115593,125.63365288872743,0.05294749191126388,0.1221292965091969,0.06918180459793302,23998276,27089864.4,66.79912466275564,59.9903801613619,NaN,NaN,8.870940483018037,4.443229289692155
2017-02-16T09:30:00-05:00,31.15,31.55,31.14,31.31,3238257,1997644.95,57.83656298016632,52.51125939439344,NaN,NaN,133.29971642511217,133.03555502341996,0.05209474652202643,0.13430023775046607,0.08220549122843963,27236533,27260727.2,67.47306333548809,59.60709340349535,NaN,NaN,9.889720634502082,5.221299481807859
2017-02-17T09:30:00-05:00,31.28,31.49,31.215,31.4,3247948,2079789.35,59.40262332700499,53.67784304667709,NaN,NaN,126.75376701415601,127.7582247991082,0.05382350750901116,0.14948487561470358,0.09566136810569242,30484481,27776272.6,69.485756329027,59.86526173099945,NaN,NaN,11.191029456321825,6.074118049595568
2017-02-21T09:30:00-05:00,31.35,31.865,31.34,31.83,4280834,2116257.75,65.91634600773247,54.91666748383735,NaN,NaN,183.69804605599296,126.45713935862246,0.07865501320995842,0.19398013461814045,0.11532512140818203,34765315,28768644.8,72.95485067516802,60.82436109777784,NaN,NaN,14.46015514732572,7.272123349271304
2017-02-22T09:30:00-05:00,31.84,31.97,31.58,31.71,2463190,2144908.25,62.88406546957162,56.36913114323226,NaN,NaN,170.95458268729354,137.85510709274212,0.08138617737702245,0.21705784312946008,0.13567166575243764,32302125,29757346,75.89515932504705,62.40690841993762,NaN,NaN,16.243881408049557,8.553803071953912
2017-02-23T09:30:00-05:00,31.84,31.96,31.67,31.92,1938411,2160290.05,65.8451535308555,57.524739807465565,NaN,NaN,158.69996704472527,154.68121584545602,0.0909964369855962,0.2494172119844329,0.1584207749988367,34240536,31805798,80.60092217818854,64.4663269161865,NaN,NaN,18.687101847787538,10.001417182787286
2017-02-24T09:30:00-05:00,31.92,32.095,31.77,32.08,2542772,2213127.1,67.94356892753643,58.58215303988283,NaN,NaN,155.67877680322732,159.15702792107905,0.10101631218033835,0.28469116522425963,0.18367485304392128,36783308,33715153,83.77951673519924,66.66196809054293,NaN,NaN,21.386981959501732,11.627926436603635
2017-02-27T09:30:00-05:00,32.09,32.3501,32.09,32.24,1902354,2225754.95,69.93293559933396,60.03195326925478,NaN,NaN,169.56490447615658,167.71925541347917,0.11053743146519279,0.3218466423754123,0.21130921091021948,38685662,35355389.2,85.91465469368107,68.85871542545316,NaN,NaN,24.273389910170632,13.434421218541777
2017-02-28T09:30:00-05:00,32.15,32.2866,32.0727,32.14,2041107,2213757.15,67.12895964108904,61.35923159276843,NaN,NaN,139.2045439846679,158.82055499921415,0.10240229764409853,0.33931208296534265,0.23690978532124413,36644555,35731237.2,86.357791051369,71.16143663789633,NaN,NaN,25.846240569952812,15.207538268743352
2017-03-01T09:30:00-05:00,32.06,32.2475,31.92,32.06,3039798,2280136.5,64.88751339408984,62.18515945752927,NaN,NaN,111.26773792365117,146.88318604648566,0.0846699813183997,0.34274726196924377,0.25807728065084407,33604757,35991763.6,86.67082915086581,73.32601203973094,NaN,NaN,26.512355720487086,16.82251219042103
2017-03-02T09:30:00-05:00,32,32.09,31.87,31.96,2142754,2295478.25,62.096387390307996,62.652970944997506,NaN,NaN,84.86072638314751,132.1153379141701,0.06038256095944017,0.3335554818501443,0.2731729208907041,31462003,35436057,82.331173150724,75.03861954325875,NaN,NaN,26.28407331854696,18.174163780153304
2017-03-03T09:30:00-05:00,31.89,31.96,31.57,31.86,1804457,2283671.7,59.34720674422789,62.68151393887153,NaN,NaN,50.9712011322011,111.17382277996487,0.03312209102361463,0.31457553467022237,0.28145344364660774,29657546,34010904.6,72.32898213911233,75.9117546185209,NaN,NaN,25.315814810275533,19.194399641599336
2017-03-06T09:30:00-05:00,31.72,31.8,31.585,31.73,2279630,2310395,55.88344396118225,62.29968315957906,NaN,NaN,31.70926355788252,83.60269459631004,0.0034371882304957135,0.2857499289347274,0.2823127407042317,27377916,31749355.4,59.89403775153899,75.58156037153216,NaN,NaN,23.4980680128565,19.809209408921788
2017-03-07T09:30:00-05:00,31.71,31.72,31.4544,31.62,1645922,2324560.6,53.0614197169396,61.97872718819128,NaN,NaN,8.637764547596463,57.489338708895765,-0.024942651223011814,0.2511344266754669,0.27607707789847874,25731994,29566843.2,50.814664334950685,74.37860896522254,NaN,NaN,21.139707656213236,19.99928058710628
2017-03-08T09:30:00-05:00,31.45,31.54,31.135,31.15,1665941,2333023.8,43.056639273467205,61.08734471167899,NaN,NaN,-58.047244534041354,23.626342217357248,-0.07393429380575828,0.18365921064128088,0.25759350444703916,24066053,27659102.4,44.46900095828198,72.78360012918871,NaN,NaN,15.622168693971265,19.37397888808699
2017-03-09T09:30:00-05:00,31.14,31.265,30.7,30.75,3171586,2422646.95,36.71229118819415,59.57846815510954,NaN,NaN,-130.58538470844832,-19.462880000961928,-0.12864104473569743,0.09679219852741738,0.2254332432631148,20894467,25545595.2,38.70268874423953,70.72857337267097,NaN,NaN,8.464494931885074,17.815481180058146
2017-03-10T09:30:00-05:00,30.91,31.16,30.54,30.72,1691120,2416124.7,36.2805075562904,57.92688845720136,NaN,NaN,-142.81407803199141,-58.219935833800434,-0.16015636200034433,0.025237790762684398,0.18539415276302873,19203347,23454755.4,34.004990194121774,68.19423293446344,NaN,NaN,2.7312585220963053,15.660592228920741
2017-03-13T09:30:00-04:00,30.72,30.9067,30.665,30.76,1929393,2436367.6,37.33873079132592,55.88563022745804,NaN,NaN,-135.88700136530872,-91.73918881843868,-0.17065138771617772,-0.027920081882193415,0.1427313058339843,21132740,22205720.2,31.541951841243304,65.23616873204024,NaN,NaN,-1.5574147051228975,13.200876952628793
2017-03-14T09:30:00-04:00,30.72,30.82,30.6,30.72,2139581,2448511.65,36.68266031773824,54.01410128804137,NaN,NaN,-129.20541956516314,-119.30782564099059,-0.17213759940328616,-0.07244069342012338,0.09969690598316276,18993159,20857953.2,29.093199679678477,61.893171614513925,NaN,NaN,-5.2556398094349355,10.564231700905403
2017-03-15T09:30:00-04:00,30.79,31.45,30.79,31.31,3130235,2482781.65,50.49871685285594,52.91792723961282,NaN,NaN,-53.06566384254638,-118.31150950269159,-0.12730188670040887,-0.05943045239234834,0.06787143430806053,22123394,20469421.4,28.40849864302561,58.165141362002295,NaN,NaN,-4.304395579841006,8.440142089370202
2017-03-16T09:30:00-04:00,31.3,31.44,31.16,31.24,1667726,2398150.8,49.12900221211816,51.57402961708294,NaN,NaN,-39.80789944420207,-100.15601244984235,-0.09761236271141956,-0.05414401908121391,0.043468343630205644,20455668,20381661.6,28.246790331645855,54.19851804746276,NaN,NaN,-3.983027162893628,6.665403624761083
2017-03-17T09:30:00-04:00,31.08,31.2469,31.01,31.1,2376280,2355051.95,46.4172863529806,49.894340385200564,NaN,NaN,-62.67452056594781,-84.12810095663363,-0.08321730843263972,-0.060553291910594,0.022664016522045714,18079388,20156869.8,27.810117267790915,50.04819394561347,NaN,NaN,-4.559821157790665,5.061800084396548
2017-03-20T09:30:00-04:00,31.1,31.245,31.05,31.1311,1573310,2271320.05,47.115600517073425,48.46481473348517,NaN,NaN,-55.532523553989726,-68.05720539436984,-0.06805427263884878,-0.06240382427651525,0.00565044836233352,19652698,19860861.4,27.213521329265276,45.82360325117749,NaN,NaN,-4.816242552292495,3.6506511362981136
2017-03-21T09:30:00-04:00,31.2,31.34,31.065,31.08,3225158,2218536.25,46.05357562509956,47.119533464271576,NaN,NaN,-47.59695111746887,-51.735511704830984,-0.05829545481426121,-0.067218870155493,-0.008923415341231785,16427540,19347737.6,26.165641070538953,41.50180410258271,NaN,NaN,-5.329344830113136,2.367794569667935
2017-03-22T09:30:00-04:00,31.14,31.177,30.86,31.15,3095471,2250150.3,47.78972763395303,46.0976291959605,NaN,NaN,-57.034833084132195,-52.529345553148154,-0.04457428324992143,-0.06464126940363357,-0.020066986153712142,19523011,18827661,25.110263113911557,37.41459624281039,NaN,NaN,-5.275956773431553,1.2758300920822938
2017-03-23T09:30:00-04:00,31.1,31.565,31.1,31.38,2233398,2264899.65,53.12747385836375,45.65336256125592,NaN,NaN,-10.55168422638367,-46.67810250958447,-0.018776451592813197,-0.04353755064472864,-0.024761099051915442,21756409,19087809.2,26.702845647379448,34.155586493400904,NaN,NaN,-3.6662626738617337,0.5698168398045756
2017-03-24T09:30:00-04:00,31.44,31.53,31.2682,31.35,3880551,2331788.6,52.37531988554769,45.40278227013918,NaN,NaN,-0.38177318918620473,-34.21955303423215,-0.0033113655790312294,-0.02890030602570448,-0.02558894044667325,17875858,19047103.2,26.607498878019555,31.7779765738638,NaN,NaN,-2.547286650537831,0.12451634118423188
2017-03-27T09:30:00-04:00,31.28,31.395,31.035,31.1,3656425,2419492.15,46.47096183225137,44.93203527837573,NaN,NaN,-30.66016071972407,-29.24508046737902,-0.009165688487534233,-0.037046051056091045,-0.02788036256855681,14219433,17960450.2,24.130468517311343,29.871962586889563,NaN,NaN,-3.255896081665662,-0.3583997192228958
2017-03-28T09:30:00-04:00,31.08,31.32,30.94,31.28,2237107,2429292.15,50.773840791725924,45.48326395825135,NaN,NaN,-23.71860930158431,-24.469412104202107,-0.000613224702578425,-0.028646893446779842,-0.028033668744201417,16456540,17966250.2,24.171045909881457,28.422108654860953,NaN,NaN,-2.5838505364901407,-0.676321264546788
2017-03-29T09:30:00-04:00,31.2,31.4,31.1601,31.39,1632291,2358916.8,53.247172872904606,46.66432693573068,NaN,NaN,19.313929416820535,-9.199659604011561,0.012054960788018827,-0.012964967759177881,-0.02501992854719671,18088831,17679414.2,23.50161645692293,27.33631777719548,NaN,NaN,-1.2851600337879652,-0.7632982315812419
2017-03-30T09:30:00-04:00,31.32,31.49,31.1254,31.46,1888606,2346209.4,54.80343221960851,47.987392983110546,NaN,NaN,45.05933222186025,1.9225436856372213,0.024058531445520177,0.005053235759703512,-0.019005295685816666,19977437,17323619.8,22.66316100849268,26.526187121079115,NaN,NaN,0.24770111745865414,-0.618869753146971
2017-03-31T09:30:00-04:00,31.42,31.7,31.38,31.6,2067006,2359336.85,57.82702313510892,49.4508424362379,NaN,NaN,119.07173220686425,25.81324476484731,0.039428689600070406,0.03028056631427134,-0.009148123285799064,22044443,18157336.8,29.05071403042561,26.348241563163562,NaN,NaN,2.4542492127937883,-0.17985275801257683
2017-04-03T09:30:00-04:00,31.66,31.7,31.515,31.64,1877371,2339223.9,58.677611871834294,51.02191040438761,NaN,NaN,143.36352446801166,60.61798180239445,0.04963159814672196,0.052891374397603386,0.0032597762508814274,23921814,20097813,41.219696650456214,27.214419918219114,NaN,NaN,4.526449850630578,0.4924761860793023
2017-04-04T09:30:00-04:00,31.64,31.8,31.5261,31.55,1737462,2343800.9,55.94358448255871,51.410829520794955,NaN,NaN,144.1934960382086,94.20040287035303,0.04765150467196747,0.06282415709084077,0.015172652418873297,22184352,21243375.4,46.99911913061769,28.542321381618553,NaN,NaN,5.554133504940553,1.2155700887737666
2017-04-05T09:30:00-04:00,31.58,31.77,31.55,31.6,2115238,2366265.75,57.138427124018044,51.98293130021637,NaN,NaN,129.73755146206224,116.28512727940138,0.04696500684247485,0.07387891097196686,0.02691390412949201,24299590,22485527.2,52.45762857722567,30.271666970588537,NaN,NaN,6.747848110019633,2.005895520380319
2017-04-06T09:30:00-04:00,31.58,31.8,31.45,31.78,1374695,2276421.2,61.21633648140097,53.040006309389256,NaN,NaN,124.94517992135484,132.26229681930027,0.05531455059859072,0.09605709237773041,0.04074254177913969,25674285,23624896.8,56.8476814585479,32.34577869849975,NaN,NaN,8.979301546428141,3.002096381244294
2017-04-07T09:30:00-04:00,31.78,31.94,31.73,31.82,1401026,2261916.5,62.079738300817766,54.10887329394243,NaN,NaN,152.71149568932768,138.99024951579298,0.0598294672984131,0.11552937590215606,0.055699908603742965,27075311,24631070.4,60.3312945411222,34.711333927918105,NaN,NaN,11.088977087517714,4.157365053569068
2017-04-10T09:30:00-04:00,31.9,32.08,31.79,32.04,1474157,2239154.7,66.497378065746,55.56914489684574,NaN,NaN,169.90022615654576,144.2975898534998,0.07305505068342137,0.14701872195801968,0.07396367127459831,28549468,25556601.2,63.26870513925042,37.36155278996892,NaN,NaN,14.317132761332124,5.608760440392361
2017-04-11T09:30:00-04:00,32.06,32.2489,32.025,32.19,1626680,2213509.65,69.13738437235378,57.09397752101722,NaN,NaN,186.24482307320653,152.70785526049937,0.08641326055250666,0.18198024696523163,0.09556698641272497,30176148,27154960.4,67.7148861934006,40.40474015278956,NaN,NaN,17.918729672197838,7.367327473507429
2017-04-12T09:30:00-04:00,32.14,32.28,32.08,32.14,1814224,2147709.1,67.23548243036862,58.10169241901757,NaN,NaN,158.8991518555222,158.54017533919136,0.08619385263373733,0.20330930220489662,0.1171154495711593,28361924,27967427.2,69.7212287012196,43.47748179949242,NaN,NaN,20.36931367832522,9.224754074195685
2017-04-13T09:30:00-04:00,32.14,32.2162,32.05,32.07,2051998,2166922.7,64.55793290839938,58.97187906350698,NaN,NaN,127.08830353486792,158.968800061894,0.07600295215163705,0.21211913976070562,0.13611618760906857,26309926,28094555.4,70.03501771631738,46.57944743079941,NaN,NaN,21.69494428214949,11.006209818189085
2017-04-17T09:30:00-04:00,32.1,32.45,32.1,32.44,2002806,2148249,71.10749853312694,60.73163168499809,NaN,NaN,153.2016880434856,159.06683853272557,0.08800288313168819,0.2461197915236788,0.1581169083919906,28312732,28342039.6,70.67220796313288,49.90385739121524,NaN,NaN,25.060237478789904,13.013928055417773
2017-04-18T09:30:00-04:00,32.36,32.56,32.29,32.52,4023270,2270747,72.29944005529157,62.2691744895385,NaN,NaN,154.83705995288028,156.05420529199247,0.09457484227452118,0.2763354612351421,0.1817606189606209,32336002,29099346.4,72.59277397065894,53.362552252699345,NaN,NaN,28.187353193408377,15.18156021798786
2017-04-19T09:30:00-04:00,32.55,32.5906,32.405,32.45,1692757,2194126.95,69.59402143972703,63.43680653002581,NaN,NaN,136.0035933755324,146.00595935245767,0.08761193610044077,0.2912755390861719,0.2036636029857311,30643245,29192765.8,72.82914976380565,56.88594748890525,NaN,NaN,29.959056828703318,17.292631162375784
2017-04-20T09:30:00-04:00,32.42,32.48,32.28,32.44,2695039,2174105.35,69.19567117530306,64.46482359828971,NaN,NaN,107.1878562648105,135.66370023431531,0.07616002011155004,0.29886362812516865,0.2227036080136186,27948206,29110022.2,72.23490271740988,60.42678618239934,NaN,NaN,31.28465707108065,19.291492006476478
2017-04-21T09:30:00-04:00,32.4,32.54,32.25,32.33,2376719,2181271.4,64.80170245065284,64.96301497797141,NaN,NaN,91.53515619127928,128.5530707655976,0.05593945762365604,0.29262793004318866,0.23668847241953261,25571487,28962334.4,71.1194654055584,63.43169699490882,NaN,NaN,31.17447972502202,20.989061680554414
2017-04-24T09:30:00-04:00,32.46,32.5,31.77,32.01,1928038,2083645.75,54.049205540370004,64.63241452572396,NaN,NaN,38.34206033763841,105.58114522442816,0.01775366594458011,0.25888055485025774,0.24112688890567763,23643449,28028477.8,64.35264384731722,65.08405036611319,NaN,NaN,27.642418660780173,21.939541249158093
2017-04-25T09:30:00-04:00,32.07,32.13,31.955,32.08,1458479,1973748.45,55.77781104539135,64.62057356592629,NaN,NaN,25.91491131657931,79.79671549716795,-0.004842196355350964,0.23507414346148892,0.23991633981683988,25101928,26581663,55.53626326436575,65.69384637566661,NaN,NaN,25.27041337640974,22.415380124479757
2017-04-26T09:30:00-04:00,32.02,32.09,31.78,31.81,1489440,1936365.1,48.239769919047085,63.984955194142664,NaN,NaN,-13.474761907597493,49.90104444054197,-0.038169049860934,0.19220502749067236,0.23037407735160637,23612488,25175511.6,48.57145909773266,65.41626284141711,NaN,NaN,20.654074913397764,22.163765094325186
2017-04-27T09:30:00-04:00,31.82,32.02,31.77,31.83,1436546,1926577.85,48.79183108391871,63.09749052289393,NaN,NaN,-26.32214267787066,23.199044652005732,-0.057880714537038414,0.15802318418030836,0.21590389871734678,25049034,24595677.2,46.00914148855435,64.64208141498901,NaN,NaN,17.159494943202663,21.44886935845054
2017-04-28T09:30:00-04:00,31.79,31.82,31.49,31.65,1816717,1922983.4,44.22050797293316,61.82183121375931,NaN,NaN,-87.03395248671113,-12.514777083592344,-0.08065693549759775,0.11508272934534958,0.19573966484294733,23232317,24127843.2,43.99261435499048,63.475032830265306,NaN,NaN,12.679638141016406,20.196122041674236
2017-05-01T09:30:00-04:00,31.7,31.9074,31.58,31.85,2636705,1951468.35,49.84346195041285,60.6322657769498,NaN,NaN,-60.5626571530156,-32.295720581723145,-0.07972544810633114,0.09608285471003342,0.17580830281636456,25869022,24572957.8,46.39970190887457,62.2701040280956,NaN,NaN,10.579322012293007,18.822293466048347
2017-05-02T09:30:00-04:00,31.82,31.971,31.72,31.86,1845637,1949881.65,50.114244836402555,59.273470095810424,NaN,NaN,-47.02473751741945,-46.88365034852289,-0.07592690422535261,0.08089967253467378,0.1568265767600264,27714659,25095504,49.162012292185636,60.94489874943739,NaN,NaN,8.99416494621385,17.41827510607199
2017-05-03T09:30:00-04:00,31.81,31.93,31.39,31.47,2193432,1972680.15,40.85130427275388,57.38888594169509,NaN,NaN,-115.93552914606747,-67.3758037962169,-0.0958844835816772,0.03697097228292989,0.1328554558646071,25521227,25477251.8,51.14294221908064,59.61787828642747,NaN,NaN,4.361953997021355,15.553086376207615
2017-05-04T09:30:00-04:00,31.31,31.5334,31.14,31.5,1428508,1938343.65,41.743324526157636,55.759271057249244,NaN,NaN,-160.67471682029878,-94.2463186247025,-0.10266377252542573,0.004525740207824924,0.10718951273325066,26949735,25857392,53.10260532957397,58.40842025880294,NaN,NaN,1.0027887713884716,13.474472432662022
2017-05-05T09:30:00-04:00,31.53,31.76,31.53,31.75,1717402,1955479,48.68799953050288,54.157878271347535,NaN,NaN,-85.39560064147257,-93.91864825565479,-0.08655390527158685,-0.001002868856232908,0.08555103641535394,28667137,26944356,58.25822704388281,57.52170733599936,NaN,NaN,0.332200623194092,11.597005031309461
2017-05-08T09:30:00-04:00,31.71,31.8335,31.42,31.58,1279826,1949419,44.778928824781865,52.19212746916827,NaN,NaN,-96.38151992021157,-101.08242080909397,-0.0835482091567378,-0.018884225030568302,0.0646639841261695,27387311,27248013.8,59.59459411337107,56.59326591762166,NaN,NaN,-1.5079949673288624,9.72486217436113
2017-05-09T09:30:00-04:00,31.54,31.59,31.35,31.46,1770226,1964222.45,42.20312259902134,50.23563469483214,NaN,NaN,-115.35719323931221,-114.74891195347254,-0.08553221073922483,-0.042251279297861544,0.04328093144136329,25617085,26828499,56.88502426783826,55.454399810766844,NaN,NaN,-3.844659237955925,7.786359115458693
2017-05-10T09:30:00-04:00,31.46,31.74,31.4,31.63,1520304,1958903.65,46.86610227257806,48.640665487494644,NaN,NaN,-78.78208138654732,-107.3182224015685,-0.07183758581374841,-0.04651605082582222,0.025321534987926185,27137389,27151731.4,58.45246465789314,54.469939949372794,NaN,NaN,-4.317082643049306,6.057296007100408
2017-05-11T09:30:00-04:00,31.49,31.5099,31.23,31.48,1999056,1968145.25,43.52903324742654,47.12118911583563,NaN,NaN,-108.34602276847288,-96.85248359120332,-0.06929171643877391,-0.06129311056054121,0.007998605878232704,25138333,26789451,55.995327976246216,53.38964441870763,NaN,NaN,-5.772962277368304,4.367259109319164
2017-05-12T09:30:00-04:00,31.47,31.51,31.32,31.36,1506755,1940883.1,41.01307539937387,46.190036962907335,NaN,NaN,-100.38021897750889,-99.8494072584106,-0.07179466998248435,-0.08174473159987272,-0.00995006161738838,23631578,25782339.2,49.73616433507953,52.34561016783351,NaN,NaN,-7.766832372804982,2.633817469015715
2017-05-15T09:30:00-04:00,31.36,31.66,31.3542,31.5,2380075,1959746.55,45.00668589105595,45.4206708804548,NaN,NaN,-71.09467303642091,-94.79203788165246,-0.06057469179092724,-0.08566842635604743,-0.025093734565120193,26011653,25507207.6,48.1526140652779,51.818206653612954,NaN,NaN,-8.19847179968041,1.0863475734876968
2017-05-16T09:30:00-04:00,31.48,31.49,31.265,31.34,1369108,1827038.45,41.54486986636957,44.94246373383498,NaN,NaN,-95.72960345619798,-90.8665199250296,-0.0603488528117123,-0.10052980057976058,-0.04018094776804827,24642545,25312299.6,47.01070837957489,51.706724459458826,NaN,NaN,-9.641542722256172,-0.4462081830471414
2017-05-17T09:30:00-04:00,31.25,31.69,31.25,31.54,2978798,1891340.5,47.02959581831382,44.81658978629178,NaN,NaN,-60.726143959729384,-87.25533243966602,-0.04391385993416045,-0.09507327268574883,-0.05115941275158838,27621343,25409090.4,47.67432054775241,51.82566582083012,NaN,NaN,-9.135963476790192,-1.6876017964390058
2017-05-18T09:30:00-04:00,31.45,31.665,31.29,31.6,2455843,1879380.7,48.588078827967436,45.12855913307994,NaN,NaN,-49.737493136572034,-75.53362651328585,-0.02701521726562766,-0.08492843433362296,-0.0579132170679953,30077186,26396861,54.00491320095736,52.54083002411346,NaN,NaN,-8.248337136051887,-2.624849702097989
2017-05-19T09:30:00-04:00,31.57,31.93,31.44,31.78,1397266,1830408.05,53.05082971426445,45.35765683049791,NaN,NaN,26.281205643103966,-50.201341589163285,-0.002992129859978425,-0.06165337939296833,-0.05866124953298991,31474452,27965435.8,61.88993658629065,53.64727535821462,NaN,NaN,-6.091062101321616,-3.1200229019870784
2017-05-22T09:30:00-04:00,31.78,31.97,31.72,31.86,1371299,1802571.1,54.92362356309326,45.701183882404386,NaN,NaN,87.5732396732697,-18.467759047225165,0.017862144832816722,-0.036333568491969004,-0.054195713324785726,32845751,29332255.4,67.17119339450619,54.93364543695179,NaN,NaN,-3.7432402781886522,-3.2090539557301603
2017-05-23T09:30:00-04:00,31.89,32.03,31.85,31.9,1995037,1829399,55.87146619498679,46.77405259113531,NaN,NaN,126.80510686741985,26.039183017498395,0.033043635573930745,-0.012891168857372293,-0.04593480443130304,34840788,31371904,73.15063321808427,56.50562336545205,NaN,NaN,-1.542439661518876,-2.9709661994142627
2017-05-24T09:30:00-04:00,31.87,32.13,31.87,32.08,1051724,1807513.2,59.952411791015365,48.07470168148229,NaN,NaN,159.02184110260973,69.98878002996622,0.05273285620830438,0.019981265829077444,-0.03275159037922694,35892512,33026137.8,76.83573985485516,58.200847260115,NaN,NaN,1.6241317774353683,-2.3145236312928867
2017-05-25T09:30:00-04:00,32.14,32.3482,32.03,32.2,1042874,1787829.6,62.445818008140776,49.05740300131357,NaN,NaN,198.6882192704881,119.67392251137827,0.07026604445486512,0.05508096518935446,-0.01518507926551066,36935386,34397777.8,79.36476613276648,59.70845719503525,NaN,NaN,5.069620559374306,-1.2596458897690022
2017-05-26T09:30:00-04:00,32.21,32.2684,31.92,32,1352143,1764600.9,56.1689056231553,49.870972772625954,NaN,NaN,127.72666971139992,139.96301532503745,0.06494695171960552,0.06599861038399624,0.00105165866439072,35583243,35219536,80.72267395279665,61.217605754994224,NaN,NaN,6.201475768196976,-0.19377136720243393
2017-05-30T09:30:00-04:00,31.99,32.06,31.9,31.91,898798,1677705.55,53.55987337897178,50.68216925690813,NaN,NaN,86.08855736261992,139.66607886290748,0.05245524339731293,0.06662071291103189,0.014165469513718955,34684445,35587274.8,81.31522908392081,62.962620384714405,NaN,NaN,6.363746753330517,0.7430169357308447
2017-05-31T09:30:00-04:00,31.95,32.06,31.81,31.86,1616250,1666236.2,52.11166644087468,51.05685241178646,NaN,NaN,69.46987651750119,128.19903279292376,0.03855586501594942,0.06236030078365573,0.02380443576770631,33068195,35232756.2,78.80047759256092,64.41604988004782,NaN,NaN,6.078631044378876,1.5052475226805635
2017-06-01T09:30:00-04:00,31.87,32.01,31.7246,31.96,1563040,1634716.6,54.747100603317904,51.85814293720727,NaN,NaN,59.085741240512625,108.21181282050433,0.033987587652272735,0.06628892033304723,0.032301332680774494,34631235,34980500.8,76.9763031609889,65.9146909646723,NaN,NaN,6.590606202892143,2.2317273341393604
2017-06-02T09:30:00-04:00,32.14,32.3065,32.07,32.24,1224855,1624533.95,61.187804987112976,53.2991950506172,NaN,NaN,130.75253690429747,94.6246763472662,0.04691705518108008,0.0909476516571246,0.044030596476044515,35856090,34764641.6,75.36846635106716,67.74556968009998,NaN,NaN,9.065431425245364,3.2079707757259324
2017-06-05T09:30:00-04:00,32.19,32.24,32,32.16,1287594,1603043.55,58.620637904959025,54.271620194467424,NaN,NaN,97.3148081491587,88.54230403481795,0.04705469373459174,0.1028489636442842,0.055794269909692454,34568496,34561692.2,73.80752195286043,69.57806310064159,NaN,NaN,10.335863658622786,4.226241187568339
2017-06-06T09:30:00-04:00,32.17,32.17,31.98,32.01,1316520,1604878.25,54.04228835519415,55.16429294366919,NaN,NaN,69.26450295905124,85.17749315410423,0.03459296283243776,0.09903547345023966,0.0644425106178019,33251976,34275198.4,71.5545934298507,71.33119774708986,NaN,NaN,10.032436952123566,5.055697725361943
2017-06-07T09:30:00-04:00,32.05,32.21,31.95,32.18,1078788,1570306.35,58.041889426597464,55.950885344260875,NaN,NaN,78.12854493676659,86.90922683795729,0.035230263833668146,0.10848034040988708,0.07325007657621893,34330764,34527712.2,72.35555062321188,73.09414275247983,NaN,NaN,11.005144065047102,5.905618631031252
2017-06-08T09:30:00-04:00,32.17,32.23,31.77,32.03,2293788,1608980.55,53.60865956957881,56.309498254375974,NaN,NaN,46.916470130314934,84.47537261591775,0.023542426570668365,0.10267810978955438,0.07913568321888602,32036976,34008860.4,68.11168449888174,74.10176927376014,NaN,NaN,10.454372132494962,6.555440559811782
2017-06-09T09:30:00-04:00,31.98,32.26,31.89,32.18,1787648,1598410.15,57.13456475176687,56.601193614197584,NaN,NaN,70.12765965812642,72.35039716668356,0.023833768356821022,0.10892789366491229,0.08509412530809127,33824624,33602567.2,64.90153188604624,74.31688322374269,NaN,NaN,11.081342956792756,7.201998045094778
2017-06-12T09:30:00-04:00,32.09,32.4,32.01,32.39,3135988,1679871.8,61.54151910989796,57.073900438969346,NaN,NaN,113.07042356372261,75.50152024959634,0.03539289272777173,0.12933524121780593,0.0939423484900342,36960612,34080990.4,66.88095752714176,74.29615209035951,NaN,NaN,13.036875396226232,8.035551952399272
2017-06-13T09:30:00-04:00,32.45,32.49,32.27,32.47,1567290,1639232.55,63.09797524713811,57.59007965698016,NaN,NaN,148.65459489149399,91.3795386360849,0.04503153267150507,0.15023176432941554,0.10520023165791047,38527902,35136175.6,70.79328250779,74.12776989676706,NaN,NaN,15.116054024490325,9.04705224841228
2017-06-14T09:30:00-04:00,32.74,32.79,32.465,32.57,2232920,1682423.15,65.00453835003557,57.950945839767314,NaN,NaN,202.32278540639533,116.21838673001066,0.05413489405372626,0.1728688492250683,0.11873395517134203,40760822,36422187.2,74.71378594372565,73.97620176025781,NaN,NaN,17.429554467675917,10.244552565449942
2017-06-15T09:30:00-04:00,32.43,32.8233,32.35,32.73,1347254,1600845.95,67.86528928672618,58.33805093109485,NaN,NaN,189.2267904848803,144.68045080092372,0.06613121541256087,0.2013979744370431,0.13526675902448224,42108076,38436407.2,79.38201370385192,73.97743372962107,NaN,NaN,20.30217831821759,11.681356244416747
2017-06-16T09:30:00-04:00,32.51,32.53,32.31,32.44,1754130,1565760.3,58.52662986049266,58.506459805190374,NaN,NaN,107.16785913453329,152.0884906962051,0.050443245915334806,0.19832081641865074,0.14787757050331593,40353946,39742271.6,81.73617312983819,74.04982652798117,NaN,NaN,19.84122974701664,12.847052459073875
2017-06-19T09:30:00-04:00,32.47,32.5,32.32,32.46,6082213,1800007.65,58.946202203180526,58.891197578348134,NaN,NaN,94.06250368952853,148.28690672136628,0.03789419394996901,0.19524531294077718,0.15735111899080817,46436159,41637381,84.50179019428026,74.27743803586398,NaN,NaN,19.605065823195208,13.812482939662637
2017-06-20T09:30:00-04:00,32.49,32.57,32.1838,32.4,2348860,1848885.7,57.080546144365904,59.24611755716894,NaN,NaN,70.33289904724637,132.62256755251678,0.02277861508436163,0.1858243878462602,0.16304577276189858,44087299,42749260.4,85.85513128184203,74.78134187081264,NaN,NaN,18.85586845957033,14.532966585363736
2017-06-21T09:30:00-04:00,32.41,32.44,32.15,32.33,1659946,1832131.15,54.89751509312841,59.256861449298256,NaN,NaN,36.78458218653516,99.51492690854474,0.00615667679141349,0.17074161875116545,0.16458494195975196,42427353,43082566.6,86.24294363581102,75.44324476187137,NaN,NaN,17.59510341377243,14.970414703707835
2017-06-22T09:30:00-04:00,32.29,32.45,32.2032,32.35,5944282,2076759.05,55.422090744033575,58.84502471764972,NaN,NaN,41.58442144151551,69.98645309987178,-0.004808511503977819,0.15857430257977967,0.1633828140837575,48371635,44335278.4,87.61710395934261,76.31814744817676,NaN,NaN,16.700804151803766,15.217613196292968
2017-06-23T09:30:00-04:00,32.35,32.62,32.3455,32.49,8197655,2434498.1,59.015525413798755,58.873230968281135,NaN,NaN,86.44046655585375,65.84097458413586,-0.003984265972295231,0.15840248161838844,0.16238674759068367,56569290,47578347.2,90.31439747359723,77.49720998537224,NaN,NaN,16.921959111883,15.461091184234402
2017-06-26T09:30:00-04:00,32.54,32.7764,32.54,32.64,2483246,2491053.25,62.50317218415436,59.477579813206866,NaN,NaN,128.2005913917266,72.66859212457548,0.004833417556395547,0.1684285195361781,0.16359510197978255,59052536,50101622.6,91.80932124860817,78.94397625814064,NaN,NaN,18.129228217242773,15.842253617521312
2017-06-27T09:30:00-04:00,32.55,32.835,32.51,32.51,2173308,2554778.75,57.90420803711304,59.46774542824369,NaN,NaN,106.62804216043902,79.92762074721401,0.00031903341662004037,0.16399389375055762,0.16367486033393758,56879228,52660008.4,92.99061611720097,80.41790950771129,NaN,NaN,17.824963123581757,16.125497832672803
2017-06-28T09:30:00-04:00,32.59,32.67,32.48,32.55,2715038,2609718.15,58.906135478999246,59.84613656463087,NaN,NaN,82.56726452463454,89.08415721483388,-0.0014667052690951754,0.1618414787475686,0.16330818401666378,59594266,56093391,94.19963848668134,82.28133479255412,NaN,NaN,17.856066225542495,16.372721888797045
2017-06-29T09:30:00-04:00,32.34,32.4196,32.16,32.22,3041682,2683650.25,48.62393003635381,59.238234084958506,NaN,NaN,-32.85447815854576,74.19637729482163,-0.02505776316868935,0.1319859800558021,0.15704374322449144,56552584,57729580.8,94.67134139108744,84.40774975719991,NaN,NaN,14.61578165292423,16.1217304265295
2017-06-30T09:30:00-04:00,32.25,32.45,32.11,32.2,1256941,2685254.55,48.076212394817354,58.276426462452754,NaN,NaN,-39.4986892758388,49.00854612848311,-0.04123870298045054,0.10549536449892827,0.1467340674793788,55295643,57474851.4,93.39789504511276,86.30181672276926,NaN,NaN,11.859069649386148,15.512778886937593
2017-07-03T09:30:00-04:00,32.34,32.56,32.22,32.5,1035657,2672657.7,56.06986315446385,57.77441845583316,NaN,NaN,24.647806378665287,28.297989125870856,-0.03141124896243916,0.10747000627632985,0.138881255238769,56331300,56930604.2,90.59398987124773,87.71615296301624,NaN,NaN,11.897632413412097,14.996329390719664
2017-07-05T09:30:00-04:00,32.42,32.58,32.02,32.11,2908644,2752263.9,46.12793059792079,56.4260893306821,NaN,NaN,-62.55275132311645,-5.538169570840242,-0.049760004380940415,0.0766812497625935,0.1264412541435339,53422656,56239289.8,87.02034717341863,88.59519305085145,NaN,NaN,8.386673339409697,14.052092811961097
2017-07-06T09:30:00-04:00,32,32.01,31.49,31.53,1839971,2790323.05,35.92570933329219,54.14469076257967,NaN,NaN,-260.7580355730095,-74.20322959036905,-0.09681913294139503,0.0054173379667901145,0.10223647090818515,51582685,54636973.6,79.2201643128797,88.58363238006771,NaN,NaN,1.0220510299589602,12.190658271675078
2017-07-07T09:30:00-04:00,31.52,31.79,31.52,31.71,1325146,2741890.95,40.3360483615406,52.84536351265452,NaN,NaN,-230.91505730939505,-113.81534542053892,-0.11068435500431256,-0.036118972847205555,0.07456538215710701,52907831,53908023,75.88752054663792,88.1658714812677,NaN,NaN,-2.9313014243630953,10.030378315098197
2017-07-10T09:30:00-04:00,31.73,31.8,31.45,31.46,1098234,2707420.25,36.57094786919272,51.24713106022683,NaN,NaN,-220.62313715686005,-150.04023499674315,-0.13020676510307924,-0.08819307422174205,0.0420136908813372,51809597,53210813.8,72.73577658500358,87.32544193774795,NaN,NaN,-7.500842254866316,7.525918233674695
2017-07-11T09:30:00-04:00,31.43,31.53,31.21,31.41,1279299,2614585.8,35.850190046807796,49.73067705325839,NaN,NaN,-209.70420529274438,-196.91063733102507,-0.13919129374880893,-0.13197542630467396,0.007215867444134966,50530298,52050613.4,67.69722166873723,86.02844839395473,NaN,NaN,-11.200988620682155,4.850645825909431
2017-07-12T09:30:00-04:00,31.58,31.93,31.58,31.82,1910810,2631761.8,45.359823490791875,49.049413367377205,NaN,NaN,-98.74584474739152,-204.1492560158801,-0.11142652814454854,-0.1320672927365507,-0.020640764592002172,52441108,51854303.8,66.85335403941855,84.64347770849814,NaN,NaN,-10.94390885080018,2.5942808720937722
2017-07-13T09:30:00-04:00,31.83,31.935,31.77,31.88,1181472,2579189.4,46.60721576046238,48.419779439979266,NaN,NaN,-69.07170838322546,-165.81199057792327,-0.08416571048787788,-0.12584790270184953,-0.041682192213971646,53622580,52262282.8,67.75300427240734,83.22461344514561,NaN,NaN,-10.320553417354875,0.7493045450296798
2017-07-14T09:30:00-04:00,31.99,32.24,31.99,32.2,1167422,2570197.8,52.79660255427946,47.97557066429931,NaN,NaN,-6.421335094457492,-120.91324613493578,-0.04186539147782254,-0.09401393156124982,-0.05214854008342728,54790002,52638717,68.59984520876993,81.67357399765795,NaN,NaN,-7.62087976377383,-0.44643607051367873
2017-07-17T09:30:00-04:00,32.17,32.33,32.12,32.27,2285069,2596744.75,54.05139003878261,47.3718719396299,NaN,NaN,16.505339349445574,-73.48755083367465,-0.008215053262235289,-0.06241735666122139,-0.0542023033989861,57075071,53691811.8,70.90202102637346,80.18019541035547,NaN,NaN,-5.096575516888859,-1.110741705710133
2017-07-18T09:30:00-04:00,32.27,32.36,32.18,32.23,2302889,2407778.55,53.181421599839574,47.03453005125322,NaN,NaN,22.416437611457884,-27.063422252834208,0.011248418983721885,-0.040141779669333744,-0.05139019865305563,54772182,54540188.6,72.64219981507905,78.72673710306104,NaN,NaN,-3.365345251660554,-1.432827926560193
2017-07-19T09:30:00-04:00,32.22,32.47,32.13,32.47,4613879,2521029.5,57.591860259158,46.94065324983599,NaN,NaN,45.061976775006045,1.6981420516453085,0.038642839554946753,-0.003086649209372183,-0.04172948876431894,59386061,55929179.2,75.25177768093646,77.37331847407927,NaN,NaN,-0.4713177578971237,-1.2954693310368974
2017-07-20T09:30:00-04:00,32.54,32.58,32.36,32.38,1048321,2490448.25,55.481167097925315,47.4304558970911,NaN,NaN,61.17577774866764,27.74763927802393,0.04842426018715359,0.01880083646962305,-0.029623423717530538,58337740,56872211.2,76.86526453526778,76.10145584152073,NaN,NaN,1.2540823888518566,-0.9312476567670754
2017-07-21T09:30:00-04:00,32.36,32.47,32.28,32.44,1200996,2253283.95,56.62252458705047,48.040906767964884,NaN,NaN,50.63192421080537,39.158291139076496,0.056115716333987965,0.040521221699954424,-0.015594494634033543,59538736,57821958,78.3931111389254,75.02968556250734,NaN,NaN,3.001945830573686,-0.36936287286125247
2017-07-24T09:30:00-04:00,32.44,32.47,32.26,32.42,1091520,1897977.2,56.10616536424466,48.04349978294923,NaN,NaN,49.41316363155374,45.73985599549813,0.05686071221600469,0.05548139563597232,-0.0013793165800323696,58447216,58096387,78.82820184612481,74.18927213214143,NaN,NaN,4.2886094297325155,0.296061741795
2017-07-25T09:30:00-04:00,32.43,32.43,32.2,32.42,2142773,1880953.55,56.10616536424466,48.75623083768665,NaN,NaN,47.04275314038687,50.665119101283935,0.054359503675616545,0.06657006301448831,0.012210559338871768,58447216,58831393.8,79.99037934354078,73.68713157286443,NaN,NaN,5.3489914333877335,1.0179088405939618
2017-07-26T09:30:00-04:00,32.43,32.7695,32.34,32.69,1903795,1867477.9,61.59028509995358,50.58941482101961,NaN,NaN,104.47459748209485,62.54764324270169,0.06706162750353709,0.09603759371829312,0.028975966214756038,60351011,59024383.8,80.2962180460909,73.76399255380808,NaN,NaN,7.903519032228572,2.0015674393989062
2017-07-27T09:30:00-04:00,32.56,32.7557,32.32,32.66,2164655,1839958.75,60.68306412839366,52.04277309008054,NaN,NaN,99.34885590225271,70.1822588734187,0.0693288930425376,0.11563708251792804,0.046308189475390435,58186356,58994107,80.08939997822574,74.0641267989215,NaN,NaN,9.774222454047445,3.11194672720584
2017-07-28T09:30:00-04:00,32.59,32.77,32.52,32.64,2060197,1790884.5,60.04803580382949,53.71970794255459,NaN,NaN,105.08913885663024,81.07370180258368,0.0654170998239517,0.12807956425533007,0.06266246443137836,56126159,58311591.6,75.37621098283685,74.2527292559096,NaN,NaN,11.171454760496054,4.2633050176758704
2017-07-31T09:30:00-04:00,32.62,32.655,32.36,32.59,1526567,1804365.8,58.40259437835544,55.33059396623656,NaN,NaN,75.89139264028006,86.36934760432895,0.05577382623127808,0.13237974722047596,0.07660592098919788,54599592,57542066.8,70.34937292300518,74.44216863121446,NaN,NaN,11.9442168173537,5.3605781319155605
2017-08-01T09:30:00-04:00,32.65,32.84,32.45,32.73,2364510,1870808.45,61.577372616030864,56.48899033232506,NaN,NaN,99.82263550050129,96.92532407635183,0.05504192440731451,0.145408326498341,0.0903664020910265,56964102,57245444,68.45429154058752,74.55652130986937,NaN,NaN,13.484354423969805,6.521117602209024
2017-08-02T09:30:00-04:00,32.65,32.65,32.45,32.57,1712537,1811003.1,56.28983182169474,57.18060576527023,NaN,NaN,70.06861911578616,90.04412840309008,0.04066311444418755,0.14119529514626095,0.1005321807020734,55251565,56225554.8,62.24547839820442,74.16312660456916,NaN,NaN,13.412237658453485,7.505563324529661
2017-08-03T09:30:00-04:00,32.55,32.66,32.39,32.49,1101311,1774070.1,53.802193456542796,57.25243368686046,NaN,NaN,57.779144807424046,81.73018618412436,0.023497181464393946,0.12990365753256583,0.10640647606817188,54150254,55418334.4,57.77865142583676,73.39018419150251,NaN,NaN,12.667280085021826,8.242951433171399
2017-08-04T09:30:00-04:00,32.46,32.66,32.46,32.59,939594,1754792.5,56.39622967049614,57.41992223198286,NaN,NaN,66.13316367589552,73.93899114797742,0.016917825003089165,0.12755375732203333,0.11063593231894417,55089848,55211072.2,56.65446554632372,72.37250165721323,NaN,NaN,12.726835961663088,8.88350636581307
2017-08-07T09:30:00-04:00,32.56,32.64,32.43,32.57,781896,1738975.6,55.722324815114426,57.601415318788206,NaN,NaN,57.82242416431996,70.32519745278539,0.009622151541650165,0.12266362174600687,0.1130414702043567,54307952,55152744.2,56.322346995882356,71.20679788441348,NaN,NaN,12.597836635832897,9.414124975815902
2017-08-08T09:30:00-04:00,32.51,32.56,32.3201,32.42,1070653,1728543.3,50.817662143808334,57.117544024834665,NaN,NaN,15.26433031641321,53.41353641596778,-0.0060582714057421105,0.10546863094717907,0.11152690235292118,53237299,54407383.6,52.11780106746766,69.55437098345142,NaN,NaN,11.128257640766154,9.659001070808795
2017-08-09T09:30:00-04:00,32.42,32.5,32.3,32.46,1134394,1689722.5,52.03021615559691,56.871047528954065,NaN,NaN,-2.3172315948744138,38.93636627383567,-0.01403293505842411,0.09398573352989104,0.10801866858831514,54371693,54231409.2,51.14700872731331,67.71735271145467,NaN,NaN,10.207133052076092,9.737305639561265
2017-08-10T09:30:00-04:00,32.37,32.42,32.155,32.17,1412033,1701250.55,43.63146993842441,55.94311505405221,NaN,NaN,-107.19823964100878,5.940889384149097,-0.03778757818661824,0.060784195855042356,0.09857177404166059,52959660,53993290.4,49.79537766717676,65.67465746347263,NaN,NaN,6.798217695328282,9.317435933242267
2017-08-11T09:30:00-04:00,32.08,32.2,31.8244,31.96,1548094,1720284.15,38.7531346522567,54.70361286033877,NaN,NaN,-228.7132256242565,-53.0283884758813,-0.0649960104558615,0.01732676097183372,0.08232277142769522,51411566,53257634,45.77103739228345,63.313431431055385,NaN,NaN,2.226114611534083,8.304390030141098
2017-08-14T09:30:00-04:00,32.08,32.535,32.07,32.49,1196939,1665877.65,53.0274981469057,54.48370805910027,NaN,NaN,-42.352337053990674,-73.06334071954342,-0.04556968958809525,0.02536065944257615,0.0709303490306714,52608505,52917744.6,44.00165397655304,60.74280819055626,NaN,NaN,2.894027914741332,7.531481156512561
2017-08-15T09:30:00-04:00,32.38,32.44,32.225,32.43,2138051,1657635.75,51.562402117777864,53.76743070323058,NaN,NaN,-47.16119220467418,-85.54844522376091,-0.03548052787176327,0.026579689190967315,0.062060217062730585,50470454,52364375.6,41.20859026023725,57.950834777280996,NaN,NaN,2.909050538016772,6.871133925298876
2017-08-16T09:30:00-04:00,32.46,32.645,32.46,32.53,1043622,1479122.9,53.85095576719865,53.27942296314523,NaN,NaN,49.09358249830482,-75.26628240512505,-0.021480913638624623,0.03520907501444981,0.05668998865307443,51514076,51792852.2,38.491052998709364,54.979524278744115,NaN,NaN,3.6753949996558997,6.414599793064165
2017-08-17T09:30:00-04:00,32.48,32.595,32.3,32.3,1375983,1495506,48.20912251194508,52.4337862994392,NaN,NaN,-31.85009763597672,-60.19665400411865,-0.026775056149874327,0.023221168465731523,0.04999622461560585,50138093,51228538.8,35.96882126420644,52.164710727413365,NaN,NaN,2.4409219716512673,5.846931532862323
2017-08-18T09:30:00-04:00,32.23,32.23,31.97,32.06,1276949,1499303.65,43.13119590254725,51.34297212259576,NaN,NaN,-173.56137100700334,-49.16628308066801,-0.04446177477690407,-0.005580993855524241,0.03888078092137983,48861144,50718454.4,33.8120548113924,49.5549022908696,NaN,NaN,-0.3436521470705104,4.962562435729061
2017-08-21T09:30:00-04:00,32.1,32.46,32.02,32.39,1094517,1499453.5,50.80430961412519,50.57346762245964,NaN,NaN,-69.1101173884447,-54.517839147558824,-0.03251134725838229,-0.0017584031515980314,0.03075294410678426,49955661,50187885.6,31.68391524427342,46.92844684113287,NaN,NaN,-0.030209811959480193,4.249309257487841
2017-08-22T09:30:00-04:00,32.45,32.52,32.24,32.37,1150211,1449825.4,50.36081228949555,50.149966227302556,NaN,NaN,-28.897377864542698,-50.86507627953252,-0.02487347425984355,-0.00033889871802017524,0.024534575541823374,48805450,49854884.8,30.391023618375,44.65312864257362,NaN,NaN,0.0638769142423896,3.6513903513099195
2017-08-23T09:30:00-04:00,32.34,32.75,32.31,32.7,973953,1403333.3,57.02669720388055,50.38028792354096,NaN,NaN,72.35056309556978,-46.213680160079534,0.0020538572054688183,0.027101897048659396,0.025048039843190577,49779403,49507950.2,29.06052696680237,42.60183403835688,NaN,NaN,2.452630614177119,3.480138960290948
2017-08-24T09:30:00-04:00,32.75,32.93,32.63,32.64,1595108,1374855.95,55.56565888115481,50.32096143858801,NaN,NaN,131.84813780790012,-13.474033071304172,0.014766302283215817,0.04350591769721035,0.028739615413994533,48184295,49117190.6,27.595154545353097,40.526168966858975,NaN,NaN,3.852932954626186,3.533395245195982
2017-08-25T09:30:00-04:00,32.76,32.91,32.65,32.8,1063585,1325025.35,58.610907192989664,50.52728875129338,NaN,NaN,145.74982347508714,50.38820582511393,0.03190895523412302,0.06862580945664831,0.03671685422252529,49247880,49194537.8,28.365150607856734,38.52922636771429,NaN,NaN,5.999089988731852,3.885637351415392
2017-08-28T09:30:00-04:00,32.84,32.86,32.54,32.63,895262,1293460.1,54.34895306476917,50.7795238170763,NaN,NaN,90.68757246939973,82.3477437966828,0.029797174434634546,0.07396332226581848,0.04416614783118393,48352618,48873929.2,27.07963053455245,36.7407856153632,NaN,NaN,6.43775331532739,4.250225346259963
2017-08-29T09:30:00-04:00,32.6,32.75,32.59,32.61,2577301,1304099.65,53.852812796532604,50.90970929142885,NaN,NaN,80.68267001375696,104.26375337234276,0.025232526404596778,0.0757068058369299,0.050474279432333125,45775317,48267902.6,24.792382636193523,34.85831232314035,NaN,NaN,6.637407012886322,4.591251298635157
2017-08-30T09:30:00-04:00,32.58,32.77,32.45,32.76,963550,1266650.3,57.02171150879783,51.8661551178841,NaN,NaN,80.10739070967483,105.81511889516375,0.030161247924152382,0.0881758393375236,0.058014591413371216,46738867,47659795.4,22.71876637409565,32.92426865934884,NaN,NaN,7.761053276619958,5.0440801526329855
2017-08-31T09:30:00-04:00,32.87,33.04,32.8,32.92,1816228,1302396.15,60.16404157423377,53.395505612311034,NaN,NaN,157.73559953712908,110.99261124100956,0.041351290887039094,0.10970370502217008,0.06835241413513099,48555095,47733955.4,23.558446525766982,31.337655026026237,NaN,NaN,9.675192233717414,5.705667592787904
2017-09-01T09:30:00-04:00,32.96,33.05,32.88,32.92,1656231,1338228,60.16404157423377,53.90525871426304,NaN,NaN,146.63069103197256,111.16878475238664,0.04557413411861515,0.12532008178339993,0.07974594766478478,48555095,47595398.4,23.05443807713847,29.8414253189252,NaN,NaN,11.214370486693795,6.492625149060174
2017-09-05T09:30:00-04:00,32.94,33.03,32.69,32.89,2346245,1416445.45,59.222456126906785,54.45240542920082,NaN,NaN,106.7156547100386,114.37440120051443,0.04319030053068079,0.13373382332813577,0.09054352279745498,46208850,47166644.8,21.520171293962647,28.435109678477016,NaN,NaN,12.234896049232905,7.312949563370564
2017-09-06T09:30:00-04:00,32.99,33.1,32.895,32.94,2529289,1489377.25,60.33661205587358,54.9156665926776,NaN,NaN,122.34144688540158,122.70615657484333,0.04179746807466703,0.14279035789078875,0.10099288981612173,48738139,47759209.2,28.593095561942263,27.728112718707937,NaN,NaN,13.398632333424057,8.182332816235348
2017-09-07T09:30:00-04:00,32.99,33.255,32.94,33.19,1652728,1515293.95,65.4235863696655,56.14527115394335,NaN,NaN,142.96855053760305,135.27838854042898,0.05376705838718092,0.16820171280009788,0.11443465441291696,50390867,48489609.2,36.22293474055887,27.746263681304544,NaN,NaN,15.95276605047406,9.292394706840879
2017-09-08T09:30:00-04:00,33.15,33.315,33.08,33.2,1102131,1499798.85,65.61356361319731,57.75115456184693,NaN,NaN,143.82035127356949,132.49533888771705,0.05804570539660356,0.1869917861586714,0.12894608076206784,51492998,49077189.8,41.62652138463929,28.304439865107888,NaN,NaN,18.100974517600108,10.550763251235054
2017-09-11T09:30:00-04:00,33.23,33.46,33.23,33.44,1267457,1485767,69.88953701884432,59.11438509075544,NaN,NaN,169.81623197458214,137.13244707623898,0.07182528916964254,0.21872769222412103,0.1469024030544785,52760455,49918261.8,48.36980964214311,29.49628946495572,NaN,NaN,21.344111590283603,12.092670156813417
2017-09-12T09:30:00-04:00,33.41,33.44,32.9447,33.08,1335606,1492700.35,58.19889176409688,59.67424791036982,NaN,NaN,102.0037384803047,136.1900638302922,0.05238322483793714,0.2123814341018999,0.15999820926396277,51424849,50961461.6,55.271555300175656,31.27347029937005,NaN,NaN,20.61720765800885,13.310461228412764
2017-09-13T09:30:00-04:00,33.06,33.06,32.82,32.94,1286694,1450132.5,54.38871326934514,59.48582048647443,NaN,NaN,43.943386772486555,120.51045180770919,0.02705815429766123,0.1938209021360393,0.16676274783837808,50138155,51241464.8,56.93555875645006,33.2645439986306,NaN,NaN,18.78835169506961,14.093017009363743
2017-09-14T09:30:00-04:00,32.89,33.18,32.76,33.17,1492508,1472576.8,59.123386383261796,59.739943879482084,NaN,NaN,61.98044547149148,104.31283079448687,0.022924176089621634,0.1954179679504051,0.17249379186078348,51630663,51489424,58.41109482439836,35.465682589990976,NaN,NaN,18.74912056955251,14.75817466081928
2017-09-15T09:30:00-04:00,32.87,33.05,32.79,33.05,3210556,1564305.45,55.86504969215159,59.54381120085078,NaN,NaN,38.45421159550024,83.23960285887301,0.009900642813918309,0.18486959537818137,0.17496895256426306,48420107,50874845.8,53.51666957634783,37.26221965916891,NaN,NaN,17.672498350908775,15.174506616546351
2017-09-18T09:30:00-04:00,33,33.105,32.78,32.86,1012304,1551073.2,51.06630008902543,59.30933598829766,NaN,NaN,17.455972921262752,52.767551048209135,-0.012501778259120966,0.15934172974036187,0.17184350799948284,47407803,49804315.4,46.2472634889918,38.63133629877172,NaN,NaN,15.206236331131917,15.179039432915717
2017-09-19T09:30:00-04:00,32.86,32.89,32.44,32.53,1990963,1595895.5,43.99728652671011,58.60536982616748,NaN,NaN,-88.69872987752238,14.627057376643709,-0.048514311426350376,0.11120061871654485,0.15971493014289523,45416840,48602713.6,39.72472049112396,39.697931859838185,NaN,NaN,10.594732416391043,14.52413843055505
2017-09-20T09:30:00-04:00,32.58,32.65,32.29,32.44,1283776,1602573.75,42.27836572966827,57.552273699086804,NaN,NaN,-149.1125436099666,-23.984128699846913,-0.07574274944060871,0.06503649334213435,0.14077924278274306,44133064,47401695.4,34.48890829932937,40.53865628306916,NaN,NaN,6.3515639852311,13.356627795508771
2017-09-21T09:30:00-04:00,32.42,32.6,32.38,32.39,2548103,1681281.25,41.312702364355445,56.20574946980978,NaN,NaN,-142.56371079131864,-64.89295995240893,-0.09331278747574853,0.02413825843805739,0.11745104591380592,41584961,45392555,27.870995106165324,40.84669546738333,NaN,NaN,2.6578704848533894,11.828233893986575
2017-09-22T09:30:00-04:00,32.36,32.46,32.0757,32.11,1542277,1678639.7,36.310993525157436,54.50196032344718,NaN,NaN,-186.81739476253045,-109.94728122401507,-0.11837346105153504,-0.03051578040061287,0.08785768065092217,40042684,43717070.4,23.7740541631118,40.898096616381416,NaN,NaN,-2.243536091784387,9.817981038876438
2017-09-25T09:30:00-04:00,32.12,32.32,32.1,32.23,1180631,1684492,39.68148579931834,53.10617672861944,NaN,NaN,-154.56214004646563,-144.35090381756075,-0.12101853535754278,-0.06341548854600632,0.05760304681153647,41223315,42480172.8,21.286413163894167,40.88139960709081,NaN,NaN,-5.213001536087422,7.670697813881601
2017-09-26T09:30:00-04:00,32.27,32.35,32.2,32.26,1360464,1707752.1,40.52883033686525,51.6913351772617,NaN,NaN,-124.0276999521032,-151.41669783247693,-0.1149430511596451,-0.0860757671380199,0.028867284021625195,42583779,41913560.6,20.24153704442618,40.28485971298252,NaN,NaN,-7.342369680304498,5.525973886140729
2017-09-27T09:30:00-04:00,32.15,32.22,31.88,31.99,1612366,1659505.35,35.67189055873936,49.56621404790984,NaN,NaN,-153.01087998430978,-152.19636510734554,-0.12260349743883366,-0.12438708777691687,-0.0017835903380832192,40971413,41281230.4,19.113936832672678,39.06278843384779,NaN,NaN,-10.771682323911296,3.1977372847047256
2017-09-28T09:30:00-04:00,31.96,32.24,31.94,32.22,1318878,1677271.75,42.04350538055867,47.88263845986422,NaN,NaN,-114.84115282894007,-146.65185351486986,-0.10628351549998648,-0.13463798471306632,-0.02835446921307984,42290291,41422296.4,20.18219094835888,37.531050545542044,NaN,NaN,-11.69269077179208,1.0705332766337534
2017-09-29T09:30:00-04:00,32.17,32.27,32.0701,32.24,2488525,1710886.6,42.57613825064681,45.931681404992965,NaN,NaN,-90.94966658303152,-127.47830787897006,-0.08894805392384154,-0.13953953661788177,-0.05059148269404022,44778816,42369522.8,27.140492311552222,36.014670736214136,NaN,NaN,-12.263101822824735,-0.834271737574602
2017-10-02T09:30:00-04:00,32.28,32.3411,32.11,32.12,1814819,1718816,40.1895633151361,44.645300801495765,NaN,NaN,-81.78968155305898,-112.92381618028871,-0.0806166052526904,-0.15136223925990322,-0.07074563400721282,42963997,42717659.2,29.570666121451296,34.17889293773382,NaN,NaN,-13.451982491815553,-2.6368018453233093
2017-10-03T09:30:00-04:00,32.12,32.1958,32.041,32.11,2533730,1728190.25,39.98840115740445,43.61670707921429,NaN,NaN,-85.14529062266077,-105.14733431440023,-0.07116176116971695,-0.159697835469359,-0.08853607429964205,40430267,42286956.8,28.31248924489904,32.13438797262303,NaN,NaN,-14.472719931406072,-4.327647286192276
2017-10-04T09:30:00-04:00,32.12,32.4068,32.05,32.39,1743145,1688883.05,47.85817009450823,42.812048772874746,NaN,NaN,-52.36068685187216,-85.01729568791272,-0.042829118601239724,-0.1420724725511917,-0.09924335394995198,42173412,42527356.6,30.100203071675153,30.11218141885709,NaN,NaN,-13.021688786099695,-5.5696532147504785
2017-10-05T09:30:00-04:00,32.43,32.61,32.43,32.49,1766812,1694587.25,50.361796322470184,42.41895924646894,NaN,NaN,-9.732307397967377,-63.9955266017182,-0.015539044869131755,-0.11866716003636668,-0.10312811516723493,43940224,42857343.2,32.58536985837377,28.617088581858944,NaN,NaN,-11.056879470937332,-6.353542679920029
2017-10-06T09:30:00-04:00,32.34,32.435,32.09,32.4,1274589,1703210.15,48.12226827066928,42.2086712594435,NaN,NaN,-41.75023174062376,-54.15563963323664,-0.002422963344374404,-0.10615681934770294,-0.10373385600332853,42665635,42434707,31.062137903419483,27.532436754318063,NaN,NaN,-10.054362909519261,-6.8822312841484905
2017-10-09T09:30:00-04:00,32.44,32.54,32.35,32.47,1148025,1697238.55,49.98518802848203,42.636378509570065,NaN,NaN,-4.697348780511412,-38.737173078727125,0.01133791642825896,-0.08956146046800484,-0.1008993768962638,43813660,42604639.6,32.42984467498148,27.011374196022167,NaN,NaN,-8.680150634357986,-7.13907690560699
2017-10-10T09:30:00-04:00,32.54,32.73,32.4622,32.52,987288,1679822.65,51.329607115189894,43.282895751393035,NaN,NaN,33.98360571451907,-14.911393811291159,0.023479380513065154,-0.07155015125493236,-0.09502953176799751,44800948,43478775.8,39.1208427501638,27.342226656796054,NaN,NaN,-7.153496647685664,-7.141136868761086
2017-10-11T09:30:00-04:00,32.56,32.75,32.52,32.7,1176430,1674309.45,55.923015780302975,44.32648956681786,NaN,NaN,64.51235151747026,8.463213862577325,0.042212132646613,-0.042264365959731265,-0.08447649860634426,45977378,44239569,44.29132461992958,28.51510733635065,NaN,NaN,-4.455906518063852,-6.757532532947195
2017-10-12T09:30:00-04:00,32.73,32.95,32.68,32.93,2136270,1706497.55,60.98934584895452,46.08922901851765,NaN,NaN,128.0732007568652,36.02431549354384,0.06718884781534062,-0.0004904388371684831,-0.06767928665250911,48113648,45074253.8,49.371705272241,30.34351098700273,NaN,NaN,-0.47250080614223067,-5.859670857689343
2017-10-13T09:30:00-04:00,33.07,33.117,32.9,33.02,1857897,1638864.6,62.79162345573092,47.739953136832845,NaN,NaN,172.54106662175343,78.88257516601928,0.08568222745809298,0.03942349767010711,-0.04625872978798586,49971545,46535435.8,56.79904458828401,32.88012751731629,NaN,NaN,3.4002783955873093,-4.536820964364107
2017-10-16T09:30:00-04:00,32.99,33.08,32.835,32.86,1423895,1659444.15,57.688998919197516,48.96567946414228,NaN,NaN,146.49698900065027,109.12144272225162,0.08299282139398613,0.0574822969544968,-0.025510524439489327,48547650,47482233.8,60.8108805943622,35.77793777088315,NaN,NaN,5.2352555551877495,-3.1408100329995565
2017-10-17T09:30:00-04:00,32.81,32.89,32.75,32.86,1767649,1648278.45,57.688998919197516,50.538330061317865,NaN,NaN,111.38623880742095,124.60196934083199,0.07718910752063232,0.07097585996130107,-0.006213247559331246,48547650,48231574.2,63.68523035374799,38.96160159381709,NaN,NaN,6.7148345450932805,-1.7328608075577228
2017-10-18T09:30:00-04:00,32.83,32.91,32.74,32.8,1294122,1648795.75,55.71974527351416,51.515204339386116,NaN,NaN,94.68461623383061,130.63642228410407,0.06573265669918642,0.07595257331465177,0.010219916615465358,47253528,48486804.2,64.63663431743872,42.13691897732279,NaN,NaN,7.41885948145635,-0.42547219484142684
2017-10-19T09:30:00-04:00,32.79,32.86,32.655,32.78,1472863,1595033.75,55.04523002043326,52.40585375151371,NaN,NaN,72.50133106467675,119.52204834566638,0.053736634485076824,0.07739070972181139,0.023654075236734566,45780665,48020207.6,61.46624304089716,44.58875831513315,NaN,NaN,7.8261752708555745,0.7533345859724303
2017-10-20T09:30:00-04:00,32.79,32.83,32.615,32.73,1253200,1580579.9,53.30783570878492,53.342873208202924,NaN,NaN,56.48506693292953,96.3108484079016,0.03999426410790657,0.07364690537161778,0.03365264126371121,44527465,46931391.6,54.72116370427004,46.38522242819163,NaN,NaN,7.717433908001511,1.7482059176908704
2017-10-23T09:30:00-04:00,32.8,32.8,32.57,32.61,1095712,1576333.95,49.28707973042557,54.00706453484729,NaN,NaN,36.20433818502487,74.25231824477652,0.021319322812726187,0.060301794779618945,0.03898247196689276,43431753,45908212.2,49.25159966964605,47.880873172816415,NaN,NaN,6.528827081569363,2.4311517982449407
2017-10-24T09:30:00-04:00,32.56,32.64,32.29,32.4,1940746,1605348.05,43.15298794890974,53.67098009587597,NaN,NaN,-20.825793999559995,47.80991168338033,-0.005260467885247352,0.03240688711033357,0.03766735499558092,41491007,44496883.6,42.884281358972366,48.794021621909074,NaN,NaN,3.633574038863716,2.602926404047623
2017-10-25T09:30:00-04:00,32.31,32.405,32.13,32.32,1912262,1620342.85,41.05667400589034,53.00632850183455,NaN,NaN,-68.43243096252273,15.186502244109684,-0.027093222530405546,0.003800826832573989,0.030894049362979535,39578745,42961927,37.24462696127471,49.12682570068771,NaN,NaN,0.5640327003215327,2.311655874943896
2017-10-26T09:30:00-04:00,32.44,32.44,32.03,32.14,1646422,1636720.05,36.73285650815972,52.19279909022673,NaN,NaN,-92.91878744408699,-17.897521457643062,-0.051126133314836925,-0.03301361728056662,0.018112516034270304,37932323,41392258.6,32.53296145698306,49.23188452594225,NaN,NaN,-3.4967692737663127,1.4818808536995807
2017-10-27T09:30:00-04:00,32.08,32.31,31.865,32.19,2042501,1614418.85,38.66514995405117,51.38422494205309,NaN,NaN,-112.78625392187773,-51.75178562860452,-0.060483624969804216,-0.05749201517798497,0.0029916097918192483,39974824,40481730.4,30.150247683244146,49.06905616938958,NaN,NaN,-6.306985370413348,0.36918567882630526
2017-10-30T09:30:00-04:00,32.2,32.57,32.1756,32.39,1738784,1610617.1,45.79642896608839,50.988997931402984,NaN,NaN,-47.33286219082228,-68.45922570377395,-0.050441809060918365,-0.06006065153432871,-0.009618842473410346,41713608,40138101.4,29.278719479199836,48.36604736432074,NaN,NaN,-6.67325032032038,-0.6368766067660783
2017-10-31T09:30:00-04:00,32.37,32.5,32.17,32.5,2091643,1588512.75,49.288732318268906,50.515120541257694,NaN,NaN,-50.9329571490118,-74.48065833366431,-0.0343959142387216,-0.052613735271812345,-0.018217821033090748,43805251,40600950.2,32.12472778676873,47.49700473338068,NaN,NaN,-5.919631336642386,-1.3915558538912651
2017-11-01T09:30:00-04:00,32.55,32.6,32.415,32.47,2057707,1604240.85,48.373348015136514,49.61397783884212,NaN,NaN,-23.747300726645694,-65.54363228648891,-0.024284009081509007,-0.048572832384977005,-0.024288823303468,41747544,41034710,34.77385374952928,46.454301053186974,NaN,NaN,-5.5691348128460385,-1.9883528480276613
2017-11-02T09:30:00-04:00,32.55,32.9432,32.51,32.75,2972110,1664505.75,56.4945598572961,49.164187581811056,NaN,NaN,47.040177266213725,-37.55183934442876,0.0014173274890279496,-0.02251716394218306,-0.02393449143121101,44719654,42392176.2,42.35626824014186,45.42267417117682,NaN,NaN,-2.6444155064347954,-2.0820760849429663
2017-11-03T09:30:00-04:00,32.57,32.8,32.5,32.75,2023359,1701944.25,56.494559857296096,49.07887050596096,NaN,NaN,26.848603409149106,-9.624867878223387,0.017670334874490875,-0.0018465728380974156,-0.01951690771258829,44719654,43341142.2,46.9950951896333,44.43583235655333,NaN,NaN,-0.32815413136390653,-1.8315158058602434
2017-11-06T09:30:00-05:00,32.94,33.385,32.91,33.25,2303733,1759729.65,67.18509357086081,49.757162981079766,NaN,NaN,164.67726338691588,32.77715723732425,0.059017860708658,0.054255418173234204,-0.004762442535423791,47023387,44403098,51.681206856939376,43.57840210678129,NaN,NaN,5.858124185569281,-0.732995807084597
2017-11-07T09:30:00-05:00,33.3,33.61,33.3,33.56,2246699,1822700.2,71.81022248206321,50.90648278169041,NaN,NaN,214.37751601218957,85.83925186956454,0.10166676914908591,0.12232101890093361,0.02065424975184769,49270086,45496065,55.993413358487324,42.9610291811419,NaN,NaN,12.901349798909381,1.2147678509145428
2017-11-08T09:30:00-05:00,33.57,33.88,33.46,33.81,2190783,1873417.85,74.8845910037223,52.32357999478249,NaN,NaN,219.98570783586374,134.58585358206642,0.13883485377970317,0.19419781697647664,0.05536296319677349,51460869,47438730,62.414131572569964,43.02873550483282,NaN,NaN,19.8323089731659,3.874416582664736
2017-11-09T09:30:00-05:00,33.7,33.97,33.33,33.81,1663345,1849771.6,74.8845910037223,53.86477680156373,NaN,NaN,178.58930752291874,160.8956796334074,0.15434840314426104,0.2482984671270998,0.09395006398283876,51460869,48786973,66.10981534818907,43.84221062225561,NaN,NaN,25.010632678841603,6.893876024975716
2017-11-10T09:30:00-05:00,33.69,33.91,33.6135,33.81,1760841,1844918.8,74.8845910037223,55.69317046394207,NaN,NaN,163.79806302521794,188.2855715566212,0.155124272197258,0.28785540422941125,0.13273113203215325,51460869,50135216,69.354831827049,45.278155776355824,NaN,NaN,29.016717440180656,10.054281941433565
2017-11-13T09:30:00-05:00,33.9,34.0238,33.81,33.91,1510302,1849239.15,76.18230233285888,58.05240720565272,NaN,NaN,152.36167017907033,185.82245291505208,0.1526503831964779,0.3235441110277506,0.1708937278312727,52971171,51324772.8,71.91041482561674,47.35145102397327,NaN,NaN,32.738337917012736,13.294861366516304
2017-11-14T09:30:00-05:00,33.89,33.95,33.76,33.88,2061986,1863956,74.93144469357622,60.47203368334457,NaN,NaN,120.67981337696868,167.08291238800788,0.13962507675760016,0.3454250737782729,0.20579999702067275,50909185,51652592.6,72.58882189241471,49.876036376197554,NaN,NaN,35.390345270587545,16.45135906709791
2017-11-15T09:30:00-05:00,33.86,33.89,33.6,33.63,1761192,1887309.5,65.30813406187235,62.51312493718119,NaN,NaN,87.74008111125185,140.63378704308553,0.10631103453719976,0.33868879019217246,0.2323777556549727,49147993,51190017.4,70.0190584202866,52.55361473071924,NaN,NaN,34.798565352502,19.072388536441352
2017-11-16T09:30:00-05:00,33.61,33.85,33.61,33.76,2092076,1918270.15,67.63576325299397,64.58245445853424,NaN,NaN,81.06289914778624,121.12850536805902,0.08603519082760741,0.33992174418948196,0.25388655336187455,51240069,51145857.4,69.76514054234367,55.383249934940636,NaN,NaN,35.008266667367124,21.348942555145033
2017-11-17T09:30:00-05:00,33.62,33.8,33.55,33.56,1758579,1943539.1,60.869383538592714,65.65909407085597,NaN,NaN,62.73135450864515,100.91516366474448,0.05373840992135015,0.3210595657635622,0.26732115584221205,49481490,50749981.6,67.40528438591922,58.10657599970631,NaN,NaN,33.03051511629886,23.017738635309865
2017-11-20T09:30:00-05:00,33.59,33.63,33.44,33.48,1566959,1967101.45,58.35460481402473,66.3066563919814,NaN,NaN,45.21072361356233,79.48497435164288,0.023135828039226314,0.296240940891245,0.27310511285201866,47914531,49738653.6,61.6665699845056,60.21670758525894,NaN,NaN,30.630044888921294,24.105210957254354
2017-11-21T09:30:00-05:00,33.58,33.695,33.5171,33.66,1228903,1931509.3,62.14426094891988,67.29029303010878,NaN,NaN,51.99310176019334,65.74763202828781,0.011739236554572485,0.2877791585452343,0.2760399219906618,49143434,49385503.4,59.75347752364796,62.00096642626742,NaN,NaN,29.724410944678066,24.9079538126006
2017-11-22T09:30:00-05:00,33.64,33.67,33.49,33.55,881058,1879949.1,58.63287268411441,67.4430296605958,NaN,NaN,41.44796826100454,56.489209458238335,-0.005555862675057699,0.2690950936468397,0.2746509563218974,48262376,49208380,58.76871050261719,63.17328373072994,NaN,NaN,27.881912923881035,25.33280511421209
2017-11-24T09:30:00-05:00,33.59,33.72,33.59,33.67,407307,1817993.35,61.207969615762835,67.77970178620056,NaN,NaN,47.85311646077087,49.84725292083527,-0.010950668992795343,0.2609626200809032,0.27191328907369855,48669683,48694302.8,55.88972568474199,63.80861448038056,NaN,NaN,27.107853442728935,25.586383446857354
2017-11-27T09:30:00-05:00,33.7,33.73,33.57,33.57,652396,1748488.1,57.96949022920803,67.12144440465394,NaN,NaN,38.699484424918076,45.04087890408985,-0.022618724848840588,0.24363988301264783,0.2662586078614884,48017287,48401462.2,54.259103103082055,63.99274992653361,NaN,NaN,25.48148385678324,25.57139779113248
2017-11-28T09:30:00-05:00,33.6,33.63,33.32,33.49,1720888,1747593.3,55.44223800790168,65.95230265649954,NaN,NaN,9.997452897665763,37.99822476091054,-0.0362791672883479,0.22090964875105357,0.25718881603940147,46296399,48077835.8,52.43828204673119,63.738811975693885,NaN,NaN,23.374639716335246,25.25757520901859
2017-11-29T09:30:00-05:00,33.48,33.5068,33.21,33.41,2106852,1748353.75,52.9559657635324,64.38597228220026,NaN,NaN,-22.745894973325864,23.050425414206707,-0.05038960851317062,0.1942018053979382,0.2445914139111088,44189547,47087058.4,47.21448012068996,62.65312258627389,NaN,NaN,20.87631859167442,24.631681406540853
2017-11-30T09:30:00-05:00,33.49,33.55,33.33,33.45,2192453,1755091.05,54.06515306793157,62.89886957250093,NaN,NaN,-23.108664134917067,10.139098935022384,-0.056269439844606306,0.17425461410535092,0.23052405394995723,46382000,46710983.2,45.36707430801422,61.1714982262614,NaN,NaN,19.1052215726037,23.842187144549833
2017-12-01T09:30:00-05:00,33.51,33.64,33.23,33.51,3029379,1757954.5,55.750482535041954,61.532147539023754,NaN,NaN,-35.70849398889554,-6.573223154910925,-0.05527765116202721,0.16142698999742322,0.21670464115945043,49411379,46859322.4,46.260273792887396,59.521886938107,NaN,NaN,18.060172793984343,23.016185094469048
2017-12-04T09:30:00-05:00,33.56,33.68,33.07,33.07,1627522,1738162.65,43.225689017315986,59.178103730770694,NaN,NaN,-139.77921177539113,-42.26896239497277,-0.08181369834197588,0.11443751823198056,0.19625121657395644,47783857,46812636.4,46.00534568625265,57.671524856723856,NaN,NaN,12.907637439094936,21.57210685798703
2017-12-05T09:30:00-05:00,33.11,33.14,32.93,32.94,1918243,1718888.15,40.3419609276037,56.70742631891551,NaN,NaN,-240.1103488935786,-92.29052275322164,-0.10424265054463233,0.06594790339316603,0.17019055393779836,45865614,46726479.4,45.5069482270927,55.73710530920085,NaN,NaN,7.694410496956351,19.589578806411218
2017-12-06T09:30:00-05:00,32.96,33.06,32.84,32.99,1815237,1697315.05,41.9461470934618,55.038712964029045,NaN,NaN,-206.19418861799693,-128.98018148215584,-0.11119682287273758,0.03119452534687639,0.14239134821961397,47680851,47424740.2,50.21437191505839,54.32248484454169,NaN,NaN,3.980679586395696,17.359736060694715
2017-12-07T09:30:00-05:00,33.03,33.16,32.9,33.12,1290434,1652297.6,46.0110371914407,53.4940896739181,NaN,NaN,-145.79696495476955,-153.51784164612633,-0.10272830060956366,0.01398097245765939,0.11670927306722305,48971285,47942597.2,53.42764218829685,53.1555206763955,NaN,NaN,2.0691928056946893,15.175372738551854
2017-12-08T09:30:00-05:00,33.18,33.26,33.11,33.2,1444011,1641330.9,48.40520701308941,52.60379135066786,NaN,NaN,-92.2365163833647,-164.82344612502018,-0.08799381070842913,0.006717009681686648,0.09471082039011577,50415296,48143380.6,54.64979402880617,52.24441422231599,NaN,NaN,1.198328283675162,13.178652102140898
2017-12-11T09:30:00-05:00,33.19,33.28,33.075,33.28,1670704,1636824.05,50.75689696416724,52.06109793282091,NaN,NaN,-76.60622905101444,-152.18884958014485,-0.06990378429806857,0.007331090017530073,0.07723487431559864,52086000,49003809.2,59.548720495450205,52.09313925881203,NaN,NaN,1.1615253519704594,11.461919709259407
2017-12-12T09:30:00-05:00,33.39,33.529,33.17,33.43,1017903,1612204.1,54.90709096239885,51.54415721949798,NaN,NaN,-20.26723435877703,-108.22022667318451,-0.04603232035632224,0.01969447387019585,0.06572679422651809,53103903,50451467,66.1702230591263,52.55147822563191,NaN,NaN,2.3790370780647865,10.164365047660176
2017-12-13T09:30:00-05:00,33.48,33.67,33.4,33.42,1735283,1595868.95,54.57685458408083,51.25444164092415,NaN,NaN,26.557415561232865,-61.66990583733856,-0.02989445420185819,0.02835872647419535,0.05825318067605354,51368620,51189020.8,68.95816749017371,53.279296581885944,NaN,NaN,3.273806545437822,9.179999547342698
2017-12-14T09:30:00-05:00,33.45,33.57,33.4,33.45,981407,1556879.7,55.4426626870751,50.84263400316074,NaN,NaN,23.641750239027186,-27.7821627985792,-0.016828988865301556,0.03721694459442659,0.05404593345972815,52350027,51864769.2,71.29246837884047,54.37949248860726,NaN,NaN,4.259024497010223,8.477003111580915
2017-12-15T09:30:00-05:00,33.2,33.27,33.0586,33.19,1770333,1540792.55,47.06898809373714,50.06402670776995,NaN,NaN,-76.98498392736803,-24.731856307379868,-0.024842923959052556,0.022992278510912456,0.04783520246996501,50579694,51897648.8,71.40514235117836,55.604209577757,NaN,NaN,2.6879169372999776,7.649990800969353
2017-12-18T09:30:00-05:00,33.25,33.455,33.25,33.3,1096416,1507684.4,50.476866841269015,49.709357338724764,NaN,NaN,-11.840399325831411,-11.77869036234327,-0.021979757485214906,0.020360505613446378,0.042340263098661284,51676110,51815670.8,70.66047929323292,56.90579509536427,NaN,NaN,2.3737238989521594,6.896238386395468
2017-12-19T09:30:00-05:00,33.3,33.31,32.61,32.67,1713000,1514986.45,36.12958905580845,48.50747328817305,NaN,NaN,-162.63352387553223,-40.25194826569433,-0.05962410130271886,-0.032189863529737295,0.027434237772981568,49963110,51187512.2,65.06147382282626,58.18058035980258,NaN,NaN,-3.311484116670122,5.437992314528955
2017-12-20T09:30:00-05:00,32.67,32.7275,32.31,32.32,1431017,1525092.15,30.878540230803864,46.85128665694965,NaN,NaN,-240.53503077194657,-93.67043753233023,-0.10267954784617525,-0.1009151970347375,0.0017643508114377517,48532093,50620206.8,60.40617125067077,59.25480156999233,NaN,NaN,-10.153761024235136,3.2105989804197996
2017-12-21T09:30:00-05:00,32.4,32.42,32.15,32.21,1218517,1541965.1,29.430787979935616,44.97130847444205,NaN,NaN,-233.88095478755469,-145.17497853764658,-0.13131926431850294,-0.16238472958669092,-0.031065465268187983,47313576,49612916.6,53.136138297565225,59.74593474889789,NaN,NaN,-15.906029662197266,0.4796520314745045
2017-12-22T09:30:00-05:00,32.26,32.46,32.2,32.42,1012801,1572239.8,35.63515536217734,44.429127499075,NaN,NaN,-171.67232647677397,-164.11244704752778,-0.12870118361079533,-0.19194194478168214,-0.06324076117088681,48326377,49162253.2,50.223767160226004,60.04725056846742,NaN,NaN,-18.33305830267967,-2.207878016261806
2017-12-26T09:30:00-05:00,32.44,32.65,32.38,32.59,811599,1580199.95,40.21733213846092,44.42022544270766,NaN,NaN,-113.99581935695403,-184.5435310537523,-0.10888793583335563,-0.19935068096258135,-0.09046274512922572,49137976,48654626.4,47.092734648958285,60.160521027172095,NaN,NaN,-18.66971517780278,-4.559569039339088
2017-12-27T09:30:00-05:00,32.67,32.7799,32.62,32.72,4420166,1715163.85,43.528142472394705,44.53322511263144,NaN,NaN,-70.4427973298831,-166.10538574462248,-0.08164026257186145,-0.19251307334405254,-0.11087281077219109,53558142,49373632.8,51.68699149901037,60.265708140311524,NaN,NaN,-17.81363212858487,-6.453006623517057
2017-12-28T09:30:00-05:00,32.75,32.92,32.66,32.91,1133100,1666476.25,48.05596719324969,44.679291541332084,NaN,NaN,-39.91676418180209,-125.9817324265936,-0.047146069001139906,-0.16980539702361597,-0.12265932802247606,54691242,50605462.6,58.35856503601044,60.617916915148214,NaN,NaN,-15.576117878020257,-7.756308231303228
2017-12-29T09:30:00-05:00,32.96,33.04,32.87,32.94,925551,1603131.15,48.75462504690813,44.70424997231914,NaN,NaN,-10.641750105611923,-81.33389149020503,-0.020021510297859868,-0.1476862158948009,-0.12766470559694104,55616793,52266106,65.31272584139214,61.379554901761495,NaN,NaN,-13.599903141878885,-8.591107504242608
2018-01-02T09:30:00-05:00,32.99,33.04,32.71,32.75,1744314,1538877.9,44.65783614186831,44.26860277072636,NaN,NaN,-30.68536359585303,-53.13649891402084,-0.012932263112356457,-0.14383003448738663,-0.13089777137503017,53872479,53375326.4,69.03276582756757,62.056986711198455,NaN,NaN,-13.202331319697386,-9.24985376359329
2018-01-03T09:30:00-05:00,32.79,32.84,32.66,32.76,1715118,1543257.7,44.92016825237569,43.55525114858185,NaN,NaN,-43.65040259236982,-39.067415561104,-0.005979383082503231,-0.1383720002281592,-0.13239261714565598,55587597,54665250.6,72.6994972903363,62.523363441999166,NaN,NaN,-12.808234327304744,-9.758193844123497
2018-01-04T09:30:00-05:00,32.75,32.75,32.2,32.2,1824077,1538549.4,34.93368769014036,42.15216779901466,NaN,NaN,-112.53882029008084,-47.486620153143534,-0.035838896956714994,-0.1771912383415497,-0.1413523413848347,53763520,54706326.2,72.8099030807543,62.79848741275492,NaN,NaN,-15.858951298266968,-10.62973062328685
2018-01-05T09:30:00-05:00,32.27,32.325,32.18,32.27,1400207,1517797.9,36.82435649011484,40.822288784946075,NaN,NaN,-121.41367232083739,-63.7860017809506,-0.04691960879686391,-0.2000018523809146,-0.1530822435840507,55163727,54800823.2,73.0796279882091,62.92614167056697,NaN,NaN,-17.63639808690721,-11.630683118089758
2018-01-08T09:30:00-05:00,32.31,32.53,32.28,32.49,990606,1502806.5,42.48125028853502,40.49459322743164,NaN,NaN,-78.82580265397796,-77.4228122906238,-0.03596967325128264,-0.198044335148154,-0.16207466189687136,56154333,54908331.2,73.40288817622442,63.0688378009274,NaN,NaN,-17.273000140779278,-12.436728407045404
2018-01-09T09:30:00-05:00,32.47,32.4899,32.1,32.12,1277214,1494466.65,36.55313421310508,39.500040896848496,NaN,NaN,-104.24968840172008,-92.1356772517972,-0.04935580793526437,-0.22376942181595183,-0.17441361388068746,54877119,55109259.2,74.03053950647981,63.3095563875879,NaN,NaN,-18.99778825237812,-13.374022670664363
2018-01-10T09:30:00-05:00,31.97,31.98,31.47,31.62,2174493,1519656.1,30.382900627348306,39.08956315195849,NaN,NaN,-176.94032852017736,-118.79366243735872,-0.08547740109780236,-0.2812603652529404,-0.19578296415513805,52702626,54532265,68.9953106078521,63.59054472937545,NaN,NaN,-22.823174525566735,-14.723901507078988
2018-01-11T09:30:00-05:00,31.7,31.74,31.3522,31.42,1343241,1535923,28.323377382541153,38.90705151993973,NaN,NaN,-180.4126873157699,-132.36843584249652,-0.11461546614128032,-0.33905229683173843,-0.2244368306904581,51359385,54051438,65.02615210832673,63.92054336206517,NaN,NaN,-26.57992747862713,-16.417619503014436
2018-01-12T09:30:00-05:00,31.39,31.43,31.1033,31.19,1657176,1532017.65,26.129785486984446,38.67126562758607,NaN,NaN,-196.44641322858902,-147.37498402404685,-0.13950222361808035,-0.39881461021305853,-0.2593123865949782,49702209,52959134.4,57.00347358133977,64.19678159662048,NaN,NaN,-30.380829652496455,-18.412363810083296
2018-01-16T09:30:00-05:00,31.38,31.85,31.27,31.34,5520298,1758962.2,29.940662444840953,38.26451613349061,NaN,NaN,-143.5007793491995,-160.30997936309114,-0.13585107288650955,-0.42912622770311515,-0.2932751548166056,55222507,52772769.2,55.7398911215439,64.59079045100033,NaN,NaN,-32.114887690633424,-20.369867221590457
2018-01-17T09:30:00-05:00,31.43,31.61,31.31,31.52,1713570,1756124.05,34.319491608206775,37.84324180990103,NaN,NaN,-126.40703457795709,-164.74144859833854,-0.1122801515261952,-0.4336253442243496,-0.3213451926981544,56936077,53184560.8,57.95751550225968,65.36684622623615,NaN,NaN,-32.07982862560842,-22.04271885073588
2018-01-18T09:30:00-05:00,31.47,31.48,31.17,31.22,2276624,1815134.45,30.85778571679802,36.938216327358404,NaN,NaN,-133.73851078033573,-156.10108505037024,-0.10783609994789095,-0.4561403176330181,-0.34830421768512715,54659453,53575926.2,60.00836727619975,65.96123021032109,NaN,NaN,-33.199731157822214,-23.636577751748213
2018-01-19T09:30:00-05:00,31.3,31.46,31.2,31.44,1640972,1811533.05,35.9592172506802,36.07416276003201,NaN,NaN,-104.58564127603411,-140.93567584242308,-0.08218239885712131,-0.4510322162565288,-0.3688498173994075,56300425,54564134.2,64.6918743875151,66.41360944971434,NaN,NaN,-32.43283319304763,-24.893185671933843
2018-01-22T09:30:00-05:00,31.46,31.75,31.43,31.74,2096095,1844786.95,42.2197520912332,35.60738612034094,NaN,NaN,-60.5479477818541,-113.7559827530761,-0.03928698633683625,-0.4179585503204528,-0.37867156398361657,58396520,56302996.4,71.10447416369703,66.8273057584504,NaN,NaN,-29.67974732819692,-25.57698019425714
2018-01-23T09:30:00-05:00,31.81,32.23,31.75,32.23,1873341,1877528.15,50.697545927485734,36.03879396217076,NaN,NaN,-4.224793132662834,-85.90078550976878,0.024381447588541938,-0.34819475449793913,-0.37257620208648107,60269861,57312467.2,74.05089717223149,67.18574371164068,NaN,NaN,-24.23420749821027,-25.3851555233933
2018-01-24T09:30:00-05:00,32.14,32.26,32.01,32.14,2990058,1976391,49.267675656268985,36.349330205305996,NaN,NaN,5.955986104525015,-59.428181373272366,0.06066258911170597,-0.2967479656968486,-0.35741055480855455,57279803,57381212.4,74.2435096780847,67.29603031076556,NaN,NaN,-20.47006853213699,-24.683000238928113
2018-01-25T09:30:00-05:00,32.12,32.14,31.865,32.07,2115890,2041605.55,48.130646481148396,37.29197011894943,NaN,NaN,-5.581009367761566,-33.79668109075753,0.0790140799117851,-0.25864295491882316,-0.33765703483060827,55163913,57482104.4,74.54217341379197,67.41976390598253,NaN,NaN,-17.843407946981923,-23.705915625792944
2018-01-26T09:30:00-05:00,32.08,32.1666,31.91,32.16,1472291,1894211.8,49.73680633781602,38.21428796521379,NaN,NaN,6.469245642338978,-11.585703707082905,0.09519633466135141,-0.21866161650391902,-0.31385795116527043,56636204,57549260.2,74.7520353433723,67.53922157420848,NaN,NaN,-15.220648277122534,-22.493734575982884
2018-01-29T09:30:00-05:00,32.07,32.11,31.76,31.79,2092851,1942199.35,43.740235758949005,38.30421549881479,NaN,NaN,-15.587892507635727,-2.5936926522392274,0.07959755668660679,-0.21436100530701196,-0.29395856199361875,54543353,56778626.8,67.84084909424493,67.14193306835281,NaN,NaN,-14.773531155614391,-21.390848373073098
2018-01-30T09:30:00-05:00,31.65,31.78,31.55,31.66,2347167,2013280.15,41.83188248293969,38.68126894666012,NaN,NaN,-43.47109975853154,-10.442953977412962,0.06003157720200181,-0.21891909049111646,-0.27895066769311827,52196186,55163891.8,56.130572324089776,65.86336398389638,NaN,NaN,-14.993730087293272,-20.47697433224741
2018-01-31T09:30:00-05:00,31.71,32.32,31.53,32.31,4213101,2136719.5,52.89751333741481,40.28945556880773,NaN,NaN,31.44414859896067,-5.345321478525837,0.08864566731450169,-0.16814358354999115,-0.25678925086449284,56409287,54989788.6,55.0276447673304,64.86567356671625,NaN,NaN,-11.396573334645964,-19.179774189732917
2018-02-01T09:30:00-05:00,32.21,32.4201,31.66,31.72,3937754,2247851.3,44.60319859204811,41.452299940915374,NaN,NaN,18.713574846287116,-0.48640463571610015,0.06662214922028489,-0.17351156433913673,-0.24013371355942162,52471533,54451312.6,51.6474576160904,63.910052531556516,NaN,NaN,-11.254976153539298,-18.0476601845624
2018-02-02T09:30:00-05:00,31.4,31.63,31.16,31.36,3719217,2342608.3,40.43683138382464,42.47423179068967,NaN,NaN,-85.76155299956442,-18.93256436409678,0.028540685849937242,-0.20445785624700008,-0.23299854209693732,48752316,52874535,43.26639143320109,62.92883237811804,NaN,NaN,-12.651936262782337,-17.276842481450963
2018-02-05T09:30:00-05:00,31.25,31.59,30.49,30.55,7652634,2655229.65,32.97362521253959,42.69087198838243,NaN,NaN,-169.09553677755014,-49.634093218079656,-0.04639229200306763,-0.29098890710077185,-0.24459661509770422,41099682,50185800.8,33.333188756119824,61.32835363773061,NaN,NaN,-16.82236244179493,-17.211916761500103
2018-02-06T09:30:00-05:00,30.29,30.66,29.82,30.49,6741167,2942757.7,32.49519523103319,42.56056510429861,NaN,NaN,-238.96076176275903,-88.73202561892516,-0.09252598940048079,-0.3602541018483052,-0.2677281124478244,34358515,46618266.6,25.099297239028928,58.98133804749983,NaN,NaN,-20.07363260977087,-17.62073331125307
2018-02-07T09:30:00-05:00,30.42,30.88,30.32,30.35,10201519,3388972.95,31.35210664918081,42.59587374232594,NaN,NaN,-175.66569518554783,-130.15399437582687,-0.12308497875269986,-0.42158433588869926,-0.2984993571359994,24156996,40167808.4,16.947656441551445,55.9055729878821,NaN,NaN,-22.993535435268246,-18.388276471826664
2018-02-08T09:30:00-05:00,30.28,30.57,29.38,29.4,10497583,3805127.45,24.94074340169817,41.80883989597009,NaN,NaN,-233.83330104542128,-180.66336955416855,-0.193691862244446,-0.5406141849415569,-0.3469223226971109,13659413,32405384.4,11.927442029515774,52.13668496231072,NaN,NaN,-28.133629730058303,-19.780469794431184
2018-02-09T09:30:00-05:00,29.55,30.32,29.17,30.09,9654492,4220690,35.291151958964235,41.313939886522306,NaN,NaN,-178.19622148905088,-199.15030325206584,-0.1805962288263715,-0.5726676087300753,-0.3920713799037038,23313905,27317702.2,9.864861536025032,47.76242691747701,NaN,NaN,-28.423063019341242,-21.015125969418335
2018-02-12T09:30:00-05:00,30.22,30.32,29.44,30.17,5294478,4402555.1,36.38644041784222,40.29171806440491,NaN,NaN,-136.66512577415946,-192.6642210513877,-0.15424113373214315,-0.5848727970688827,-0.4306316633367396,28608383,24819442.4,9.038339303235617,43.118672783977296,NaN,NaN,-28.24924954164334,-22.048572194021908
2018-02-13T09:30:00-05:00,30.09,30.48,29.99,30.39,3049307,4279005.55,39.42305442943926,39.58853083391707,NaN,NaN,-90.02071176475368,-162.87621105178664,-0.1116708228943144,-0.5702201919546326,-0.4585493690603182,31657690,24279277.4,8.865383711240568,38.44880664348843,NaN,NaN,-27.081388536666047,-22.767545957256786
2018-02-14T09:30:00-05:00,30.1,30.231,29.74,30.2,4055336,4396093.85,37.74718541323655,38.84685504335194,NaN,NaN,-96.75328509311859,-147.0937290333008,-0.08707945677872414,-0.5673986900337233,-0.4803192332549992,27602354,24968349,11.199821997016073,33.924352970861584,NaN,NaN,-26.68982576856348,-23.327871644586313
2018-02-15T09:30:00-05:00,30.22,30.53,30.09,30.48,2924096,4428467.45,41.681637296634584,38.2714858261247,NaN,NaN,-62.444463796189204,-112.81596158345437,-0.04485329126142107,-0.5363858473317755,-0.49153255607035445,30526450,28341756.4,21.765266242196972,30.139583749349054,NaN,NaN,-25.108548031034427,-23.58225398550747
2018-02-16T09:30:00-05:00,30.48,30.82,30.47,30.68,7702831,4731560.4,44.38541270254458,38.31756989352438,NaN,NaN,-34.80733267767248,-84.1381838211787,0.0012092761244538175,-0.4900209609147872,-0.491230237039241,38229281,31324831.6,29.727574080512014,27.417206962653847,NaN,NaN,-22.972832855037712,-23.495193824011793
2018-02-20T09:30:00-05:00,30.52,30.84,30.35,30.37,12237265,5238618.9,41.19718579769485,38.27223441600689,NaN,NaN,-41.7560877826544,-65.15637622287767,0.014711985249037385,-0.4728402554779443,-0.48755224072698167,25992016,30801558.2,29.166813495533546,25.491224189185548,NaN,NaN,-22.14745897630202,-23.30266027433897
2018-02-21T09:30:00-05:00,30.36,30.47,29.81,29.81,3924002,5341151.95,36.14613391149372,37.07570731415539,NaN,NaN,-76.17927224531851,-62.38808831899064,-0.008888975864490167,-0.49866346055759436,-0.4897744846931042,22068014,28883623,27.145620700732593,23.499651041571415,NaN,NaN,-23.04815527816751,-23.266302417743045
2018-02-22T09:30:00-05:00,29.93,30.41,29.93,30.15,2969597,5340128.9,40.885132441066695,36.810131160513855,NaN,NaN,-59.95749862025164,-55.02893102441725,0.002947559924535992,-0.4860900347874342,-0.48903759471197017,25037611,28370674.4,26.614417930141684,21.711576778289366,NaN,NaN,-22.277805339364118,-23.1250885494032
2018-02-23T09:30:00-05:00,30.28,30.7,30.21,30.7,3106537,5389661.25,47.653107341834456,37.32557944322884,NaN,NaN,-21.173975733994503,-46.77483341197831,0.04977013278508491,-0.42682492873061406,-0.47659506151569897,28144148,27894214,26.10344715264543,20.485652186821106,NaN,NaN,-19.359793695726815,-22.587189284592288
2018-02-26T09:30:00-05:00,30.79,30.84,30.6073,30.81,2436181,5437855.75,48.91286850535002,38.464096821286724,NaN,NaN,8.203786706160722,-38.17260953521167,0.08787355097005911,-0.3667531228031251,-0.4546266737731842,30580329,26364423.6,24.47844928164166,19.85317079578695,NaN,NaN,-16.647510684975288,-21.73866377036129
2018-02-27T09:30:00-05:00,30.84,30.85,30.15,30.15,5371793,5601802.85,42.33044164573076,39.16661442233656,NaN,NaN,-29.261877651011023,-35.673767508882996,0.06917464504105347,-0.36815836747186736,-0.43733301251292084,25208536,26207727.6,24.31150275023883,19.796899760873377,NaN,NaN,-16.407414854160642,-20.977056782332625
2018-02-28T09:30:00-05:00,30.31,30.56,30.11,30.11,3312493,5650069.15,41.961872893485875,39.924454868358346,NaN,NaN,-41.431340933815235,-28.72418124658234,0.05526265890687915,-0.3682546888793219,-0.42351734778620104,21896043,26173333.4,24.2723720423692,20.32009373236036,NaN,NaN,-16.333748176528378,-20.313726981503446
2018-03-01T09:30:00-05:00,30.12,30.43,29.86,29.96,5627200,5720774.1,40.53650185001388,41.03843761466662,NaN,NaN,-64.22537459058783,-29.57775644064958,0.037934412865597955,-0.3760993317042036,-0.4140337445698016,16268843,24419579.8,22.30129320947188,21.061083102357223,NaN,NaN,-16.700599912832022,-19.797565971693242
2018-03-02T09:30:00-05:00,29.85,29.92,29.61,29.86,4863186,5767045.7,39.57145475308358,41.34417352853228,NaN,NaN,-118.00394067151,-48.94374942815267,0.022477719580170974,-0.3859365950945879,-0.40841431467475886,11405657,21071881.6,19.110955975231008,21.721518419443363,NaN,NaN,-17.280373667140648,-19.43796707104287
2018-03-05T09:30:00-05:00,29.74,30.3852,29.66,30.28,2574221,5709795.9,45.44586030761536,41.991274949230366,NaN,NaN,-41.432751022255786,-58.87105697383597,0.042138298622592996,-0.35574144139651764,-0.39787974001911064,13979878,17751791.4,16.57800351116377,22.260065862866803,NaN,NaN,-16.05086752321369,-18.95409570706727
2018-03-06T09:30:00-05:00,30.27,30.49,30.09,30.4,11143364,5884332.4,47.03026537532385,42.534647159650696,NaN,NaN,25.34347265830842,-47.94998691197208,0.0635377227329571,-0.31845758660291423,-0.38199530933587134,25123242,17734732.6,16.565854477162446,22.810099489004077,NaN,NaN,-14.577599155494275,-18.328881913985413
2018-03-07T09:30:00-05:00,30.24,30.6,30.17,30.53,19120473,6503297.7,48.7662328780197,43.32172197856378,NaN,NaN,53.5659506931782,-28.950528586573398,0.0853985893878565,-0.27524707260105075,-0.36064566198890724,44243715,22204267,30.862159910786204,24.214552197130512,NaN,NaN,-12.854465501453605,-17.54682242648087
2018-03-08T09:30:00-05:00,30.62,30.77,30.49,30.77,2200918,6103267.65,51.90030298607823,44.0516266706669,NaN,NaN,116.87322244247483,7.2691908200391335,0.11322799889698781,-0.2191106633676725,-0.3323386622646603,46444633,28239425,44.65285769664375,25.84938015816243,NaN,NaN,-10.477874036983504,-16.536972656552674
2018-03-09T09:30:00-05:00,30.78,30.97,30.6332,30.97,2277322,5692254.6,54.403458092451594,44.76720134137454,NaN,NaN,150.33016691329956,60.936012337001046,0.14052873573901603,-0.1566777425908903,-0.2972064783299063,48721955,35702684.6,56.26947562900409,27.745230268769006,NaN,NaN,-7.733948343061703,-15.279397754625393
2018-03-12T09:30:00-04:00,30.97,31.1956,30.93,31.12,3270440,5373052,56.24271231389874,45.841881806817675,NaN,NaN,183.87118714034457,105.9967999695211,0.16255578445213092,-0.09401174776474264,-0.25656753221687356,51992395,43305188,64.45391654570415,30.26573762949548,NaN,NaN,-4.888097936533958,-13.794926352040902
2018-03-13T09:30:00-04:00,31.2,31.37,31.09,31.22,2837207,5250188.45,57.474270820676246,47.36532015747356,NaN,NaN,184.99637751220365,137.92738094030014,0.17656131261754515,-0.03586589144494212,-0.21242720406248727,54829602,49246460,69.29094152408967,33.276117688306705,NaN,NaN,-2.1457629554247073,-12.130760152524303
2018-03-14T09:30:00-04:00,31.3,31.365,31.16,31.28,3261626,5260804.4,58.23383622358992,48.60451328479665,NaN,NaN,161.18888922369032,159.45196864640258,0.1818497886780232,0.014885031785041747,-0.16696475689298146,58091228,52015962.6,71.25458306578767,36.46470091228141,NaN,NaN,0.3714413964592706,-10.344731359812364
2018-03-15T09:30:00-04:00,31.31,31.415,31.14,31.28,3602399,5238157.55,58.23383622358992,49.36027963349347,NaN,NaN,141.54354765599587,164.3860336891068,0.17715382242072422,0.05447752113292381,-0.12267630128780041,58091228,54345281.6,72.8282923891158,39.802189857743585,NaN,NaN,2.4856498427404006,-8.511819759447684
2018-03-16T09:30:00-04:00,31.07,31.31,30.985,31.26,2807538,5232329.65,57.83449105359902,49.99753838693983,NaN,NaN,107.26497947382806,155.7729962012125,0.16476584878817005,0.08328100969741214,-0.0814848390907579,55283690,55657628.6,73.7018382199015,43.31814621047643,NaN,NaN,4.1947008786245075,-6.696602525437371
2018-03-19T09:30:00-04:00,31.26,31.26,30.77,30.95,4095745,5051975.35,51.89419369466984,50.680663533292616,NaN,NaN,66.91829777495698,132.38241832813497,0.12932341479451176,0.08016942940238181,-0.04915398539212996,51187945,55496738.6,73.39032775413341,46.82377656789747,NaN,NaN,4.249567508145978,-5.1328639492111785
2018-03-20T09:30:00-04:00,30.97,31.19,30.8238,30.94,3647232,4622473.7,51.709685290995516,51.376935847400446,NaN,NaN,59.18850332183491,107.22084349006123,0.10013938756497028,0.07602024906408289,-0.02411913850088739,47540713,54038960.8,70.48343925519842,50.124567083099556,NaN,NaN,4.249382116979789,-3.792543082612469
2018-03-21T09:30:00-04:00,30.94,31.03,30.52,30.66,4715836,4662065.4,46.702639907778156,51.8173742800979,NaN,NaN,13.967597699199372,77.77658518516303,0.05894887623023625,0.04956695678690792,-0.009381919443328326,42824877,50985690.6,64.70285689191856,53.15325020327431,NaN,NaN,2.9153125096522037,-2.83427799800323
2018-03-22T09:30:00-04:00,30.62,31.02,30.52,30.55,5319800,4779575.55,44.864690118492454,52.19546252048425,NaN,NaN,2.5071670845564764,49.969309070875134,0.02310685436681891,0.019501648515195313,-0.0036052058516235974,37505077,46868460.4,57.81690562870273,55.91796089280801,NaN,NaN,1.2698337846414367,-2.2479763147682776
2018-03-23T09:30:00-04:00,30.6,30.67,29.9901,30.07,6203061,4934401.75,37.86248862033395,51.653793114249865,NaN,NaN,-76.33702421358514,13.248908333392517,-0.031169140708897564,-0.04256663173774555,-0.01139749102884799,31302016,42072125.6,51.0067482331207,58.37715694437636,NaN,NaN,-2.3895476973054497,-2.2682007979878738
2018-03-26T09:30:00-04:00,30.32,30.535,30.13,30.48,4544254,5039805.4,45.66346832614577,51.556164753594274,NaN,NaN,-46.67635377986266,-9.47002197757141,-0.03728519414570741,-0.058003983710982254,-0.020718789565274842,35846270,39003790.6,47.178301791746854,60.563760323989534,NaN,NaN,-3.3227991872469063,-2.418857710739164
2018-03-27T09:30:00-04:00,30.49,30.96,30.19,30.53,6480461,5095238.8,46.54483334855194,51.397493358632296,NaN,NaN,-17.653792827257654,-24.83848120738992,-0.035784294023793795,-0.06544915709501709,-0.02966486307122329,42326731,37960994.2,45.916912756882724,61.63909981299643,NaN,NaN,-3.820166207406444,-2.61904463883449
2018-03-28T09:30:00-04:00,30.63,31.205,30.63,31.09,7058294,5282528.85,55.291737974274106,51.639738714932,NaN,NaN,51.301340120189415,-17.371732723191908,0.0030406535508102905,-0.025864046132710428,-0.028904699683520718,49385025,39273023.8,47.80769711187491,61.86444548551294,NaN,NaN,-1.4555683808198583,-2.4528337448324
2018-03-29T09:30:00-04:00,31.19,31.23,30.965,31.08,4264131,5214375.4,55.11829483195061,51.690798482039085,NaN,NaN,66.17272870489454,-4.638620399124295,0.02684132443418861,0.004646955859215041,-0.022194368574973568,45120894,40796187.2,49.99342060297593,61.41615584079664,NaN,NaN,0.35809300959865015,-2.0512727799136785
2018-04-02T09:30:00-04:00,31.12,31.19,30.48,30.7,6294573,5285944.75,48.84769294357063,51.16258281272992,NaN,NaN,-1.068236926710812,10.41513705825057,0.016303686839297598,-0.0018147600258515695,-0.018118446865149167,38826321,42301048.2,52.12655404563592,60.53562994793462,NaN,NaN,-0.01564103642341687,-1.7604682451293554
2018-04-03T09:30:00-04:00,30.76,30.915,30.52,30.81,7277427,5521105.05,50.59970375024368,50.67154230769903,NaN,NaN,-19.557355766730375,15.838936660877028,0.016029358979608672,0.0019182518593616749,-0.014111107120246998,46103748,44352543.8,54.947951713235916,59.51113067573078,NaN,NaN,0.21188788850327894,-1.4787030831818362
2018-04-04T09:30:00-04:00,30.62,31.24,30.55,31.17,5217221,5224797.9,55.92078516330105,50.506324374821254,NaN,NaN,34.194680088855044,26.20863124409957,0.038120137351203016,0.03353906456875677,-0.0045810727824462435,51320969,46151391.4,57.32299750052586,58.51601742106923,NaN,NaN,2.090875077917895,-0.9687633458818746
2018-04-05T09:30:00-04:00,31.22,31.225,30.93,31.2,3365478,4437048.15,56.34280187324238,50.37125049265358,NaN,NaN,63.48458291200494,28.645279802462674,0.05192418335516856,0.06032415641151445,0.008399973056345895,54686447,47211675.8,58.70487305791995,57.50720175455523,NaN,NaN,3.7203061461618323,-0.2988962755899165
2018-04-06T09:30:00-04:00,31.11,31.34,30.81,30.88,5657555,4609880,50.76024780572621,49.8659474035198,NaN,NaN,29.143392752141484,21.239412611912062,0.03735610709692566,0.05509510692750297,0.01773899983057731,49028892,47993275.4,59.73977189308645,56.50991130263987,NaN,NaN,3.4375535545496843,0.23488227157288366
2018-04-09T09:30:00-04:00,30.94,31.14,30.795,30.87,3302033,4661115.55,50.59155086938941,49.77290148742834,NaN,NaN,6.064452436361426,22.665950484526512,0.025466950553180597,0.04957268802205306,0.02410573746887246,45726859,49373383,61.57111685411429,55.66568195263851,NaN,NaN,3.161352052894565,0.6529493831902667
2018-04-10T09:30:00-04:00,31.08,31.08,30.54,30.66,6040291,4799608.1,47.054899200611935,49.44041676668666,NaN,NaN,-40.64943998105369,18.447533641661842,0.0030585611238278035,0.027928938873657216,0.024870377749829413,39686568,48089947,58.88843074250427,54.837467058874644,NaN,NaN,1.8844906043764371,0.8288838433597197
2018-04-11T09:30:00-04:00,30.57,31.02,30.57,30.74,2896673,4802581.4,48.530997968770954,49.57101377104328,NaN,NaN,-30.226412768650118,5.56331507016081,-0.006268243457183902,0.017035073428349534,0.023303316885533436,42583241,46342401.4,55.352000205645645,54.16954872414086,NaN,NaN,1.2364402202447209,0.8871061829147199
2018-04-12T09:30:00-04:00,30.82,30.91,30.31,30.38,2634548,4771227.5,42.75445263233745,49.42028252203222,NaN,NaN,-94.1681994607624,-25.967241404392656,-0.03497232306471733,-0.020412086945363228,0.014560236119354102,39948693,43394850.6,49.90794745182637,53.60462314007826,NaN,NaN,-1.0954946076151386,0.6038774985533115
2018-04-13T09:30:00-04:00,30.39,30.59,30.35,30.54,3011706,4741692.85,45.839983647526545,49.99010359540311,NaN,NaN,-98.29582776045415,-51.45508550691178,-0.041052093790781466,-0.03675488111912273,0.0042972126716587355,42960399,42181152,47.8222410896356,53.37715834411504,NaN,NaN,-2.1549182119284733,0.2097638256273423
2018-04-16T09:30:00-04:00,30.62,30.805,30.49,30.68,2515270,4727079.45,48.457827052007744,50.1897006472504,NaN,NaN,-39.94042619515557,-60.656061233215176,-0.033815461638453934,-0.03797211437640868,-0.00415665273795475,45475669,42130914,47.733318672255294,53.4168024070085,NaN,NaN,-2.2855496737148413,-0.14670953142154103
2018-04-17T09:30:00-04:00,30.77,31.27,30.6575,31.09,2845835,4664583.95,55.275700406940175,50.81333400856384,NaN,NaN,79.94338091867813,-36.537497053268815,-0.0013038808509290402,-0.00578650380161605,-0.0044826229506870095,48321504,43857901.2,51.099489772403246,53.78698647954568,NaN,NaN,-0.277043617961207,-0.1653286866414933
2018-04-18T09:30:00-04:00,31.13,31.2,31.01,31.01,2118086,4588126.65,53.78082673329287,50.70541177706519,NaN,NaN,99.32803243694691,-10.626608012149413,0.014077553833841074,0.013114319341614333,-0.0009632344922267406,46203418,44581936.6,52.481246743835065,54.12081145325711,NaN,NaN,0.9135267973970509,-0.01120647463598698
2018-04-19T09:30:00-04:00,30.9,30.93,30.31,30.49,2722978,4488483.75,45.2202796035945,49.99841068932546,NaN,NaN,-62.93773582865695,-4.380515285728324,-0.01019603308786423,-0.013708275852057028,-0.003512242764192798,43480440,45288286,53.85125330870555,54.39637093223781,NaN,NaN,-0.7785833085745184,-0.12083173662720574
2018-04-20T09:30:00-04:00,30.53,30.606,30.18,30.22,3173424,4381164.95,41.52436324726107,49.47531571101764,NaN,NaN,-124.00988370451417,-9.52332647454033,-0.042074502994167526,-0.0561053715069022,-0.01403086851273468,40307016,44757609.4,52.62371748271353,54.43188260631478,NaN,NaN,-3.4153837331381554,-0.5914820218430556
2018-04-23T09:30:00-04:00,30.22,30.39,30.135,30.28,1929888,4167506.3,42.64618376977501,48.90720714098416,NaN,NaN,-145.17951535401457,-30.571144306312124,-0.05589271879204241,-0.0838967670027877,-0.028004048210745286,42236904,44109856.4,51.092764199597084,54.15651206962629,NaN,NaN,-5.169870245299447,-1.2455374823368257
2018-04-24T09:30:00-04:00,30.31,30.48,30.16,30.31,3913988,4135993,43.232594828717986,48.00090783137109,NaN,NaN,-127.7087249359,-72.10156547722775,-0.05945388259683961,-0.1023214014567948,-0.04286751885995519,46150892,43675734,50.042006515611654,53.636441284989566,NaN,NaN,-6.411901253058513,-1.983589449582781
2018-04-25T09:30:00-04:00,30.26,30.36,30.0332,30.21,2337885,3928864.2,41.7020003318104,46.955136292697375,NaN,NaN,-142.99771725115963,-120.56671541484907,-0.06456023170488125,-0.12356780849105675,-0.059007576786175506,43813007,43197651.8,48.85052456096426,52.932559249492726,NaN,NaN,-7.890350297429061,-2.8274124278465353
2018-04-26T09:30:00-04:00,30.31,30.7832,30.2862,30.6,2621938,3707046.4,49.24852209438531,46.84715588474445,NaN,NaN,-41.97827361584663,-116.37482297228698,-0.03894958866978869,-0.10769456262341137,-0.06874497395362268,46434945,43788552.8,50.42175799269665,52.266986828036316,NaN,NaN,-6.9441673118226355,-3.4155202684145496
2018-04-27T09:30:00-04:00,30.51,31.11,30.34,31.01,3408342,3664256.95,55.735633568185186,47.21459036322987,NaN,NaN,34.6439584238393,-84.6440545466163,0.005936444993732262,-0.06132441771145736,-0.06726086270518962,49843287,45695807,55.20485323945875,51.812253712703786,NaN,NaN,-3.995653216435332,-3.49839640384609
2018-04-30T09:30:00-04:00,30.94,31.13,30.85,30.89,2895513,3494303.95,53.57707546336806,47.68046009628387,NaN,NaN,68.93612193723338,-41.820927088366716,0.02671402783916471,-0.03386832790623373,-0.06058235574539844,46947774,46637981,57.39170469446658,51.70534470927252,NaN,NaN,-2.2643319937451127,-3.322101488117379
2018-05-01T09:30:00-04:00,30.94,31.135,30.8229,31.11,3076965,3284280.85,56.87461424823273,48.276432687674,NaN,NaN,79.2899563433286,-0.4211908325210004,0.05292882456890511,0.005578674965732944,-0.047350149603172166,50024739,47412750.4,59.15744663630532,51.97716231146249,NaN,NaN,0.2293523754982415,-2.8147509361722904
2018-05-02T09:30:00-04:00,31,31.13,30.791,30.97,3362818,3191560.7,54.23449783343396,49.096435916323756,NaN,NaN,64.3924185880188,41.05683633531468,0.05808234419057204,0.025252780635042882,-0.032829563555529157,46661921,47982533.2,60.45535003122777,52.73054820999117,NaN,NaN,1.499921532919324,-2.1983691548734883
2018-05-03T09:30:00-04:00,30.93,31.085,30.8,30.96,3260561,3186314.85,54.04152823954088,49.682260530039066,NaN,NaN,64.54327657235268,62.361146372954536,0.05792882221632445,0.039581464214876405,-0.018347358001448044,43401360,47375816.2,58.3297520649441,53.48108470822749,NaN,NaN,2.4695031602755635,-1.531530252709338
2018-05-04T09:30:00-04:00,30.93,31.4,30.92,31.31,1804110,2993642.6,59.476231243705286,50.46928940087461,NaN,NaN,128.16735736935055,81.06582616205678,0.0772993247305398,0.0782767979117267,0.0009774731811869053,45205470,46448252.8,55.13792795631902,54.009985371374896,NaN,NaN,4.993794386671726,-0.5993410185120431
2018-05-07T09:30:00-04:00,31.36,31.43,31.235,31.37,1737450,2915413.45,60.34201370670393,50.8311689222863,NaN,NaN,147.4648939135894,96.77158055732798,0.08920837049665273,0.11248793630200282,0.02327956580535009,46942920,46447282,55.13452745205168,54.29820234849264,NaN,NaN,7.31387400612382,0.5311182707216515
2018-05-08T09:30:00-04:00,31.27,31.32,31.045,31.15,1693246,2698061.2,55.64739914977887,50.96449552346388,NaN,NaN,93.75285831885174,99.66416095243261,0.07774415807736232,0.120459763402053,0.042715605324690674,45249674,45492269,51.75314840673184,54.24619532441384,NaN,NaN,7.954942672418416,1.5916646138211892
2018-05-09T09:30:00-04:00,31.15,31.39,31.06,31.39,1498150,2628135.05,59.36179278637405,51.97460360794813,NaN,NaN,104.64075932625475,107.7138291000798,0.0814099438952926,0.14447803519380642,0.06306809129851382,46747824,45509449.6,51.810406540580544,54.100420555262055,NaN,NaN,9.62509105371719,2.739296962377761
2018-05-10T09:30:00-04:00,31.5,31.745,31.47,31.68,1628823,2577848.8,63.35527488814953,53.53395443944016,NaN,NaN,157.21846549868337,126.24886688534593,0.09737208640274644,0.18478319930194687,0.08741111289920042,48376647,46504507,55.13166487130891,54.27955965444743,NaN,NaN,12.324245393853111,4.108575309731382
2018-05-11T09:30:00-04:00,31.69,31.81,31.49,31.53,1206691,2487598.05,60.06726579364154,54.778317441144914,NaN,NaN,137.752898788922,128.1659751692602,0.09190288241571534,0.2022897159188446,0.11038683350312925,47169956,46897404.2,56.40916246593165,54.659302387757045,NaN,NaN,13.58141656593131,5.461838346331372
2018-05-14T09:30:00-04:00,31.54,31.56,31.15,31.31,1882887,2455978.9,55.51646194719953,55.655736521036445,NaN,NaN,78.97061003990453,114.46711839452325,0.06861092862424309,0.19615049428343312,0.12753956565919003,45287069,46566234,54.98799575402223,55.01258733335779,NaN,NaN,13.267070445579044,6.576871503366753
2018-05-15T09:30:00-04:00,31.11,31.11,30.695,30.78,2371139,2432244.1,46.39684539738264,55.991082597148754,NaN,NaN,-12.1004522212792,93.29645628649708,0.015429169276894472,0.14682602725530813,0.13139685797841366,42915930,46099485.2,52.96272837487561,55.30631617720861,NaN,NaN,9.91353383768506,7.053537551126511
2018-05-16T09:30:00-04:00,30.85,30.96,30.6401,30.7,1562199,2404449.75,45.19015074521913,55.701198929351165,NaN,NaN,-27.290762094915177,66.91015200226312,-0.025016282907271703,0.10012650434432402,0.12514278725159572,41353731,45020666.6,48.514979783995834,55.170117733729974,NaN,NaN,6.8611804638274325,7.0260579672266426
2018-05-17T09:30:00-04:00,30.67,30.72,30.46,30.54,1758187,2356210.2,42.792994762135876,54.77672472891907,NaN,NaN,-64.27647156081487,22.611164590363465,-0.060407043004788316,0.04963398349561032,0.11004102650039864,39595544,43264446,42.28893857749114,54.24755240073229,NaN,NaN,3.582356936970013,6.534100677189981
2018-05-18T09:30:00-04:00,30.56,30.72,30.43,30.56,1395298,2267303.9,43.19860249093321,54.03540523088801,NaN,NaN,-69.74793871399135,-18.8890029102192,-0.07914951854600186,0.011104128317896311,0.09025364686389817,40990842,42028623.2,38.54077607760378,52.9010574995278,NaN,NaN,1.0684271301077137,5.753290170463943
2018-05-21T09:30:00-04:00,30.63,30.955,30.43,30.87,1477092,2244664.1,49.209704891786394,53.48791170542756,NaN,NaN,-41.73309197006285,-43.02974331221268,-0.0677871400496642,0.005519721801817923,0.07330686185148212,42467934,41464796.2,36.93245003400422,51.313557742220596,NaN,NaN,0.6524196939336521,5.024594388102473
2018-05-22T09:30:00-04:00,30.87,30.95,30.7201,30.91,1567206,2127325,49.94577440928135,53.18157431798808,NaN,NaN,-26.338688321798692,-45.877390532316575,-0.055227525553414716,0.00427245490971373,0.059499980463128446,44035140,41688638.2,38.037952688534354,49.712315074885346,NaN,NaN,0.5279656395787755,4.382218852599088
2018-05-23T09:30:00-04:00,30.9,31.27,30.89,31.16,1543949,2087628.2,54.39435441207652,53.20677618745491,NaN,NaN,23.25351930944127,-35.76853425144528,-0.029048318368582404,0.02318958250240044,0.052237900870982845,45579089,42533709.8,42.160050985278644,48.55733642633782,NaN,NaN,1.743012186691537,4.00518932889801
2018-05-24T09:30:00-04:00,31.17,31.29,30.8851,31.04,1537537,2033408.15,52.00515197397171,52.67312766818823,NaN,NaN,8.022742780443131,-21.308691383193683,-0.019251300260726946,0.028173775545074164,0.04742507580580111,44041552,43422911.4,46.214650742344006,47.91995948248246,NaN,NaN,2.067828642751335,3.728423516591342
2018-05-25T09:30:00-04:00,31.07,31.32,31.07,31.19,1713600,1948671.05,54.68456679380439,52.26902431726683,NaN,NaN,37.4492506165803,0.13074648292064522,-0.0029612499303936016,0.04372351339280911,0.04668476332320271,45755152,44375773.4,50.2400973114971,47.570357329585704,NaN,NaN,3.12300497946896,3.6419351541452873
2018-05-29T09:30:00-04:00,31.12,31.375,30.99,31.27,3255068,1966648.8,56.09245415131993,52.300813960234045,NaN,NaN,38.83148866306152,16.243662609545517,0.012084068670057575,0.06178984916077468,0.049705780490717104,49010220,45684230.6,55.19865451185998,47.81646490852342,NaN,NaN,4.404657376084162,3.750895471565127
2018-05-30T09:30:00-04:00,31.24,31.805,31.16,31.68,3589029,1992252,62.51942804348624,52.526359335742065,NaN,NaN,117.47742261612346,45.00688479712995,0.04659280009740719,0.10794678061247609,0.0613539805150689,52599249,47397052.4,60.71709925931697,48.45265724557602,NaN,NaN,7.584823939109904,4.298599538357237
2018-05-31T09:30:00-04:00,31.54,31.68,31.44,31.58,3811890,2014705.6,60.20470707130128,52.30131877739575,NaN,NaN,108.8738516737597,62.13095126999362,0.0588386139281111,0.13490224792520777,0.07606363399709667,48787359,48038706.4,62.576787376779116,48.98445171025247,NaN,NaN,9.524538039534903,5.045162181382618
2018-06-01T09:30:00-04:00,31.57,31.775,31.48,31.71,2424373,1972896.2,62.16579170386432,52.45121348526881,NaN,NaN,117.70152754665457,84.06670822323592,0.0710324740924601,0.1648542266126718,0.0938217525202117,51211732,49472742.4,66.4046755157818,49.698416928098915,NaN,NaN,11.736846867694585,6.001117136570041
2018-06-04T09:30:00-04:00,31.78,32.02,31.675,32.02,3660699,2065725.65,66.41591193212344,53.22974562704909,NaN,NaN,152.21760352870632,107.02037880566112,0.09387983051636434,0.21117154066566712,0.11729171014930279,54872431,51296198.2,70.53216745864475,50.80871490700052,NaN,NaN,15.027719504024375,7.290631760492089
2018-06-05T09:30:00-04:00,32.07,32.135,31.81,31.86,2623581,2110032.2,62.512652106790625,54.38087467772108,NaN,NaN,138.25331542928674,126.90474415890617,0.0919986227080471,0.23228998853436167,0.14029136582631457,52248850,51943924.2,71.85495505372755,52.158159669775664,NaN,NaN,16.612105052872767,8.622270802260758
2018-06-06T09:30:00-04:00,31.84,31.96,31.715,31.95,2120347,2131387.25,63.80136085171067,55.710246828184765,NaN,NaN,110.0879114592043,125.42684192752233,0.09046137841658602,0.2533680888470471,0.16290671043046107,54369197,52297913.8,72.57939568162821,53.877046519606544,NaN,NaN,18.30158126371646,10.005029439611572
2018-06-07T09:30:00-04:00,31.98,32.03,31.76,31.95,4379659,2275462.7,63.80136085171067,57.21084440601153,NaN,NaN,102.49628739127486,124.15132907102536,0.08327053915629218,0.2669948843758263,0.18372434521953412,54369197,53414281.4,74.78375632457362,56.198104930112436,NaN,NaN,19.67294034594937,11.3861595690884
2018-06-08T09:30:00-04:00,31.92,32.085,31.87,32.06,2237271,2305885.1,65.48333172251873,58.80261077969622,NaN,NaN,109.53946191727316,122.51891594514909,0.07974324439149744,0.2834034007089059,0.20366015631740847,56606468,54493228.6,76.73075464771262,58.92596054226306,NaN,NaN,21.31405033180176,12.804429678047452
2018-06-11T09:30:00-04:00,32.03,32.16,31.99,32.05,1788617,2334981.4,65.18679542813706,59.94383153229269,NaN,NaN,109.73789124390105,114.02297348818804,0.07085722431949049,0.2922316867167716,0.2213744623972811,54817851,54482312.6,76.66625795148093,61.764089679225684,NaN,NaN,22.59913051443145,14.203672654673737
2018-06-12T09:30:00-04:00,31.92,32.31,31.915,32.23,1508887,2316281.4,67.99614968875527,61.23314405225512,NaN,NaN,106.64636609390016,107.70158362111071,0.07104213707450047,0.3101771337404067,0.2391349966659062,56326738,55297890.2,78.1444032111275,64.62883614512519,NaN,NaN,24.517171630804757,15.677029651263883
2018-06-13T09:30:00-04:00,32.23,32.27,31.475,31.51,2002591,2297854,50.456398512917836,60.9518614880295,NaN,NaN,46.388029936482205,94.9616073165663,0.019305024523504966,0.2632662773202874,0.24396125279678244,54324147,55288880.2,78.08555305787142,67.19494343602467,NaN,NaN,20.644348259686936,16.38664659532432
2018-06-14T09:30:00-04:00,31.63,31.939,31.63,31.81,2131113,2326299.7,55.596055115677146,61.208354569579896,NaN,NaN,47.46108180339092,83.95456619898951,0.0027863543770627053,0.24744419576811083,0.24465784139104813,56455260,55706092.8,78.878759881261,69.52809408880447,NaN,NaN,19.09291651250202,16.77325658349256
2018-06-15T09:30:00-04:00,31.53,31.76,31.4532,31.49,2442731,2360526.9,49.676233789248194,60.850616497825875,NaN,NaN,7.294239551511673,63.50552172583722,-0.03036544461212895,0.20670103562588693,0.23706648023801588,54012529,55187305,75.23225316629126,71.31324807843262,NaN,NaN,15.717005281006347,16.622363540280244
2018-06-18T09:30:00-04:00,31.39,31.55,31.285,31.46,2107132,2396118.6,49.14787934438664,60.35457544018779,NaN,NaN,-26.97044010231148,36.16385545659471,-0.05362836294125006,0.1700310265614533,0.22365938950270337,51905397,54604814.2,71.24950545204317,72.45973743130284,NaN,NaN,12.930261745575745,16.09492042675103
2018-06-19T09:30:00-04:00,31.34,31.675,31.34,31.5,2535768,2449052.4,49.91281819589596,59.45410330821705,NaN,NaN,-22.42211040358546,10.350160157097587,-0.06488417547884628,0.1425541701541455,0.2074383456329918,54441165,54227699.6,68.71327712252133,73.0308929929603,NaN,NaN,10.939788367829696,15.35847298976227
2018-06-20T09:30:00-04:00,31.54,31.87,31.48,31.84,3724989,2556941.55,55.97489777041053,59.15197407243914,NaN,NaN,20.402172410287914,5.152988651858734,-0.04873093512410201,0.1465246767278643,0.1952556118519663,58166154,54996101,70.9800240107845,73.63112418110354,NaN,NaN,11.09662783782197,14.749637968056513
2018-06-21T09:30:00-04:00,31.87,32.07,31.78,32.03,2826958,2621092,58.96386307576859,58.923264884718016,NaN,NaN,72.20138674307006,10.101049639794562,-0.025706592883645685,0.1631223707474092,0.1888289636310549,60993112,55903671.4,73.42870666931711,74.13284069207035,NaN,NaN,12.175701646588326,14.381932779275344
2018-06-22T09:30:00-04:00,32.14,32.34,31.935,32.31,2292913,2658860.8,62.95535331554858,58.676082126391236,NaN,NaN,128.27573605556725,34.29734894060568,0.006219629105929464,0.19660350001346671,0.19038387090753725,63286025,57758370.6,77.5902168043544,74.63698707390675,NaN,NaN,14.397303753604056,14.384128632750874
2018-06-25T09:30:00-04:00,32.33,32.385,32.045,32.23,6956705,2921016.05,61.125944272333385,58.57703156678714,NaN,NaN,125.58181193927572,64.80779934892311,0.019063216784711068,0.21421289188842607,0.195149675103715,56329320,58643155.2,79.25905971344551,75.16585169245802,NaN,NaN,15.624973775771991,14.561392224611033
2018-06-26T09:30:00-04:00,32.27,32.545,32.16,32.4,2106650,2863595.15,63.54987809576286,58.55906851279087,NaN,NaN,157.33636639276003,100.75949470819221,0.03518386390768097,0.2391295049883162,0.20394564108063523,58435970,59442116.2,80.65966121917151,75.74301351656825,NaN,NaN,17.40192728811551,14.967182947968816
2018-06-27T09:30:00-04:00,32.48,32.61,32.31,32.31,3679584,2868122.9,61.36823933586332,58.385274118801775,NaN,NaN,152.59644679422433,127.1983495849795,0.035840653707377296,0.24874645821485686,0.21290580450747956,54756386,58760162.6,75.94552358971731,75.82599689264995,NaN,NaN,18.221579987361174,15.432096810739152
2018-06-28T09:30:00-04:00,32.3,32.68,32.3,32.63,2795789,2817317.85,65.85641083365945,58.4119226267404,NaN,NaN,165.07084332478036,145.77224090132157,0.052854121380581515,0.27897345623320646,0.22611933485262495,57552175,58071975.2,71.4098621198714,75.4459331406613,NaN,NaN,20.349783810349116,16.134623524969147
2018-06-29T09:30:00-04:00,32.6,32.86,32.34,32.71,2922950,2842246.7,66.89198862792094,58.53372214101067,NaN,NaN,163.21835849885338,152.7607653899788,0.06379105922438091,0.3058581588831011,0.24206709965872017,60475125,57509795.2,67.84525797536509,74.81586171379588,NaN,NaN,22.40064884098696,17.02976999868598
2018-07-02T09:30:00-04:00,32.67,32.75,32.155,32.52,6280223,2973222.9,62.07641031787358,58.110883614519125,NaN,NaN,105.95877898113282,148.8361587983502,0.05296985158050149,0.308279414134347,0.2553095625538455,54194902,57082911.6,65.18443618058842,73.89014978304309,NaN,NaN,22.71414200186808,17.841823141997708
2018-07-03T09:30:00-04:00,32.56,32.98,32.47,32.71,2916190,2987853.35,64.80501027826514,59.13578445490107,NaN,NaN,139.65469406919044,145.2998243336363,0.053208308700426865,0.3218199484293791,0.26861163972895225,57111092,56817936,63.519175453004756,72.84969423983833,NaN,NaN,23.803406898416068,18.693477964343188
2018-07-05T09:30:00-04:00,32.77,33.16,32.705,33.14,2699731,3016822.55,70.05598573569628,60.16863664204529,NaN,NaN,167.7817617739823,148.33688732958788,0.07556121593451065,0.36306315964709057,0.2875019437125799,59810823,57828823.4,66.9844557558446,72.00010108802289,NaN,NaN,26.511810676028368,19.81038263744107
2018-07-06T09:30:00-04:00,33.23,33.35,33.165,33.28,2440842,2919881.7,71.54455416416975,61.73065952596827,NaN,NaN,182.29891487059754,151.78250163875128,0.09192391393571381,0.40240683613222217,0.31048292219650836,62251665,58768721.4,69.85190792672785,71.61579071376836,NaN,NaN,29.19928560505076,21.15165448995674
2018-07-09T09:30:00-04:00,33.33,33.33,32.81,32.97,2344596,2925247.95,63.962255391921204,62.78882924364931,NaN,NaN,123.91924251959274,143.92267844289918,0.07474684325997993,0.4039164762714833,0.32916963301150337,59907069,58655110.2,69.07100224166714,71.46018334159864,NaN,NaN,29.06306389116356,22.281855832986285
2018-07-10T09:30:00-04:00,32.99,33.17,32.8,33.13,3077336,2989683.9,65.96703689526112,63.93555915074677,NaN,NaN,108.0718270571834,144.34528805810928,0.06727208459821526,0.41325973875927247,0.3459876541610572,62984405,60413010.8,73.92785488385385,71.83265318169381,NaN,NaN,29.584796341434917,23.325133048478946
2018-07-11T09:30:00-04:00,33.1,33.19,32.975,33.03,2347572,3031618.15,63.58616104491453,64.47922081321134,NaN,NaN,100.07925386191204,136.4302000166536,0.04952446706114394,0.4078932379874871,0.35836877092634317,60636833,61118159,75.58412849103414,72.16151778742594,NaN,NaN,29.27818833353484,24.175569517772644
2018-07-12T09:30:00-04:00,33.11,33.17,32.94,33.11,1660672,3014522.2,64.68428765132523,64.88782256860824,NaN,NaN,92.57804079670622,121.38945582119838,0.03764268324619918,0.40542212498409214,0.36777944173789295,62297505,61615495.4,76.70799991252875,72.39575301908391,NaN,NaN,29.349034366219794,24.914635924693666
2018-07-13T09:30:00-04:00,33.13,33.255,32.98,33,2143349,3015134,61.91926239396031,64.81381607420909,NaN,NaN,85.09337482039798,101.94834781115847,0.017849201694697614,0.39009094385626497,0.37224174216156736,60154156,61195993.6,73.62932738779973,72.11283234647287,NaN,NaN,28.60485373620318,25.441809897766454
2018-07-16T09:30:00-04:00,32.86,32.96,32.5944,32.82,2759077,3030951.3,57.58166699177371,64.56065341131196,NaN,NaN,39.717339608678685,85.10796722897567,-0.01037349012134764,0.3592748795098828,0.36964836963123043,57395079,60693595.6,70.00560906600958,71.45187158594175,NaN,NaN,26.688689451586377,25.619935548312156
2018-07-17T09:30:00-04:00,32.83,32.91,32.56,32.6,1720405,3011614.95,52.7205296697615,63.78712852374043,NaN,NaN,17.139879347266486,66.9215776869923,-0.04492903075985322,0.3134870811814139,0.3584161119412671,55674674,59231649.4,60.65129682705303,70.02270270079042,NaN,NaN,23.55625493885913,25.32512403267601
2018-07-18T09:30:00-04:00,32.55,32.68,32.32,32.48,2092178,2989435.45,50.22962645539415,62.991513317992634,NaN,NaN,-28.85804762234841,41.134117390140204,-0.07515825108094426,0.26446829809008676,0.339626549171031,53582496,57820782,53.25552976331222,68.4019888560472,NaN,NaN,20.18619596829949,24.59099145205079
2018-07-19T09:30:00-04:00,32.42,32.935,32.36,32.79,2363436,2921357.8,56.01165041777751,62.28831614542963,NaN,NaN,1.7899816388508412,22.976505558569137,-0.073478255662418,0.2477787295930085,0.3212569852554265,55945932,56550467.4,47.624552019898594,66.70303813462057,NaN,NaN,18.923009581357146,23.781279756237414
2018-07-20T09:30:00-04:00,32.71,32.77,32.39,32.5,2041667,2882093.25,50.1429752280366,61.09195804543789,NaN,NaN,-41.73896475935415,-2.3899623573812874,-0.0900093766212613,0.2087452644788499,0.2987546411001112,53904265,55300489.2,42.82607710472232,64.91595378671751,NaN,NaN,15.951072565930923,22.66267872905077
2018-07-23T09:30:00-04:00,32.49,32.49,32.2133,32.41,2796857,2907290.45,48.44647817245156,60.11839146362204,NaN,NaN,-93.10667443842692,-28.954765166802407,-0.10411960150056015,0.168605139224411,0.27272474072497116,51107408,54042955,38.61117586842949,63.01786376442045,NaN,NaN,13.010291784808228,21.283766308444694
2018-07-24T09:30:00-04:00,32.39,32.52,32.14,32.32,2104204,2664665.4,46.743349259770596,58.828272819443846,NaN,NaN,-107.98799713013452,-53.980340462282605,-0.11573546468049173,0.12805540987435649,0.2437908745548482,49003204,52708661,34.70794354207594,60.959918627925525,NaN,NaN,10.075874533389106,19.68263891200818
2018-07-25T09:30:00-04:00,32.34,32.695,32.32,32.64,2608813,2689773.55,53.061713955977474,57.614396263749654,NaN,NaN,-51.87417805241516,-58.58356654829596,-0.09874996082875315,0.12035342351890677,0.2191033843476599,51612017,52314565.2,33.62668298599412,58.577220572936206,NaN,NaN,9.403514477144642,18.21419256417053
2018-07-26T09:30:00-04:00,32.67,32.9,32.67,32.75,2256929,2618640.8,55.03649255066682,56.43524900564231,NaN,NaN,4.34853089877856,-58.07185669631042,-0.077904720667162,0.1217224835137074,0.1996272041808694,53868946,51899168,32.4781609057478,55.90766721429478,NaN,NaN,9.447924989507744,16.96186862493299
2018-07-27T09:30:00-04:00,32.85,32.8548,32.4208,32.45,2666272,2612164.95,48.983697098094716,55.3653519846547,NaN,NaN,-54.23396592376337,-60.57085692919226,-0.08172069604480495,0.09747633412486323,0.17919703016966818,51202674,51358849.8,30.9952300609598,53.187969201387105,NaN,NaN,7.589619285149729,15.62297586210681
2018-07-30T09:30:00-04:00,32.48,32.515,32.19,32.42,2941061,2613070.5,48.41033625307897,54.11130193878455,NaN,NaN,-103.69136389710185,-62.68779482092727,-0.08337677659295101,0.0749760594284794,0.1583528360214304,48261613,50789690.8,29.468854451203924,50.01232631334069,NaN,NaN,5.928779694933558,14.238090695367774
2018-07-31T09:30:00-04:00,32.67,33.14,32.62,33.05,4027273,2500423,59.208504235204984,53.79861216666244,NaN,NaN,47.15968014363038,-31.6582593661743,-0.041282571768307574,0.10674962131104593,0.1480321930793535,52288886,51446827.2,33.538382623169014,47.009058751350324,NaN,NaN,8.002374167101047,13.347274048472528
2018-08-01T09:30:00-04:00,32.8,33.31,32.65,33.27,3776606,2543443.8,62.185082804267985,53.62009753472977,NaN,NaN,77.66315624194421,-5.750792507302418,-0.00004433426373781635,0.14797677524968122,0.14802110951341904,56065492,52337522.2,38.7010520360692,44.29427676017463,NaN,NaN,10.712776293374096,12.97091722631561
2018-08-02T09:30:00-04:00,33.14,33.315,33.0475,33.11,2963070,2556610.75,58.823230886329576,53.39895242704186,NaN,NaN,94.19086434322529,12.217674181586924,0.014245011750548764,0.16582737420160498,0.15158236245105622,53102422,52184217.4,38.151727447389355,41.76016247871676,NaN,NaN,11.817865304082403,12.806195523139438
2018-08-03T09:30:00-04:00,33.13,33.585,33.1,33.54,2720956,2570616.45,64.3943721137137,53.88557422146614,NaN,NaN,152.95554188058958,53.655575742457515,0.048514197924597324,0.21222510985680287,0.16371091193220555,55823378,53108358.2,43.36992459503699,39.857613587932995,NaN,NaN,14.71309869605111,13.07861026212682
2018-08-06T09:30:00-04:00,33.57,33.67,33.4,33.47,2860789,2596426.1,62.90235745262325,54.612847634527704,NaN,NaN,157.78679653058103,105.95120782799408,0.06149050789125052,0.2405740467962687,0.17908353890501819,52962589,54048553.4,48.16181891958643,38.96550802311396,NaN,NaN,16.5035605241084,13.567888870981331
2018-08-07T09:30:00-04:00,33.49,33.49,33.21,33.4,2122407,2548679.65,61.371012093776706,55.408660894412165,NaN,NaN,113.09144803624982,119.13756140651796,0.0603004666461463,0.25445912221270106,0.19415865556655476,50840182,53758812.6,46.84625698963623,38.50770282499424,NaN,NaN,17.46971553921697,14.12529268072928
2018-08-08T09:30:00-04:00,33.45,33.45,33.155,33.19,2437336,2553167.85,56.8960030176471,55.47182893726,NaN,NaN,85.88446468950782,120.78182309603069,0.04122170494236946,0.24568578674451658,0.20446408180214712,48402846,52226283.4,40.53868947056061,38.00156978575581,NaN,NaN,16.91417827172776,14.523704908014777
2018-08-09T09:30:00-04:00,33.2,33.37,33.17,33.25,1937518,2567010.15,57.8418669050292,56.0217497713309,NaN,NaN,80.90582504286617,118.12481523595886,0.029067596658788303,0.2407985776256325,0.2117309809668442,50340364,51673871.8,38.52510630217355,37.694357585573755,NaN,NaN,16.74019195358384,14.840345914524642
2018-08-10T09:30:00-04:00,33.19,33.32,32.91,32.93,2655975,2592641.45,51.36769018421033,56.23040777217081,NaN,NaN,38.87012347283422,95.30773155440781,-0.0024260977571737563,0.208698358770377,0.21112445652755077,47684389,50046074,33.27946537345112,37.31352112164672,NaN,NaN,14.589647263089429,14.804531821462469
2018-08-13T09:30:00-04:00,32.93,33.03,32.85,32.92,1652317,2537303.45,51.17492253685133,56.54694872053373,NaN,NaN,13.069083209026816,66.36418889009697,-0.024601513237713146,0.18037256498040932,0.20497407821812247,46032072,48659970.6,29.58534376269749,36.94762113740541,NaN,NaN,12.80898504073204,14.51945370992955
2018-08-14T09:30:00-04:00,32.99,33.125,32.91,33.05,1559098,2529238.1,53.6120451052049,56.58625808833568,NaN,NaN,29.15353263974503,49.57660581079601,-0.030783395324443186,0.1664948340625685,0.19727822938701167,47591170,48010168.2,28.015338571185936,36.54681082206197,NaN,NaN,11.992561797706166,14.158469151040496
2018-08-15T09:30:00-04:00,33.06,33.365,32.96,33.34,2604725,2554865.45,58.57904210282292,56.839297342061116,NaN,NaN,63.22544222543281,45.044801317981005,-0.016335788256493983,0.1768584940663942,0.19319428232288818,50195895,48368778,30.21625851213213,36.38524636537514,NaN,NaN,12.747783614996033,13.956942645891287
2018-08-16T09:30:00-04:00,33.33,33.63,33.31,33.6,4032213,2638304.3,62.460032733721285,57.801892744605865,NaN,NaN,112.07709982008123,51.27905627342402,0.008407318169250722,0.20370343003445157,0.19529611186520085,54228108,49146326.8,34.86633383734096,36.661753777973786,NaN,NaN,14.603827817767653,14.049354813302196
2018-08-17T09:30:00-04:00,33.62,33.93,33.59,33.92,2608618,2666651.85,66.60707304875365,59.101659658582626,NaN,NaN,155.8752142811441,74.680074435086,0.04211626746093464,0.24794144619136915,0.20582517873043452,56836726,50976794.2,44.2795749801117,37.71966238718149,NaN,NaN,17.565982208500834,14.55173015547343
2018-08-20T09:30:00-04:00,33.97,34.135,33.91,33.96,1947056,2624161.8,67.09638150927698,59.66507946387349,NaN,NaN,172.894817852007,106.64522136368205,0.06171281717874516,0.282966200203866,0.22125338302512082,58783782,53527136.2,54.20920283875207,39.19614954543743,NaN,NaN,20.085185098816563,15.342223718808164
2018-08-21T09:30:00-04:00,33.89,33.95,33.6,33.65,2117720,2624837.6,59.78488882873823,59.49363703704993,NaN,NaN,111.51969767718752,123.11845437117054,0.048959866398542606,0.2824532160232991,0.23349334962475649,56666062,55342114.6,59.711648590971436,40.696906442216154,NaN,NaN,20.031348338987847,16.01209866454812
2018-08-22T09:30:00-04:00,33.63,33.63,33.3,33.44,1380324,2563413.15,55.382186416851766,59.24784814637294,NaN,NaN,50.153933773559416,120.50415268079587,0.022869583115989967,0.26208032851974394,0.23921074540375398,55285738,56360083.2,62.437953444187876,42.431636870558904,NaN,NaN,18.606487393951827,16.382725625891506
2018-08-23T09:30:00-04:00,33.43,33.515,33.34,33.36,1233473,2512240.35,53.758034449787104,58.48810974180675,NaN,NaN,34.082981838040986,104.90532908438782,-0.001968414139816771,0.23675022772898302,0.2387186418687998,54052265,56324914.6,62.281149522098566,43.782438651063295,NaN,NaN,16.955269804401887,16.46451765139299
2018-08-24T09:30:00-04:00,33.32,33.6,33.3,33.59,3533112,2555582.35,57.60723745519978,58.10988688484793,NaN,NaN,48.34542740981482,83.39937171012195,-0.004931491718405845,0.23255427722079247,0.23748576893919832,57585377,56474644.8,62.71052138441346,44.821631684265235,NaN,NaN,16.694913914118207,16.497431403210875
2018-08-27T09:30:00-04:00,33.61,33.6699,33.36,33.54,2515273,2534292.95,56.50606224578618,57.762390467134324,NaN,NaN,48.023511895232744,58.4251105187671,-0.011886170009794,0.22262805642695582,0.23451422643674982,55070104,55731909.2,59.115620633500946,45.698014801684145,NaN,NaN,16.16160785163633,16.4494566101288
2018-08-28T09:30:00-04:00,33.54,33.95,33.45,33.95,1887907,2427324.65,62.787595277515365,58.183218485696344,NaN,NaN,113.85021577268571,58.89121413786673,0.008405085772188653,0.24502058365198565,0.236615497879797,56958011,55790299,59.3130849769438,47.03904305214008,NaN,NaN,17.643885884047265,16.620089363545723
2018-08-29T09:30:00-04:00,33.94,34.06,33.88,33.9,1468720,2311930.35,61.61884611773863,58.45300271517559,NaN,NaN,143.17751150498478,77.49592968415179,0.015334581785333146,0.2557837251114634,0.24044914332613027,55489291,55831009.6,59.46010250665298,48.534399923888614,NaN,NaN,18.489606016350567,16.887163171089274
2018-08-30T09:30:00-04:00,33.96,33.97,33.665,33.72,1730056,2250279.65,57.4713494989707,58.88897838051562,NaN,NaN,87.62351119890322,88.20403555632424,0.00519468309415827,0.2469424971938281,0.24174781409966983,53759235,55772403.6,59.12886981158145,50.38078595518363,NaN,NaN,17.970782779235886,17.041965972253074
2018-08-31T09:30:00-04:00,33.76,33.95,33.74,33.85,1579345,2193199.1,59.58702395814467,59.48984276775086,NaN,NaN,93.67422540281365,97.269795154924,0.004659204786154975,0.24757182008236356,0.24291261529620858,55338580,55323044.2,56.52863552281941,52.305306795192344,NaN,NaN,18.156937467945298,17.20124761449482
2018-09-04T09:30:00-04:00,33.78,33.89,33.48,33.55,2310741,2165696.7,53.030743233930835,59.448321205517,NaN,NaN,35.6230801596763,94.78970880781272,-0.017280552948241323,0.22131192411090694,0.23859247705914827,53027839,54914591.2,54.195659109933736,54.175329690817186,NaN,NaN,16.30482787214759,17.07318765130236
2018-09-05T09:30:00-04:00,33.48,33.85,33.32,33.76,3256969,2222424.8,56.628203303531144,59.30897557699616,NaN,NaN,32.98403095384035,78.61647184404364,-0.018899585580463396,0.214967995083569,0.2338675806640324,56284808,54779950.6,53.41311578816779,55.83224806767687,NaN,NaN,15.831620739415861,16.89582094960429
2018-09-06T09:30:00-04:00,33.81,33.93,33.76,33.87,1960404,2198578.2,58.424499118188,59.020723175886644,NaN,NaN,79.26229313733029,65.83342817051275,-0.014035799433833013,0.21632283137174113,0.23035863080557414,58245212,55331134.8,56.201233900174294,57.35616950073639,NaN,NaN,15.980237969758694,16.765023381054917
2018-09-07T09:30:00-04:00,33.71,33.72,33.41,33.44,1898969,2196650.75,49.75034736464021,57.81667134130711,NaN,NaN,-10.016513232158951,46.3054232843003,-0.039793223811999456,0.18061710104057482,0.22041032485257428,56346243,55848536.4,58.69993294154025,58.38619506940987,NaN,NaN,13.301184064634587,16.27018919299487
2018-09-10T09:30:00-04:00,33.59,33.8,33.55,33.62,1797136,2153708.8,52.9025773263903,56.80282818538664,NaN,NaN,20.03024314899239,31.57662683353605,-0.04437371123247108,0.16494318581198542,0.2093168970444565,58143379,56409496.2,61.279137304607104,58.891190388399515,NaN,NaN,12.086001428522893,15.672448083784587
2018-09-11T09:30:00-04:00,33.51,33.74,33.42,33.63,1534349,2147810.4,53.078680516588065,56.32381330594734,NaN,NaN,-9.66113780379288,22.51978324084222,-0.046188654299041815,0.15158107917065422,0.19776973346969604,59677728,57739474,66.60419428604462,59.383515080904736,NaN,NaN,11.175648929886812,15.030048204656334
2018-09-12T09:30:00-04:00,33.67,33.76,33.51,33.66,1388556,2139283.3,53.63873629849422,56.19928115463609,NaN,NaN,-4.711935029084853,14.980590044257179,-0.04479343886498366,0.14177793488846646,0.18657137375345012,61066284,58695769.2,69.81826684663076,59.91068032393637,NaN,NaN,10.59317109444394,14.396208617483135
2018-09-13T09:30:00-04:00,33.79,33.96,33.71,33.87,1576464,2087870.25,57.465932346913874,56.464131004430854,NaN,NaN,74.5880258738856,14.04573659156826,-0.0298700249772465,0.14923384253189198,0.17910386750913848,62642748,59575276.4,72.44489131850298,60.636661880822395,NaN,NaN,11.196582846249518,13.939119221592618
2018-09-14T09:30:00-04:00,33.77,33.79,33.375,33.58,1828268,1977673,51.182327549529525,56.005208868311556,NaN,NaN,-50.650530716313895,5.918933094737271,-0.03909046047908524,0.13024079191028193,0.16933125238936717,60814480,60468923.8,74.84075898771032,61.503107423915026,NaN,NaN,9.82938488527472,13.352014316404347
2018-09-17T09:30:00-04:00,33.5,33.82,33.495,33.77,2339110,1964197.6,54.678874605830266,55.87469546545755,NaN,NaN,5.988164888853611,3.110517442709515,-0.03223886887006794,0.12903266630178223,0.16127153517185017,63153590,61470966,77.23133603448277,62.79708709541374,NaN,NaN,9.72820850222556,12.834327771521663
2018-09-18T09:30:00-04:00,33.72,33.79,33.5,33.57,1451798,1939434.7,50.57268151293763,55.002201625130574,NaN,NaN,-24.7773720289443,0.08727059767923376,-0.04048822377421932,0.11066125545407601,0.15114947922829533,61701792,61875778.8,78.13520110755111,64.14152396188568,NaN,NaN,8.385318679768323,12.198755044128328
2018-09-19T09:30:00-04:00,33.58,33.59,33.195,33.25,2033141,1935205.75,44.77847741301425,53.799318146221694,NaN,NaN,-158.67081429978722,-30.704505256461243,-0.06533595338959858,0.0694795374912971,0.13481549088089567,59668651,61596252.2,75.89477049333559,65.3154288180773,NaN,NaN,5.346758906789643,11.219898453079944
2018-09-20T09:30:00-04:00,33.26,33.52,33.13,33.5,1928398,1962609.45,49.63353098434011,53.23947396660522,NaN,NaN,-132.77198230840253,-72.17650689291887,-0.06275968143470938,0.05636588908750895,0.11912557052221832,61597049,61387112.4,74.18091122417403,66.39057463326249,NaN,NaN,4.319818802147052,10.23417278866096
2018-09-21T09:30:00-04:00,33.17,33.305,33.04,33.15,1954881,1998679.85,43.82436246363924,52.11356957414055,NaN,NaN,-217.14596983043674,-105.47559471574343,-0.08127718530136295,0.017529088895514633,0.09880627419687758,59642168,61152650,72.21214234206036,67.51082512035113,NaN,NaN,1.4893052887069254,8.98490600295324
2018-09-24T09:30:00-04:00,33.04,33.05,32.375,32.5,2862014,1965124.95,35.51169821129139,50.86220921538058,NaN,NaN,-324.73215710849337,-171.61965911521284,-0.13100519304652156,-0.06495021711127436,0.0660549759352472,56780154,59877962.8,62.50033575096753,68.10401630899639,NaN,NaN,-4.184451553364106,7.103569209193619
2018-09-25T09:30:00-04:00,32.5,32.6651,32.4335,32.47,1710599,1924891.25,35.180022758745395,49.33019631932446,NaN,NaN,-256.35439360927563,-217.9350634312791,-0.15782297673561246,-0.13122374498426836,0.026599231751344085,55069555,58551515.4,54.31427646986852,68.16838492911788,NaN,NaN,-8.58208098898061,4.862762038025872
2018-09-26T09:30:00-04:00,32.5,32.53,32.07,32.11,2323283,1946660.05,31.39111088976054,47.399240017293934,NaN,NaN,-235.6303553741114,-233.32697164614393,-0.18957536186743174,-0.2103699705829456,-0.020794608715513856,52746272,57167039.6,47.344174902042305,67.53573785782274,NaN,NaN,-13.617731842019232,2.222691483733715
2018-09-27T09:30:00-04:00,32.16,32.38,32.13,32.21,1599120,1953180.05,33.53256842714835,46.2408272360445,NaN,NaN,-184.78914852297694,-243.7304048890588,-0.19296794113452487,-0.26200453513366995,-0.06903659399914508,54345392,55716708.2,41.35677413982853,66.2969408005576,NaN,NaN,-16.887862212965867,-0.5073876157947965
2018-09-28T09:30:00-04:00,32.22,32.63,32.17,32.61,3145496,2023952.05,41.41020167093686,45.41994326065498,NaN,NaN,-122.20481080401912,-224.7421730837753,-0.15882218677864907,-0.2675643274724564,-0.10874214069380735,57490888,55286452.2,39.750716575762034,64.75919646278297,NaN,NaN,-17.057730562175287,-2.8717223224205806
2018-10-01T09:30:00-04:00,32.61,32.6984,32.34,32.36,3654352,2127702.4,38.35086857086074,44.36795669310303,NaN,NaN,-104.50406570063527,-180.69655480220368,-0.1440576026041802,-0.2888141439490326,-0.14475654134485239,53836536,54697728.6,37.59911774748188,62.68740528145705,NaN,NaN,-18.209079817242333,-5.062773393109403
2018-10-02T09:30:00-04:00,32.37,32.44,32.26,32.26,2752415,2149786.1,37.168008461359136,43.19147613330767,NaN,NaN,-106.87526900591757,-150.80072988153205,-0.1323137583346538,-0.31014873926316966,-0.17783498092851585,51084121,53900641.8,34.84879912697146,60.189586158624245,NaN,NaN,-19.50028740362682,-7.125275394611891
2018-10-03T09:30:00-04:00,32.29,32.405,31.71,31.89,2625236,2118199.45,33.100077282732386,41.45105791443756,NaN,NaN,-124.61895332821557,-128.5984494723529,-0.14000808644967733,-0.3528450889906125,-0.21283700254093518,48458885,53043164.4,32.12629962584505,57.30968675200582,NaN,NaN,-21.94355882474428,-9.242173027487947
2018-10-04T09:30:00-04:00,31.89,31.89,31.47,31.74,2934681,2166913.3,31.59056743443307,40.05164647764496,NaN,NaN,-136.91675361050028,-119.02397048985753,-0.1451235422516744,-0.39424143035552817,-0.24911788810385377,45524204,51278926.8,27.38579644690556,53.920046570519766,NaN,NaN,-24.405431446976696,-11.408352801700625
2018-10-05T09:30:00-04:00,31.78,31.95,31.7,31.75,3406587,2242294.2,31.813820138100994,38.41842830137858,NaN,NaN,-111.32316490283876,-116.84764130962147,-0.13781285808380506,-0.42138396070861006,-0.283571102624805,48930791,49566907.4,23.726966353768134,50.09830587904015,NaN,NaN,-26.293528044049026,-13.534806407750397
2018-10-08T09:30:00-04:00,31.85,32.305,31.77,32.16,3076178,2306246.3,40.401651444009616,37.69192615359801,NaN,NaN,-75.63040969170966,-111.07291010783635,-0.09725577935424773,-0.40514082681761465,-0.3078850474633669,52006969,49200994,23.019086951206233,46.16144058215837,NaN,NaN,-25.295835697715546,-15.21495344917399
2018-10-09T09:30:00-04:00,32.15,32.37,32.01,32.27,4429886,2451023.15,42.49427793066216,37.52876904771573,NaN,NaN,-56.38574476803893,-100.97500526026063,-0.05691020723885909,-0.37902280651194076,-0.32211259927308167,56436855,50271540.8,29.633551880264676,42.85706782408188,NaN,NaN,-23.842157160236212,-16.447411122182878
2018-10-10T09:30:00-04:00,32.18,32.33,31.76,31.76,4361520,2599671.35,36.155642796544996,36.566062748587505,NaN,NaN,-79.49027662586374,-91.94926991979027,-0.058249426622747014,-0.3949243825515154,-0.3366749559287684,52075335,50994830.8,33.77385934726513,39.970849832874094,NaN,NaN,-24.556471118341022,-17.605848264491183
2018-10-11T09:30:00-04:00,31.82,31.85,30.76,30.83,9558497,2998773,27.964130675327965,35.43318904942242,NaN,NaN,-160.877804480185,-96.7414800937272,-0.11231631823421473,-0.47707035372153683,-0.3647540354873221,42516838,50393357.6,32.08328491724032,37.10450287395838,NaN,NaN,-28.30474807416566,-19.13426252301611
2018-10-12T09:30:00-04:00,31.01,31.28,30.65,30.81,5288208,3171770,27.81816584941427,34.88365102357405,NaN,NaN,-171.90527688139898,-108.85790248943927,-0.13826755181100686,-0.5375884752510807,-0.3993209234400738,37228630,48052925.4,26.520420466966087,34.53450892510113,NaN,NaN,-31.151802061482233,-20.851053885654125
2018-10-15T09:30:00-04:00,30.8,31.29,30.76,31,3894526,3249540.8,31.47739050024903,34.61917729082431,NaN,NaN,-148.78416516790855,-123.48865358467904,-0.13151917995505918,-0.5637198983838978,-0.4322007184288386,41123156,45876162.8,22.59618963031464,32.268931293704426,NaN,NaN,-32.22356180875575,-22.475697874668644
2018-10-16T09:30:00-04:00,31.04,31.675,30.93,31.58,3272185,3340560.15,41.26578383936752,35.3245110729391,NaN,NaN,-94.0951538722595,-131.03053540552315,-0.07944044201074935,-0.5315012709422753,-0.45206082893152594,44395341,43467860,19.20950324400141,30.25931188955865,NaN,NaN,-29.738903493939706,-23.513298677421652
2018-10-17T09:30:00-04:00,31.54,31.675,31.26,31.49,3449444,3411375.3,40.303681140760474,35.808161981054255,NaN,NaN,-75.86042828324692,-130.3045657369998,-0.044256336217793235,-0.5073812492037675,-0.46312491298597425,40945897,41241972.4,16.715805045622943,28.49924266854396,NaN,NaN,-28.116122613722748,-24.170844954036095
2018-10-18T09:30:00-04:00,31.48,31.775,31.37,31.5,3345155,3482213.15,40.46975877518461,35.74098748850052,NaN,NaN,-58.60877960080527,-109.85076076112384,-0.015023231994391928,-0.48190395297896416,-0.46688072098457223,44291052,41596815.2,18.53146745300748,26.983582016918636,NaN,NaN,-26.793687177540864,-24.545536700251063
2018-10-19T09:30:00-04:00,31.53,31.93,31.53,31.82,2999908,3534464.5,45.67781310254402,36.26434066933505,NaN,NaN,-20.924670411240573,-79.65463946709215,0.028765168874542002,-0.4309242598913947,-0.4596894287659367,47290960,43609281.2,28.104537353990025,26.305397703097785,NaN,NaN,-24.02947573141343,-24.47181370470283
2018-10-22T09:30:00-04:00,31.9,31.995,31.36,31.37,4269565,3604842.05,40.33394441597969,36.49047895180794,NaN,NaN,-43.49906867343294,-58.59762016819705,0.030175924589425418,-0.4219695230291549,-0.45214544761858033,43021395,43988929,29.78084586162548,25.94340104128736,NaN,NaN,-23.303654752871104,-24.304933854441153
2018-10-23T09:30:00-04:00,31.28,31.71,31.16,31.57,5159699,3777297.05,43.49780928758036,37.233174095011364,NaN,NaN,-53.10932253321681,-50.4004539003885,0.046363943612811986,-0.39419051810256533,-0.4405544617153773,48181094,44746079.6,33.1295206282837,26.01505968431869,NaN,NaN,-21.708137091899584,-23.933962888363787
2018-10-24T09:30:00-04:00,31.62,32.21,31.56,31.94,5443614,3933313.6,48.896603522979305,38.46931952990752,NaN,NaN,23.40403913623312,-30.54756041649248,0.08170879233121131,-0.33841847130136316,-0.42012726363257447,53624708,47281841.8,42.9432743879367,27.126308108678064,NaN,NaN,-18.598264019398062,-23.171720192797256
2018-10-25T09:30:00-04:00,32.01,32.49,31.86,32.32,5413761,4124045.65,53.781078121930975,40.03840938589538,NaN,NaN,81.1127484455295,-2.6032548072255386,0.12765988117103155,-0.260552412168785,-0.38821229333981655,59038469,50231325.2,51.803388961775596,29.131766866392876,NaN,NaN,-14.341100152139411,-21.91020304413185
2018-10-26T09:30:00-04:00,32.18,32.22,31.31,31.48,8951587,4414350.2,43.81225165038176,40.282023686350534,NaN,NaN,-12.1525871310163,-0.8488381511806786,0.09970141128471316,-0.2635855292339251,-0.36328694051863825,50086882,50790509.6,53.28449884442399,31.293582001622717,NaN,NaN,-13.968484574104579,-20.775671834127955
2018-10-29T09:30:00-04:00,31.71,32.15,31.71,32,6143161,4538790.65,49.99189829090155,40.81756799779621,NaN,NaN,52.38600212089071,18.32817600768405,0.11344827415374586,-0.2214765978264559,-0.33492487198020177,56230043,53432239.2,59.60078381620769,33.43409856847579,NaN,NaN,-11.420485151325781,-19.439216593727643
2018-10-30T09:30:00-04:00,32.04,32.75,31.96,32.53,7427396,4772539.7,55.37859433598518,42.19063596489907,NaN,NaN,146.7781260884718,58.30566573202176,0.15299420343321724,-0.14368211768868022,-0.29667632112189746,63657439,56527508.2,65.48864351275233,35.69944029458202,NaN,NaN,-7.352743888920443,-17.712577635898043
2018-10-31T09:30:00-04:00,32.53,32.53,32.02,32.09,4202426,4851399.2,50.513910890069,43.80133455166629,NaN,NaN,99.46902654867377,73.51866321450989,0.1443855861280957,-0.11619433846177785,-0.26057992458987356,59455013,57693569.2,67.41530631066463,38.22315610839804,NaN,NaN,-5.804434861652099,-16.011414382434335
2018-11-01T09:30:00-04:00,32.18,32.315,31.97,32.21,4848839,4947107.1,51.758557877353596,45.511362553661954,NaN,NaN,80.4108256383266,73.37827865306932,0.1414547176574506,-0.08376152751806032,-0.22521624517551092,64303852,58746645.8,69.09340764090194,41.264083763679174,NaN,NaN,-4.192246639657143,-14.322961847751879
2018-11-02T09:30:00-04:00,32.27,32.28,31.58,31.94,6876848,5120620.15,48.78538606327828,46.747647951021186,NaN,NaN,34.20974240785161,82.6507445608429,0.1170249003244701,-0.07893511976992329,-0.1959600200943934,57427004,60214670.2,71.31145614487808,44.74374565757656,NaN,NaN,-3.854558128016698,-12.827475602075424
2018-11-05T09:30:00-05:00,32.02,32.58,32.02,32.47,4093076,5171465.05,54.33107399206238,47.68088296192796,NaN,NaN,107.28056248582288,93.62965663382933,0.1311880173759649,-0.03197499837443729,-0.16316301575040218,61520080,61272677.6,72.82511413674281,48.573432149915234,NaN,NaN,-1.7142421764579636,-11.239870826987215
2018-11-06T09:30:00-05:00,32.47,32.66,32.41,32.65,2958751,5097908.3,56.07085888245361,48.80710994347747,NaN,NaN,136.72218617059605,91.61846865025419,0.146162797666599,0.019540481332846582,-0.12662231633375243,64478831,61436956,73.06277005234645,52.5982153646812,NaN,NaN,0.5563067672955226,-9.554702599232538
2018-11-07T09:30:00-05:00,32.82,33.03,32.625,33.01,3917920,5075728.3,59.40200739651136,50.15941341642939,NaN,NaN,163.23434888803126,104.37153311812567,0.1720153549291134,0.08839687732763934,-0.08361847760147406,68396751,63225303.6,75.56773046245635,56.672234151070406,NaN,NaN,3.5264860859318112,-7.685961358494774
2018-11-08T09:30:00-05:00,32.97,33.08,32.795,33.08,2664963,4731051.6,60.036584077463594,51.185039914637926,NaN,NaN,158.02515021991022,119.89439803444239,0.18443147799288062,0.14692086988962672,-0.037510608103253906,71061714,64576876,77.28681793942891,60.18525419288746,NaN,NaN,6.090890754088772,-5.717839628125696
2018-11-09T09:30:00-05:00,33.03,33.2,32.93,33.12,3558677,4644575.05,60.417326533557606,52.61956720875064,NaN,NaN,151.70128068879868,143.39270569063177,0.18544014416066243,0.19428957209757414,0.008849427936911708,74620391,68015553.4,80.95784130703554,63.84075386755962,NaN,NaN,8.276373154642453,-3.718666373444532
2018-11-12T09:30:00-05:00,33.13,33.49,33.13,33.19,2861879,4592942.7,61.11550728880034,53.87797420883778,NaN,NaN,158.50184631616,153.63696245669922,0.18073783571324825,0.234771722578472,0.05403388686522377,77482270,71207991.4,83.60687056770054,67.44627886323225,NaN,NaN,10.280215751187386,-1.7188260699256865
2018-11-13T09:30:00-05:00,33.19,33.35,33.01,33.26,6307604,4744713.65,61.84036316874087,54.80252846924931,NaN,NaN,132.19640349685324,152.73180592195067,0.17229056370890394,0.2693970915013537,0.09710652779244977,83789874,75070200,86.12217188278605,70.53048582715006,NaN,NaN,12.155331207959824,0.26319639834367203
2018-11-14T09:30:00-05:00,33.38,33.38,33.08,33.25,4368960,4790689.45,61.66351923005423,55.365559976972406,NaN,NaN,119.19925724431194,143.9247875932068,0.1564407429051003,0.2926574564238251,0.13621671351872483,79420914,77275032.6,87.31843214958619,73.06727462627939,NaN,NaN,13.678350800924141,2.179647027283739
2018-11-15T09:30:00-05:00,33.12,33.1799,32.67,32.99,7158895,4981376.45,57.09208883234578,56.31411977568412,NaN,NaN,72.85429502114614,126.890616553454,0.12047104566991274,0.28680552060611575,0.16633447493620301,72262019,77515093.6,87.44532591638396,75.50733370284796,NaN,NaN,13.842515782856617,3.8457711352227215
2018-11-16T09:30:00-05:00,32.98,33.46,32.94,33.46,3738085,5018285.3,62.5036436935053,57.2078158758701,NaN,NaN,103.67706612444826,117.2857736405839,0.12008850734551135,0.3164451091180922,0.19635660177258085,76000104,77791036.2,87.59893194299238,77.50720142618972,NaN,NaN,15.518759664842255,5.513340925168369
2018-11-19T09:30:00-05:00,33.47,33.76,33.31,33.55,4668155,5038214.8,63.45414379745329,57.78464083740353,NaN,NaN,121.26271606014733,109.83794758938134,0.11750694582928317,0.34324028405918483,0.22573333822990166,80668259,78428234,87.965104125329,79.11266289851663,NaN,NaN,17.184135141343308,7.180597241764788
2018-11-20T09:30:00-05:00,33.42,33.65,33.1,33.11,6593695,5109914.6,55.982589835465916,58.17526076207474,NaN,NaN,81.34564868113759,99.66779662623824,0.07959122497695659,0.3252223694510974,0.2456311444741408,74074564,76485172,80.18939071653189,80.02509749893571,NaN,NaN,16.52126206708019,8.51497793109556
2018-11-21T09:30:00-05:00,33.15,33.36,32.94,33.09,3707504,5023109.1,55.661763571602314,58.454061168806795,NaN,NaN,55.353444816938975,86.89863414076365,0.04813835663107807,0.3058040902629884,0.2576657336319103,70367060,74674401.2,73.65515939089518,80.35093690964952,NaN,NaN,15.889860142562645,9.568532532733714
2018-11-23T09:30:00-05:00,33.01,33.13,32.78,32.97,2542965,4879569.3,53.67421141379546,58.80326297955803,NaN,NaN,28.717436721801345,78.07126248089469,0.015893606928153614,0.27753274229210234,0.2616391353639487,67824095,73786816.4,70.61762129579208,80.30137727757196,NaN,NaN,14.805688138249884,10.316697619236024
2018-11-26T09:30:00-05:00,33.05,33.18,32.85,33.04,3242150,4594097.45,54.690580729701146,58.82894203224651,NaN,NaN,32.2512972370827,63.78610870342159,-0.0030680242265124225,0.2578041050808082,0.2608721293073206,71066245,72800044.6,67.29491200340803,79.90636283947661,NaN,NaN,14.156724371846053,10.865272869608885
2018-11-27T09:30:00-05:00,33.02,33.23,32.86,33.22,3233570,4448617.9,57.28572165320671,58.91571794444316,NaN,NaN,41.052228648940975,47.744011221180315,-0.00568311830640289,0.25376823142431704,0.2594513497307199,74299815,71526355.8,63.1636944219888,79.19928600873678,NaN,NaN,14.277018869890327,11.352665155363377
2018-11-28T09:30:00-05:00,33.22,33.53,33.08,33.49,3645661,4259531.15,60.90307546364112,59.02293709209528,NaN,NaN,85.14857375468166,48.50459623588913,0.00784111063981452,0.2692527380304881,0.2614116273906736,77945476,72300538.2,64.58676389237793,78.41493125373118,NaN,NaN,15.382194197442983,11.92831216137475
2018-11-29T09:30:00-05:00,33.48,33.695,33.28,33.53,2600744,4179447.05,61.424285541376605,59.12205862523193,NaN,NaN,108.5540449654465,59.14471626559064,0.016076258003765442,0.2815069498953804,0.26543069189161494,80546220,74336370.2,68.07904530392106,77.75723320833777,NaN,NaN,16.445664036271108,12.573648143502801
2018-11-30T09:30:00-05:00,33.63,33.885,33.465,33.85,4327224,4153366.3,65.39840565433474,59.477849991001726,NaN,NaN,152.46079890561234,83.89338870235284,0.03839691629079417,0.31342683725510767,0.2750299209643135,84873444,77746240,72.89962682808687,77.18164645984143,NaN,NaN,18.53238107616911,13.424895705312274
2018-12-03T09:30:00-05:00,33.9,34.03,33.7,34.01,5321254,4075586.6,67.21697840011609,59.9136693560957,NaN,NaN,187.4008142730892,114.92329210955413,0.058077673602213886,0.3476270129670809,0.289549339364867,90194698,81571930.6,77.08146436026848,76.71554601645343,NaN,NaN,20.839490839355694,14.484123581604191
2018-12-04T09:30:00-05:00,33.96,34.13,33.51,33.56,6476775,4194771.55,57.986234721693776,59.63837446702092,NaN,NaN,132.7251106616225,133.25786851209043,0.036010948611517046,0.3345630251292633,0.29855207651774623,83717923,83455552.2,78.81483795589705,76.19359359310421,NaN,NaN,20.190046106243546,15.299255370838384
2018-12-06T09:30:00-05:00,33.48,34.5,33.09,34.48,6368479,4365257.95,67.74016840722508,60.07242083681883,NaN,NaN,180.22709530637613,152.27357282242934,0.07628260787857183,0.39390533636596103,0.3176227284873892,90086402,85883737.4,80.82786084485599,75.72998135705204,NaN,NaN,22.98789405508383,16.39763232573059
2018-12-07T09:30:00-05:00,34.37,34.38,33.8599,33.96,5559933,4447358.6,59.352734244806555,60.23389550913746,NaN,NaN,158.93384668781442,162.3495331669029,0.061444352387482915,0.3944281689717428,0.3329838165842599,84526469,86679787.2,81.45016137619083,75.30175531846682,NaN,NaN,22.290383802055953,17.23945396520564
2018-12-10T09:30:00-05:00,33.96,33.99,33.315,33.83,9157920,4772006.45,57.43800704478855,59.8720643199434,NaN,NaN,68.4833037808523,145.55403414195092,0.03759096063523115,0.37997251737829885,0.3423815567430677,75368549,84778808.2,75.17500130414365,74.4143317014062,NaN,NaN,21.09122008115689,17.78970626748439
2018-12-11T09:30:00-05:00,33.99,34.14,33.87,33.89,4645247,4826334.95,58.109702183979316,59.49031849040955,NaN,NaN,109.73057386452878,130.0199860602388,0.021377169060414425,0.3691030180685857,0.3477258490081713,80013796,82742627.8,69.03944731030688,73.06249907176176,NaN,NaN,20.368946267931683,18.158169124691145
2018-12-12T09:30:00-05:00,34.02,34.12,33.225,33.25,4298852,4898183.6,49.191910088968406,59.0052699370883,NaN,NaN,14.737561853353961,106.42247629858511,-0.033919402945275845,0.30532659532657647,0.3392459982718523,75714944,81142032,64.57762269688575,71.94737278464417,NaN,NaN,16.631628021588778,17.94009182424795
2018-12-13T09:30:00-05:00,33.28,33.76,33.28,33.48,4652721,4815439.45,52.040413036432724,58.74660204171904,NaN,NaN,6.3510189279259075,71.64726102289505,-0.055214890186098486,0.2702273855392292,0.3254422757253277,80367665,79198284.6,59.544904342586136,70.93949742405067,NaN,NaN,14.563174857831907,17.457675114759944
2018-12-14T09:30:00-05:00,33.38,33.52,33.21,33.42,4138687,4803925.8,51.2334648858811,58.572263004010885,NaN,NaN,-23.664992925301828,35.12749310027182,-0.07246408818004824,0.2348621655002674,0.30732625368031563,76228978,77538786.4,55.56353827457403,69.86420577967796,NaN,NaN,12.679069562913861,16.775017178781933
2018-12-17T09:30:00-05:00,33.46,33.54,32.1,32.17,7213986,4806680.35,38.00997865256456,57.38079142707256,NaN,NaN,-187.6547413592862,-16.100115927755873,-0.16205077863000383,0.10476278039281084,0.2668135590228147,69014992,76268075,52.660027675671,68.81885689912532,NaN,NaN,5.778934849146707,15.20414827454833
2018-12-18T09:30:00-05:00,32.46,32.73,32.33,32.49,8109104,5025231.3,42.12797154890912,56.2980949910513,NaN,NaN,-174.11306774886287,-72.8688442504342,-0.19171784689515903,0.027166250403865888,0.21888409729902492,77124096,75690135,51.34583437669825,67.97472403874742,NaN,NaN,1.8470043579525777,13.295984857891796
2018-12-19T09:30:00-05:00,32.52,32.78,32.09,32.19,12877982,5435722.65,39.48009372733758,54.76788200988676,NaN,NaN,-169.84934731917937,-109.78622608494088,-0.22140324788325075,-0.05786996255503851,0.16353328532821224,64246114,73396369,46.39683332330039,66.67544328381332,NaN,NaN,-2.2056281970045672,11.081468707192315
2018-12-20T09:30:00-05:00,32.31,32.325,31.58,31.8,11332951,5672685.45,36.287034955434706,52.972364110890915,NaN,NaN,-193.60148519415864,-149.7767269093578,-0.25478294865071005,-0.15494540048517536,0.09983754816553472,52913163,67905468.6,37.162655925770274,64.46712975680255,NaN,NaN,-6.624699059350888,8.552016169114715
2018-12-21T09:30:00-05:00,31.6,32.1,30.9186,30.95,15124041,6243512.3,30.49763109767285,50.479451642557926,NaN,NaN,-213.19818446634497,-187.6833652175664,-0.31750376935669034,-0.2970421635303282,0.02046160582636214,37789122,60217497.4,28.584509081751335,61.30176420349287,NaN,NaN,-12.656569121871128,5.522218270402452
2018-12-24T09:30:00-05:00,31.1,31.1,29.8009,29.81,10641039,6648416,24.7860078244657,47.44866803001147,NaN,NaN,-250.0429142828858,-200.1609998022863,-0.41311057373787863,-0.49592661134598615,-0.08281603760810752,27148083,51844115.6,22.494290707459555,57.40268037114937,NaN,NaN,-20.25932297958045,1.8391409489763237
2018-12-26T09:30:00-05:00,29.91,30.77,29.52,30.76,10947937,7033705.35,35.60846046016462,45.85025558275938,NaN,NaN,-185.66950247235766,-202.47228674698528,-0.38999732897074785,-0.5703126988215423,-0.1803153698507945,38096020,44038500.4,18.530729488087218,53.096672623448676,NaN,NaN,-22.104284340921367,-1.5813483781519175
2018-12-27T09:30:00-05:00,30.56,30.84,29.93,30.83,14151826,7579618.15,36.33537665635423,43.6070561719829,NaN,NaN,-142.23139861592827,-196.94869700633507,-0.34895495322900644,-0.6165090613870525,-0.2675541081580461,52247846,41638846.8,17.509300535474168,48.57391831563569,NaN,NaN,-23.174779975796746,-4.666124320672607
2018-12-28T09:30:00-05:00,31.11,31.24,30.6773,30.94,10390956,7916882.9,37.52885442875121,42.04820761369323,NaN,NaN,-101.21701541842462,-178.47180305118826,-0.2954784092156065,-0.6369021196775542,-0.3414237104619477,62638802,43583974.6,21.296298535028086,44.2772138269812,NaN,NaN,-23.581178640079614,-7.3682749377307495
2018-12-31T09:30:00-05:00,31.04,31.05,30.51,31,7807197,8177205.55,38.2092831594149,40.67472733616654,NaN,NaN,-94.66648118336066,-154.76546239459142,-0.23952912634952817,-0.6408351183988579,-0.4013059920493297,70445999,50115350,32.50162680450124,41.22911564843532,NaN,NaN,-23.680394180550024,-9.698577686704931
2019-01-02T09:30:00-05:00,30.8,30.85,30.11,30.29,10467418,8484215.25,33.552181508216265,38.92061871646918,NaN,NaN,-104.41332508987678,-125.63954455598964,-0.23355659834403814,-0.6932517399793774,-0.45969514163533925,59978581,56681449.6,41.51633207033935,39.2631788455805,NaN,NaN,-25.293985242691114,-11.926493051845814
2019-01-03T09:30:00-05:00,30.26,30.93,30.25,30.43,9743843,8705344.7,35.22860767323796,37.92323997248843,NaN,NaN,-87.10985404442819,-105.92761487040374,-0.2044442848854322,-0.7152504977421295,-0.5108062128566973,69722424,63006730.4,48.63332749804427,38.12430061709182,NaN,NaN,-26.050711064092784,-13.94423848216681
2019-01-04T09:30:00-05:00,30.68,31.02,30.47,30.74,9620865,8862549.2,38.904248412102625,36.984942499321996,NaN,NaN,-68.80452845195661,-91.2422408376094,-0.15103954504518735,-0.6996056441631815,-0.5485660991179941,79343289,68425819,53.81847890716829,37.71527022884768,NaN,NaN,-25.54433715415864,-15.6013954353085
2019-01-07T09:30:00-05:00,30.78,31.22,30.75,31,5143676,8801309.05,41.88309827357711,36.31705916987171,NaN,NaN,-50.51227202273401,-81.10129215847128,-0.08805498119657273,-0.65863482561371,-0.5705798444171373,84486965,72795451.6,57.54033775966025,37.85647019206812,NaN,NaN,-24.220899304534715,-16.832753130912245
2019-01-08T09:30:00-05:00,31.19,31.61,31.09,31.54,7575948,8902109.8,47.597783991338545,37.001902408355555,NaN,NaN,-22.1863471929739,-66.60526536039393,-0.004298083182765033,-0.5759524483955936,-0.5716543652128285,92062913,77118834.4,60.89812161915551,38.4449054737456,NaN,NaN,-21.28236921065737,-17.468412570875834
2019-01-09T09:30:00-05:00,31.58,31.63,31.14,31.41,5100840,8699255.8,46.41452959503774,37.30808512593618,NaN,NaN,-18.14137160985991,-49.35087466439056,0.045339797906356005,-0.5149796178298836,-0.5603194157362396,86962073,82515532.8,64.65551761808322,39.395597133844525,NaN,NaN,-19.239916239695194,-17.721484523564314
2019-01-10T09:30:00-05:00,31.32,31.95,31.26,31.91,7837241,8858855.5,51.41702641497289,38.160723175052986,NaN,NaN,10.689259313001607,-29.791051992904606,0.11109223006728652,-0.42145412815213135,-0.5325463582194179,94799314,87530910.8,67.75645071222243,40.921284090196096,NaN,NaN,-15.920730089193649,-17.46423389008279
2019-01-11T09:30:00-05:00,31.81,31.9895,31.68,31.97,3095107,8798668.25,51.99616386248942,39.28280381127119,NaN,NaN,33.287191820308465,-9.372707938451589,0.15516512576092883,-0.33858995101825684,-0.4937550767791857,97894421,91241137.2,69.8629119925648,43.25701666639571,NaN,NaN,-13.064725508234327,-16.83573269267587
2019-01-14T09:30:00-05:00,31.85,32.06,31.74,31.87,2918330,8711948.7,50.90696250892197,40.74061319778898,NaN,NaN,46.38822899102663,10.007392264300538,0.17277485506091195,-0.2777865079530457,-0.45056136301395766,94976091,93338962.4,71.01589805502229,46.28783016448648,NaN,NaN,-10.997242071410977,-16.00166260392374
2019-01-15T09:30:00-05:00,31.89,32.3,31.89,32.23,3925044,8701266.55,54.59446914333965,42.86978900627997,NaN,NaN,83.27126692357085,31.098915087609488,0.2018371897461525,-0.19826487583126706,-0.40010206557741956,98901135,94706606.8,71.77405622630647,49.80781341583269,NaN,NaN,-8.130365326452191,-14.877191564284947
2019-01-16T09:30:00-05:00,32.2,32.515,32.11,32.38,7295977,8705366.1,56.0749362046408,44.33168013088541,NaN,NaN,107.11022063889983,56.14923353736144,0.2226925628209998,-0.12173636205116978,-0.3444289248721696,106197112,98553614.6,73.84641860022927,53.75893406669998,NaN,NaN,-5.301972868729607,-13.509303179205613
2019-01-17T09:30:00-05:00,32.34,32.58,32.29,32.54,3397134,8469767.6,57.660730176597916,45.85491966804568,NaN,NaN,122.06442102493763,78.42426587974865,0.23744131347670028,-0.047627283026294265,-0.28506859650299454,109594246,101512601,75.34580197819332,57.89011274117992,NaN,NaN,-2.459971402338076,-11.930827211081679
2019-01-18T09:30:00-05:00,32.67,32.67,32.3936,32.66,7865642,8219150.6,58.860342665563806,47.37859739924658,NaN,NaN,129.74732615783932,97.71629274725481,0.24449551428893068,0.02055079635816881,-0.22394471793076187,117459888,105425694.4,77.20681125784535,61.88372079280973,NaN,NaN,0.2773598060560079,-10.186800494347724
2019-01-22T09:30:00-05:00,32.63,32.72,32.33,32.6,8116287,8058317.4,57.97583958691115,48.79049428692489,NaN,NaN,117.81830648948146,112.00230824694577,0.23431269324378157,0.06894614862396509,-0.16536654461981648,109343601,108299196.4,78.490790720031,65.16866107249042,NaN,NaN,2.365467248907642,-8.393619388168386
2019-01-23T09:30:00-05:00,32.77,32.77,32.41,32.62,3087514,7456491.05,58.20131676561194,50.551146805310296,NaN,NaN,107.13059850776449,116.7741745637845,0.21843120822146175,0.10767246565701072,-0.11075874256445103,112431115,111005192.4,79.65317561287705,67.89272132552883,NaN,NaN,4.189715706963626,-6.596000088863812
2019-01-24T09:30:00-05:00,32.57,32.825,32.39,32.75,4578045,7153341.35,59.71436173273648,52.30012923813162,NaN,NaN,100.86024349497056,115.52417913499865,0.20633253881981203,0.14715693096031401,-0.05917560785949802,117009160,113167602,80.55739827124783,70.17301209504338,NaN,NaN,6.16699095385197,-4.772715654190129
2019-01-25T09:30:00-05:00,32.86,33.16,32.66,33.13,3031405,6757514.75,63.83532487691121,54.08092041418938,NaN,NaN,119.02862397941783,114.91701972589469,0.21272323956767739,0.20672844160009873,-0.005994797967578659,120040565,115256865.8,81.41669225268829,72.14431304829479,NaN,NaN,9.097130634571691,-2.7913090415098694
2019-01-28T09:30:00-05:00,33.02,33.49,32.96,33.46,5276029,6313724.9,66.99301404038209,55.87448582610397,NaN,NaN,134.26839081083892,115.82123265649462,0.22669198574996952,0.27737018421988324,0.05067819846991373,125316594,116828207,82.05893257671045,73.89564124951266,NaN,NaN,12.613876019789338,-0.5905683184671258
2019-01-29T09:30:00-05:00,33.34,33.74,33.28,33.72,2530031,5920678.65,69.26966374109566,57.4224772368009,NaN,NaN,141.35677014987286,120.52892538857289,0.2396943258844403,0.3502961058254641,0.1106017799410238,127846625,120528811.8,83.50477109645175,75.5104019264624,NaN,NaN,16.344110131896418,1.828671460156237
2019-01-30T09:30:00-05:00,33.76,34.12,33.63,34,5119342,5786285.9,71.5458380145359,59.217570695336484,NaN,NaN,151.72644492101313,129.4480946712226,0.2521393786978286,0.42577600331330956,0.17363662461548096,132965967,124635782.2,84.95396691866455,76.96029116221821,NaN,NaN,20.273006636905176,4.463576485406085
2019-01-31T09:30:00-05:00,33.97,34.39,33.66,34.33,7024510,5614140.5,73.9909732866911,60.82999547188779,NaN,NaN,154.82344273172797,140.2407345185741,0.2661989509261348,0.5063853132731495,0.24018636234701468,139990477,129232045.6,86.39458403543574,78.2915863995906,NaN,NaN,24.460021813591226,7.320211532289676
2019-02-01T09:30:00-05:00,34.38,34.47,33.67,34.12,9829209,5618408.8,69.87592711532473,62.10712141851888,NaN,NaN,140.050495585474,144.44510883978532,0.24546518691951424,0.5470178459964075,0.3015526590768932,130161268,131256186.2,86.98556348316833,79.51463293463371,NaN,NaN,26.84491207785487,10.109454467370417
2019-02-04T09:30:00-05:00,34.08,34.34,33.8,34.32,6513595,5463045.3,71.50152447571665,63.578161559004215,NaN,NaN,131.1501056619122,143.82145180999999,0.22961630934167115,0.5885730457539822,0.358956736412311,136674863,133527840,87.63472176149185,80.70169177081009,NaN,NaN,29.346331413758914,12.857579745425918
2019-02-05T09:30:00-05:00,34.36,34.56,34.13,34.55,4186255,5415174.25,73.28680957213987,64.91332873248994,NaN,NaN,132.16368345140722,141.98283447030684,0.21905119619200852,0.6327707316523217,0.41371953546031315,140861118,136130738.6,88.35167137129675,81.8858071383094,NaN,NaN,32.014033354667646,15.594215975317594
2019-02-06T09:30:00-05:00,34.45,34.49,34.1646,34.28,3535191,5213136.4,67.90867323238453,65.75859566304307,NaN,NaN,109.16476813993346,133.47049911409093,0.17994359101727736,0.6386490242319098,0.4587054332146325,137325927,137002730.6,88.59034109748559,82.93894445954199,NaN,NaN,32.75669752953746,18.045999054491862
2019-02-07T09:30:00-05:00,34.2,34.585,34.09,34.57,6325257,5274357.25,70.41957284762087,66.66994156811613,NaN,NaN,104.43168544622338,123.39214765699,0.1603239539818161,0.6591103756919026,0.49878642171008647,143651184,137734872,88.79788073811068,83.89980722810752,NaN,NaN,34.13510362364143,20.34444256437037
2019-02-08T09:30:00-05:00,34.43,34.67,34.37,34.57,2913078,5028149.1,70.41957284762087,67.4956008668345,NaN,NaN,102.64107177769272,115.91026289543375,0.13507495839623396,0.6676301197053789,0.5325551613091449,143651184,140432855.2,89.55208177157351,84.78161226480238,NaN,NaN,35.252947514203036,22.47422898577504
2019-02-11T09:30:00-05:00,34.6,34.72,34.45,34.67,2971860,5021986.75,71.31707697345007,68.44854639444442,NaN,NaN,98.53577815144138,109.3873973933396,0.11369508722954946,0.6746740203460817,0.5609789331165322,146623044,142422491.4,90.0823722750404,85.6095823758745,NaN,NaN,36.440688718499906,24.469437519021447
2019-02-12T09:30:00-05:00,34.7,34.7,34.293,34.43,8982910,5325215.75,66.13106567120056,69.0149570305579,NaN,NaN,80.23753416019649,99.00216753509744,0.07390393666639583,0.653358853949527,0.5794549172831311,137640134,141778294.6,88.51585663895342,86.24263102059422,NaN,NaN,36.031972345386365,26.12122820850215
2019-02-13T09:30:00-05:00,34.41,34.68,34.3,34.66,3751846,5316555.85,68.49543182179109,69.64217632263322,NaN,NaN,79.7983275510468,93.1288794173201,0.05448473070097626,0.6475608306593514,0.5930760999583752,141391980,142591505.2,88.78108199709287,86.83003700101173,NaN,NaN,36.32987431990416,27.57960622441672
2019-02-14T09:30:00-05:00,34.68,34.92,34.47,34.79,4006996,5152106.8,69.77957647351917,70.06676572239094,NaN,NaN,89.04079976080865,90.05070228023716,0.04234630370052528,0.6460089795840318,0.6036626758835065,145398976,142941063.6,88.89975458553631,87.36454145335802,NaN,NaN,36.93578607382777,28.916203345761158
2019-02-15T09:30:00-05:00,34.89,35.01,34.79,35,2674768,5115988.5,71.78058546923701,70.40873511016629,NaN,NaN,102.56554385155655,90.03559669500993,0.04041654161786057,0.6541833529058323,0.6137668112879717,148073744,143825575.6,89.21075374600572,87.8753858225934,NaN,NaN,38.02089438345118,30.216873494002588
2019-02-19T09:30:00-05:00,34.95,35.12,34.88,35.04,3921311,4918771.95,72.1587343752522,70.61509729832034,NaN,NaN,106.03149035669622,91.53473913606089,0.03404541392533411,0.6563235786946393,0.6222781647693052,151995055,144899977.8,89.59220005325956,88.31020217665109,NaN,NaN,39.02613318835476,31.475339164624327
2019-02-20T09:30:00-05:00,34.87,35,34.5632,34.82,3200288,4672972,66.85257418921293,70.27986416794012,NaN,NaN,81.00590030134086,91.68841236428977,0.008554320375924518,0.6329710652392109,0.6244167448632864,148794767,147130904.4,90.3547346707619,88.69597130180091,NaN,NaN,38.43724481917498,32.46989711527442
2019-02-21T09:30:00-05:00,34.69,34.89,34.48,34.88,4484154,4742804,67.55334283520003,69.82003342140504,NaN,NaN,72.1418271637022,90.15711228682086,-0.00973506326894591,0.6122479157771039,0.6219829790460498,153278921,149508292.6,91.10282218031269,89.03227402643496,NaN,NaN,38.12625329726086,33.27794799841534
2019-02-22T09:30:00-05:00,34.92,35.22,34.76,35.08,3477804,4687791.95,69.8420493696328,69.81761358242706,NaN,NaN,108.27962053846815,94.00487644235275,-0.013595133840656581,0.6049890617452292,0.6185841955858857,156756725,151779842.4,91.76040566589027,89.37333418234368,NaN,NaN,38.468832756881525,34.01950296391051
2019-02-25T09:30:00-05:00,35.14,35.19,34.75,34.79,4075825,4740012.95,62.912431221407275,69.20410692140496,NaN,NaN,89.27898182139488,91.34756403632042,-0.039448508453145514,0.5692735600194538,0.6087220684725994,152680900,152701273.6,92.01811458577768,89.68643366979268,NaN,NaN,36.77621126347586,34.41331843527699
2019-02-26T09:30:00-05:00,34.89,34.95,34.66,34.72,2674701,4609946.55,61.330620859782584,68.35009344195086,NaN,NaN,59.069913877966194,81.95524874057442,-0.06360178616916201,0.5292198357611468,0.5928216219303089,150006199,152303502.4,90.69930323451878,89.85412166002281,NaN,NaN,34.913944116752376,34.48483638977348
2019-02-27T09:30:00-05:00,34.59,34.77,34.33,34.61,3252267,4646058.35,58.827522948173815,67.70143985022153,NaN,NaN,4.049256856044133,66.56392005151507,-0.08783106657425321,0.48303278871249233,0.5708638552867455,146753932,151895335.4,89.28520979720912,89.9037551385745,NaN,NaN,32.62350795755142,34.21893232802747
2019-02-28T09:30:00-05:00,34.6,35.12,34.49,34.71,5002118,4640197.15,60.409441444157245,66.98643046425984,NaN,NaN,50.19600017105968,62.174754652986564,-0.09723595090779324,0.44931891665200396,0.5465548675597972,151756050,151590761.2,88.18040349274844,89.85964962104863,NaN,NaN,31.08369077888775,33.77104067815037
2019-03-01T09:30:00-05:00,34.77,34.77,34.265,34.67,5897514,4583847.35,59.42588911607391,66.20116734057791,NaN,NaN,-16.01463333981593,37.31590387732975,-0.10556902393590117,0.4145935876399207,0.5201626115758219,145858536,149411123.4,80.50331919279887,89.21330943685042,NaN,NaN,29.521534991957193,33.16396843726563
2019-03-04T09:30:00-05:00,34.77,34.85,34.405,34.81,6178613,4401317.55,61.77189017218183,65.51936828334446,NaN,NaN,13.709701102444537,22.202047733539683,-0.10106568029717228,0.3938305112043565,0.4948961915015288,152037149,149282373.2,80.05992736505641,88.49742051470871,NaN,NaN,28.76198671600131,32.535113905656445
2019-03-05T09:30:00-05:00,34.75,35.04,34.69,34.91,4066400,4278957.8,63.39976035441871,65.32427504643148,NaN,NaN,75.16884319754875,25.421833597456235,-0.09107514951317391,0.3810522546100614,0.47212740412323534,156103549,150501843.2,81.12057366889861,87.96918601684766,NaN,NaN,28.531932215440715,31.9632308070542
2019-03-06T09:30:00-05:00,34.92,35.05,34.76,34.82,3832295,4261259.8,60.886790838644096,64.78080069049241,NaN,NaN,67.519907041219,38.115963634491216,-0.09008685370027403,0.3595188369978928,0.4496056906981668,152271254,151605307.6,82.05094704682308,87.48846209182838,NaN,NaN,27.667134628435306,31.349502781537215
2019-03-07T09:30:00-05:00,34.84,35.09,34.68,34.79,7592561,4464128.3,60.03260916019165,64.08458873954045,NaN,NaN,52.67135701255307,38.61103500278989,-0.0907584064732444,0.3361576826066113,0.4269160890798557,144678693,150189836.2,76.8212412616938,86.62571114012535,NaN,NaN,26.711247718251553,30.686894915353548
2019-03-08T09:30:00-05:00,34.72,34.985,34.6562,34.82,3120329,4303881.9,60.62745622844229,63.28793665091224,NaN,NaN,32.08042373581741,48.23004641791656,-0.08839919968122195,0.31641708947832825,0.4048162891595502,147799022,150577933.4,77.24940560819172,85.77132913028149,NaN,NaN,26.039182916547293,30.022936058381227
2019-03-11T09:30:00-04:00,34.98,35.39,34.9316,35.36,4124138,4364434.9,69.44328868164756,63.093976244226205,NaN,NaN,204.8026907583476,86.44864434909718,-0.051515556823479136,0.3404218431302013,0.39193739995368043,151923160,150555135.6,77.15923907437696,84.88326048893272,NaN,NaN,27.983466306802722,29.731583236727154
2019-03-12T09:30:00-04:00,35.41,35.63,35.39,35.55,4323816,4432032.7,71.83304834343386,63.44972439809913,NaN,NaN,267.78794463771567,124.97246463713054,-0.017144935756798707,0.37050623025768203,0.38765116601448074,156246976,150583821,77.19530749314012,83.94330140481689,NaN,NaN,30.395943260170593,29.826491811504788
2019-03-13T09:30:00-04:00,35.57,35.83,35.57,35.72,2725988,4119186.6,73.80690003890302,63.89640705550648,NaN,NaN,263.216707350159,164.11182469891855,0.012611530685789463,0.40341557937171757,0.3908040486859281,158972964,151924163,78.87400737107325,83.06981463272835,NaN,NaN,33.063786596298044,30.288962495046682
2019-03-14T09:30:00-04:00,35.73,35.82,35.61,35.81,4504403,4156814.45,74.81319661279569,64.25148900144669,NaN,NaN,211.20751213939525,195.819055724287,0.03278189392498321,0.43178141609215714,0.39899952216717394,163477367,155683897.8,82.71717870652084,82.42386984991626,NaN,NaN,35.58116303340197,31.044991143383154
2019-03-15T09:30:00-04:00,35.64,35.66,35.39,35.46,5436255,4228277.4,64.44427370586874,64.36090632176537,NaN,NaN,122.21887126284433,213.84674522969235,0.017732020971896634,0.42116454838204476,0.4034325274101481,158041112,157732315.8,84.38399804973794,81.8785758116277,NaN,NaN,34.58021565702814,31.55002321676101
2019-03-18T09:30:00-04:00,35.5,35.57,35.12,35.28,3318303,4260454.15,59.85007989436398,64.25515339566404,NaN,NaN,69.70866439652247,186.82793995732735,-0.007795686501818111,0.3936879192828755,0.4014836057846936,154722809,158292245.6,84.81510533079361,81.45827596136162,NaN,NaN,32.271021836953395,31.653023019645634
2019-03-19T09:30:00-04:00,35.31,35.37,35.07,35.18,3464275,4237602.35,57.40179133667163,64.15331542341387,NaN,NaN,39.431293407514644,141.15660971128713,-0.03342931200351368,0.3596969657803015,0.3931262777838152,151258534,157294557.2,80.54815931733489,80.8342009270849,NaN,NaN,29.615725556850396,31.3619805249606
2019-03-20T09:30:00-04:00,35.21,35.53,34.9474,35.34,8689846,4512080.25,60.20666239257648,64.13883120544382,NaN,NaN,47.70854137826316,98.05497651690796,-0.04111678311011324,0.3417302988961737,0.3828470820062869,159948380,157489640.4,80.75206889691563,80.30360559881112,NaN,NaN,28.21886103500265,30.912963454966608
2019-03-21T09:30:00-04:00,35.29,35.98,35.27,35.97,4798015,4527773.3,68.89219073706698,64.81499560694333,NaN,NaN,127.28102929962462,81.26967994895384,-0.007064946918223458,0.37401589835850757,0.38108084527673103,164746395,157743446,81.03067764883042,80.34127405995623,NaN,NaN,29.920439696444532,30.771174346606312
2019-03-22T09:30:00-04:00,35.97,36.3065,35.8,35.8,5026025,4605184.35,64.78314515057221,65.03008524825692,NaN,NaN,146.11518687539657,86.04894307146428,0.0003251963314228057,0.38148734069100954,0.38116214435958673,159720370,158079297.6,81.41405482641366,80.43799745005319,NaN,NaN,29.874433884407143,30.643068566292143
2019-03-25T09:30:00-04:00,35.82,35.97,35.665,35.83,4370843,4619935.25,65.1778599756627,65.15709236406006,NaN,NaN,106.91043115922596,93.48929642400496,0.0033796950222313993,0.38538676313737597,0.38200706811514457,164091213,159952978.4,83.42648959777983,80.60270573068753,NaN,NaN,29.964882479021902,30.54618483953925
2019-03-26T09:30:00-04:00,35.96,36.07,35.85,36.05,2357456,4604073,68.009511777239,65.66585814538827,NaN,NaN,120.83434100805887,109.76990594411382,0.015674226947014924,0.4015998517989132,0.3859256248518983,166448669,162991005.4,86.06176316890821,80.88919259655076,NaN,NaN,30.950632170728987,30.603963029709213
2019-03-27T09:30:00-04:00,36.11,36.22,35.71,35.93,2939068,4588413.05,64.9090056370922,66.0141721794526,NaN,NaN,103.75743726530784,120.97968512152275,0.011382002582634443,0.4001531280801913,0.3887711254975569,163509601,163703249.6,86.59971955130277,81.58765533152284,NaN,NaN,30.79176393244022,30.630791730099357
2019-03-28T09:30:00-04:00,36.01,36.235,35.89,36.23,3626548,4519634.55,68.74522951888432,66.59401312876989,NaN,NaN,116.31366948186906,118.78621315797163,0.02369600312600728,0.41839112940506595,0.3946951262790587,167136149,164181200.4,86.96333692144795,82.28150756818401,NaN,NaN,31.888001818964064,30.810393171365742
2019-03-29T09:30:00-04:00,36.22,36.29,36.065,36.22,3565689,4403043.3,68.47650130776387,66.52495688777819,NaN,NaN,117.61462779481619,113.08610134185555,0.02593545970130584,0.427114450905691,0.40117899120438516,163570460,164951218.4,87.54950184958633,83.02366919498468,NaN,NaN,32.67367241866119,31.076575920979376
2019-04-01T09:30:00-04:00,36.27,36.29,35.7699,36.11,6733127,4430769,65.44588865212407,66.06873119554179,NaN,NaN,88.39968347764795,109.38395180553997,0.015302112738934337,0.4203066321280531,0.40500451938911874,156837333,163500442.4,80.2301108313669,83.24044086200088,NaN,NaN,32.43457257046101,31.270575442333897
2019-04-02T09:30:00-04:00,36.15,36.485,35.88,36.42,6604514,4557674.7,69.53761403527915,65.76378219528293,NaN,NaN,112.69413337218903,107.75591027836599,0.023926301718527665,0.4349123965372783,0.41098609481875065,163441847,162899078,77.34363526332184,83.13112856859004,NaN,NaN,33.48804414712052,31.58735668587484
2019-04-03T09:30:00-04:00,36.41,36.5399,36.1,36.38,3581255,4545122.7,68.41191708009868,65.30654794294743,NaN,NaN,118.04087069758666,110.61259696482175,0.02177793169137404,0.4382085094329682,0.41643057774159414,159860592,162169276.2,73.87025760899627,82.49920563305258,NaN,NaN,34.007185220438465,31.933046476526787
2019-04-04T09:30:00-04:00,36.42,36.43,36.11,36.27,3507681,4340878.7,65.28213958649243,65.36639550584913,NaN,NaN,100.04620216586964,107.35910350162187,0.00847327870599135,0.42702217612408333,0.418548897418092,156352911,160012628.6,64.63304421629641,81.08842321637819,NaN,NaN,33.53414509391942,32.16177485044002
2019-04-05T09:30:00-04:00,36.31,36.5869,36.21,36.55,2869863,4328355.4,69.15091895812373,66.03074115326054,NaN,NaN,125.69928820171445,108.97603558300152,0.01374311216265428,0.43572778762140985,0.42198467545875556,159222774,159143091.4,61.30447782340265,79.40909268013597,NaN,NaN,34.28290293811386,32.464793148679135
2019-04-08T09:30:00-04:00,36.54,36.59,36.27,36.37,2918493,4268073.15,64.19820704352546,66.51619941803581,NaN,NaN,108.11501793302165,112.91910247407625,0.0009913718071147826,0.42322389021764906,0.4222325184105343,156304281,159036481,60.89043261630888,78.00496934434841,NaN,NaN,33.41019003387115,32.59984984656371
2019-04-09T09:30:00-04:00,36.38,36.43,36.21,36.26,2094520,4156608.35,61.30839293679331,66.59489445690843,NaN,NaN,78.45353976648795,106.07098375293603,-0.017922497646971958,0.39982939635181936,0.4177518939987913,154209761,157190063.8,54.07815444492671,76.0996897406349,NaN,NaN,31.817918162271653,32.48814532023627
2019-04-10T09:30:00-04:00,36.35,36.55,36.31,36.55,2606206,4150619.25,65.6929021323133,66.36637384228318,NaN,NaN,104.53489226457806,103.36978806633434,-0.014139259424718553,0.40007781971789314,0.4142170791426117,156815967,156581138.8,52.01152985225896,74.02689346945124,NaN,NaN,31.758510335801788,32.38391175103134
2019-04-11T09:30:00-04:00,36.56,36.7,36.3501,36.5,3705545,4110676.35,64.3391589394673,66.33466054148997,NaN,NaN,102.9196601401001,103.94447966118041,-0.01799401689180108,0.3917245580278603,0.4097185749196614,153110422,155932641,49.82759806467245,71.77071798646972,NaN,NaN,31.30719589005312,32.23009519946302
2019-04-12T09:30:00-04:00,36.45,36.7,36.2,36.7,2691282,3973427.7,67.2466490793146,66.4824311917508,NaN,NaN,98.54965115789548,98.51455225241662,-0.010438621369555867,0.3966702982077166,0.40710891957727247,155801704,155248427,47.55858748292684,69.20872497826595,NaN,NaN,31.792397170988966,32.167566909681014
2019-04-15T09:30:00-04:00,36.71,36.71,36.37,36.48,2115294,3913277.25,61.32376978606412,66.00487819238118,NaN,NaN,90.57732760452107,95.0070141867165,-0.022907256396777875,0.37847484908130014,0.401382105478078,153686410,154724852.8,45.838433592453846,66.3356300085192,NaN,NaN,30.391922170608666,31.91390337552782
2019-04-16T09:30:00-04:00,36.49,36.49,35.44,35.62,3994518,3939789.4,44.73622742199311,64.56396546273125,NaN,NaN,-77.53717196029788,63.808871841359334,-0.08806403396320683,0.29130206302406947,0.3793660969872763,149691892,153821279,42.95118872606116,63.21787780671623,NaN,NaN,22.69656950294846,30.59714139373077
2019-04-17T09:30:00-04:00,35.73,35.8,35.135,35.25,4323531,3721473.65,39.75401587990866,62.493164488518694,NaN,NaN,-201.28546897583522,2.6447995932766846,-0.1513577215701959,0.1901689450245314,0.3415266665947273,145368361,151531757.8,36.65159611834029,59.62418203506569,NaN,NaN,14.514806434615865,28.29966497100007
2019-04-18T09:30:00-04:00,35.41,35.59,35.11,35.53,2756855,3619415.65,44.767064557829634,60.79963329209482,NaN,NaN,-180.03935333496565,-53.94700310173647,-0.1683392444469713,0.13110261103601317,0.29944185548298446,148125216,150534716.6,34.292785070934556,55.82013083659057,NaN,NaN,9.836966971980788,25.662136685425885
2019-04-22T09:30:00-04:00,35.46,35.46,34.825,35.14,4012606,3568744.7,39.79950839926924,58.967748988319464,NaN,NaN,-200.8168636877038,-113.82030607085633,-0.19777715576495516,0.052220410776790516,0.24999756654174568,144112610,148196897.8,29.49889154957657,52.19647231646269,NaN,NaN,4.145983047059265,22.58840045137351
2019-04-23T09:30:00-04:00,35.27,35.63,35.14,35.54,5469085,3623656.8,46.37234777818146,57.31308711281249,NaN,NaN,-125.82618430332498,-157.10100845242553,-0.1826125775222651,0.02173184463891431,0.2043444221611794,149581695,147375954.8,28.017720337025025,48.67319267887005,NaN,NaN,1.9178414803398824,19.635463455511562
2019-04-24T09:30:00-04:00,35.64,35.93,35.55,35.79,3304210,3670994.5,50.04355743337671,56.00106142376092,NaN,NaN,-58.62224065590294,-153.31802219154653,-0.1494434137362601,0.017540154990854262,0.16698356872711437,152885905,148014757.4,30.924177873992164,45.605615554941174,NaN,NaN,1.4778971241408942,17.041525408172895
2019-04-25T09:30:00-04:00,35.68,35.86,35.46,35.75,4198357,3733958.95,49.46013866221647,54.87091850059836,NaN,NaN,-65.7251524653567,-126.20595888945084,-0.12489461765152537,0.010865296662707635,0.135759914314233,148687548,148678594.8,33.91059161238253,43.41115465466162,NaN,NaN,0.9493770479993165,14.74264707100524
2019-04-26T09:30:00-04:00,35.89,36.015,35.71,35.99,2517014,3678482.25,53.000604660497764,53.7173246221965,NaN,NaN,-24.74847863259688,-95.1477839489771,-0.08888218352724206,0.02465718490518043,0.11353936843242249,151204562,149294464,36.64713068694096,41.64991557348579,NaN,NaN,1.6776959840465626,12.876225487154
2019-04-29T09:30:00-04:00,35.87,36.07,35.575,35.62,3256824,3663039,47.478569438175384,52.523064793242916,NaN,NaN,-46.226461949393325,-64.22970360131498,-0.08629858892536138,0.00566613227572077,0.09196472120108215,147947738,150061489.6,39.98038937882724,40.15634105652281,NaN,NaN,0.47041887542578914,11.103967399764256
2019-04-30T09:30:00-04:00,35.64,36.075,35.39,36.03,4650163,3558890.8,53.286573230887896,51.950077671392535,NaN,NaN,-30.459399049380526,-45.15634655052611,-0.05482850989175339,0.02342908383639042,0.07825759372814381,152597901,150664730.8,42.54090444793327,39.33225177102329,NaN,NaN,1.4273253797294443,9.721589968330711
2019-05-01T09:30:00-04:00,36.06,36.47,35.96,36.03,6051274,3531228.8,53.286573230887896,51.063911321290725,NaN,NaN,25.095948553607943,-28.412708708623928,-0.032942932485847384,0.037078928120834576,0.07002186060668196,152597901,150607130,42.355097456529606,38.64250659989977,NaN,NaN,2.164825698130984,8.642052215445036
2019-05-02T09:30:00-04:00,36.04,36.46,36.04,36.1,5382631,3621297.6,54.28751480324315,50.345936740131854,NaN,NaN,34.90763332171584,-8.286151551209413,-0.013669693075310657,0.05293474426254363,0.06660443733785429,157980532,152465726.8,49.95119294754807,38.65133480581945,NaN,NaN,3.0617765445914435,7.844869976751665
2019-05-03T09:30:00-04:00,36.25,36.41,36.08,36.35,3223438,3607085.45,57.76796675829671,49.66888800291629,NaN,NaN,48.698981811854246,6.403340537680817,0.014474183914493094,0.08469716723097065,0.07022298331647756,161203970,154465608.4,56.58116179547878,39.295804399573164,NaN,NaN,4.8910946234588915,7.422902069138412
2019-05-06T09:30:00-04:00,36.19,36.34,35.97,36.2,3377164,3632450.5,55.05922954626215,49.221420842930435,NaN,NaN,33.18988549762083,22.286610027083647,0.02114260102879284,0.0966512346024686,0.07550863357367577,157826806,156441422,61.94478549418231,40.44625810683948,NaN,NaN,5.622027682145324,7.165634299567971
2019-05-07T09:30:00-04:00,36.08,36.14,35.32,35.58,3711849,3672118.3,45.551667188653724,49.27966654054905,NaN,NaN,-50.01511878014997,18.375466080929762,-0.016041443761013865,0.05545682887240844,0.0714982726334223,154114957,156744833.2,62.70665701366524,41.85736298452549,NaN,NaN,3.20312993153081,6.599562246991233
2019-05-08T09:30:00-04:00,35.65,35.92,35.565,35.58,3831514,3758968,45.55166718865372,49.693784491173695,NaN,NaN,-44.09430318450763,4.537415733306645,-0.03915859977520505,0.02255002291441599,0.06170862268962104,154114957,157048244.4,63.493738342746774,43.77465885769738,NaN,NaN,1.3122304977433643,5.844229139955823
2019-05-09T09:30:00-04:00,35.5,35.74,35.26,35.7,5684523,3912883.85,47.58340102970986,49.89495138202228,NaN,NaN,-62.345700300025264,-14.913250991041576,-0.04449969288023038,0.0060840065893330575,0.05058369946956344,159799480,157412034,64.46219947317819,45.92961702928621,NaN,NaN,0.35069840030082444,5.059439034290824
2019-05-10T09:30:00-04:00,35.62,36.2,35.595,36.11,3268361,3891024.65,53.91135693130669,50.9029405628821,NaN,NaN,27.414224999299346,-19.170202353552558,-0.019810558898502084,0.025820500846435834,0.04563105974493792,163067841,157784808.2,65.47297392502364,48.49919434181815,NaN,NaN,1.4625192487671896,4.54559335064459
2019-05-13T09:30:00-04:00,35.87,36.1699,35.8,36.11,3392058,3926063.45,53.91135693130669,51.44144121667676,NaN,NaN,50.853920482333855,-15.637395356609954,-0.0037133954553978388,0.04098931542569062,0.04470271088108846,163067841,158833015.2,68.21093550980036,51.37013828273068,NaN,NaN,2.3472389744283917,4.231542725470847
2019-05-14T09:30:00-04:00,36.18,36.39,36.1,36.24,3984429,4019520.2,55.870440923518274,51.85764718025829,NaN,NaN,113.7804053098824,17.121709461396524,0.014459407276917878,0.06277696997723581,0.04831756270031793,167052270,161420477.8,73.74550195780321,54.428804288717174,NaN,NaN,3.656572566170436,4.149404131285074
2019-05-15T09:30:00-04:00,36.24,36.61,36.1,36.48,3478218,3993705.2,59.309245160912525,52.561154787308006,NaN,NaN,132.34538766014262,52.409647630326575,0.039967519261456204,0.09827696177713818,0.05830944251568198,170530488,164703584,78.7911646365279,57.63455950472756,NaN,NaN,5.80815186764027,4.386368093621531
2019-05-16T09:30:00-04:00,36.48,36.84,36.45,36.69,2834171,3919237.2,62.09275537511447,53.21059412406635,NaN,NaN,168.02775465502754,98.48433862133713,0.06673045962081994,0.1417225170417069,0.07499205742088697,173364659,167416619.8,81.88871901077937,60.86610152785887,NaN,NaN,8.484343399607667,4.971793137333836
2019-05-17T09:30:00-04:00,36.52,36.71,36.44,36.64,3403223,3951555.6,61.022415123639945,54.1780116730281,NaN,NaN,136.5378352260308,120.30906066668342,0.07613225972991036,0.1701573820832749,0.09402512235336455,169961436,168795338.8,83.22920045126696,63.95530231874743,NaN,NaN,10.3903653269994,5.7458748787146305
2019-05-20T09:30:00-04:00,36.51,36.57,35.92,36.05,3472111,3924530.85,50.05726185896714,53.947346575033755,NaN,NaN,40.45073803615645,118.22842417744793,0.03952451629241446,0.14343076771888263,0.10390625142646817,166489325,169479635.6,83.86741829456247,66.90719616493523,NaN,NaN,8.775959328503934,6.178744085827388
2019-05-21T09:30:00-04:00,36.21,36.455,36.15,36.35,2353582,3768755.7,54.53122587031972,54.03625033499318,NaN,NaN,66.29143449175913,108.73063001382329,0.03270555714542327,0.14478819785824726,0.11208264071282399,168842907,169837763,84.2061691345907,69.89655842765389,NaN,NaN,8.823489061789424,6.556564796679107
2019-05-22T09:30:00-04:00,36.39,36.55,36.31,36.52,1982786,3702684.5,56.88806532429996,54.2220039436401,NaN,NaN,92.2463541850987,100.7108233188145,0.03654425311666229,0.15776295710865185,0.12121870399198956,170825693,169896804,84.2648300429823,72.34753250589918,NaN,NaN,9.599546965025969,6.991276535014373
2019-05-23T09:30:00-04:00,36.42,36.735,36.36,36.7,2521111,3618822.2,59.2939980025299,54.33100617537104,NaN,NaN,116.84861690145588,90.47499576810017,0.04741661495014238,0.18048947267966753,0.13307285772952515,173346804,169893233,84.2444491398523,74.32348160192586,NaN,NaN,10.98726003310821,7.56213132045635
2019-05-24T09:30:00-04:00,36.86,36.99,36.74,36.75,1523622,3569152.6,59.96239763595095,54.68123246749166,NaN,NaN,155.07531624991626,94.18249197287727,0.053723226755128806,0.20022689117343617,0.14650366441830737,174870426,170875031,85.29735495523218,75.99152227771513,NaN,NaN,12.308650007325337,8.24020541858049
2019-05-28T09:30:00-04:00,36.93,36.99,36.36,36.37,2496427,3531132.75,52.85858407921917,55.203155102532044,NaN,NaN,85.615837944099,103.2155119544658,0.02927347034106212,0.183095502344635,0.1538220320035729,172373999,172051965.8,86.46504528633615,77.68855001147735,NaN,NaN,11.311794499056104,8.679003858648436
2019-05-29T09:30:00-04:00,36.34,36.43,35.8016,35.95,2648701,3431059.65,46.325963925990294,55.2584620123418,NaN,NaN,-43.559273695215815,81.2453703170708,-0.015791511903328975,0.13408264212441168,0.14987415402774065,169725298,172228444,86.63643232444687,79.34159958159877,NaN,NaN,8.305421137287661,8.62563489845404
2019-05-30T09:30:00-04:00,35.99,36.285,35.93,36.17,2656216,3261306.75,49.824012856193,55.41850571423346,NaN,NaN,-25.9311823887436,57.60986300230233,-0.030536040586041424,0.11170410329518887,0.1422401438812303,172381514,172539608.2,86.95020004549065,80.94788533676396,NaN,NaN,6.919162151155433,8.381853077411382
2019-05-31T09:30:00-04:00,36.09,36.67,36.04,36.47,4582080,3221279.2,54.20675852954825,55.43960582839357,NaN,NaN,37.69466844979146,41.779073311969455,-0.020328352904663394,0.11682970275040105,0.13715805565506445,176963594,173262966.2,87.67468949049874,82.53372216286932,NaN,NaN,7.1480102680459705,8.205589818930608
2019-06-03T09:30:00-04:00,36.6,36.67,36.29,36.61,6621392,3391176.9,56.13244355049259,55.59825487262113,NaN,NaN,63.984776328377606,23.560965327661727,-0.005180697049241095,0.13068218434351309,0.13586288139275418,183584986,175005878.2,89.22666613624925,84.03484577904423,NaN,NaN,7.934896181565404,8.166919299307008
2019-06-04T09:30:00-04:00,36.62,36.62,36.1,36.41,3596835,3402160.45,52.72161997745773,55.373339090759664,NaN,NaN,26.737248128623023,11.785247364566526,-0.00941702783715101,0.12409159659631541,0.13350862443346642,179988151,176528708.6,90.36788685876414,85.22215898625574,NaN,NaN,7.546777914943151,8.078327672969314
2019-06-05T09:30:00-04:00,36.62,37.26,36.49,37.24,4495215,3441328.75,62.81882542460304,55.624023395308996,NaN,NaN,160.00103861760334,52.49730982713036,0.040172866580725,0.18372470765937265,0.14355184107864766,184483366,179480322.2,92.11201455633169,86.17364826624171,NaN,NaN,10.737519067738324,8.458212157936316
2019-06-06T09:30:00-04:00,37.34,37.38,37.08,37.31,2272535,3363379.8,63.52631953007487,55.72642083494902,NaN,NaN,200.46251348834397,97.77604900254786,0.07230742537102475,0.2339361227924286,0.16162869742140384,186755901,182355199.6,93.37106949078499,86.9938161576707,NaN,NaN,13.440311250476004,9.1699405997277
2019-06-07T09:30:00-04:00,37.52,37.66,37.38,37.43,2114012,3184854.25,64.76412575199141,55.99368587983127,NaN,NaN,220.02734609918772,134.24258453242712,0.09484285122655561,0.28018226145459835,0.18533941022804273,188869913,184736463.4,94.1972672497093,87.77724950041657,NaN,NaN,16.002619181262844,10.146037539947008
2019-06-10T09:30:00-04:00,37.48,37.51,37.13,37.3,3041358,3173504.1,62.297569823576005,56.86799359158904,NaN,NaN,155.97159887215284,152.63994904118218,0.09400980026620959,0.3028516605608047,0.20884186029459512,185828555,185185177.2,94.34041088701811,88.52532039987769,NaN,NaN,17.348174130994533,11.17491419581094
2019-06-11T09:30:00-04:00,37.4,37.48,37.115,37.37,2472168,3127509.6,63.112233203546346,57.48092268681951,NaN,NaN,133.90802802678093,174.07410502081376,0.09112277608069452,0.32274533039546327,0.23162255431476875,188300723,186847691.6,94.8475572624548,89.28541955186797,NaN,NaN,18.68425536680201,12.247677220238236
2019-06-12T09:30:00-04:00,37.42,37.69,37.38,37.51,2555518,3056064.05,64.7526348160993,58.042677650519465,NaN,NaN,143.81822598947053,170.8375424951872,0.09135925307640436,0.3458216206602742,0.25446236758386986,190856241,188122266.6,95.2024922196493,90.06668113591562,NaN,NaN,20.282565207179985,13.395518361229914
2019-06-13T09:30:00-04:00,37.54,37.615,37.415,37.56,2511316,3007718.95,65.3453633378989,58.47491803161724,NaN,NaN,122.49782764085843,155.2446053256901,0.08758926762392844,0.3639489521137804,0.276359684489852,193367557,189444597.8,95.54534612344524,90.87388806331512,NaN,NaN,21.77078907844958,14.59198560654701
2019-06-14T09:30:00-04:00,37.56,37.8463,37.56,37.72,1945880,2963304.4,67.24363981982705,58.995006759036976,NaN,NaN,127.91044106015431,136.82122431788338,0.08832604735557842,0.386767243684325,0.2984411963287466,195313437,190733302.6,95.85615592151446,91.62808813233528,NaN,NaN,23.58416139509,15.876582147767436
2019-06-17T09:30:00-04:00,37.82,38.175,37.82,38.13,4130206,2999653.55,71.54499530638242,60.329750418120064,NaN,NaN,147.2327890060783,135.07346234466849,0.10760206000904798,0.43294377134005657,0.3253417113310086,199443643,193456320.2,96.42392195779932,92.33943646601122,NaN,NaN,26.545785699122654,17.400754083675324
2019-06-18T09:30:00-04:00,38.33,38.49,37.87,38.02,4654378,3058766.9,68.92976460636675,61.944307609575525,NaN,NaN,138.49562370387557,135.9909814800874,0.10405719221228477,0.45541320159636456,0.3513560093840798,194789265,194754028.6,96.65886944303529,93.05532483162469,NaN,NaN,28.259366886859826,18.951984484130254
2019-06-19T09:30:00-04:00,37.99,38.395,37.81,38.27,4654331,3173804.35,71.4812508236785,63.49125317868163,NaN,NaN,125.720246058189,132.3713854938311,0.10913165807546965,0.48777058197841683,0.3786389239029472,199443596,196471499.6,96.94494444234567,93.76923514568576,NaN,NaN,30.509600877085557,20.603072540266727
2019-06-20T09:30:00-04:00,38.45,38.62,38.42,38.5,4478825,3298606.3,73.62700810608713,64.87841386272012,NaN,NaN,146.90087980193607,137.25199592604665,0.11781745700658941,0.525910745161184,0.40809328815459456,203922421,198582472.4,97.25594243458806,94.45361035597786,NaN,NaN,33.093295573773034,22.387390116481914
2019-06-21T09:30:00-04:00,38.17,38.17,37.58,37.77,9512509,3648176.2,58.565411046745226,65.0521972553096,NaN,NaN,67.14967959537985,125.09984363309177,0.06677795852747426,0.4915657363139374,0.42478777778646315,194409912,198401767.4,96.35173055718037,94.96254352890152,NaN,NaN,30.464541533867994,23.54126889039421
2019-06-24T09:30:00-04:00,37.86,37.99,37.52,37.58,5083625,3826176.35,55.38944182699666,65.2427559588481,NaN,NaN,47.045165580611034,105.06231894799832,0.015288713538222864,0.44389866970924174,0.4286099561710189,189326287,196378296.2,86.63824198572087,94.69614032368413,NaN,NaN,27.28358370423159,24.07588529237098
2019-06-25T09:30:00-04:00,37.62,37.76,37.06,37.07,3829009,3892805.45,47.88324539323747,64.17592881375056,NaN,NaN,-2.2223632411103837,76.91872155900113,-0.054239771038660456,0.3608102423726933,0.4150500134113538,185497278,194519898.8,78.78275484122085,93.74405034403335,NaN,NaN,21.86706169084743,23.760339063581903
2019-06-26T09:30:00-04:00,37.07,37.07,36.22,36.35,7944624,4157601.6,39.70304791022516,62.47426655518986,NaN,NaN,-100.85219952729643,31.60423244190405,-0.1447081894509673,0.23416477659764467,0.378872966048612,177552654,190141710.4,64.048918763335,91.64961100635837,NaN,NaN,13.957993089233497,22.36000392438927
2019-06-27T09:30:00-04:00,36.57,36.79,36.55,36.65,4578462,4253713.9,43.99615293469804,60.990839925383185,NaN,NaN,-94.22161733927861,-16.620266986338887,-0.17813501240300472,0.15620420054485606,0.3343392129478608,182131116,185783449.4,53.35240725613333,88.73212100681724,NaN,NaN,9.24272113306909,20.486106382772103
2019-06-28T09:30:00-04:00,36.71,36.9785,36.65,36.77,5010567,4275138.25,45.66270483777259,59.802635283540084,NaN,NaN,-82.03740983056113,-46.45768487152709,-0.1851381528664381,0.10291652186481315,0.28805467473125124,187141683,184329803.6,50.33305556484636,85.58873848380496,NaN,NaN,6.158342675454658,18.43928299601247
2019-07-01T09:30:00-04:00,36.95,37,36.2851,36.7,6780378,4283087.55,44.82475052336762,58.49638652067017,NaN,NaN,-103.77418489214467,-76.62155496607824,-0.18691571368796228,0.0544100326212984,0.24132574630926068,180361305,182536807.2,46.81388836678972,82.1577621341146,NaN,NaN,3.471191326500995,16.30098418608226
2019-07-02T09:30:00-04:00,36.8,37.39,36.77,37.38,5959009,4401196.25,53.71123278984605,57.70771494736637,NaN,NaN,-39.307887093455456,-84.03865973654726,-0.13703553316678047,0.07003132985078508,0.20706686301756555,186320314,182701414.4,47.179018073890845,78.72751398084615,NaN,NaN,4.0862866100319115,14.55602738950364
2019-07-03T09:30:00-04:00,37.49,37.9299,37.4479,37.92,3519524,4352411.7,59.315105906133894,57.276982273668864,NaN,NaN,46.593617630646904,-54.54949630495859,-0.06601422386970585,0.12454908318043323,0.19056330705013907,189839838,185158851.2,52.42956194936079,75.64781511126868,NaN,NaN,6.603295718583106,13.419922865086422
2019-07-05T09:30:00-04:00,37.64,37.839,37.13,37.71,5079182,4492744.05,56.45284806234176,56.506211433848485,NaN,NaN,11.772749177210782,-33.35062300166071,-0.03317790711187593,0.14909092316029415,0.18226883027217008,184760656,185684759.2,53.494955321418985,72.6220150684047,NaN,NaN,7.630919556154193,12.592922392381817
2019-07-08T09:30:00-04:00,37.68,37.93,37.62,37.85,3435871,4558837,57.91100875022784,55.53235525126602,NaN,NaN,46.80141513689202,-7.582858008170083,-0.0035847363976005964,0.17778790977516934,0.18137264617276994,188196527,185895728,53.94059545715683,69.58749174693025,NaN,NaN,8.919255318310721,12.06811281037166
2019-07-09T09:30:00-04:00,37.77,38.095,37.72,38.05,3166642,4565101.2,59.97299320627447,54.892585865545136,NaN,NaN,65.3999864394488,26.25197625814861,0.02626160046594217,0.21419964675519765,0.18793804628925548,191363169,188096100.8,58.41638066817671,66.85588540586892,NaN,NaN,10.62376041914245,11.861776754481774
2019-07-10T09:30:00-04:00,38.19,38.31,37.97,38.26,8591227,4871054.15,62.074002000487525,54.2206395210315,NaN,NaN,90.59271347209835,52.23209637125937,0.05528034380861763,0.2570384760500275,0.20175813224140987,199954396,190822917.2,63.190129064612165,64.44482716460224,NaN,NaN,12.686174613365639,11.979547877179469
2019-07-11T09:30:00-04:00,38.2,38.21,37.605,37.77,5157712,5001163.85,54.840661511209895,52.87875762139741,NaN,NaN,39.466679655523045,50.8067087762346,0.03746079733037874,0.2485841289043833,0.21112333157400456,194796684,191814286.4,64.77345908648925,62.12464978259518,NaN,NaN,12.203004865672932,12.011470304107107
2019-07-12T09:30:00-04:00,37.79,37.84,37.495,37.62,3620415,5056618.8,52.8118558210505,52.46778939099064,NaN,NaN,7.609198223659221,49.973998585524285,0.012830673235995849,0.22716167311899937,0.21433099988300353,191176269,193097409,66.76599972065513,60.01138329427196,NaN,NaN,11.184467892561418,11.893327102457723
2019-07-15T09:30:00-04:00,37.7,37.92,37.57,37.67,2650114,5091830.5,53.43030580729843,52.32785110386934,NaN,NaN,17.645183286795028,44.14275221550489,-0.0020427480971421663,0.21177756476157583,0.213820312858718,193826383,194223380.2,68.45235082423407,58.712391068451474,NaN,NaN,10.543005416257456,11.700424004429113
2019-07-16T09:30:00-04:00,37.63,37.746,37.49,37.61,3533020,5061971.2,52.54042629502839,52.6605068825687,NaN,NaN,5.47571206480879,32.157897340576895,-0.017036455018657165,0.19252474408539655,0.2095611991040537,190293363,194009419,67.74885781547377,57.92425556661239,NaN,NaN,9.765207098396985,11.423964446424524
2019-07-17T09:30:00-04:00,37.71,37.83,37.225,37.42,3227299,4990617.25,49.71663676297591,53.375763229193744,NaN,NaN,-8.928692023682492,12.253616241420719,-0.03957702649307937,0.1600899159877045,0.19966694248078387,187066064,191431752.6,59.77825739161871,57.61920832577552,NaN,NaN,8.3054629171244,10.978464227953078
2019-07-18T09:30:00-04:00,37.33,37.52,37.13,37.41,4028807,4959341.05,49.5656459288348,53.77358415734636,NaN,NaN,-25.282503930413565,-0.6962204757666008,-0.054088828922819326,0.13205590632725972,0.18614473525007905,183037257,189079867.2,53.58388402024725,57.63574238035509,NaN,NaN,7.060017614350286,10.418686140295536
2019-07-19T09:30:00-04:00,37.45,37.49,36.76,36.8,4515822,4961190.9,41.321598612174846,53.46350514123224,NaN,NaN,-70.3301061892605,-16.284081358350548,-0.10097494070391017,0.059926059370191354,0.16090100007410152,178521435,186548900.4,47.83888270800633,57.45758717629508,NaN,NaN,3.3876750349718168,9.414255982392149
2019-07-22T09:30:00-04:00,36.85,36.89,36.605,36.76,3030990,4637114.95,40.841886876333504,53.1790148807298,NaN,NaN,-101.02175943799102,-40.017469903307756,-0.12908858424558214,-0.00045973023287615433,0.128628854012706,175490445,182881712.8,40.98262576341967,57.04106841891151,NaN,NaN,0.25636192846114075,8.105985403259147
2019-07-23T09:30:00-04:00,36.85,37.13,36.72,37.12,3084844,4537175.9,46.82513257390408,52.68715057959109,NaN,NaN,-56.289960772365376,-52.37060447074259,-0.1181409602053827,-0.01904734624402238,0.09909361396136032,178575289,180538098,37.30312374445232,56.33564739538019,NaN,NaN,-0.780737943156678,6.836453496628315
2019-07-24T09:30:00-04:00,37.17,37.21,36.96,37.09,2663632,4478907.05,46.40393989226329,51.76492443574318,NaN,NaN,-38.14827486597965,-58.21452103920203,-0.10790400467277161,-0.035786391879604196,0.07211761279316742,175911657,178307216.6,34.159200751465036,55.030621595530484,NaN,NaN,-1.7454616661418578,5.610465616232576
2019-07-25T09:30:00-04:00,37.05,37.13,36.77,36.93,3237489,4243550.3,44.124316008383246,50.884315003317575,NaN,NaN,-66.86102663145056,-66.53022557940942,-0.10669948176047486,-0.06125673940742615,0.0454427423530487,172674168,176234598.8,31.502745366899447,53.45974945592195,NaN,NaN,-3.2080655838360577,4.3506754447941995
2019-07-26T09:30:00-04:00,36.96,37.15,36.77,37.05,2822339,4155744.15,46.256762368070454,50.05186883316348,NaN,NaN,-64.50123913098507,-65.36445216775434,-0.0931073201377749,-0.07094140781916991,0.02216591231860498,175496507,175629613.2,30.751010465430454,51.8033505279415,NaN,NaN,-3.8659814514329227,3.1768673167617534
2019-07-29T09:30:00-04:00,37.14,37.44,37.12,37.19,3030934,4056762.5,48.71582780568251,49.24778559026406,NaN,NaN,-25.521513416794853,-50.2644029635151,-0.07097478643945515,-0.06655257073071397,0.0044222157087411874,178527441,176237012.4,32.49273975538284,49.95166189131336,NaN,NaN,-3.7584959327981498,2.186101138253196
2019-07-30T09:30:00-04:00,37.19,37.6752,37.18,37.56,3455585,3890522.85,54.62493528220896,48.7157093961013,NaN,NaN,8.026328765249906,-37.401145055992046,-0.029809708394303195,-0.032839919784137805,-0.0030302113898346104,181983026,176918559.8,34.48396929139662,47.901221907512245,NaN,NaN,-1.937998613001375,1.5969440309311143
2019-07-31T09:30:00-04:00,37.6,37.89,37.19,37.41,6644017,3924773.25,52.008631413515026,48.513421531980235,NaN,NaN,10.236690912378542,-27.724151900320408,-0.011990584517275063,-0.01801844203642844,-0.006027857519153376,175339009,176804030.2,34.300871812987324,45.72460853083353,NaN,NaN,-1.135322448431832,1.206620248164979
2019-08-01T09:30:00-04:00,37.52,37.84,37.16,37.5,9956296,4246611.85,53.449284912883655,48.55895218139689,NaN,NaN,14.174000152353175,-11.517146543559656,0.005605207938921379,0.000978652404498348,-0.004626555534423031,185295305,179328257.6,41.653992185192486,43.93089370687192,NaN,NaN,-0.057174522257332654,1.0260781381046489
2019-08-02T09:30:00-04:00,37.54,38.045,37.465,37.79,4953608,4240333.15,57.840933317090574,48.8739970035249,NaN,NaN,67.62143919957028,14.907389122551411,0.03488937743178519,0.03898516625530846,0.0040957888235232665,190248913,182278738.8,48.858940192370845,42.53136437602455,NaN,NaN,2.186316109229682,1.1918264196939392
2019-08-05T09:30:00-04:00,37.7,37.7199,36.62,37.07,6359706,4386524.9,46.189836454096934,48.42038344345837,NaN,NaN,-57.52692589562354,8.506306626785673,0.005429110250733582,0.010882176636940244,0.005453066386206662,183889207,183351092,51.21680877634323,41.350503730372374,NaN,NaN,0.5420525378864246,1.0990015794357229
2019-08-06T09:30:00-04:00,37.15,37.68,37.02,37.53,6841522,4570268.9,52.73977631146187,48.63632198263594,NaN,NaN,5.8550060982642185,8.072042093388534,0.01598579338212522,0.025435308113863186,0.009449514731737966,190730729,185100632.6,54.8724415801388,41.000088315266666,NaN,NaN,1.3651400805596339,1.1370213653105672
2019-08-07T09:30:00-04:00,37.56,38.13,36.955,37.88,7396241,4510519.6,57.0259896222158,49.1692036750203,NaN,NaN,73.26485677943833,20.677675266800488,0.04401454906170856,0.06446770105887367,0.02045315199716511,198126970,189658224.8,62.711492432926335,41.65206034474374,NaN,NaN,3.5262029595129465,1.4783330216251929
2019-08-08T09:30:00-04:00,37.93,38.48,37.6,38.48,5601795,4532723.75,63.18937214079075,50.73118749849287,NaN,NaN,190.09654587757552,55.862184411844964,0.09737924553003394,0.14217720890970753,0.044797963379673594,203728765,193344916.8,67.6124977881162,43.06446142189445,NaN,NaN,7.644196093804675,2.3591706033651185
2019-08-09T09:30:00-04:00,38.39,38.63,38.09,38.47,4695743,4586490.15,63.02712607473469,52.31584744123581,NaN,NaN,206.15530550717403,83.5689576733657,0.12467583134901916,0.20064275256594755,0.07596692121692838,199033022,195101738.6,69.65901494888773,45.11277493514216,NaN,NaN,10.710919213635748,3.552277547689494
2019-08-12T09:30:00-04:00,38.46,38.585,38.205,38.43,3992784,4653623.65,62.337640522673894,53.423883723290785,NaN,NaN,181.50448063795105,131.3752389800806,0.1320038069486283,0.24097167990271373,0.10896787295408546,195040238,197331944.8,72.07161712419227,47.596238747980735,NaN,NaN,12.911380985915727,4.889292324578956
2019-08-13T09:30:00-04:00,38.44,38.6,38.09,38.46,5176067,4735776,62.667501294679894,54.585566680606256,NaN,NaN,152.6925808674336,160.74275393391449,0.13059807301872603,0.272215464227493,0.14161739120876696,200216305,199229060,73.96788163470342,50.439715953926324,NaN,NaN,14.775826138534287,6.3016542980011465
2019-08-14T09:30:00-04:00,38.36,38.36,37.81,37.86,5999560,4874389.05,52.72194173286323,55.1996828037834,NaN,NaN,78.70684704620538,161.8311519872679,0.08328912242046288,0.24572879423434557,0.1624396718138827,194216745,198447015,71.8035598689913,53.31834556121861,NaN,NaN,13.327365637400975,7.305327346486836
2019-08-15T09:30:00-04:00,37.97,38.47,37.86,38.39,5501448,4948021.1,58.92336042391733,56.10443980777246,NaN,NaN,99.15158720058469,143.64216025186974,0.08161306562855306,0.264456003849574,0.18284293822102096,199718193,197644900.6,69.55554260801094,56.09009785711721,NaN,NaN,14.126777549856984,8.279820232682571
2019-08-16T09:30:00-04:00,38.48,38.76,38.37,38.66,3766892,4910574.6,61.680885466775386,57.03051535499338,NaN,NaN,129.9693049727911,128.40496014499314,0.09184807900720732,0.2976530369800301,0.20580495797282278,203485085,198535313.2,70.65390011829422,58.81589502589659,NaN,NaN,15.69333681587985,9.338894030282182
2019-08-19T09:30:00-04:00,38.84,39.09,38.65,39.01,2930852,4905567.7,64.96429035195823,57.76904071711833,NaN,NaN,149.82489058251826,122.0690421339066,0.11390825685352915,0.3481902790397342,0.23428202218620506,206415937,200810453,73.30411608015167,61.58876265366481,NaN,NaN,18.094722837805165,10.58972671707118
2019-08-20T09:30:00-04:00,39.06,39.15,38.69,38.72,3245447,4913597.85,60.35003980038756,58.36485560189494,NaN,NaN,123.98443324302116,116.32741260902412,0.10112086291931216,0.36068310083534527,0.2595622379160331,203170490,201401290,73.96175404821093,64.42168281332364,NaN,NaN,18.57313725858402,11.7302139372873
2019-08-21T09:30:00-04:00,38.81,38.9766,38.66,38.88,3480651,4954448.8,61.95559037841699,58.97244884943303,NaN,NaN,109.01184085964194,122.38841137171141,0.09564949623961305,0.3791241082155494,0.2834746119759364,206651141,203888169.2,76.57723967130144,66.91620049090285,NaN,NaN,19.464899938777748,12.835169080357364
2019-08-22T09:30:00-04:00,38.92,39.11,38.64,39.07,2511056,4918127.15,63.828701886858894,59.40014660441648,NaN,NaN,110.51395139965831,124.66088421152615,0.09674701715509587,0.4044083834198062,0.30766136626471036,209162197,205776970,78.35553398404996,69.02310004745136,NaN,NaN,20.776760753142057,13.969682176469462
2019-08-23T09:30:00-04:00,39.08,39.3375,38.4149,38.58,6048089,5079414.65,56.15059259588953,60.111629185973094,NaN,NaN,83.6214900378335,115.39132122453464,0.0582877382767607,0.38052103911066126,0.32223330083390056,203114108,205702774.6,78.10468165506897,70.94366239593178,NaN,NaN,19.46686211558856,14.754993596343619
2019-08-26T09:30:00-04:00,38.77,38.95,38.59,38.94,3620971,5108916.5,59.96133001242236,60.62745445032742,NaN,NaN,83.47200358809955,102.12074382565089,0.05116328727905861,0.3861874099327238,0.3350241226536652,206735079,205766603,78.16943097029556,72.60773306665725,NaN,NaN,19.58389156661445,15.444836163525165
2019-08-27T09:30:00-04:00,39.12,39.23,38.79,38.81,3042290,5088251.75,58.001099884526994,60.69710518334965,NaN,NaN,91.025116603593,95.52888049776527,0.03266510808269807,0.3758555077570378,0.34319039967433973,203692789,205871062.8,78.28262179540964,73.71995659254891,NaN,NaN,19.06855488161259,15.962510266109083
2019-08-28T09:30:00-04:00,38.83,38.99,38.725,38.92,3129537,4912527.75,59.21605178660026,60.413296586621755,NaN,NaN,76.35291366085694,88.99709505800827,0.02324959044486974,0.3722523877304269,0.34900279728555716,206822326,205905299.8,78.32229439690762,74.48494206460545,NaN,NaN,19.008847652340854,16.39770132128505
2019-08-29T09:30:00-04:00,39.13,39.265,38.98,39.2,3070711,4568248.5,62.212580430983216,60.355114754925225,NaN,NaN,107.03559121291006,88.30142302065863,0.030816498433978268,0.38752342032803,0.35670692189405173,209893037,206051467.8,78.50284772713685,75.11664440590896,NaN,NaN,19.854461169211092,16.891524156703056
2019-08-30T09:30:00-04:00,39.32,39.39,39.09,39.21,3623097,4501722.95,62.31906275359401,60.35378777141951,NaN,NaN,108.04987492883727,93.1870999988594,0.03132998571705342,0.3958694040403685,0.3645394183233151,213516134,208131873,80.93658255269838,75.74985622223083,NaN,NaN,20.567635854829547,17.416682970721126
2019-09-03T09:30:00-04:00,39.15,39.77,39.13,39.77,6160951,4491785.2,67.79249851686076,60.71985900157534,NaN,NaN,150.2138887567004,106.53547703257955,0.062423915422035625,0.44256931260085963,0.380145397178824,219677085,210720274.2,83.44745899273931,76.42696889066197,NaN,NaN,22.915777119156544,18.20226784906904
2019-09-04T09:30:00-04:00,39.96,40.14,39.85,40.1,3541514,4326784.8,70.51088191824677,61.99049758624559,NaN,NaN,212.17956102672346,130.76636591720566,0.09623473941166322,0.500438821443403,0.4042040820317398,223218599,214625436.2,86.3653038313618,77.4670934594027,NaN,NaN,25.781822965761126,19.28506143716791
2019-09-05T09:30:00-04:00,40.1,40.11,39.61,39.75,3925895,4153267.5,64.31107412972455,62.37533427951753,NaN,NaN,169.63707863538605,149.42319891211147,0.08636069100722338,0.512154945790769,0.42579425478354566,219292704,217119511.8,87.839648102025,78.77310099468943,NaN,NaN,26.287914408490483,20.285469004499706
2019-09-06T09:30:00-04:00,39.77,39.9866,39.69,39.8,2457626,3996059.05,64.78740286311498,62.59722837925608,NaN,NaN,147.28917051450665,157.4739147724308,0.07495365687953598,0.5194863258829656,0.44453266900342964,221750330,219490970.4,89.05187472317942,80.08724203789552,NaN,NaN,26.83532328153545,21.22116247264767
2019-09-09T09:30:00-04:00,39.82,39.83,39.4,39.5,4619175,3992230.65,59.64372244982426,62.21718781481794,NaN,NaN,91.79809968565094,154.22355972379353,0.04067673569581387,0.49537858862319695,0.4547018529273831,217131155,220213974.6,89.3988516085065,81.23686600420658,NaN,NaN,25.751126720253552,21.868300222305653
2019-09-10T09:30:00-04:00,39.31,39.31,38.65,38.92,5632879,4074235.4,51.1831150532345,61.562407475735576,NaN,NaN,-9.469908120901092,122.28680034827323,-0.024099391160567862,0.42457761397667326,0.4486770051372411,211498276,218578212.8,82.99040740236421,81.88176981521754,NaN,NaN,22.011508352640096,21.888758526639144
2019-09-11T09:30:00-04:00,38.86,38.94,38.61,38.83,7353167,4183090.4,49.997925042415204,60.708288523164015,NaN,NaN,-41.625382884067285,71.52581156611505,-0.07327057499956546,0.3570887863877843,0.43035936138734976,204145109,214763514.8,70.32905164061115,81.43547067016821,NaN,NaN,18.64696785595893,21.42564557368483
2019-09-12T09:30:00-04:00,39.12,39.31,38.76,39.06,5425638,4154394.3,52.99355837860892,59.93434970114617,NaN,NaN,-8.722778758551044,35.85384008732764,-0.08949459728168863,0.31849111478523895,0.4079857120669276,209570747,212819123.4,64.89444573916593,80.47396436696222,NaN,NaN,16.722608485720606,20.75378313254708
2019-09-13T09:30:00-04:00,38.95,39.16,38.465,38.59,5653825,4162013.15,46.82061306725538,59.26792259195802,NaN,NaN,-74.11694417951011,-8.42738285147571,-0.12868587531787296,0.24712836791958637,0.3758142432374593,203916922,209252441.8,56.30018629673533,78.91650041279551,NaN,NaN,13.045196764312845,19.65255650851362
2019-09-16T09:30:00-04:00,38.58,39.01,38.54,38.99,4535690,4200453.05,51.95047058360099,58.6957183470422,NaN,NaN,-56.71730964762526,-38.13046471813095,-0.124403444094141,0.22030993811978306,0.34471338221392406,208452612,207516733.2,52.64621412375122,77.09341349518522,NaN,NaN,11.53882987405392,18.493452703590805
2019-09-17T09:30:00-04:00,39.16,39.55,39.15,39.54,6054621,4356641.5,57.956025247845794,58.6924987301364,NaN,NaN,51.353749114717,-25.965733271007327,-0.08324083606716426,0.24066233712996876,0.323903173197133,214507233,208118524.6,53.76659359248501,75.34226862354775,NaN,NaN,12.24438916029925,17.600729340263438
2019-09-18T09:30:00-04:00,39.64,39.71,39.033,39.42,4031740,4395956.15,56.30255890416441,58.4843920956767,NaN,NaN,40.79133841857981,-9.482389010477906,-0.06368837169298047,0.24429270858090746,0.30798108027388793,210475493,209384601.4,56.11886302179561,73.75630923961117,NaN,NaN,12.276168993052327,16.84007786209042
2019-09-19T09:30:00-04:00,39.48,39.69,39.38,39.55,3941526,4418999.9,57.710160005407104,58.16279063670697,NaN,NaN,62.865433651955534,4.835253471623409,-0.04260612455738422,0.2547234245771577,0.2973295491345419,214417019,210353855.8,57.88541379188216,72.28363538709299,NaN,NaN,12.734963330116885,16.253632928951344
2019-09-20T09:30:00-04:00,39.37,39.44,39.1,39.12,5392505,4563072.35,51.769835574878634,57.40927440965587,NaN,NaN,-1.590803355690575,19.340481636387317,-0.05731098921704936,0.2256908126132302,0.28300180183027956,209024514,211375374.2,59.72563507167198,70.76856770987682,NaN,NaN,11.261701442898884,15.540499859515279
2019-09-23T09:30:00-04:00,39.09,39.425,39.02,39.26,3203051,4420820.45,53.449888171840406,56.38480224215442,NaN,NaN,-3.3531925952880255,30.013305046854764,-0.05716897722100961,0.21154058030401757,0.2687095575250272,212227565,212130364.8,61.07926087299806,69.17083927275245,NaN,NaN,10.571316659732934,14.830616545260659
2019-09-24T09:30:00-04:00,39.36,39.49,39.03,39.21,6528741,4566208.95,52.743249066949176,55.11568560991888,NaN,NaN,-6.337232021136336,18.47510881968408,-0.05972373153463678,0.19405489310673119,0.25377862464136797,205698824,210368683,56.32238755134956,67.02491668132299,NaN,NaN,9.80689952144226,14.112942684715174
2019-09-25T09:30:00-04:00,39.22,39.34,39.03,39.17,3912642,4609726.55,52.149266442981656,54.24698506086582,NaN,NaN,-23.913170728695455,5.534206990229026,-0.0630605431802603,0.17495294566604258,0.23801348884630288,201786182,208630820.8,52.0185249438053,64.46626502716444,NaN,NaN,9.013612778294318,13.384466983797909
2019-09-26T09:30:00-04:00,39.29,39.6283,39.26,39.55,2568779,4581688.65,57.09288000089684,53.697376284993084,NaN,NaN,39.34609370507168,0.8303390008522555,-0.03976546549315879,0.18830665697985438,0.22807212247301317,204354961,206618409.2,47.49277031853212,61.49775756968965,NaN,NaN,9.729800601353654,12.862371786305872
2019-09-27T09:30:00-04:00,39.62,39.64,38.98,39.29,3350711,4595688.65,53.05410774321713,53.22668952023543,NaN,NaN,-4.369533902187978,0.2745928915527749,-0.04175187328711236,0.17588228086412272,0.21763415415123508,201004250,205014356.4,44.192368765213786,58.26872308088302,NaN,NaN,9.173624310612785,12.335407861206859
2019-09-30T09:30:00-04:00,39.32,39.55,39.28,39.34,3492472,4589157.4,53.73195201497284,53.408749303216744,NaN,NaN,14.825262498048,3.9102839102199782,-0.039601458869652245,0.16813233056416976,0.207733789433822,204496722,203468187.8,41.218930848501756,55.285046184178555,NaN,NaN,8.905706435493505,11.84545051467638
2019-10-01T09:30:00-04:00,39.3,39.4,38.85,39,6075617,4584890.7,48.593801694368345,53.30845477835625,NaN,NaN,-54.579563773507125,-5.738182440254176,-0.05976952186436896,0.13302188710336083,0.19279140896772978,198421105,202012644,38.58682271731477,53.017744118228826,NaN,NaN,7.1762589257716645,11.178423144832848
2019-10-02T09:30:00-04:00,38.95,39.045,38.53,38.76,5305283,4673079.15,45.30076385826504,52.75896945547454,NaN,NaN,-121.39176772524334,-25.233901839563753,-0.08635113771972641,0.08485248681807178,0.1712036245377982,193115822,200278572,35.664863806741735,50.929916837341366,NaN,NaN,4.720313070339291,10.255835991333768
2019-10-03T09:30:00-04:00,38.76,39.3,38.7,39.22,6328378,4793203.3,52.01304732175385,53.12985761651015,NaN,NaN,-37.45570876248846,-40.59426233307578,-0.07069001564751898,0.08284110497839947,0.15353112062591845,199444200,199296419.8,34.09029308699023,49.343495893788145,NaN,NaN,4.565121206066737,9.44287673629562
2019-10-04T09:30:00-04:00,39.28,39.4898,39.24,39.4,2653396,4802991.8,54.37251955868718,53.3028611147306,NaN,NaN,59.96466651017583,-27.727422250603023,-0.04708077474211142,0.09468015219827919,0.1417609269403906,202097596,199515089,34.7806781485679,48.06738618127505,NaN,NaN,5.151987013137186,8.82989249013013
2019-10-07T09:30:00-04:00,39.3,39.51,39.1499,39.33,3165995,4730332.8,53.27546267181886,52.96853521644296,NaN,NaN,51.78583045996435,-20.335308658219752,-0.03557455169870835,0.09729273731700516,0.1328672890157135,198931601,198402064.8,32.892098679522434,46.57635083034915,NaN,NaN,5.315342879945006,8.327813974389397
2019-10-08T09:30:00-04:00,39.3,39.465,38.94,39.14,4616750,4679526.35,50.30837600219469,52.540379294873695,NaN,NaN,-0.06371326711922407,-9.43213855694217,-0.0398344790606642,0.08307419018988327,0.12290866925054747,194314851,197580814,31.531597043630825,44.82011754619452,NaN,NaN,4.601775966419406,7.795522830393684
2019-10-09T09:30:00-04:00,39.29,39.42,39.165,39.26,2969903,4460363.15,52.12201640630764,52.14122618065231,NaN,NaN,29.137844417833502,20.6737838716732,-0.033878745005152866,0.08056023799410639,0.11443898299925925,197284754,198414600.4,34.49405297233007,43.14930605908365,NaN,NaN,4.513087735217687,7.326603531082827
2019-10-10T09:30:00-04:00,39.21,39.42,39.04,39.36,3373438,4357753.15,53.64050023253502,52.27484508477062,NaN,NaN,22.550949317869456,32.675115487744776,-0.02303137846751513,0.08564975991486534,0.10868113838238047,200658192,198657398.8,35.37098301229621,41.409688054842526,NaN,NaN,4.858163093676526,6.973969182881927
2019-10-11T09:30:00-04:00,39.47,39.57,39.19,39.23,4953383,4322731.05,51.360013832485244,52.12556834624525,NaN,NaN,39.79824001734496,28.641830189178602,-0.024312237842844198,0.07829084107882522,0.10260307892166942,195704809,197378841.4,32.87517388068319,39.39511041253432,NaN,NaN,4.533476107640435,6.625327314990285
2019-10-14T09:30:00-04:00,39.26,39.44,39.11,39.29,1794051,4185649.1,52.366572473895424,52.09866287531285,NaN,NaN,6.327898446365445,19.550243786458825,-0.02094692085941148,0.07641942784740507,0.09736634870681656,197498860,197092293.2,32.324669884458544,37.68098772204211,NaN,NaN,4.526850019196721,6.325544844162633
2019-10-15T09:30:00-04:00,39.3,39.37,38.99,39.32,3091132,4037474.65,52.89150030561434,52.15167957978661,NaN,NaN,-19.732353190180223,15.616515801846623,-0.01671267366765164,0.076475506622252,0.09318818028990364,200589992,198347321.4,37.27858697887064,36.62813501026106,NaN,NaN,4.6565273353484855,6.087113771474898
2019-10-16T09:30:00-04:00,39.32,39.36,39.015,39.27,5942883,4133031.8,51.86561054659757,51.7783031901938,NaN,NaN,-22.38087847274545,5.3127712237308335,-0.017223085631346294,0.07165932325072077,0.08888240888206707,194647109,197819792.4,36.0829537637453,35.81314811349057,NaN,NaN,4.510426529751315,5.861872736942957
2019-10-17T09:30:00-04:00,39.37,39.64,39.2699,39.53,4775615,4174736.25,56.58163746978333,52.030269599234245,NaN,NaN,148.1220095057276,30.42698326130246,-0.0008578707163020283,0.08781007048668954,0.08866794120299157,199422724,197572698.8,35.508479670898865,35.19287032103951,NaN,NaN,5.631231563550031,5.828923997886825
2019-10-18T09:30:00-04:00,39.52,39.99,39.52,39.91,2313294,4020775.7,62.382651557862474,52.64817670944065,NaN,NaN,274.8497319191608,77.43728164166562,0.03288684350204714,0.1297764955805505,0.09688965207850335,201736018,198778940.6,40.4895128239441,35.14076903357111,NaN,NaN,8.371124783435672,6.192095538679518
2019-10-21T09:30:00-04:00,39.92,40.21,39.81,40.18,1957337,3958490,65.8717217714355,53.88231385780258,NaN,NaN,291.91474354221276,134.55465066083508,0.06866083871842564,0.1827157004765354,0.11405486175810976,203693355,200017839.6,45.17327995281371,35.61123026467817,NaN,NaN,11.846261207765995,6.999833491406157
2019-10-22T09:30:00-04:00,40.27,40.34,40.01,40.06,2226043,3743355.1,63.07171961062098,55.151667840113724,NaN,NaN,235.2605514373397,185.55323158633908,0.07878603517870308,0.2125374057314886,0.13375137055278552,201467312,200193303.6,45.82363195581276,36.33685656104039,NaN,NaN,13.952755007033508,7.9931079936386356
2019-10-23T09:30:00-04:00,40.08,40.23,39.79,40.13,2160605,3655753.25,64.03217027676028,56.010176622614175,NaN,NaN,166.33440407703256,223.29628809629466,0.08425006876332866,0.23906395650694634,0.15481388774361768,203627917,201989465.2,52.08883324988505,37.62246657267574,NaN,NaN,15.98064920507311,9.134185309557846
2019-10-24T09:30:00-04:00,40.21,40.26,39.865,39.98,1781849,3616406.75,60.40658468894884,56.44118127477573,NaN,NaN,134.904434542952,220.65277310373958,0.07227423310120315,0.24515667912012162,0.17288244601891847,201846068,202474134,53.646560601571785,38.970029605033154,NaN,NaN,16.709800776287857,10.216416090519276
2019-10-25T09:30:00-04:00,39.89,39.95,39.4,39.49,2842495,3590995.95,50.37278537912237,56.233847182440265,NaN,NaN,35.78259276463975,172.83934527283537,0.028132485061342083,0.2080480523455961,0.179915567284254,199003573,201927645,51.60904218802853,40.30695414135503,NaN,NaN,14.252617993669665,10.793016362397903
2019-10-28T09:30:00-04:00,39.42,39.4778,38.99,39.07,3323460,3582545.35,43.67606018281762,55.760110338199055,NaN,NaN,-55.87885077483301,103.28062640942619,-0.02945313348340578,0.14309915042999677,0.17255228391340255,195680113,200324996.6,46.081548718610044,41.34623640385354,NaN,NaN,9.819045931681309,10.65387772943839
2019-10-29T09:30:00-04:00,39.13,39.42,39.06,39.17,2167245,3387126.75,45.53274172293791,55.28944786081549,NaN,NaN,-50.04012672207193,46.22049077754387,-0.05919406149558165,0.09855970704392547,0.15775376853950712,197847358,199601005.8,43.79936935989855,42.01090186010843,NaN,NaN,6.843971717765982,10.109605442056617
2019-10-30T09:30:00-04:00,39.25,39.46,38.95,39.46,2637805,3253752.85,50.616755246322306,55.073466076086014,NaN,NaN,-42.10793216273612,4.532023529590146,-0.057663136967050777,0.08567484733069364,0.14333798429774441,200485163,198972455,41.861052090524446,42.47447822283902,NaN,NaN,5.919819439734895,9.511064584582085
2019-10-31T09:30:00-04:00,39.53,39.58,39.18,39.33,3264804,3100574.15,48.434257198891416,54.864483459400745,NaN,NaN,-29.474836775527542,-28.34383073410576,-0.06328386754619825,0.06423314986499662,0.12751701741119487,197220359,198047313.2,39.11710155053577,42.92033019925706,NaN,NaN,4.482862025674153,8.792749933309523
2019-11-01T09:30:00-04:00,39.38,39.515,38.82,39.23,3370033,3136406,46.76389159500609,54.464291968051505,NaN,NaN,-67.62497917517358,-49.025345122068416,-0.0710337023618092,0.038724889458933376,0.10975859182074257,193850326,197016663.8,36.26514507616476,43.20179271295036,NaN,NaN,2.799889586054277,7.9366270265587735
2019-11-04T09:30:00-05:00,39.16,39.2,38.74,38.79,3045521,3130382.3,40.195309506305065,53.55742119667228,NaN,NaN,-121.59038398359398,-62.167651763820615,-0.10124786483988235,-0.016801239229110365,0.08444662561077199,190804805,196041602.2,33.75757408508966,42.950291791965995,NaN,NaN,-0.8581949663568688,6.680223884713682
2019-11-05T09:30:00-05:00,38.67,38.67,37.89,38.12,6643622,3231725.9,32.6701047237011,52.186313637893946,NaN,NaN,-236.66180878433974,-99.49198817627419,-0.1584056546805571,-0.11356044273992438,0.04484521194063271,184161183,193304367.2,27.920983342493244,42.36729390473371,NaN,NaN,-6.968429479326593,4.730416261279357
2019-11-06T09:30:00-05:00,38.17,38.4386,38.1349,38.26,2425605,3204511,35.39197442510496,50.67276627755978,NaN,NaN,-195.44059771004825,-130.1585212857366,-0.1774015361535931,-0.17690670825135868,0.0004948279022344293,186586788,190524692.2,23.48108700593295,41.50819442866471,NaN,NaN,-10.83766300174769,2.5064049379897795
2019-11-07T09:30:00-05:00,38.15,38.16,37.715,37.85,3725777,3222127.95,31.38986184738941,48.45899558395456,NaN,NaN,-215.64661312256868,-167.39287655514482,-0.20617785839897698,-0.2572274950964868,-0.051049636697509816,182861011,187652822.6,19.95116051056064,40.04116926342304,NaN,NaN,-15.523759150771662,-0.06933278897614059
2019-11-08T09:30:00-05:00,37.77,38.05,37.68,37.78,2612196,3105068.6,30.750516093479533,45.95033803552913,NaN,NaN,-184.53621448364737,-190.7751236168396,-0.21740794233632804,-0.3228095646179199,-0.10540162228159183,180248815,184932520.4,17.29843985078523,38.050109256135286,NaN,NaN,-19.385702988960244,-2.8288142461167265
2019-11-11T09:30:00-05:00,37.76,37.9869,37.75,37.85,2538716,3142301.85,32.23687768059395,43.747849326241486,NaN,NaN,-146.2407915279626,-195.70520512571335,-0.2076216948603405,-0.36492874085701743,-0.15730704599667694,182787531,183329065.6,15.95206920353506,35.916426202401176,NaN,NaN,-22.009523929237062,-5.568915629419632
2019-11-12T09:30:00-05:00,37.85,38.1064,37.55,37.6,6213767,3298433.6,29.778558577199064,41.301162776272825,NaN,NaN,-130.78982812824583,-174.53080899449455,-0.20512426985368185,-0.41371238331377924,-0.2085881134600974,176573764,181811581.8,14.77967263540215,33.251486158509536,NaN,NaN,-25.002936772324187,-8.345204364120281
2019-11-13T09:30:00-05:00,37.66,38.07,37.64,37.98,2220756,3112327.25,37.5714209435512,39.67007965160157,NaN,NaN,-100.26767402581501,-155.4962242576479,-0.1666536087999913,-0.41690512446008654,-0.25025151566009524,178794520,180253128.2,13.66861515931275,30.395918626919606,NaN,NaN,-25.11922338437494,-10.741492795585232
2019-11-14T09:30:00-05:00,38.07,38.36,38.02,38.36,2525065,2999799.75,44.23590602182967,39.23173112608066,NaN,NaN,-61.32852445004732,-124.63260652314361,-0.10727247864659356,-0.3843421139683372,-0.2770696353217436,181319585,179944843,13.453168494445293,27.670499077377947,NaN,NaN,-23.007353917514823,-12.493758670146603
2019-11-15T09:30:00-05:00,38.39,38.56,38.27,38.55,2615713,3014920.7,47.26713804206137,39.48823668745522,NaN,NaN,-37.38520535070833,-95.2024046965558,-0.049778788977432264,-0.33929312154353397,-0.2895143325661017,183935298,180682139.6,16.82960257266646,25.581074352667695,NaN,NaN,-20.298172839144236,-13.608674980003407
2019-11-18T09:30:00-05:00,38.6,38.93,38.57,38.76,2855536,3059830.65,50.47169761227991,39.84101925097965,NaN,NaN,-5.5056597070824616,-67.05537833237977,0.004907784551376693,-0.2833796018768808,-0.2882873864282575,186790834,181482800.2,20.458636619214246,23.913879156904528,NaN,NaN,-17.028246766981397,-14.097185235285977
2019-11-19T09:30:00-05:00,38.83,38.93,38.69,38.84,3345142,3115785.6,51.676459251615796,39.91671239421489,NaN,NaN,8.095560564615418,-39.27830059380753,0.04666066938659602,-0.22996154969501248,-0.2766222190816085,190135976,184195242.6,31.382014979600783,23.165376506124264,NaN,NaN,-14.01624272471526,-14.08562201949016
2019-11-20T09:30:00-05:00,38.81,38.95,38.6126,38.86,5711442,3293327.45,51.99086915984359,40.170756105711476,NaN,NaN,14.729378664203182,-16.278890055803902,0.07418280456635595,-0.18389371337366356,-0.2580765179400195,195847418,187605822.2,42.141332464150125,23.381392999953864,NaN,NaN,-11.488460389066216,-13.714598929429597
2019-11-21T09:30:00-05:00,38.77,38.77,38.2908,38.34,3556116,3382040.8,43.97889062803467,39.971827465213515,NaN,NaN,-17.877746863990936,-7.58873453859262,0.056712009674436625,-0.18718650584697372,-0.24389851552141034,192291302,189800165.6,47.81134421598692,24.206121509941163,NaN,NaN,-11.600108375194793,-13.412528850253196
2019-11-22T09:30:00-05:00,38.38,38.4,37.935,38.12,3616857,3420758.9,41.0935916578947,40.035990476041356,NaN,NaN,-53.17742291868868,-10.747178052188683,0.030972406812431214,-0.20518300700587133,-0.23615541381830255,188674445,190747995,50.086663758180634,25.372485058019084,NaN,NaN,-12.587265182867549,-13.294634040626676
2019-11-25T09:30:00-05:00,38.2,38.41,38.085,38.15,2716630,3390417.4,41.655710526232994,40.677819461936494,NaN,NaN,-39.72570054966676,-17.591186220705545,0.017283211397125464,-0.21455139957189573,-0.2318346109690212,191391075,191668043.2,52.26233152601899,27.111152785413783,NaN,NaN,-13.21620699066427,-13.283430176346332
2019-11-26T09:30:00-05:00,38.18,38.68,38.1504,38.68,4916850,3527897.65,50.62070110091422,41.76558565306572,NaN,NaN,9.219413576480402,-17.366415618332546,0.04373402813224411,-0.17716707580371605,-0.22090110393596016,196307925,192902433,55.09071656768845,29.36898346839632,NaN,NaN,-10.936194008599124,-12.948110723811016
2019-11-27T09:30:00-05:00,38.66,38.81,38.51,38.8,2605673,3526291.05,52.403951936661876,43.26659208801375,NaN,NaN,50.66222553359554,-10.179846244454074,0.06769231045899057,-0.13628571586222193,-0.2039780263212125,198913598,193515669,56.47053104622752,31.977509935229673,NaN,NaN,-8.528674383307838,-12.316762675167706
2019-11-29T09:30:00-05:00,38.77,38.95,38.61,38.65,2550797,3490590.7,49.97448741393514,44.63973289661772,NaN,NaN,66.92904109153157,6.7815113466504275,0.07144733405918052,-0.11466885874723687,-0.1861161928064174,196362801,194329968.8,58.3025721260882,34.906376526322745,NaN,NaN,-7.254184057721,-11.593537158389605
2019-12-02T09:30:00-05:00,38.55,38.62,37.94,37.94,6651532,3654665.65,40.42200678809494,45.22438497572494,NaN,NaN,-35.712192686829546,10.274557393022253,0.026441767285201367,-0.1530639836999157,-0.17950575098511706,189711269,194537333.6,58.77835905561407,37.965397230042676,NaN,NaN,-9.264683252293693,-11.260843743233046
2019-12-03T09:30:00-05:00,37.92,38.32,37.91,38.25,3584003,3681589.75,45.33519757210229,46.33557347536088,NaN,NaN,-31.971927088408655,11.825312085273875,0.01826702425052712,-0.15667197067195815,-0.17493899492248527,193295272,194918173,59.68812107196109,41.17314354693974,NaN,NaN,-9.280382875068389,-10.977920762066667
2019-12-04T09:30:00-05:00,38.17,38.545,38.09,38.45,2283784,3463597.85,48.297583170876564,47.10172792016983,NaN,NaN,13.25060111456159,12.631549592890114,0.026544084278771474,-0.14175888957402094,-0.16830297385279241,195579056,194772399.2,59.150000539193144,44.42181393121691,NaN,NaN,-8.32421103327032,-10.598819372238617
2019-12-05T09:30:00-05:00,38.39,38.51,38.235,38.51,3042155,3494425.35,49.18721989061836,47.45539319651187,NaN,NaN,24.38944553871417,7.376993593913838,0.03570394630673063,-0.12367304096937914,-0.15937698727610977,198621211,194713921.8,58.92051703755148,47.669481684295924,NaN,NaN,-7.289521564067777,-10.126062542499927
2019-12-06T09:30:00-05:00,38.52,38.7,38.485,38.52,3855610,3500917,49.3436675362805,47.603716731813236,NaN,NaN,53.038153351634676,4.598816045934458,0.04166469671525169,-0.10729611638204517,-0.14896081309729686,202476821,195936725.8,62.221161850365085,50.91173591841726,NaN,NaN,-6.415529835473638,-9.595986441496171
2019-12-09T09:30:00-05:00,38.57,38.68,38.415,38.57,2585450,3499579.7,50.16978821957425,47.582151775191406,NaN,NaN,44.56233670054049,20.653721923408465,0.04776557783270624,-0.08925384080641408,-0.13701941863912032,205062271,199006926.2,68.96389014911237,54.376396884838485,NaN,NaN,-5.4635060898624115,-9.005632105548491
2019-12-10T09:30:00-05:00,38.6,38.71,38.2,38.3,7303326,3737810.2,45.82388453387654,47.16411072392432,NaN,NaN,-1.2015230817776184,26.807802724734678,0.03310395205880928,-0.09563947856560873,-0.128743430624418,197758945,199899660.8,70.60665857964344,57.17815714198439,NaN,NaN,-5.862578287982505,-8.556624417324779
2019-12-11T09:30:00-05:00,38.39,38.39,37.88,38.01,6222871,3738265.4,41.650599888507564,46.42552006168603,NaN,NaN,-103.55953665056204,3.4457751717099483,0.004845571972936169,-0.12268646565824781,-0.12753203763118398,191536074,199091064.4,67.14020149540391,58.96379064421681,NaN,NaN,-7.449884577789192,-8.398518725962552
2019-12-12T09:30:00-05:00,38.03,38.16,37.44,37.55,7621046,4008279.9,36.04328451747291,45.85869105378877,NaN,NaN,-209.40065306309725,-43.31224454865234,-0.04131368621160614,-0.17917414539569165,-0.13786045918408552,183915028,196149827.8,56.31058558785913,59.57087931363625,NaN,NaN,-10.673783961642293,-8.723556616773942
2019-12-13T09:30:00-05:00,37.54,37.73,37.26,37.59,6184141,4191233.7,36.839564287200524,45.554831955882044,NaN,NaN,-214.98380914451099,-96.91663704788147,-0.06427012924555467,-0.21819812074102884,-0.15392799149547418,190099169,193674297.4,49.12797584755777,59.50240160573462,NaN,NaN,-13.022023489346502,-9.337623312855737
2019-12-16T09:30:00-05:00,37.65,37.99,37.415,37.88,5093947,4315145.4,42.435314924969,45.61051798436319,NaN,NaN,-131.05798671840145,-132.04070173166986,-0.055379181999300475,-0.22315196899459977,-0.1677727869952993,195193116,191700466.4,44.27833181876843,58.93211591235957,NaN,NaN,-13.370236982652175,-9.913710979969514
2019-12-17T09:30:00-05:00,37.95,38,37.395,37.47,4452043,4394970.75,37.39152534802802,44.665576859157035,NaN,NaN,-139.73934344127585,-159.7482658035695,-0.07153912997267264,-0.2571966994611401,-0.18565756948846746,190741073,190296892,41.16637359359547,57.937519985638644,NaN,NaN,-15.285254938427336,-10.681074402606345
2019-12-18T09:30:00-05:00,37.47,38.07,37.47,38,3504142,4402920.75,46.2802632809705,44.22817052660765,NaN,NaN,-83.5426881800471,-155.7448961094665,-0.04240170644070709,-0.23865970253935131,-0.19625799609864422,194245215,190838720.2,42.83658529210521,56.96366671748705,NaN,NaN,-13.99217497405344,-11.15408876995593
2019-12-19T09:30:00-05:00,37.96,38.39,37.89,38.36,3334475,4284072.4,51.33433031227617,44.32530216220344,NaN,NaN,0.8553684534818184,-113.6936918061507,0.0028474393229882267,-0.19269869694490893,-0.19554613626789716,197579690,193571652.6,50.473767668057896,56.40446639905632,NaN,NaN,-11.182290022937845,-11.158117520381918
2019-12-20T09:30:00-05:00,38.1,38.345,38.05,38.24,3691768,4290855,49.657252409790914,44.98496256375315,NaN,NaN,3.603876672946931,-69.97615464265913,0.025184096931329558,-0.1640660151037352,-0.18925011203506475,193887922,194329403.2,52.37372436081397,55.946992492284885,NaN,NaN,-9.492583612917551,-10.920184105029865
2019-12-23T09:30:00-05:00,38.31,38.36,37.94,38.01,3000587,4260041.5,46.5202243069338,45.069607330526836,NaN,NaN,-22.071378541246425,-48.178833007228114,0.024911383680071397,-0.1581108824349755,-0.1830222661150469,190887335,193468247,50.02498045651135,55.2567681626099,NaN,NaN,-9.08808669448323,-10.658455903523203
2019-12-24T09:30:00-05:00,38.04,38.15,37.92,38.06,1120202,4180220.1,47.299652399559314,44.99832656114704,NaN,NaN,-33.71838679546232,-26.97464167806541,0.028294018656084496,-0.14765474279494128,-0.17594876145102578,192007537,193721539.8,50.72494321940101,54.65497835405332,NaN,NaN,-8.52960766827826,-10.354334727059639
2019-12-26T09:30:00-05:00,38.14,38.31,38.06,38.29,1607212,4014738.2,50.84833553152158,45.11697767835441,NaN,NaN,12.01369436663802,-7.863365168728381,0.04521312346546508,-0.11943235711919442,-0.1646454805846595,193614749,193595446.6,50.346894167132234,54.042576720451954,NaN,NaN,-6.9846160218434745,-9.872946340600187
2019-12-27T09:30:00-05:00,38.41,38.47,38.265,38.43,1828523,3975880.7,52.92620305456147,45.372873072517336,NaN,NaN,61.18421052631738,4.202403245838736,0.0638830582921622,-0.08479165771945674,-0.14867471601161894,195443272,193168163,49.013819808545044,53.09919514603623,NaN,NaN,-5.082993899500217,-9.188667420443048
2019-12-30T09:30:00-05:00,38.35,38.46,38.22,38.4,2638354,3980258.55,52.41486046999484,45.5332353761188,NaN,NaN,62.39507554561204,15.960643020371759,0.07167706535921023,-0.05907838431260615,-0.13075544967181638,192804918,192951562.2,48.315432913892906,51.62430534352056,NaN,NaN,-3.6707845962950727,-8.400398445564766
2019-12-31T09:30:00-05:00,38.38,38.71,38.35,38.67,3674954,3831429.65,56.48927091896661,46.295048689339524,NaN,NaN,109.72949389180037,42.32081750698112,0.09122760949337552,-0.01672093780509698,-0.1079485472984725,196479872,194070069.6,52.11019124264128,50.30312910516326,NaN,NaN,-1.24447062292555,-7.378123042330593
2020-01-02T09:30:00-05:00,38.79,38.85,38.07,38.22,4380139,3871236.45,48.96427616386094,46.81745413757904,NaN,NaN,53.517206477735954,59.767936161620774,0.07096540734578041,-0.019241788116246994,-0.0902071954620274,192099733,194088508.8,52.17253435859492,49.234010023962625,NaN,NaN,-1.3309488660090565,-6.514241017141802
2020-01-03T09:30:00-05:00,37.99,38.585,37.97,38.5,3498976,3931996.05,53.14654596077579,48.039115669243536,NaN,NaN,46.545024497382904,66.67420218776975,0.07323667531684282,0.0013386486840261114,-0.0718980266328167,195598709,194485300.8,53.5731536451185,49.038479170909724,NaN,NaN,-0.10710267935885509,-5.598935540315667
2020-01-06T09:30:00-05:00,38.43,38.66,38.35,38.51,3097192,3934747.9,53.2937566535945,49.214415123985965,NaN,NaN,83.58339584896387,71.15403925229904,0.07211473176421977,0.018245388072458013,-0.05386934369176176,198695901,195135826.6,55.8556203619162,49.51902520764961,NaN,NaN,0.9139347889292234,-4.668525493280683
2020-01-07T09:30:00-05:00,38.4,38.4,37.885,38.09,3550992,3919517,46.66244807796912,49.51635320634312,NaN,NaN,-6.696058607083338,57.335812421759975,0.041318843598335674,-0.0022207891938421653,-0.04353963279217784,195144909,195603824.8,57.47534219824025,50.46166880618331,NaN,NaN,-0.2171493000672347,-4.032614608535905
2020-01-08T09:30:00-05:00,38.13,38.34,37.99,38.28,5089035,4044696.25,49.71094242348341,50.396311568875646,NaN,NaN,19.999056648277463,39.38972497305537,0.03237287410041964,-0.003073540166653288,-0.03544641426707293,200233944,196354639.2,60.010385218716536,51.80766963654911,NaN,NaN,-0.23712284996053237,-3.4904015001679944
2020-01-09T09:30:00-05:00,38.25,38.36,38.15,38.27,2885011,3823780.5,49.55042183114766,50.62989432245973,NaN,NaN,39.135811449775325,36.51344596746325,0.0247536557319467,-0.004504344602139554,-0.029258000334086254,197348933,197404479.2,63.30445680477358,53.26966045888256,NaN,NaN,-0.29951760433930125,-3.034560943621038
2020-01-10T09:30:00-05:00,38.35,38.651,38.265,38.64,6513184,3838296.15,55.30160375543506,50.91327099697107,NaN,NaN,102.06658067349437,47.617757202685546,0.04255972494715165,0.023941655849853305,-0.018618069097298344,203862117,199057160.8,67.80100169116153,54.507320031961385,NaN,NaN,1.3811534325774728,-2.403744604164108
2020-01-13T09:30:00-05:00,38.66,39.11,38.6501,39.11,2988092,3606648.45,61.3318347612307,51.74716973635964,NaN,NaN,204.48029555752524,71.79713714439782,0.08165321243840093,0.08344844645070282,0.0017952340123018919,206850209,200688022.4,71.51086171758367,55.87425841458779,NaN,NaN,4.847219889886465,-1.367892533585455
2020-01-14T09:30:00-05:00,39.07,39.07,38.705,38.92,3720228,3483452.8,57.929461726593644,52.56211526633534,NaN,NaN,169.60676334902186,107.05770153561886,0.08973413377848131,0.11396290123540354,0.024228767456922224,203129981,202285036.8,74.59738778795368,57.629430366833674,NaN,NaN,6.637237568882841,-0.22430251894712705
2020-01-15T09:30:00-05:00,39.02,39.31,39.01,39.19,4468672,3452189.05,61.221618416282666,53.55654141038701,NaN,NaN,208.47526744041295,144.75294369404597,0.10710496733242086,0.1581099766224483,0.05100500929002744,207598653,203757978.6,77.06537917132212,59.51089007768518,NaN,NaN,9.195063858149522,1.121321249209537
2020-01-16T09:30:00-05:00,39.28,39.54,39.18,39.54,4244510,3441812.4,65.04066182223357,54.57027900258072,NaN,NaN,219.51872210456656,180.8295258250042,0.13424922930741084,0.218816545924291,0.08456731661688016,211843163,206656824.6,80.98157237524862,61.699081378264914,NaN,NaN,12.634028239414363,2.765993676381655
2020-01-17T09:30:00-05:00,39.52,39.73,39.47,39.59,3014779,3417344.25,65.56243765560006,55.4728671883692,NaN,NaN,206.019103799971,201.62003045029954,0.14664505951273266,0.267873641007796,0.12122858149506333,214857942,208855989.6,83.30992233379246,64.14880298721117,NaN,NaN,15.534095376606013,4.590008204985135
2020-01-21T09:30:00-05:00,39.6,40.02,39.53,39.99,2329540,3367097.5,69.48611217188491,56.69224230993278,NaN,NaN,194.60640083756695,199.6452515063079,0.17114899708923073,0.33516482785660173,0.164015830767371,217187482,210923444.2,85.15047805895061,66.77987764042958,NaN,NaN,19.346906083502095,6.6981364733447
2020-01-22T09:30:00-05:00,40.1,40.21,39.6,39.67,5815176,3473267.9,63.27502574726024,57.176939083382315,NaN,NaN,154.91723655117713,196.70734614673893,0.15561872376140215,0.3585392354691237,0.20292051170772155,211372306,212571909.2,86.43499275069178,69.23164917671889,NaN,NaN,20.6089615330063,8.6853971961535
2020-01-23T09:30:00-05:00,39.69,40.08,39.59,40.05,2637757,3455126.4,67.04243638655865,58.46823624214643,NaN,NaN,139.38169371211728,182.88863140107978,0.16012758334317903,0.4030799908866953,0.2429524075435163,214010063,213854191.2,87.35153585850483,71.74443499814103,NaN,NaN,22.92398564414391,10.719481260152131
2020-01-24T09:30:00-05:00,40.13,40.205,39.84,39.99,2397860,3519009.3,65.89303085949743,59.37869944919798,NaN,NaN,131.70269121097286,165.32542522236105,0.14851548610767207,0.4285967651781064,0.28008127907043434,211612203,213807999.2,87.1231682887683,74.14086461554459,NaN,NaN,24.404424612110766,12.674473167574792
2020-01-27T09:30:00-05:00,39.75,39.97,39.71,39.82,6741550,3775726.2,62.61735754034487,60.04467094110872,NaN,NaN,98.09224407815975,143.7400532779988,0.12004937092471762,0.4301429927263314,0.31009362180161376,204870653,211810541.4,77.66737360273909,75.69884698988908,NaN,NaN,24.63900549011842,14.38369207079531
2020-01-28T09:30:00-05:00,39.87,40.089,39.77,39.92,2904339,3829517,63.75866090456814,61.265829000151506,NaN,NaN,95.4494728614601,123.90866768277742,0.09946887703574647,0.4344297180962968,0.33496084106055035,207774992,209928043.4,69.96080952946184,76.59066608497633,NaN,NaN,25.163718409824337,15.923695833513744
2020-01-29T09:30:00-05:00,40.05,40.14,39.67,39.71,5409629,3968080.75,59.64073910150303,61.97510019143862,NaN,NaN,77.48065183711932,108.42135073996587,0.06489961582655568,0.4160853608437449,0.35118574501718924,202365363,208126654.8,63.47068636093557,76.83783045227769,NaN,NaN,24.400381314377935,17.134650902208627
2020-01-30T09:30:00-05:00,39.58,39.8332,39.51,39.8,3847411,3976703.6,60.808982525306995,62.779283098164285,NaN,NaN,58.34830483507871,92.21467296455816,0.042372023857081664,0.40415077483854134,0.3617787509814597,206212774,206567197,58.41828529222448,76.48881820138133,NaN,NaN,24.0940752794939,18.12885438467795
2020-01-31T09:30:00-05:00,39.7,39.75,39.135,39.23,7586235,4137008.4,50.78302737487999,62.45652764241036,NaN,NaN,17.677653002309643,69.40966532282552,-0.013643382055728848,0.3447245234117986,0.35836790546752745,198626539,203970064.2,51.1200022612581,75.2973182421025,NaN,NaN,20.62851228409416,18.485948370308837
2020-02-03T09:30:00-05:00,39.39,39.638,39.235,39.27,6254806,4274799.9,51.38873737165263,61.74630640029763,NaN,NaN,14.010780607869142,52.5933726287674,-0.048752009886177505,0.29742789310980555,0.34617990299598306,204881345,203972202.6,51.12541646304652,73.84121500963556,NaN,NaN,18.02723179243209,18.420417430612158
2020-02-04T09:30:00-05:00,39.41,39.9252,39.335,39.78,5309787,4385429.65,58.41578947902518,61.78104409689989,NaN,NaN,46.14966286474171,42.733410629423716,-0.038810804274724775,0.2976663976525771,0.33647720192730185,210191132,204455430.6,52.40828583597826,72.25627915592304,NaN,NaN,17.873015462693104,18.342217149480863
2020-02-05T09:30:00-05:00,39.82,39.92,39.65,39.75,3049305,4360345.3,57.88570708855943,61.54276471634823,NaN,NaN,54.37139219540239,38.11155870108032,-0.03552745103539218,0.2920678881330616,0.3275953391684538,207141827,205410723.4,54.92703320188763,70.67496872953485,NaN,NaN,17.59017998431091,18.234783268742298
2020-02-06T09:30:00-05:00,39.88,40.01,39.8,39.92,2676696,4239728.35,60.09547962539861,61.1895374165743,NaN,NaN,70.34325071189409,40.5105478764434,-0.023744722470246393,0.29791443608064583,0.3216591585508922,209818523,206131873.2,56.78632736387602,68.94673694300823,NaN,NaN,18.007224797344946,18.202274915685532
2020-02-07T09:30:00-05:00,39.94,39.985,39.825,39.94,3216597,4256307.65,60.35900857067345,60.81786391050811,NaN,NaN,68.86371594032255,50.74776046404598,-0.016770950759643022,0.30069547010133846,0.3174664208609815,213035120,209013589.4,63.3010509269779,67.51753184252148,NaN,NaN,18.42064112877444,18.233470088983946
2020-02-10T09:30:00-05:00,40.07,40.42,40.03,40.4,3489343,4105115.6,65.9317464810671,60.56398064687827,NaN,NaN,145.17537057574484,76.98067845762111,0.014941079791799206,0.3361427706007305,0.3212016908089313,216524463,211342213,67.55727869164969,66.26087474485713,NaN,NaN,20.504314084279525,18.557876374026172
2020-02-11T09:30:00-05:00,40.54,41.17,40.54,40.89,10001682,4455795.1,70.66287357438434,61.09168406310142,NaN,NaN,260.3441199783203,119.81956988033684,0.06237665085322058,0.39917250437545704,0.33679585352223645,226526145,214609215.6,72.3945546075575,65.25798630606184,NaN,NaN,23.936543710799427,19.32625742213664
2020-02-12T09:30:00-05:00,40.94,41.25,40.79,41.15,2539704,4396768.9,72.81977244958466,61.504350924746134,NaN,NaN,270.44114721786065,163.03352088482848,0.1023605497892418,0.46474654075878874,0.36238599096954693,229065849,218994020,77.28901652390573,64.53923492501903,NaN,NaN,27.50321641696009,20.494394421397132
2020-02-13T09:30:00-05:00,41.09,41.4947,41.04,41.4,2825534,4314612,74.74264880275669,62.13646649212179,NaN,NaN,243.2008218424747,197.6050351109446,0.13470638591088796,0.5307689733581569,0.3960625874472689,231891383,223408592,80.95092262465712,64.09836023472539,NaN,NaN,31.100073021705704,22.009491364298356
2020-02-14T09:30:00-05:00,41.5,41.89,41.44,41.88,2235317,4214152.35,77.965805120945,63.23278417645038,NaN,NaN,228.1376608189246,229.45982408666504,0.17494024963217447,0.614737899487487,0.43979764985531256,234126700,227626908,83.66180421234012,64.52653384969689,NaN,NaN,35.35315034377071,23.915728361365833
2020-02-18T09:30:00-05:00,41.93,41.93,41.59,41.84,3260145,4226420.65,77.08301855381663,64.18452400853957,NaN,NaN,180.82377428825842,236.58950482916777,0.18442514121597542,0.6703290763752818,0.4859039351593064,230866555,230495326.4,85.20377324914992,65.61531697253174,NaN,NaN,38.40852704016663,25.98612817262309
2020-02-19T09:30:00-05:00,41.85,41.85,41.25,41.25,2606076,4240247.45,65.33248861799294,64.5910775454317,NaN,NaN,119.28545144291628,208.37777112208695,0.13861990177879913,0.6591788123828053,0.5205589106040062,228260479,230842193.2,85.38342117501445,67.18051231639451,NaN,NaN,37.20792696671333,27.589242286064554
2020-02-20T09:30:00-05:00,41.36,41.74,41.16,41.71,3901832,4144580.25,69.26622418503503,65.19516623541227,NaN,NaN,108.53943310375935,175.9974282992667,0.12725366991885756,0.6796259980025781,0.5523723280837205,232162311,231461485.6,85.71685734059427,69.1304103198495,NaN,NaN,37.52865264681156,29.009158051885553
2020-02-21T09:30:00-05:00,41.71,42,41.66,41.93,2987222,4162053.5,70.96321893315944,66.6366084895751,NaN,NaN,118.00298216626668,150.95786036402507,0.1224627012990196,0.7054507047074949,0.5829880034084753,235149533,232113115.6,86.076769877343,71.627322292427,NaN,NaN,38.349437487768846,30.343483685583166
2020-02-24T09:30:00-05:00,41.44,41.815,41.1807,41.37,4703114,4277316.2,61.634192581691984,67.36842671886362,NaN,NaN,74.3160519829586,120.19353859683187,0.07198723574011745,0.6729720480836221,0.6009848123435046,230446419,231377059.4,83.51676122573086,73.94098977547587,NaN,NaN,35.80117341011119,31.123153646230026
2020-02-25T09:30:00-05:00,41.48,41.62,40.18,40.33,9190388,4399758.1,48.802707461044584,66.68177800329357,NaN,NaN,10.940841153981351,86.21695196997645,-0.035272932237307764,0.5568936470468699,0.5921665792841777,221256031,229454954.6,77.07068465278849,75.70258969096233,NaN,NaN,28.43034521772575,30.73846672787227
2020-02-26T09:30:00-05:00,40.38,40.695,39.8907,39.98,8642238,4686653.05,45.378759014358515,65.78842456942208,NaN,NaN,-34.21233600419392,55.517394480554415,-0.12838731416202553,0.43168243658164585,0.5600697507436714,212613793,226325617.4,67.88417858257054,76.62810007529683,NaN,NaN,21.41989560854485,29.407242282254067
2020-02-27T09:30:00-05:00,39.32,39.48,37.71,37.72,15861495,5209246.35,30.49904418537045,63.674393466562925,NaN,NaN,-170.88280381328912,-0.3670529028552892,-0.3293532989062891,0.14837812711081,0.4777314260170991,196752298,219243614.8,52.60291237642289,76.32928471905016,NaN,NaN,7.307015013563027,26.250066958155347
2020-02-28T09:30:00-05:00,36.92,37.16,35.6933,36.79,44499097,7241830.65,26.629465864612726,61.265140416130016,NaN,NaN,-248.65857612572225,-73.69936456125308,-0.5017554541972216,-0.14946289172942784,0.3522925624677937,152253201,202664348.4,33.55795030342183,74.2047775316533,NaN,NaN,-5.002606982994149,21.785399252276846
2020-03-02T09:30:00-05:00,36.97,38.63,36.88,38.62,19686199,7846828.85,42.176134933011944,59.56831101984036,NaN,NaN,-137.73247397772676,-116.10906975339017,-0.46993639438717183,-0.2351279305161711,0.23480846387100074,171939400,190962944.6,26.316104613715893,71.25897938322946,NaN,NaN,-7.6508977671241745,17.580213963790985
2020-03-03T09:30:00-05:00,38.7,39.555,38.22,38.59,37984002,9433288.65,42.01894826805425,57.5223163551025,NaN,NaN,-87.6803250890913,-135.8333030020047,-0.42941321566766205,-0.3019580557135768,0.12745515995408524,133955398,173502818,19.54008801934883,67.48366034121456,NaN,NaN,-9.477658584238483,13.714803599786777
2020-03-04T09:30:00-05:00,39.1,40.14,39.04,40.09,13713025,9853450.55,51.70981234700976,56.01446206206144,NaN,NaN,-30.35950747989199,-135.0627372971443,-0.286939010611471,-0.23121860331025346,0.055720407301217495,147668423,160513744,16.198562267368743,63.12005646574762,NaN,NaN,-6.7921908394179775,10.78523296561467
2020-03-05T09:30:00-05:00,39.43,39.75,38.73,39.17,13348365,10368403.55,46.56875666114209,54.002041194803255,NaN,NaN,-59.34457657682736,-112.75509184985194,-0.24181736501531775,-0.2465512989679297,-0.004733933952611957,134320058,148027296,13.762153757861725,58.320858689547954,NaN,NaN,-6.8742784845531135,8.2624456155907
2020-03-06T09:30:00-05:00,38.32,38.66,37.24,38.5,16942321,11081684.8,43.200251046352044,51.51878733233234,NaN,NaN,-107.64064951424922,-84.55150652755734,-0.24357420223444923,-0.3092016867456735,-0.06562748451122427,117377737,141052203.2,12.620231061379059,53.24646060733645,NaN,NaN,-8.255168796268984,5.902786413896459
2020-03-09T09:30:00-04:00,36.45,36.96,35.75,35.78,12791835,11560446.7,32.8208690853307,48.35720522744048,NaN,NaN,-171.85448843027598,-91.3759094180672,-0.40489252393433106,-0.5717431394291381,-0.16685061549480706,104585902,127581503.6,10.762844825983507,47.92925143425314,NaN,NaN,-14.068648895980681,3.0497242267711537
2020-03-10T09:30:00-04:00,36.7,37.58,35.4,37.52,18902393,12331099.2,42.361232851039034,46.716401244086626,NaN,NaN,-120.80824338024522,-98.00149307629798,-0.3722147073075478,-0.6321189996292418,-0.259904292321694,123488295,125488083,10.504115631868359,42.580729609742704,NaN,NaN,-14.398114969117579,0.5571757702156206
2020-03-11T09:30:00-04:00,36.61,36.67,35.15,35.51,16039455,12632987.85,36.00095526437408,44.34031060689655,NaN,NaN,-139.18600961827596,-119.76679350397475,-0.45812478135945767,-0.8325602690210161,-0.37443548766155843,107448840,117444166.4,9.553755461250006,37.140508046932396,NaN,NaN,-17.451420972986877,-2.0154809073847364
2020-03-12T09:30:00-04:00,33.26,34.58,28,32.46,9058567,12958931,28.90817350248757,41.33637879041999,NaN,NaN,-231.03502077333746,-154.10488234327678,-0.679186111142615,-1.2234181265898272,-0.5442320154472122,98390273,110258209.4,8.788761267406088,31.61993600336547,NaN,NaN,-23.218997210650958,-5.044554664994196
2020-03-13T09:30:00-04:00,34.17,35.36,32.53,35.31,9694874,13302398,40.67072002934156,39.83898789382353,NaN,NaN,-127.4718359160912,-158.0711196236452,-0.5952970104527042,-1.2883532785130924,-0.6930562680603882,108085147,108399691.4,8.597027254229403,26.268526433972507,NaN,NaN,-22.22017153520466,-7.498214217881404
2020-03-16T09:30:00-04:00,31.8,32.66,29.43,29.66,5840090,13482636.65,30.054327499287325,38.499817896555165,NaN,NaN,-199.77823349127752,-163.65586863584548,-0.8657618332392987,-1.7752585596095116,-0.909496726370213,102245057,107931522.4,8.546447387198072,21.37393805785891,NaN,NaN,-26.790815117149926,-10.25430006063405
2020-03-17T09:30:00-04:00,30.11,32.29,29.44,31.46,7267752,13683017,35.80361978126534,37.815879379905645,NaN,NaN,-156.5042206638046,-170.79506409255737,-0.8667357755671175,-1.9929164458291098,-1.1261806702619923,109512809,105136425.2,8.234939713830173,17.11327813866317,NaN,NaN,-27.21555657465567,-12.67733670549428
2020-03-18T09:30:00-04:00,29.6,30.87,28.37,29.25,12255764,14165501.4,32.293855955619364,37.944080220637716,NaN,NaN,-163.53292003438685,-175.66444617577955,-0.9526803650168254,-2.317031126533024,-1.3643507615161987,97257045,103098066.2,8.005771305213656,13.927768062148226,NaN,NaN,-29.069285372017816,-15.019043657854786
2020-03-19T09:30:00-04:00,28.82,29.54,28,28.79,13526144,14646717,31.599501182206197,38.29908274332296,NaN,NaN,-152.98720833968096,-160.05488368904827,-0.9735252895916751,-2.5812573735057924,-1.6077320839141174,83730901,100166191.8,7.674931174356857,12.07898098150073,NaN,NaN,-30.64244722102932,-17.250958452594006
2020-03-20T09:30:00-04:00,28.95,29.6,26.97,27.16,16549907,15324851.25,29.20337837380424,37.37245727480813,NaN,NaN,-144.38223018147525,-163.43696254212506,-1.024922085630008,-2.8888846909516275,-1.8639626053216194,67180994,91985361.2,6.827137146063379,10.68691187666841,NaN,NaN,-32.76241255899958,-19.4668804677948
2020-03-23T09:30:00-04:00,26.88,26.92,24.88,25.46,28171339,16498262.5,26.911396972951763,36.29334646801509,NaN,NaN,-154.14164412813807,-154.30964466949715,-1.0949051295497028,-3.232594017258748,-2.137688887709045,39009655,79338280.8,5.766626051674535,9.703093164691676,NaN,NaN,-35.2712039401474,-21.72464096384517
2020-03-24T09:30:00-04:00,26.63,27.77,26.22,27.68,15346904,16806088.3,34.17658924549278,35.040973389335306,NaN,NaN,-112.94521224935352,-145.59784298660693,-0.9202082943301844,-3.2879492556217755,-2.367740961291591,54356559,68307030.8,5.032339384593229,8.905505815921996,NaN,NaN,-34.65455620520292,-23.571771712610566
2020-03-25T09:30:00-04:00,27.88,30.43,27.48,28.91,18863489,17317150.85,37.862045209582426,34.41906542850962,NaN,NaN,-75.79540545462821,-128.05034007065518,-0.6623908942159349,-3.19572957906151,-2.533338684845575,73220048,63499631.4,4.748563020348669,8.261677906099633,NaN,NaN,-32.88140220617262,-24.901718925976574
2020-03-26T09:30:00-04:00,29.16,31.26,28.96,31.13,17228557,17385503.95,43.960725849506424,34.47338505730636,NaN,NaN,-46.08640043562566,-106.67017848984415,-0.301301138460337,-2.9099651079209963,-2.6086639694606593,90448605,64843172.2,6.338186244498161,7.812960419179567,NaN,NaN,-29.275375398656884,-25.526526993502333
2020-03-27T09:30:00-04:00,30.17,31.95,30.15,31.21,11840766,15752587.4,44.173364441831005,35.28427758277066,NaN,NaN,-31.63181482598355,-84.12009541874579,-0.03029426690428494,-2.6465318030910154,-2.6162375361867305,102289371,71864847.6,14.38031228342929,8.071350951854267,NaN,NaN,-26.453841934891027,-25.65900055655786
2020-03-30T09:30:00-04:00,31.38,32.18,30.69,32.02,10377675,15287161.2,46.39137677259728,35.57214500573911,NaN,NaN,-18.687956781421608,-57.029357949402495,0.2166997113554574,-2.345362896992409,-2.5620626083478664,112667046,86596325.8,28.291634151042288,9.341887988938122,NaN,NaN,-23.476949096213374,-25.34727891936579
2020-03-31T09:30:00-04:00,31.79,31.84,30.27,31,9016318,13838777,44.01962789329524,36.144907336376335,NaN,NaN,-24.550837905350406,-39.35048308060186,0.3184148135631921,-2.164044091393876,-2.4824589049570682,103650728,96455159.6,35.808490478577056,11.217226204461483,NaN,NaN,-21.72542369212083,-24.829871029759367
2020-04-01T09:30:00-04:00,29.6,29.62,28.4799,29.12,11255408,13715896.15,39.96413011538381,36.934618523011785,NaN,NaN,-59.8516232924653,-36.16172664816928,0.2681309343951068,-2.147295236963185,-2.4154261713582916,92395320,100290214,38.50877922121573,13.340084629733601,NaN,NaN,-21.459965183218138,-24.348455908824906
2020-04-02T09:30:00-04:00,28.78,29.97,28.76,29.55,11021706,13599563.2,41.296296861910534,36.97930258248099,NaN,NaN,-47.87089610478326,-36.5186257820008,0.2720206812284349,-2.075400319822748,-2.347421001051183,103417026,102883898.2,40.33675214824138,15.60720783644874,NaN,NaN,-20.85163385452049,-23.84890990106713
2020-04-03T09:30:00-04:00,29.34,29.8,28.77,29.3,7984071,13151650.7,40.73041875425969,37.741880529264726,NaN,NaN,-46.23584050863787,-39.43943091853167,0.2656454988127437,-2.0153641275352534,-2.281009626347997,95432955,101512615,39.665380478640714,17.82998877155179,NaN,NaN,-20.514210449986923,-23.37252426519853
2020-04-06T09:30:00-04:00,30.41,31.55,30.41,31.42,9514472,12987782.55,47.32243151490357,38.56465279595318,NaN,NaN,18.78646544412164,-31.944546473423024,0.40381305862672345,-1.776243303064593,-2.1800563616913164,104947427,99968691.2,38.88072355209189,20.018973331427624,NaN,NaN,-18.259597735782748,-22.642106189567702
2020-04-07T09:30:00-04:00,32.68,32.99,31.41,31.43,19488587,13017092.25,47.3521766142566,39.64024712871298,NaN,NaN,62.67140294512448,-14.500098303328064,0.48975859491662765,-1.5678581180455318,-2.0576167129621594,124436014,104125748.4,42.19636933256918,22.461158904810162,NaN,NaN,-16.429921134861225,-21.75465118175249
2020-04-08T09:30:00-04:00,31.84,33.97,31.5,33.79,27207820,13575510.5,53.95951141544966,41.23739071680179,NaN,NaN,120.99488021237863,21.66920239764072,0.6873222226054945,-1.1984639347052912,-1.8857861573107857,151643834,115975451.2,50.44828456850213,25.516398432963395,NaN,NaN,-12.779221639683373,-20.472446961456903
2020-04-09T09:30:00-04:00,34.4,35.95,34.35,35.53,49899825,15617573.4,58.131605808832276,43.30369267644666,NaN,NaN,186.28715150063886,68.50081191872513,0.9033557978163311,-0.7565914100403717,-1.6599472078567028,201543659,135600777.8,60.50462562501596,29.350504752888583,NaN,NaN,-8.32161973124821,-18.736614499998517
2020-04-13T09:30:00-04:00,35.33,35.39,33.695,33.9,9877343,15626696.85,53.26240162433105,45.18590729440233,NaN,NaN,150.62625836103385,107.87323169265949,0.9025166836616445,-0.5318013532796471,-1.4343180369412916,191666316,154847450,67.47587160309567,33.75830800656151,NaN,NaN,-5.978664417062646,-16.91405020243625
2020-04-14T09:30:00-04:00,34.59,35.19,34.59,35.03,6720297,15670707.2,56.01310938265896,46.74565873277133,NaN,NaN,147.75526450753603,133.66699150534237,0.9398696911397277,-0.25948092301663195,-1.1993506141563597,198386613,173535287.2,72.54342771509397,38.58052860159729,NaN,NaN,-3.1774009855683634,-14.951671742883695
2020-04-15T09:30:00-04:00,34.11,34.38,33.36,33.68,5379026,15576270.9,52.070280023906484,47.76053264808019,NaN,NaN,97.79947977731713,140.6926068717809,0.8387927147679543,-0.15085972069641684,-0.9896524354643711,193007587,187249601.8,75.55370003279315,43.638038388200464,NaN,NaN,-1.9923241375852578,-13.100336370698205
2020-04-16T09:30:00-04:00,33.73,34.02,33.265,33.46,4373022,15182133.8,51.434876531851046,48.29440055396196,NaN,NaN,81.79451700484023,132.8525342302732,0.7264513103234089,-0.08158829756010988,-0.8080396078835188,188634565,194647748,77.01752689384959,48.686562720297,NaN,NaN,-1.2166997016271395,-11.402673989402338
2020-04-17T09:30:00-04:00,34.35,34.7,33.96,34.54,6540401,14832846.65,54.37807181390315,49.02330822339568,NaN,NaN,96.2850244909749,114.85210882834042,0.6942459361281836,0.059767812276710686,-0.634478123851473,195174966,193374009.4,76.17183324766077,53.10024278917068,NaN,NaN,0.29423289499176236,-9.731687291631753
2020-04-20T09:30:00-04:00,33.93,34.06,33.26,33.26,5773912,14294046.9,50.47387146094922,49.31491498684939,NaN,NaN,62.79909540086457,97.28667623630656,0.5617645186028769,0.06772752440212315,-0.49403699420075375,189401054,192920957,75.85279123668337,56.497468295287895,NaN,NaN,0.46513653522663945,-8.274998173509125
2020-04-21T09:30:00-04:00,32.48,33.01,32.3701,32.77,7839485,13277454.2,49.02283764842453,49.67228711221576,NaN,NaN,30.337892835738916,73.80320190194715,0.4225124940546768,0.034103623367592206,-0.3884088706870846,181561569,189555948.2,73.39391881758843,59.182141748074415,NaN,NaN,0.19586743572377793,-7.064874515047282
2020-04-22T09:30:00-04:00,33.27,33.64,33.02,33.34,5385959,12779406.95,50.79492163888731,50.4459150781803,NaN,NaN,45.088235312805814,63.260953009044876,0.3530003376301446,0.052841551350596205,-0.3001587862795484,186947528,188343936.4,72.482531234362,61.60883832044202,NaN,NaN,0.4554461966111022,-5.99054298481037
2020-04-23T09:30:00-04:00,33.4,33.62,32.89,32.96,6367844,12154624.7,49.558073207861355,51.03604196003393,NaN,NaN,32.776456460417215,53.45734090016028,0.26941238176206256,0.03660669092302982,-0.23280569083903274,180579684,186732960.2,71.21665409866904,63.81454560261541,NaN,NaN,0.3401844202450217,-5.086153355516743
2020-04-24T09:30:00-04:00,33.13,33.231,32.715,33.08,5142663,11550330,49.97234812554418,51.696179772268536,NaN,NaN,22.646008017765226,38.72953760551835,0.21267859285973406,0.03304255023563485,-0.1796360426240992,185722347,184842436.4,69.67872571532683,65.95835597666442,NaN,NaN,0.35029923535357727,-4.309517271106697
2020-04-27T09:30:00-04:00,33.35,34.16,33.35,34.04,4024307,11159507.05,53.278255581213834,52.121595777004984,NaN,NaN,54.875413655374615,37.144801256420365,0.22887265459554196,0.10645477562032823,-0.12241787897521372,189746654,184911556.4,69.70448531711708,68.1600532455948,NaN,NaN,1.2286093006084742,-3.5183563322902436
2020-04-28T09:30:00-04:00,34.64,35.02,34.04,34.07,5955252,10938385.9,53.38192951367406,52.55229241267766,NaN,NaN,72.9567488046519,45.66857245020296,0.23005548636203396,0.16515147897732874,-0.06490400738470523,195701906,187739623.8,70.7976369345199,70.20300093144841,NaN,NaN,1.9920347490752652,-2.7311576063808856
2020-04-29T09:30:00-04:00,34.76,34.87,34.14,34.16,6095148,10792327.4,53.713753991830984,52.53473831099062,NaN,NaN,69.37064223383976,50.525053834409746,0.22507228084408026,0.2164363436703951,-0.008635937173685153,201797054,190709529,71.94258867149347,71.73830836737638,NaN,NaN,2.724179599869141,-1.951823719773739
2020-04-30T09:30:00-04:00,33.71,34.05,33.37,33.92,6837488,10571431.4,52.637771909405735,52.14232160388872,NaN,NaN,35.28047062245653,51.0258566668176,0.1949127361645245,0.23500498303197048,0.04009224686744598,194959566,193585505.4,73.04473730700627,72.63403063037568,NaN,NaN,3.099063545914089,-1.2302683961040493
2020-05-01T09:30:00-04:00,33.09,33.31,32.68,32.88,5724454,10306568.8,48.137773941221866,51.776276769380914,NaN,NaN,-27.228670766079386,41.05092091004868,0.09905578640696083,0.16391197987614703,0.0648561934691862,189235112,194288058.4,73.32044545463829,73.05150019120015,NaN,NaN,2.2978623200389103,-0.7262497223693408
2020-05-04T09:30:00-04:00,32.59,32.89,32.09,32.86,6816567,10248193.6,48.05269659713967,51.20767585612954,NaN,NaN,-78.16277564675934,14.443283049621888,0.031914204538995294,0.10474894914293031,0.07283474460393502,182418545,192822436.6,71.67345204692045,72.98935907204489,NaN,NaN,1.5963104688099263,-0.39445540934373124
2020-05-05T09:30:00-04:00,33.14,33.509,33.025,33.07,4899378,10017438.9,49.07051704209162,50.993407071714195,NaN,NaN,-41.4855455834646,-8.445175828001414,0.0008958553731781976,0.07395456382040777,0.07305870844722957,187317923,191145640,69.74320966037538,72.57432404544363,NaN,NaN,1.2299379358156093,-0.16239921717811118
2020-05-06T09:30:00-04:00,33.17,33.32,32.46,32.46,4609942,9273506.65,46.236586819324785,50.62210066367661,NaN,NaN,-96.56167777115049,-41.63163982899946,-0.05818764440567335,0.00032415294013787843,0.05851179734581123,182707981,187327825.4,65.42301595266639,71.74614469250197,NaN,NaN,0.19501980508181055,-0.11133935685526522
2020-05-07T09:30:00-04:00,32.78,33.16,32.56,32.75,4927730,8159502.15,47.780607731836234,50.15085322924325,NaN,NaN,-85.38204993646951,-65.76414394078468,-0.07419606333955028,-0.034233281828626616,0.03996278151092366,187635711,185863054.4,63.79035542244472,70.86175341927225,NaN,NaN,-0.335616738055908,-0.14337898274107133
2020-05-08T09:30:00-04:00,33.13,33.45,33.04,33.35,4428821,5885951.95,50.92110933634765,50.182798791771724,NaN,NaN,-31.120944789230293,-66.54259874541485,-0.042414084709464166,-0.013054824375906549,0.029359260333557617,192064532,186428938.4,64.16244378315048,70.02672860116276,NaN,NaN,-0.030053261193252908,-0.12718959394852586
2020-05-11T09:30:00-04:00,32.99,33.45,32.78,32.95,4566415,5620405.55,48.813451313790296,50.167842625012135,NaN,NaN,-51.964174648330676,-61.302878545729115,-0.046065068116280986,-0.028222074811793618,0.017842993304487367,187498117,187444852.8,64.86056522902129,69.41720334483652,NaN,NaN,-0.29146552677103954,-0.1506575843517421
2020-05-12T09:30:00-04:00,33.08,33.11,31.53,31.55,16049438,6086862.6,42.22576982205018,49.55576035238091,NaN,NaN,-167.92319718826326,-86.59040886668885,-0.1354460273035584,-0.15146454082496064,-0.016018513521402232,171448679,184271004,60.871075356518304,68.58781363927626,NaN,NaN,-2.3654555997021256,-0.46705730083036834
2020-05-13T09:30:00-04:00,31.37,31.74,30.895,31.05,5131507,6074486.65,40.14214142886404,48.88319379673824,NaN,NaN,-232.1146541288065,-113.70100413822006,-0.21613077053874002,-0.28618197669482726,-0.07005120615608725,166317172,180992842.2,56.97313163073957,67.5704191772813,NaN,NaN,-4.7396071193946625,-1.0774215606252675
2020-05-14T09:30:00-04:00,30.65,31.09,30.03,31.09,8269373,6269304.2,40.395535327229844,48.1991357397158,NaN,NaN,-232.4420935680994,-143.11301286454605,-0.25218112231688106,-0.38527760905218855,-0.1330964867353075,174586545,178383009,54.00796273444321,66.45107896436103,NaN,NaN,-6.6539070822913065,-1.8740623494347015
2020-05-15T09:30:00-04:00,30.87,30.99,30.39,30.98,7482884,6316428.35,39.89536855593305,47.24321523791002,NaN,NaN,-190.31572961546925,-174.95196982979382,-0.26736356101490966,-0.46730093800394457,-0.1999373769890349,167103661,173390834.8,48.77836540688902,64.95635611363046,NaN,NaN,-8.410291095434333,-2.8078093131489346
2020-05-18T09:30:00-04:00,31.91,32.75,31.91,32.49,6286430,6342054.25,49.19483948976063,46.944137379059065,NaN,NaN,-40.17094931370837,-172.59332476286937,-0.164676516526378,-0.4057830226470074,-0.2411065061206294,173390091,170569229.6,46.06343929363863,63.18962771071036,NaN,NaN,-7.4712920211057,-3.4740211285713296
2020-05-19T09:30:00-04:00,32.32,32.44,31.86,31.86,5799350,6240047.5,45.9971966589441,46.39295471242429,NaN,NaN,-63.740518444951924,-151.75678901420707,-0.12968865752025693,-0.40321732802095056,-0.2735286705006936,167590741,169797642,45.32059119781597,61.288056462590546,NaN,NaN,-7.571636889565533,-4.059394808713359
2020-05-20T09:30:00-04:00,32.2,32.25,31.9095,32.16,4041654,6172832.25,47.73921111378576,46.04305751273715,NaN,NaN,-52.828997809997745,-115.89965775044534,-0.07932144377290501,-0.3726804752168249,-0.2933590314439199,171632395,170860686.6,46.598351084605824,59.39902887527624,NaN,NaN,-7.165868567123805,-4.503176774200566
2020-05-21T09:30:00-04:00,32.05,32.27,31.76,32,4289036,6068891.85,46.870808139559806,45.95255995547558,NaN,NaN,-54.727883116341445,-80.35681566009376,-0.05113041673456009,-0.35727205236212,-0.3061416356275599,167343359,169412049.4,45.05329300164132,57.379946557205024,NaN,NaN,-7.06112266032216,-4.868597615075079
2020-05-22T09:30:00-04:00,32.03,32.72,31.88,32.7,4743160,6048916.7,51.06482303079328,46.16771184359369,NaN,NaN,-17.498970221220212,-45.79346378124396,0.016682913323448845,-0.2852879939732489,-0.30197090729669773,172086519,170408621,46.37067033399824,55.572605006282004,NaN,NaN,-5.7935076640276435,-5.000727622068303
2020-05-26T09:30:00-04:00,33.73,33.97,33.345,33.74,5756959,6135549.3,56.55242140012826,46.70213358345345,NaN,NaN,88.0735292574686,-20.144568067008542,0.12743583044869428,-0.1426761192358299,-0.2701119496845242,177843478,171299298.4,47.580319677458995,53.989541436073694,NaN,NaN,-3.0105109665627383,-4.7164109569960795
2020-05-27T09:30:00-04:00,34.43,34.46,33.6,34.46,5779762,6126774.8,59.90468830559148,47.67842654675821,NaN,NaN,131.60093103338465,18.923721828658763,0.23858449348654553,0.02811866717365774,-0.2104658263128878,183623240,174505798.2,51.7957143708673,53.01616275165947,NaN,NaN,0.4180315201557176,-3.982919174545823
2020-05-28T09:30:00-04:00,34.86,34.91,34.44,34.85,5281381,6086086.45,61.631574751733176,48.66778133389371,NaN,NaN,173.94738028129913,64.27899744691813,0.32255099443349045,0.19272291672897524,-0.12982807770451518,188904621,177960243.4,55.90931821070382,52.4532315222494,NaN,NaN,3.8086984509580084,-2.86983094233099
2020-05-29T09:30:00-04:00,34.62,34.82,34.31,34.65,7830923,6135758.2,60.199669229680644,49.33053561198892,NaN,NaN,151.23908316754003,105.47239070369442,0.34669099944604126,0.3035356716030364,-0.043155327843004854,181073698,180706311.2,58.91109897757933,52.07813546470861,NaN,NaN,6.222523442949123,-1.5709231730052595
2020-06-01T09:30:00-04:00,34.62,35.605,34.52,35.34,5275578,6113314.4,63.36226372046716,50.369736498180124,NaN,NaN,164.60835793865408,141.89385633566928,0.38807499876812845,0.4419384206171557,0.05386342184902726,186349276,183558862.6,61.81904194266807,51.86088380139766,NaN,NaN,9.267626056273668,-0.022558997393984148
2020-06-02T09:30:00-04:00,35.56,35.71,35.16,35.57,4586771,6001824.6,64.37835842219972,51.95206425533366,NaN,NaN,155.10800660981326,155.3007518061382,0.4078571552456447,0.5636848659060831,0.15582771066043843,190936047,186177376.4,64.31562234617368,52.10692287208736,NaN,NaN,12.104710732113004,1.7099081068212998
2020-06-03T09:30:00-04:00,35.89,36.625,35.83,36.42,3685708,5941141.1,67.9193470111222,53.93615036835211,NaN,NaN,168.50456645045404,162.6814788895521,0.4517000444035382,0.7204527661648612,0.268752721761323,194621755,188377079.4,66.30863998084848,52.773744897095135,NaN,NaN,15.694262389500407,3.707673004346886
2020-06-04T09:30:00-04:00,36.24,36.26,35.46,35.74,3692397,5895263.85,62.561475993534664,55.51943184451674,NaN,NaN,122.55523385340466,152.4030496039732,0.409654876563298,0.7808213174654455,0.37116644090214745,190929358,188782026.8,66.67760775636405,53.67871954151805,NaN,NaN,17.22697650463248,5.639002075816256
2020-06-05T09:30:00-04:00,36.87,37.3,36.71,37.05,5313699,5914562.3,67.82695603901189,57.514545236165226,NaN,NaN,149.86968226853966,152.12916942417314,0.4420442803681254,0.9237217913623041,0.48167751099417877,196243057,191815898.6,69.38291748172408,55.15047326114912,NaN,NaN,20.306057994130917,7.734295778432636
2020-06-08T09:30:00-04:00,37.44,37.86,37.38,37.86,4384547,5912348.6,70.58201316616262,59.04220049876536,NaN,NaN,149.92355131685812,149.19220809981397,0.48647358533424034,1.0897694926619792,0.6032959073277389,200627604,194671564.2,71.71097452016072,56.98244006304356,NaN,NaN,23.812865510902462,10.031234311642612
2020-06-09T09:30:00-04:00,37.31,37.6,36.97,37.42,3636116,5865833.65,67.2149100335255,60.55775145409261,NaN,NaN,118.21100713873673,141.81280820559863,0.45523935803779136,1.172345104874978,0.7171057468371866,196991488,195882652.4,72.6604299834659,58.935285690589986,NaN,NaN,25.63380191025591,12.26017254001594
2020-06-10T09:30:00-04:00,37.26,37.43,36.5,36.72,3956989,5261211.2,62.13637624473456,61.58612039201752,NaN,NaN,92.94237339917359,126.70036959534255,0.3605878691973581,1.1678405833338843,0.8072527141365262,193034499,195565201.2,71.97849144407576,60.74815285912354,NaN,NaN,25.57421776556299,14.162179000808376
2020-06-11T09:30:00-04:00,35.33,35.72,34.41,34.45,17916012,5900436.45,49.16369514541913,61.74989803529319,NaN,NaN,19.8240211718173,106.15412705902509,0.13013387197980086,0.9699200541112774,0.8397861821314765,175118487,192403027,65.3946000160584,62.20110336015334,NaN,NaN,20.82794737607428,15.114431625846363
2020-06-12T09:30:00-04:00,35.52,35.69,34.66,35.54,7645083,5869221.95,54.1172665475994,61.967929715065054,NaN,NaN,30.24113401505823,82.2284174083288,0.04077302179429676,0.8907524593743474,0.8499794375800507,182763570,189707129.6,60.32816702868958,63.19806740977415,NaN,NaN,18.668304150479567,15.622127700793964
2020-06-15T09:30:00-04:00,34.58,36.12,34.53,35.99,5147826,5752469.05,56.02248944672163,61.930077432678864,NaN,NaN,34.570448937018746,59.15779693236092,0.0035948313610127958,0.8544729767813166,0.8508781454203038,187911396,187163888,55.926219888803566,63.79420313915591,NaN,NaN,17.615199739330425,15.906852277727744
2020-06-16T09:30:00-04:00,37.1,37.2,35.99,36.59,6559294,5766112.25,58.49705436235524,61.82953215101914,NaN,NaN,75.11304823592917,50.5382051517994,0.010637119515683358,0.8641745448149081,0.8535374252992247,194470690,186659728.4,55.06840749594696,64.02796693380445,NaN,NaN,17.57483902192529,16.14513609832739
2020-06-17T09:30:00-04:00,36.82,36.82,36.15,36.16,3553834,5653836.45,56.06237598917349,61.43173223940773,NaN,NaN,59.70320921036582,43.890372314037855,-0.02072965930488113,0.8276253511681233,0.8483550104730044,190916856,186236199.8,54.314715772244426,63.91406675962879,NaN,NaN,16.76422132587178,16.233576845119448
2020-06-18T09:30:00-04:00,35.9,35.95,35.54,35.71,2260961,5564801.8,53.55049073181352,60.9567909181315,NaN,NaN,20.094280765905918,43.94442423285558,-0.07575530501094718,0.7536608792093205,0.8294161842202676,188655895,188943681.4,58.248667479334955,63.8667502240399,NaN,NaN,15.31780251807663,16.102751941256187
2020-06-19T09:30:00-04:00,36.22,36.25,35.08,35.35,5057350,5603217.5,51.56019540968673,60.11378603879005,NaN,NaN,-0.22385039905598517,37.851427350032736,-0.13680908345150722,0.6584048299058836,0.7952139133573908,183598545,189110676.4,58.48611558137529,63.628684055376134,NaN,NaN,13.525961339517266,15.734638998150627
2020-06-22T09:30:00-04:00,34.97,35.105,34.51,34.98,2525370,5492328,49.52294489528504,59.05268507258186,NaN,NaN,-63.66524943860856,18.20428767490727,-0.19876699981663593,0.5467551635865959,0.7455221634032319,181073175,187743032.2,55.692605510947345,63.0127542814314,NaN,NaN,11.43192274611167,15.119965247859348
2020-06-23T09:30:00-04:00,35.31,35.4,34.8,34.85,2444934,5326726.75,48.793457509587775,57.686550108186545,NaN,NaN,-61.201116155095626,-9.058545203297687,-0.242274406445104,0.44267915534685187,0.6849535617919559,178628241,184574542.4,49.76248655669422,61.8308861797061,NaN,NaN,9.502110390737146,14.317414553984747
2020-06-24T09:30:00-04:00,34.45,34.58,33.26,33.96,6262798,5350878.55,44.01345501191716,56.361691466642434,NaN,NaN,-148.65495150692,-50.73017734675485,-0.3198858929904238,0.2850961955539262,0.60498208854435,172365443,180864259.8,43.87150382325829,60.20187875591282,NaN,NaN,6.371230478390151,13.182245400328377
2020-06-25T09:30:00-04:00,33.78,34.34,33.6735,34.32,3520096,5262814.3,46.30484397222084,54.82439774758593,NaN,NaN,-127.15754386907723,-80.18054227375148,-0.3343034693217275,0.1871027518921906,0.5214062212139181,175885539,178310188.6,40.33197195590788,58.12681121835452,NaN,NaN,4.383675732017013,11.925306876283896
2020-06-26T09:30:00-04:00,34.22,34.39,33.65,33.73,4398864,5091211.35,43.18533903911268,52.86749245279664,NaN,NaN,-134.59851854982762,-107.05547590390582,-0.36822136922272863,0.061129509685507344,0.429350878908236,171486675,175887814.6,37.26142564124585,55.666129155574886,NaN,NaN,1.7577759793113799,10.47280246243068
2020-06-29T09:30:00-04:00,34.01,34.31,33.63,34.31,4052672,5030066.05,46.967678922966876,51.42126165918531,NaN,NaN,-111.96096863737502,-116.71461974365911,-0.3370777441430374,0.00800369872943918,0.3450814428724766,175539347,174781049,35.916019118010055,53.0415283794709,NaN,NaN,0.5793662243063978,9.059454428412925
2020-06-30T09:30:00-04:00,34.38,34.98,34.29,34.81,3640581,4982756.55,50.054578556063746,50.558276109994544,NaN,NaN,-62.28083471399946,-116.93056345543987,-0.27112456068841745,0.00617574201195481,0.27730030270037226,179179928,174891386.4,36.16348481688075,50.483313620385545,NaN,NaN,0.4621087983780312,7.8312621955507975
2020-07-01T09:30:00-04:00,34.95,35.87,34.8749,35.76,5182469,5057594.6,55.37010215764059,51.00159089658179,NaN,NaN,-2.972953586959045,-87.79416387144768,-0.157474898842148,0.08045667914768728,0.23793157798983527,184362397,177290777.2,41.457662507367715,48.77353236976478,NaN,NaN,1.9656922154497232,6.99332362696493
2020-07-02T09:30:00-04:00,36.29,36.32,35.51,35.64,2586002,5002274.85,54.57992292598425,51.034637780752135,NaN,NaN,20.477234079536352,-58.26720828172496,-0.08781369458200888,0.12816445976232416,0.21597815434433304,181776395,178468948.4,43.917187413016954,47.601319540073874,NaN,NaN,2.965897749956908,6.417977073106641
2020-07-06T09:30:00-04:00,36.25,36.36,35.613,35.68,3206283,4896904.05,54.811418357553734,50.94813270295443,NaN,NaN,30.935236721778406,-25.160457227403754,-0.038964387392160266,0.16727267010413271,0.20623705749629298,184982678,181168149,49.18449691656077,47.119767899199395,NaN,NaN,3.8513677946553977,6.051318604756464
2020-07-07T09:30:00-04:00,35.38,35.53,35.09,35.1,2668635,4811108.45,50.770684364703136,50.39624913169356,NaN,NaN,-10.762651565290831,-4.920793812986919,-0.04519847934146609,0.14973895831946038,0.19493743766092647,182314043,182523088.2,51.63986112486537,46.87487172983642,NaN,NaN,3.5088421116991992,5.688107677176855
2020-07-08T09:30:00-04:00,35.21,35.32,34.7704,35.08,11063802,5182492.75,50.632072116547796,50.008370283648865,NaN,NaN,-19.112358899184258,3.7129013499761117,-0.04979006911205555,0.13269985127085704,0.1824899203829126,171250241,180937150.8,48.6751788043994,46.47204766070463,NaN,NaN,3.188507620556146,5.331021954802468
2020-07-09T09:30:00-04:00,35.01,35.1,34.4,34.96,6024660,5285876.3,49.75435290183407,49.73721758150748,NaN,NaN,-35.64303744406925,-2.821115421445924,-0.05937975635733833,0.10826522493623969,0.16764498129357802,165225581,177109787.6,42.35542118812409,45.336815782761,NaN,NaN,2.6889408623671325,4.953581798740277
2020-07-10T09:30:00-04:00,34.96,35.1801,34.82,35,5978367,4688994.05,50.06509319914555,49.630424566468825,NaN,NaN,-16.915890693575943,-10.299740376068385,-0.061253282332058456,0.09107837837850496,0.15233166071056342,171203948,174995298.2,39.31819615754338,43.96767868105872,NaN,NaN,2.343408195340845,4.580699855397501
2020-07-13T09:30:00-04:00,35.12,35.19,34.36,34.45,10021672,4807823.5,45.86492039309994,49.369137102027025,NaN,NaN,-49.16878820124827,-26.32054536067372,-0.0957050676135435,0.032700326193634055,0.12840539380717755,161182276,170235217.8,33.49522859446657,42.382151758452956,NaN,NaN,0.9294670245100457,4.059095165270722
2020-07-14T09:30:00-04:00,34.49,34.9,34.4,34.79,6205802,4860722.3,48.72849877080608,49.36449719211406,NaN,NaN,-41.90963470835082,-32.54994198928572,-0.09175440316346314,0.013712389852848617,0.10546679301631176,167388078,167250024.8,30.449611180789617,41.00266066017405,NaN,NaN,0.43758431799888153,3.541736472803316
2020-07-15T09:30:00-04:00,35.25,35.37,34.755,34.95,7492465,4907380.85,50.06707482728037,49.79689860749714,NaN,NaN,3.1294731311054016,-28.10157558322779,-0.07521898020171969,0.011443067764162151,0.08666204796588184,174880543,167976085.2,32.06752308386692,40.159519178788955,NaN,NaN,0.36201267191984865,3.087490215534249
2020-07-16T09:30:00-04:00,34.81,34.97,34.455,34.54,3339298,4896654.05,46.702315617270955,49.825289439286436,NaN,NaN,-36.82743137247715,-28.338454368909357,-0.08786711771224516,-0.023171849174424608,0.06469526853782055,171541245,169239218,34.90457147589581,39.77184771593095,NaN,NaN,-0.5940250270765681,2.5615594665898467
2020-07-17T09:30:00-04:00,34.69,35.19,34.51,35.02,8696362,5218424.1,50.865541812686864,50.37387535168459,NaN,NaN,5.222069605978993,-23.910862308998368,-0.06114592154623516,-0.011737133394973398,0.04940878815126176,180237607,171045949.8,38.839098488825876,39.884538633615236,NaN,NaN,-0.31726417542986163,2.150298946301317
2020-07-20T09:30:00-04:00,35.05,35.24,34.57,34.69,2792256,5105169.4,48.0846414139212,50.45365838675275,NaN,NaN,-0.5817541758197325,-14.193455503912663,-0.06270250276877545,-0.028969340309707547,0.0337331624590679,177445351,174298564.8,45.25437148935658,40.55156380299713,NaN,NaN,-0.8342304608415689,1.723937602423762
2020-07-21T09:30:00-04:00,35.01,35.09,34.6,34.7,5930723,5275437.05,48.17710148073295,50.319552881371976,NaN,NaN,-6.187261390085637,-7.048980840259626,-0.06006053108183355,-0.04134250139322404,0.018718029688609507,183376074,177496164,50.7262101157827,41.59175846720441,NaN,NaN,-1.2408166447746654,1.3004012813954153
2020-07-22T09:30:00-04:00,34.65,35.13,34.43,35.12,21831541,6244767.4,52.04047905882561,50.08172266002805,NaN,NaN,11.326959224833649,-5.409483621513979,-0.028623352027616216,-0.017061160345910764,0.011562191681705452,205207615,183561578.4,59.08091131836681,42.85056195370434,NaN,NaN,-0.56357849197429,1.0341184566283146
2020-07-23T09:30:00-04:00,35.06,35.25,34.56,34.94,9896092,6426432.1,50.30945553277005,49.77668927479846,NaN,NaN,7.711429696708167,3.4982885923230844,-0.019011243606377612,-0.012201862826266563,0.006809380780111049,195311523,188315634,64.20406235976577,44.29962444990068,NaN,NaN,-0.43909161443969086,0.823659875047171
2020-07-24T09:30:00-04:00,34.88,35.1,34.73,34.8,3388992,6419876.9,48.945761353305514,49.357713774495025,NaN,NaN,-8.086280154965186,0.8366186401342496,-0.020986512220240873,-0.01942375949519004,0.0015627527250508307,191922531,190652618.8,66.42916315495103,45.53138632407142,NaN,NaN,-0.6872614269168859,0.6078139747665914
2020-07-27T09:30:00-04:00,34.82,35.23,34.46,35.21,3487853,6374326.35,52.966579556326664,49.514563431039555,NaN,NaN,-0.033773759231813916,0.9462147234518319,0.005026570176004848,0.00784596544505689,0.0028193952690520425,195410384,194245625.4,69.56187633267362,46.81153026748628,NaN,NaN,0.17483251053647172,0.5459594798765743
2020-07-28T09:30:00-04:00,35.2,36.0978,35.12,35.92,3591090,6351247.25,58.98985971176052,50.111548259269036,NaN,NaN,151.20333574592829,32.424334150654616,0.06635240257222519,0.08575989848433352,0.019407495912108337,199001474,197370705.4,72.00852732250632,48.47819801877964,NaN,NaN,2.7408529440930574,0.8595156890503577
2020-07-29T09:30:00-04:00,36.05,36.6,36.03,36.6,3072616,6322849,63.77476123589818,51.11300599741647,NaN,NaN,225.7856537814539,75.31607306197867,0.14453102061473588,0.20007127168052818,0.05554025106579231,202074090,196744000.4,70.77981483812096,50.50851185092227,NaN,NaN,6.541321576422439,1.6712022443892263
2020-07-30T09:30:00-04:00,36.13,36.32,35.82,36.3,3104033,6218927.2,60.42513460166906,51.85300895473957,NaN,NaN,154.91149017244084,104.7560851571252,0.16630365989288443,0.26341982593189783,0.09711616603901341,198970057,197475707.2,71.39356095383795,52.79960933637188,NaN,NaN,8.728332898272626,2.6793637663725693
2020-07-31T09:30:00-04:00,36.25,36.32,35.74,36.26,4594545,6319354.35,59.972835668218956,52.860717188676645,NaN,NaN,139.780596932706,134.32946057465944,0.16779431963031613,0.30685906557690856,0.13906474594659243,194375512,197966303.4,71.82093112207923,55.537159516915644,NaN,NaN,10.37658073248764,3.7789661901032936
2020-08-03T09:30:00-04:00,36.13,36.18,35.585,35.68,4744121,6396246.25,53.696494316028875,53.21557401333541,NaN,NaN,97.35300603320458,153.80681653314673,0.1216505090149542,0.2911278822152852,0.169477373200331,189631391,196810504.8,69.19805977376717,58.30490584498547,NaN,NaN,9.979687651349572,4.664783541709904
2020-08-04T09:30:00-04:00,35.69,36.325,35.64,36.21,4030959,6464362.45,58.01991814770551,53.783634250508634,NaN,NaN,113.37615938504906,146.24138126097088,0.1186296107371893,0.3177643866218176,0.1991347758846283,193662350,195742680,66.77188481674101,60.78378882590504,NaN,NaN,10.954109906277045,5.563258736648067
2020-08-05T09:30:00-04:00,36.35,36.43,35.84,35.94,2729232,6047633.95,55.19264527378415,54.39008636883101,NaN,NaN,98.22775893697379,120.72980229207485,0.09147116702919944,0.3134737346711276,0.22200256764192816,190933118,193514485.6,61.895218323302196,62.711692172148354,NaN,NaN,10.91572262712732,6.32789643528796
2020-08-06T09:30:00-04:00,35.87,36.07,35.745,36.01,2887798,5890790.85,55.79408205902574,54.74212495785522,NaN,NaN,72.62680865123494,104.27286598783367,0.07209699236951916,0.3121238081038271,0.24002681573430795,193820916,192484657.4,59.724138943507924,64.20348077605422,NaN,NaN,11.056756949151032,7.003447937268399
2020-08-07T09:30:00-04:00,35.86,36.525,35.85,36.5,4065476,5795146.3,59.85610959684914,55.582944113778645,NaN,NaN,99.4522998282357,96.20720656693962,0.08525656816701355,0.3465975259430749,0.26134095777606137,197886392,193186833.4,60.7354508112157,65.30927215618702,NaN,NaN,12.382697064439933,7.771912098292904
2020-08-10T09:30:00-04:00,36.58,36.67,36.29,36.44,2986402,5443382.8,59.139504349083545,56.365972890089395,NaN,NaN,105.72035826520978,97.88067701334066,0.082823789694915,0.36487069489470514,0.28204690519979014,194899990,194240553.2,62.266642498704606,66.13358875496716,NaN,NaN,13.266967908647478,8.5569200712007
2020-08-11T09:30:00-04:00,36.75,36.75,35.6167,35.74,5520128,5409099.1,51.40692171253747,56.320718793925955,NaN,NaN,53.95422174625718,85.99628948558225,0.029713478894662082,0.31918875381811773,0.28947527492345565,189379862,193384055.6,60.21126136639299,66.21432804411188,NaN,NaN,11.731530232580173,9.010435808540626
2020-08-12T09:30:00-04:00,36,36.28,35.84,36.19,4035214,5236236.55,55.440464784612566,56.68721945477184,NaN,NaN,56.31883506447113,77.61450471108174,0.020946193232349475,0.31565801646389247,0.294711823231543,193415076,193880447.2,61.014460845876215,65.98649936454834,NaN,NaN,11.63850895372426,9.385874829281144
2020-08-13T09:30:00-04:00,36.09,36.36,35.73,35.77,4096610,5274102.15,51.17114322150576,56.84617530250044,NaN,NaN,35.16079831713035,70.12130264426081,-0.015137255871711441,0.27579025339190366,0.2909275092636151,189318466,192979957.2,58.69953511329183,65.43438307585839,NaN,NaN,10.232691186892582,9.506848594654207
2020-08-14T09:30:00-04:00,35.75,36.13,35.7122,35.86,2416846,4960126.35,52.023725743331795,56.77882860157223,NaN,NaN,24.756790543814343,55.182200787376544,-0.0338688835768301,0.24859140479257746,0.28246028836940756,191735312,191749741.2,55.59614668242928,64.4368309579838,NaN,NaN,9.342160545179569,9.483321730443544
2020-08-17T09:30:00-04:00,35.85,36.18,35.7358,36.18,2824928,4961759.95,55.03030049917142,56.49600294353015,NaN,NaN,38.22931644986566,41.68399242430773,-0.02598752619817951,0.2499758806216832,0.2759634068198627,194560240,191681791.2,55.42185554248179,63.25206868798205,NaN,NaN,9.463843949308433,9.480539190281386
2020-08-18T09:30:00-04:00,36.25,36.265,35.91,36.14,2603648,4795406.2,54.569944616070885,55.838516042113916,NaN,NaN,45.749150434607294,40.04297816197776,-0.024753947270756194,0.24502097273141743,0.2697749200021736,191956592,192197137.2,56.534782363094756,62.23456636833732,NaN,NaN,9.433897787218392,9.473876132700958
2020-08-19T09:30:00-04:00,36.21,36.23,35.35,35.4,4328863,3920272.3,46.77424631382607,54.863452592982284,NaN,NaN,-43.825553733317456,20.01410040242005,-0.07236767875278616,0.1793153215611909,0.25168300031397706,187627729,191039667.8,53.31526000641045,60.94325915780678,NaN,NaN,7.022748320444908,9.123715016664379
2020-08-20T09:30:00-04:00,35.26,35.945,35.1701,35.78,3032806,3577108,50.67131124499048,54.19905799132311,NaN,NaN,-66.40801757340185,-0.2996627756864051,-0.07646124353341496,0.15610644589720835,0.2325676894306233,190660535,191308081.6,53.96989273319985,59.66818498717254,NaN,NaN,6.149612230267708,8.698843190036284
2020-08-21T09:30:00-04:00,35.87,35.99,35.441,35.9,2155668,3515441.8,51.86975115126578,54.06857633669717,NaN,NaN,-53.415252092663636,-15.934071302982,-0.06948094147330089,0.1457165125889972,0.2151974540622981,192816203,191524259.8,54.52299616381849,58.61996615789049,NaN,NaN,5.786790235267447,8.282835625069307
2020-08-24T09:30:00-04:00,35.95,35.97,35.4303,35.95,3438554,3512976.85,52.38878939266411,53.66635285419421,NaN,NaN,-79.12972461754507,-39.40587951646414,-0.06023454852932508,0.13990426840064174,0.20013881692996682,196254757,191863163.2,55.427233975836906,57.80963395496877,NaN,NaN,5.634972056511227,7.9045694009895815
2020-08-25T09:30:00-04:00,36.06,36.1,35.741,36.06,3226731,3494758.9,53.57494333411661,53.550802715646526,NaN,NaN,-18.112605934605405,-52.17823079030668,-0.0460861783685364,0.1425310939692963,0.1886172723378327,199481488,193368142.4,59.29758416336398,57.62408865783033,NaN,NaN,5.8315276103166465,7.608420573750591
2020-08-26T09:30:00-04:00,35.96,36.01,35.5667,35.81,2231486,3452702.4,50.495872236482064,53.172359156893414,NaN,NaN,-77.94076674467432,-59.00127339257806,-0.05247634404980467,0.12302184227557689,0.17549818632538156,197250002,195292597,63.64478092620489,57.90413451373725,NaN,NaN,5.157671242127447,7.258313526375856
2020-08-27T09:30:00-04:00,35.9,36.3999,35.86,36.29,3098379,3452419.7,55.7538570452493,52.879341117493425,NaN,NaN,82.3893978990076,-29.24179029809617,-0.024698184265205148,0.1446254559938751,0.16932364025908025,200348381,197230166.2,67.41791485182704,58.381453373780914,NaN,NaN,6.062977029426769,7.087551169668844
2020-08-28T09:30:00-04:00,36.35,36.57,35.99,36.57,1583896,3301887.25,58.521454427279764,52.83519469450744,NaN,NaN,144.6070161057184,10.36266334158024,0.010332602328133739,0.18223939316924742,0.17190679084111368,201932277,199053381,70.51854307030338,58.97087484318082,NaN,NaN,7.648160771248206,7.167638255608753
2020-08-31T09:30:00-04:00,36.52,36.52,36.12,36.25,3522726,3240817.5,54.33824389678689,53.04457485052525,NaN,NaN,102.9007821027856,46.768764685646374,0.009758674798234529,0.18410513433890685,0.17434645954067232,198409551,199484339.8,71.21582311241708,59.75691496789683,NaN,NaN,7.8038676540289575,7.258528169668782
2020-09-01T09:30:00-04:00,36.14,36.24,35.87,36.19,4280165,3253277.8,53.565096218920125,52.910619952975786,NaN,NaN,28.285011127326733,56.0482880980328,0.0034688390620656595,0.1786825083682544,0.17521366930618873,194129386,198413919.4,66.97845012175245,60.18291420188799,NaN,NaN,7.715299872876049,7.323781270126963
2020-09-02T09:30:00-04:00,36.24,37.04,35.96,37,4663480,3349990.2,61.52418177550812,53.6501227068331,NaN,NaN,193.8207625559715,110.40059395816198,0.049439567715972854,0.23701312895115478,0.18757356123518193,198792866,198722492.2,67.57735328564817,60.81704407134202,NaN,NaN,10.125447571117373,7.724019313125593
2020-09-03T09:30:00-04:00,36.95,37.2,36.11,36.38,8939741,3652587.35,53.90760207203495,53.784685301740474,NaN,NaN,138.28648988167404,121.58001235469526,0.03438440208045779,0.23055406383575416,0.19616966175529638,189853125,196623441,59.65174859354509,61.106729922136005,NaN,NaN,9.765829783162303,8.015706523130838
2020-09-04T09:30:00-04:00,36.5,36.73,35.62,36.25,9308109,3914719,52.441626795130695,53.599780037166134,NaN,NaN,35.38718777852564,99.73604668925671,0.013060891095525134,0.2124957756247028,0.19943488452917765,180545016,192345988.8,47.441232766455144,60.5366854381341,NaN,NaN,9.017732554944761,8.158853099104256
2020-09-08T09:30:00-04:00,36.01,36.1,35.52,35.79,6823044,4106551.1,47.51749844849251,53.09603388233911,NaN,NaN,-74.62401707128112,64.23108685444336,-0.032163281107712716,0.15923078314453676,0.19139406425224947,173721972,187408473,37.81806331259629,59.199776934527065,NaN,NaN,6.797461647261223,7.964368605983823
2020-09-09T09:30:00-04:00,36.03,36.67,35.96,36.18,4081741,4034631.75,51.661657560291836,53.4451346856581,NaN,NaN,61.84406700383495,70.94289802974501,-0.035678878024912486,0.14679546672110888,0.18247434474602137,177803713,184143338.4,33.04453899703552,57.75186829100028,NaN,NaN,6.238007929406126,7.717745652187009
2020-09-10T09:30:00-04:00,36.14,36.2502,35.65,35.67,6048351,4135288.6,46.491693622207684,53.14659056974504,NaN,NaN,-53.80562887033149,21.417619744484405,-0.07022263263833844,0.09469605394809832,0.16491868658643677,171755362,178735837.6,26.972423641690497,55.82347764160676,NaN,NaN,4.067348646694561,7.196260365688088
2020-09-11T09:30:00-04:00,35.77,35.86,35.29,35.55,5445038,4202710,45.34191355504698,52.68031645572942,NaN,NaN,-121.45015903181722,-30.529710038213842,-0.09735445420952052,0.04322561882453613,0.14058007303405665,166310324,174027277.4,23.007880505360006,53.572397951716866,NaN,NaN,1.9698100656196953,6.449624608535461
2020-09-14T09:30:00-04:00,35.79,36.514,35.79,36.42,3205612,4242148.3,54.18783220029826,52.80881951341757,NaN,NaN,51.34036875303786,-27.3390738433114,-0.0550169471494468,0.07180888909724814,0.12682583624669494,169515936,171821461.4,21.41952112906317,51.14327560551874,NaN,NaN,3.0220710858061506,5.959974105288417
2020-09-15T09:30:00-04:00,36.52,37.2399,36.49,36.9,2947772,4248290.5,58.20668421277389,53.13965814760737,NaN,NaN,179.69613162869135,23.52495589668309,0.003879693035105658,0.131675452540577,0.12779575950547134,172463708,171569808.6,21.239372481128555,48.424831913930504,NaN,NaN,5.263734175210837,5.860511258134477
2020-09-16T09:30:00-04:00,37.08,37.515,36.96,37.14,3545389,4295377.55,60.09179987049414,53.825081550036806,NaN,NaN,204.4629144746876,52.04872539085362,0.054742735936352066,0.19622417942591142,0.14148144348955935,176009097,171210885.4,20.968494965894934,45.37652577390836,NaN,NaN,7.683727506109138,6.120970722130857
2020-09-17T09:30:00-04:00,36.82,37.06,36.0737,36.32,3656866,4261777.7,51.53822056968732,53.52396465892524,NaN,NaN,59.993821071734715,74.80861537926687,0.030132657525747064,0.1791472653967432,0.14901460787099613,172352231,171330259.2,21.327867077567603,42.0843795043184,NaN,NaN,6.896600253547197,6.23177494090462
2020-09-18T09:30:00-04:00,36.34,36.34,35.5299,35.6,6254276,4422851.2,45.42424475322677,52.58844968220716,NaN,NaN,-75.3177749621918,84.03509219319196,-0.03417932222922154,0.10629045508446922,0.14046977731369076,166097955,171287785.4,21.29077063342568,38.56811004454142,NaN,NaN,4.0634824404936305,5.922018869417336
2020-09-21T09:30:00-04:00,34.99,35.04,34.255,34.44,6227340,4626434.8,37.6705835472519,51.39790251438324,NaN,NaN,-264.6910164364905,20.828815155286282,-0.14800621483457274,-0.044537991229525176,0.10346822360504757,159870615,169358721.2,19.621498031349347,34.882801110179436,NaN,NaN,-1.3908635107935026,4.877321386530073
2020-09-22T09:30:00-04:00,34.53,35.13,34.48,34.85,4577973,4683405.75,41.473215726233846,50.534196764905644,NaN,NaN,-188.9399371473485,-52.89839859992169,-0.18637003345496542,-0.1294943182136592,0.05687571524130621,164448588,167755697.2,18.335039585606964,31.408271786169045,NaN,NaN,-4.267880719315975,3.5708639428377804
2020-09-23T09:30:00-04:00,34.79,34.86,33.795,33.85,4331130,4738625.7,35.74513617677009,48.69283636499579,NaN,NaN,-219.7408513954105,-137.7391517739413,-0.2649820954768659,-0.27435190410477617,-0.009369808627910266,160117458,164577369.4,16.083463967109026,27.730136834844817,NaN,NaN,-8.858819846241504,1.7951948301121685
2020-09-24T09:30:00-04:00,33.87,34.45,33.74,34.01,4926435,4873373.15,37.23874750199558,47.50220389570727,NaN,NaN,-186.61890795024348,-187.06169757833695,-0.2900675647088737,-0.3719542645140024,-0.0818866998051287,165043893,163115701.8,15.161364859848817,24.552252282437937,NaN,NaN,-11.820495767357654,-0.14990382666923452
2020-09-25T09:30:00-04:00,33.88,34.71,33.82,34.67,2764983,4856703.35,43.11300794244407,46.83587397765823,NaN,NaN,-129.09001858160647,-197.8161463022199,-0.24771862625024405,-0.39153498261793374,-0.1438163563676897,167808876,163457886,16.37016709901978,22.332890449049696,NaN,NaN,-12.232895064133773,-1.8760454320213114
2020-09-28T09:30:00-04:00,35.12,35.42,35.06,35.27,2802765,4917646.8,47.88818816040113,46.862351814223125,NaN,NaN,-45.602760632463514,-153.99849514141448,-0.16858756777651576,-0.3545508160883344,-0.18596324831181862,170611641,165606091.2,23.7183839193534,21.325770492389488,NaN,NaN,-10.922437280223757,-3.1683871246216606
2020-09-29T09:30:00-04:00,35.17,35.32,34.88,35.09,2217579,4852389.45,46.623771709384634,46.50250282487262,NaN,NaN,-52.61548029101941,-126.73360377014868,-0.11994390251752213,-0.33589312645872127,-0.21594922394119914,168394062,166395186,26.28074182405416,20.84264212289082,NaN,NaN,-10.302001152569346,-4.187474842899901
2020-09-30T09:30:00-04:00,35.26,35.6,34.92,35.27,4386053,4857683.85,48.09953817505589,46.61734886436177,NaN,NaN,-34.212236544454825,-89.62788079995754,-0.06971139060894055,-0.30308846220237484,-0.2333770715934343,172780115,168927717.4,33.949204353117395,21.340983602278452,NaN,NaN,-9.34563797130861,-4.924355289815431
2020-10-01T09:30:00-04:00,35.4,35.86,35.17,35.85,5842181,4916618.9,52.64306898358277,47.13885996640005,NaN,NaN,1.7094123013582145,-51.96221674963721,0.004569660206422604,-0.22766499633540604,-0.23223465654182865,178622296,171643398,41.032692563469,22.628470177857672,NaN,NaN,-7.093101592513264,-5.234176190200835
2020-10-02T09:30:00-04:00,35.31,36.54,35.29,36.43,4494648,4694364.25,56.72309671699613,47.31995028902132,NaN,NaN,47.52759862682646,-16.638693307950614,0.09001951870361727,-0.11971025816230707,-0.20972977686592434,183116944,174705011.6,47.82597727925669,24.514645617157207,NaN,NaN,-3.8689092536144396,-5.039138056402779
2020-10-05T09:30:00-04:00,36.53,36.68,35.885,36.63,2185895,4338253.55,58.06476553441304,47.309813240566974,NaN,NaN,75.1191009115914,7.505679000860368,0.15353446175549018,-0.0178116996715616,-0.17134616142705178,185302839,177643251.2,53.37719693983328,26.810204507064686,NaN,NaN,-0.8408406727255364,-4.43938128730603
2020-10-06T09:30:00-04:00,36.73,36.83,36.19,36.32,4224397,4208321.2,55.20779392845993,46.96095567327882,NaN,NaN,73.64209653531029,32.757194366126306,0.16707452184573895,0.03749699088012193,-0.12957753096561703,181078442,180180127.2,57.57438959976217,29.424911266626633,NaN,NaN,0.842542053197148,-3.6848208100912903
2020-10-07T09:30:00-04:00,36.56,36.655,36.29,36.42,2158451,4112156.7,55.96055657195462,47.27683681629791,NaN,NaN,72.65847532956404,54.13133674093008,0.17436594668044836,0.08837990238494342,-0.08598604429550494,183236893,182271482.8,60.71424036114137,32.238223644024764,NaN,NaN,2.4353348677528968,-2.8105128561135495
2020-10-08T09:30:00-04:00,36.65,37.21,36.6,37.03,2208727,3920175.5,60.339127494637744,48.34218558354155,NaN,NaN,103.89086963261578,74.56762820718158,0.20950821273874762,0.1758992216279296,-0.033608991110818026,185445620,183636147.6,62.65637855070018,35.192909923830086,NaN,NaN,5.154750638607191,-1.6726180711534437
2020-10-09T09:30:00-04:00,37.24,37.25,36.7887,36.93,2615360,3778691.6,59.298279032963414,49.88702097537809,NaN,NaN,95.43765762154113,84.14964000612453,0.2144765779523827,0.23448673132966036,0.020010153377277656,182830260,183578810.8,62.51653834947718,38.25684137512493,NaN,NaN,7.092936584211132,-0.4203959775299331
2020-10-12T09:30:00-04:00,37,37.2,36.76,37.12,2747255,3755773.75,60.68591310894767,51.25935650271479,NaN,NaN,91.50080988255768,87.42598180031777,0.21829036376967142,0.29287310808936695,0.07458274431969553,185577515,183633746,62.602659418553195,41.41881422033538,NaN,NaN,9.114101897988816,0.9416751475441738
2020-10-13T09:30:00-04:00,37,37,36.28,36.49,4258720,3821321.15,54.09979607815964,52.570403638528326,NaN,NaN,60.86463449728725,84.87048939271317,0.16835254440960878,0.2850234248317065,0.11667088042209772,181318795,183681816.6,62.68345445300075,44.74738496932764,NaN,NaN,9.03048210046312,2.097218997961166
2020-10-14T09:30:00-04:00,36.54,36.55,36.02,36.07,7041591,3996131.25,50.18918087210624,53.49543459353623,NaN,NaN,38.02718358018729,77.94423104283781,0.10036008317399112,0.24212098438958662,0.1417609012155955,174277204,181889878.8,57.68077041229727,47.784485365931104,NaN,NaN,7.804318304842855,2.9125188989442643
2020-10-15T09:30:00-04:00,35.85,36.54,35.83,36.24,3691224,3997849.15,51.71072467289473,54.10955721713985,NaN,NaN,38.94069707348946,64.95419653101256,0.06203928007961579,0.21931000131511524,0.15727072123549946,177968428,180394440.4,53.82041346816731,50.45950296372735,NaN,NaN,7.215565822790191,3.527239888065111
2020-10-16T09:30:00-04:00,36.27,36.34,35.99,36.11,2730511,3821660.9,50.44181532336965,54.29195915735188,NaN,NaN,32.468462138286405,52.3603574343616,0.025038238079098718,0.18856851883437287,0.16353028075527415,175237917,178875971.8,50.15020215553846,52.34748998059772,NaN,NaN,6.371099608756739,3.9335055624496293
2020-10-19T09:30:00-04:00,36.19,36.33,35.5,35.54,3782533,3699420.55,45.204077337706146,54.19055241651771,NaN,NaN,-0.7978099346421715,33.90063347092163,-0.03733278676188498,0.11686429730291792,0.1541970840648029,171455384,176051545.6,44.12297052661486,53.62193488792348,NaN,NaN,4.083452824632744,3.95492659990436
2020-10-20T09:30:00-04:00,35.74,36.035,35.68,35.78,5962176,3768630.7,47.6680779792235,54.15973383110111,NaN,NaN,-1.6906659075975696,21.389573389944683,-0.060558236498654494,0.0784992884414848,0.1390575249401393,177417560,175271298.6,42.59983119985472,54.23983680554757,NaN,NaN,2.845197640843469,3.7963938914670896
2020-10-21T09:30:00-04:00,35.67,35.87,35.56,35.65,3566744,3730411.4,46.449672009575856,53.71734833295776,NaN,NaN,-24.56408758435694,8.871319157035838,-0.0815049928243615,0.03717628390968741,0.11868127673404891,173850816,175186021,42.427442305121794,54.3394617870942,NaN,NaN,1.4701006044226177,3.4640662790321652
2020-10-22T09:30:00-04:00,35.64,35.69,35.335,35.4,3013909,3634785.1,44.11445811687598,52.81673129009204,NaN,NaN,-62.734556337079276,-11.46373152507791,-0.10739779797887461,-0.015565970739544355,0.09183182723933025,170836907,173759716.8,39.54503564000456,53.747965955719046,NaN,NaN,-0.36300469508318417,2.917341854158544
2020-10-23T09:30:00-04:00,35.54,35.73,35.345,35.63,2194229,3606247.4,46.766041486546726,52.0096795723873,NaN,NaN,-66.21163560001867,-31.199751072738923,-0.10415608714796312,-0.03836328169562364,0.06579280545233948,173031136,173318360.6,38.66956922536545,52.69742111897135,NaN,NaN,-1.2173031456577998,2.326678282756209
2020-10-26T09:30:00-04:00,35.36,35.36,34.87,35.2,3322561,3632237.2,42.6881260687578,51.11541758240857,NaN,NaN,-121.86085924997543,-55.41236093580558,-0.12470562729361057,-0.09008922866467373,0.03461639862893684,169708575,172968998.8,37.95331353543357,51.29591568580502,NaN,NaN,-3.137541926709017,1.5460753956897482
2020-10-27T09:30:00-04:00,35.26,35.44,34.75,34.75,2760529,3659384.7,38.86839367830512,49.89454880429076,NaN,NaN,-141.2122642224338,-83.31668059877282,-0.16008194571370718,-0.16548603351319713,-0.005404087799489955,166948046,170875096,33.900383167201284,49.38064017195216,NaN,NaN,-5.959797357343257,0.4738078595421762
2020-10-28T09:30:00-04:00,34.19,34.57,33.83,33.98,5331549,3706659.5,33.36663918560413,47.96794249650264,NaN,NaN,-219.61043804641747,-122.32595069118493,-0.22295370973174108,-0.2840962249641663,-0.061142515232425226,161616497,168428232.2,29.88431797142411,47.039778702003865,NaN,NaN,-10.301307605145265,-1.065494349698887
2020-10-29T09:30:00-04:00,34.06,34.66,33.74,34.37,4989670,3664033.95,38.14253962551296,46.45681825311332,NaN,NaN,-173.08169196091248,-144.39537781595158,-0.22522659798290812,-0.34267576271106037,-0.11744916472815226,166606167,167582084.2,28.621586316993117,44.618710699683575,NaN,NaN,-12.473960249708362,-2.695275192557383
2020-10-30T09:30:00-04:00,34.16,34.37,33.71,34.15,5662410,3722422.05,36.551041751405556,44.73289887043173,NaN,NaN,-160.08965438669057,-163.17098157328593,-0.2278135742941383,-0.4022161325958251,-0.17440255830168683,160943757,165164608.4,25.32867069156707,41.95628293347028,NaN,NaN,-14.748136869277193,-4.417112574945927
2020-11-02T09:30:00-05:00,34.53,34.99,34.29,34.99,5349743,3880614.45,45.84272779530408,44.143108278799204,NaN,NaN,-86.50869608336518,-156.1005489399639,-0.1622958444790182,-0.3772723639004596,-0.2149765194214414,166293500,164481593.4,24.472009058282367,39.22689397670468,NaN,NaN,-13.777398889141027,-5.754296334116655
2020-11-03T09:30:00-05:00,35.27,35.76,35.16,35.54,4895923,3914190.75,50.91165980096792,44.19471391657503,NaN,NaN,-18.31845348884627,-131.52178679324638,-0.07566316937961773,-0.30955548114596354,-0.2338923117663458,171189423,165329868.8,27.74075850177816,37.08832169738189,NaN,NaN,-11.264749869378106,-6.5415039820111485
2020-11-04T09:30:00-05:00,35.69,36.3,35.45,35.64,5642501,4088393.25,51.79509142466817,44.20074011313028,NaN,NaN,13.45582351568309,-84.90853448082628,-0.008882980672763996,-0.24499603760730082,-0.23611305693453682,176831924,168372954.2,38.09179546904018,35.96484898315852,NaN,NaN,-8.995773711043018,-6.892113943301416
2020-11-05T09:30:00-05:00,35.92,36.12,35.611,35.77,4718833,4213898.55,52.97978821072826,44.382023890798756,NaN,NaN,23.9577188071074,-45.500652327222305,0.04388810235309548,-0.18125292899316747,-0.22514103134626295,181550757,171361872.2,46.2379203652077,35.68540028384918,NaN,NaN,-6.79499911272176,-6.878240396075751
2020-11-06T09:30:00-05:00,35.8,36.055,35.5,35.63,4562437,4311252.4,51.51157166385424,44.83255919980933,NaN,NaN,21.393500116904846,-9.204021426503221,0.06778140287360782,-0.1404142777542532,-0.208195680627861,176988320,174570784.8,53.3370288809007,36.34354730915531,NaN,NaN,-5.3974023317965125,-6.666692101178716
2020-11-09T09:30:00-05:00,37.35,39.11,36.48,36.57,11855595,4766669.4,59.60592355376946,45.68526245513404,NaN,NaN,199.23277920929493,47.94427363202881,0.14109073187544924,-0.031832265783549474,-0.1729229976589987,188843915,179080867.8,61.10985043631273,37.66569154033089,NaN,NaN,-1.4739198191396912,-5.9248674894588556
2020-11-10T09:30:00-05:00,36.62,36.99,36.46,36.77,9593438,5033405.3,61.094073063460705,46.73129110184011,NaN,NaN,126.86851068258775,76.9816664663156,0.19398342847489825,0.0695562879346241,-0.12442714054027415,198437353,184530453.8,68.03782513052383,39.49500459928817,NaN,NaN,2.185130553562427,-4.766296340455815
2020-11-11T09:30:00-05:00,36.96,37.27,36.6701,37.05,6219439,4992297.7,63.14136979409307,48.09035622164133,NaN,NaN,142.339131104998,102.75832798417859,0.23596993849674613,0.17053528258065853,-0.0654346559160876,204656792,190095427.4,73.27370544957017,41.904195299971434,NaN,NaN,5.868452371027168,-3.247046524529675
2020-11-12T09:30:00-05:00,36.94,37.165,36.45,36.67,5034964,5059484.7,58.63205657734876,48.93792872812719,NaN,NaN,111.24981761526848,120.2167477458108,0.2262621784836385,0.21739306718846052,-0.008869111295177978,199621828,193709641.6,76.02108339615101,44.57216059788469,NaN,NaN,7.65050318179262,-1.6902537093407757
2020-11-13T09:30:00-05:00,36.87,37.6,36.87,37.51,3078986,5076908.45,64.64311290559526,50.50614207361555,NaN,NaN,149.26387654622883,145.79082303167561,0.26200420090289767,0.3186361398334441,0.05663193893054644,202700814,198852140.4,79.28415954912822,47.52436388457716,NaN,NaN,11.239003448434701,0.15678302748429251
2020-11-16T09:30:00-05:00,38.19,38.27,37.3,37.75,4066863,5091124.95,66.15626235998567,52.45527555087845,NaN,NaN,158.3175110666216,137.60776940314094,0.28547185170360523,0.41347175356005295,0.12799990185644775,206767677,202436892.8,81.20427115124006,50.903213026294225,NaN,NaN,14.634038564505621,2.2249623899159108
2020-11-17T09:30:00-05:00,37.52,37.91,37.24,37.77,4501152,5018073.75,66.28574893919502,54.8066405332778,NaN,NaN,123.90889531833254,137.0158463302899,0.28532541699952424,0.48465667310585303,0.1993312561063288,211268829,205003188,82.45781554362706,54.658462852880156,NaN,NaN,17.375632754102114,4.38934387051394
2020-11-18T09:30:00-05:00,37.8,38.145,37.11,37.13,4579127,5068692.9,58.564060405701866,56.265320589005576,NaN,NaN,96.25601292423478,127.79922269413723,0.22761583487066817,0.48385104969466397,0.2562352148239958,206689702,205409770,82.65518342457739,58.51800550342188,NaN,NaN,17.433339193512943,6.252771773799512
2020-11-19T09:30:00-05:00,37.08,37.26,36.68,37.19,4583867,5147190.8,59.045727839358584,57.87208388100222,NaN,NaN,62.06448271255055,117.96215571359365,0.18100560091794432,0.4824922159714262,0.3014866150534819,211273569,207740118.2,83.78150089305373,62.69320766067093,NaN,NaN,17.62045748688368,7.876726875668679
2020-11-20T09:30:00-05:00,37.24,37.25,36.81,36.94,2799025,5177430.6,56.11854444705976,58.60607078469906,NaN,NaN,53.72484269803511,98.8543489439549,0.12359958469384275,0.4559860959207853,0.33238651122694257,208474544,208894864.2,84.32469788958979,66.96839972005003,NaN,NaN,16.924665104880887,9.16928947984185
2020-11-23T09:30:00-05:00,37.15,37.22,36.755,36.82,4084767,5215540.9,54.716361808623965,58.877835213817356,NaN,NaN,44.82518533532636,76.15588379769586,0.07045088736165933,0.42045012042901675,0.3499992330673574,204389777,208419284.2,83.090401788507,70.9219456691021,NaN,NaN,15.949088840542633,10.137832245656249
2020-11-24T09:30:00-05:00,37.24,37.37,36.7582,36.8,3206517,5237840.3,54.472071906924675,59.0690481054071,NaN,NaN,43.10942176735275,59.995989087499915,0.028977932129896855,0.3862216482297285,0.35724371609983163,201183260,206402170.4,77.88325120191149,73.76419250716434,NaN,NaN,15.076887184130513,10.843411522581144
2020-11-25T09:30:00-05:00,36.87,36.97,36.57,36.89,3553293,5148927.5,55.436271663155004,59.24451120915187,NaN,NaN,27.052929001426477,46.15537230293826,0.003951083144999312,0.3621825700310808,0.3582314868860815,204736553,206011540.6,76.87846506135082,75.95280284260312,NaN,NaN,14.586107542055672,11.378082382506078
2020-11-27T09:30:00-05:00,37.06,37.06,36.67,36.82,1791122,4989000.1,54.47002737826712,59.45582947446707,NaN,NaN,24.236596834547598,38.589795127337666,-0.019675547808218008,0.33363705212580896,0.35331259993402697,202945431,204345913,72.5787818523275,77.32721376913362,NaN,NaN,13.91969296147551,11.74116960807314
2020-11-30T09:30:00-05:00,36.8,36.8,36.325,36.5,4225243,4917141.75,50.16541587020187,58.78150749706938,NaN,NaN,-16.687293946784518,24.507367798373735,-0.05709557359119677,0.28194313294503104,0.3390387065362278,198720188,202395041.8,67.79609643289052,77.80480276888918,NaN,NaN,12.172927010108392,11.802849236935318
2020-12-01T09:30:00-05:00,36.87,37.0884,36.79,36.96,4492359,4874272.55,55.597609673856276,58.3889029692405,NaN,NaN,20.412789988362608,19.624888728980984,-0.05129150230656493,0.27492432865302163,0.32621583095958656,203212547,202159595.8,67.2203775273593,77.74641365437742,NaN,NaN,12.069163408300057,11.840894118558852
2020-12-02T09:30:00-05:00,36.86,37.09,36.54,36.57,3019079,4780430.35,50.56507757131648,57.49059638189931,NaN,NaN,-21.869187764343213,6.62916682264179,-0.0728277739134311,0.2351811135677977,0.3080088874812288,200193468,201961637.4,66.70746003683138,77.27739612489607,NaN,NaN,10.517921695393511,11.65189805810666
2020-12-03T09:30:00-05:00,36.64,37.02,36.6,36.84,2953448,4645977.7,53.69033579153499,57.13761632576975,NaN,NaN,-18.544976861459332,-2.490414349935373,-0.06808582848165068,0.2229016018791654,0.2909874303608161,203146916,201643710,65.83856834033591,76.55007362090929,NaN,NaN,10.081714817449251,11.427586166584174
2020-12-04T09:30:00-05:00,37.05,37.35,37.01,37.33,3325695,4576320.8,58.78300402120076,56.71903711974158,NaN,NaN,54.57320472456251,3.5769072280676086,-0.03292671890358845,0.24982903173133053,0.282755750634919,206472611,202349146,66.86973876058022,75.66332927887014,NaN,NaN,11.232173007382592,11.399670000983948
2020-12-07T09:30:00-05:00,37.28,37.36,36.835,36.96,3027844,4499591.15,53.95777315048477,55.847716461920086,NaN,NaN,0.16935501166330202,6.948237019757175,-0.035353962969207564,0.2385632969234095,0.27391725989261706,203444767,203294061.8,68.25212444605184,74.73817594278526,NaN,NaN,10.743177787467504,11.305885399053027
2020-12-08T09:30:00-05:00,36.82,37.04,36.77,36.79,2184257,4016024.25,51.85175708493108,54.81671704375838,NaN,NaN,-44.89724269209342,-6.113769516334032,-0.04836825358874847,0.2134569429066815,0.26182519649542996,201260510,202903654.4,67.00806521137403,73.63462234762434,NaN,NaN,9.70754271343066,11.077550729678403
2020-12-09T09:30:00-05:00,36.83,36.86,36.22,36.45,3443251,3708514.9,47.83079532190212,54.05005525205839,NaN,NaN,-138.0303974169979,-29.346011446864974,-0.07807483107892516,0.1642316576467735,0.24230648872569865,197817259,202428412.6,65.4442773543094,72.40527191403378,NaN,NaN,7.594534042748522,10.579976917259849
2020-12-10T09:30:00-05:00,36.31,36.6,36.14,36.25,2687502,3531918.05,45.59113266227925,53.089012739409874,NaN,NaN,-161.43122922707937,-57.923261919988974,-0.10757412144903031,0.10783883691441076,0.21541295836344107,195129757,200824980.8,60.328693347098934,70.730071375037,NaN,NaN,5.1562255077724455,9.805155287333077
2020-12-11T09:30:00-05:00,36.1,36.28,35.85,36.27,2340564,3397198.05,45.86412149357194,52.35655395701788,NaN,NaN,-183.4264400613479,-105.52319087717106,-0.12111201749895908,0.06402293648974222,0.1851349539887013,197470321,199024522.8,55.11867229784109,68.64392668991209,NaN,NaN,3.247520457761255,8.86835031167996
2020-12-14T09:30:00-05:00,36.58,36.795,35.99,36.01,3412563,3413876.9,42.853931543806084,51.509237509530884,NaN,NaN,-135.76728232947264,-132.71051834539827,-0.14152884901396895,0.008223892721240134,0.14975274173520908,194057758,197147121,50.24591033605484,66.2978915861655,NaN,NaN,0.727920350192,7.705431745753108
2020-12-15T09:30:00-05:00,36.2,36.64,35.94,36.64,2593162,3340191.85,51.210025231169105,51.276234175548346,NaN,NaN,-96.8366648558874,-143.09840277815707,-0.10806668629316749,0.014669383868749719,0.1227360701619172,196650920,196225203,48.001753036236984,64.1634988600459,NaN,NaN,0.9442885348597777,6.7395541441969185
2020-12-16T09:30:00-05:00,36.71,36.905,36.4385,36.65,2919263,3261097.4,51.331673935160424,50.983048623548726,NaN,NaN,-28.763800749817936,-121.24508344472106,-0.08190900138759812,0.020349818427419564,0.10225881981501768,199570183,196575787.8,48.93577014983216,62.16759208065172,NaN,NaN,1.153309359232215,5.941519174916246
2020-12-17T09:30:00-05:00,36.85,37.13,36.74,37.08,2124388,3138360.45,56.36926137111771,51.118708194466635,NaN,NaN,62.149556841440194,-76.52892623101714,-0.03471074474557914,0.058870388883043745,0.09358113362862289,201694571,197888750.6,52.38523555322232,60.725195916429925,NaN,NaN,2.867181020980565,5.502328010068291
2020-12-18T09:30:00-05:00,37.11,37.13,36.175,36.44,4150872,3116710.7,48.34786953954737,50.98888345656274,NaN,NaN,-41.30243330385034,-48.10412487951761,-0.04500466344372686,0.0373253043239643,0.08232996776769116,197543699,197903426.2,52.42392137070242,59.627183411987914,NaN,NaN,1.8434873278842585,4.979636484042001
2020-12-21T09:30:00-05:00,35.53,35.74,35.3,35.65,5463223,3249920.6,40.657013800976166,49.921698037071295,NaN,NaN,-248.08538785508551,-70.56774598464021,-0.10026401444966362,-0.04300005029438836,0.05726396415527526,192080476,197507969.8,51.216367981359724,58.48403987298794,NaN,NaN,-1.770807838932227,4.015287295045683
2020-12-22T09:30:00-05:00,35.68,35.9,35.53,35.9,1673611,3129362.8,43.70867553233704,49.43195503428706,NaN,NaN,-166.24660276994993,-84.44973356745272,-0.11421114846883695,-0.08549997143077093,0.02871117703806602,193754087,196928603.2,49.420304093889726,57.24924301992069,NaN,NaN,-3.635515532749589,2.9223154625035015
2020-12-23T09:30:00-05:00,36.02,36.2179,35.56,35.56,1965455,3067309.7,40.64726274805652,48.500306959752876,NaN,NaN,-142.31847800772874,-107.16066901903488,-0.13892556476203355,-0.1449457789144759,-0.006020214152442367,191788632,195372293,44.868515370009796,55.75138209346881,NaN,NaN,-6.185095332194457,1.6212567775466502
2020-12-24T09:30:00-05:00,35.7,35.91,35.68,35.91,1599955,2969642.8,44.923797847378,47.510363661622684,NaN,NaN,-114.0184031238877,-142.39426101210046,-0.12474230694891765,-0.16194809783858943,-0.03720579088967178,193388587,193711096.2,40.57292727432281,53.873038415879,NaN,NaN,-6.897949070335151,0.4042273707063928
2020-12-28T09:30:00-05:00,36.03,36.23,35.86,36.2,2955526,3027863,48.250918649348804,47.10273119725582,NaN,NaN,-61.10576359792975,-146.35492707091635,-0.09046699726915818,-0.1502895374761195,-0.05982254020696133,196344113,193471179,39.977644772204826,51.853432724889934,NaN,NaN,-6.413446586523283,-0.5697260517549895
2020-12-29T09:30:00-05:00,36.36,36.51,35.92,35.92,2212178,2927209.75,45.39925668251389,46.64183831136888,NaN,NaN,-52.3923767124214,-107.21632484238353,-0.08156502288750084,-0.16177881881633738,-0.08021379592883654,194131935,193881470.8,41.55684275466598,50.03548826369649,NaN,NaN,-6.907877028057989,-1.4751761912268464
2020-12-30T09:30:00-05:00,36.01,36.39,35.935,36.12,2364953,2820839.45,47.77357740715656,46.63775131745848,NaN,NaN,-42.05572353473612,-82.37814899534077,-0.05821483789586472,-0.15298234329866744,-0.09476750540280272,196496888,194430031,43.69001109913166,48.481612102612374,NaN,NaN,-6.584734060821986,-2.2051130297404375
2020-12-31T09:30:00-05:00,36.13,36.61,35.85,36.56,4083972,2874084.1,52.65169870315702,47.142077463235466,NaN,NaN,-6.211997406368842,-55.156852875068786,-0.011583926976394238,-0.10924741412329553,-0.09766348714690129,200580860,196188476.6,49.991260828616845,47.743224065577934,NaN,NaN,-4.771199469204998,-2.5716968068068033
2021-01-04T09:30:00-05:00,36.64,36.71,35.37,35.38,4967013,2974762.35,41.465891338066456,46.827918166413646,NaN,NaN,-90.57512095061999,-50.46819644041522,-0.056163790744149386,-0.16786822557708803,-0.11170443483293864,195613847,196633528.6,51.471409800925805,47.48270531579827,NaN,NaN,-7.006463792973371,-3.2052349476877415
2021-01-05T09:30:00-05:00,35.4,35.68,35.31,35.34,4432400,3030097.6,41.14677180784053,46.705978185273246,NaN,NaN,-144.9198741402003,-67.23101854886934,-0.082695705524053,-0.2150740667380049,-0.13237836121395188,191181447,195600995.4,47.92719917067784,47.317083089699906,NaN,NaN,-8.817140822863943,-4.0069357869986275
2021-01-06T09:30:00-05:00,35.35,35.395,34.97,35.17,7383479,3247879.35,39.74674123515023,45.88717218555761,NaN,NaN,-174.66524061585963,-91.68559132955697,-0.10463248476637002,-0.2631689671719144,-0.15853648240554438,183797968,193534202,41.73268175640026,46.86929228399729,NaN,NaN,-10.713161838514738,-4.9649680800723575
2021-01-07T09:30:00-05:00,35.25,35.4,35.015,35.28,3433837,3310358.35,41.142254036756704,45.15935647852877,NaN,NaN,-143.2709651645613,-111.928639655522,-0.10443173539289338,-0.2890761516466611,-0.18464441625376773,187231805,191681185.4,37.10252379239574,46.02406040132326,NaN,NaN,-11.823977224150216,-5.944826529226337
2021-01-08T09:30:00-05:00,35.37,35.77,35.32,35.66,3419871,3309189.35,45.81139365826099,44.40522307046758,NaN,NaN,-73.30393955030388,-125.34702808430902,-0.07289734529202307,-0.2757660978687966,-0.2028687525767735,190651676,189695348.6,32.89094617259954,44.6316111598502,NaN,NaN,-11.356269895128397,-6.717889867212346
2021-01-11T09:30:00-05:00,35.47,35.63,34.955,35.06,4050012,3377314.85,40.366309267747944,43.83511162248191,NaN,NaN,-119.19076875364043,-131.0701576449131,-0.08575188379968166,-0.3100586073263756,-0.22430672352669392,186601664,187892912,29.606041118481883,43.00176257040588,NaN,NaN,-12.667658194565815,-7.567856771119985
2021-01-12T09:30:00-05:00,34.99,35.13,34.65,35.09,4372475,3478910.4,40.74554287963547,43.84143512810043,NaN,NaN,-139.3196687649077,-129.95011656985457,-0.08535411255890119,-0.3309993642253204,-0.2456452516664192,190974139,187851450.4,29.53297359718532,41.45294868582199,NaN,NaN,-13.5958395485317,-8.428997167893087
2021-01-13T09:30:00-05:00,35.07,35.63,35.07,35.57,3024381,3459501.3,46.59726020142786,44.04776260446406,NaN,NaN,-64.53548603703088,-107.92416565408882,-0.04775841412759807,-0.3053432693259168,-0.25758485519831875,193998520,189891560.8,37.68273206086141,40.61455068346283,NaN,NaN,-12.604238990946422,-9.025460285472136
2021-01-14T09:30:00-05:00,35.67,36.02,35.5,35.79,3792554,3519470.9,49.07937665391401,44.65005645488244,NaN,NaN,-8.85298292989719,-81.04056920715601,-0.00530234571885313,-0.26421278734688514,-0.258910441628032,197791074,192003414.6,44.79970121856899,40.609635386931345,NaN,NaN,-11.028821095892152,-9.31165468696071
2021-01-15T09:30:00-05:00,35.71,36.4061,35.63,36.34,4212957,3584155.6,54.7427068271818,45.351407096297,NaN,NaN,56.47775988533875,-55.08422932002749,0.05904640534769773,-0.18510243494340983,-0.24414884029110756,202004031,194273885.6,51.24630538318972,41.3720195375647,NaN,NaN,-7.845975760663883,-9.10227198320402
2021-01-19T09:30:00-05:00,36.52,36.54,36.025,36.1,3318148,3643843.6,52.02368605066575,45.620890482105345,NaN,NaN,88.22311021037827,-13.601453527223754,0.0831932647926441,-0.14015725930030243,-0.22335052409294653,198685883,196690729.4,57.00267089121177,42.588092831779484,NaN,NaN,-6.037261690117738,-8.66441336990598
2021-01-20T09:30:00-05:00,36.19,36.9939,36.01,36.85,4404380,3656519,58.894672282707944,46.58484873926208,NaN,NaN,162.96749732169565,46.855979690096916,0.14386641203708717,-0.04351750904658758,-0.18738392108367474,203090263,199113954.2,61.86450387592683,44.038640054726685,NaN,NaN,-2.130853432044014,-7.731047664497127
2021-01-21T09:30:00-05:00,36.7,36.7694,36.37,36.73,2668917,3516803.7,57.476314554209225,47.27790139262298,NaN,NaN,142.04205391866122,88.17148768123533,0.16840367403071568,0.023120671454719854,-0.14528300257599583,200421346,200398519.4,64.17693311118074,45.501991627015904,NaN,NaN,0.5474043958187892,-6.548411655880567
2021-01-22T09:30:00-05:00,36.55,36.91,36.52,36.82,2355188,3550882.55,58.287686513284044,47.6804719504892,NaN,NaN,138.49046417537363,117.6401771022895,0.18202326276198905,0.08224607587649047,-0.09977718688549857,202776534,201395611.4,65.90512482381398,46.63869619810141,NaN,NaN,2.9560434021205153,-5.190632361880413
2021-01-25T09:30:00-05:00,36.81,37.37,36.63,37.15,5784453,3741832.45,61.210238972287,49.09078249579066,NaN,NaN,155.37565214984883,137.41975555519153,0.20298727553718116,0.1539569075359779,-0.049030368001203264,208560987,202707002.6,68.08581811118428,47.82543964883416,NaN,NaN,5.897447540556821,-3.6066209472465225
2021-01-26T09:30:00-05:00,37.2,37.63,37.12,37.53,3398852,3831777.3,64.31112126690738,50.74537888572401,NaN,NaN,173.9744189865154,154.57001731041893,0.23018389695673017,0.23869950319470945,0.008515606237979277,211959839,205361793.8,71.99135203671608,49.54430771069404,NaN,NaN,9.380694302800228,-1.751290197239844
2021-01-27T09:30:00-05:00,37.3,37.69,36.81,37.05,8415083,4104755.15,58.00351188361302,52.04943393204278,NaN,NaN,126.15955194972759,147.20842823602533,0.20445347834799937,0.2640824541729785,0.05962897582497913,203544756,205452692.4,72.11717069430176,51.71462834911557,NaN,NaN,10.477949083961411,-0.004256014211093229
2021-01-28T09:30:00-05:00,37.12,37.5913,36.8,37.15,11831231,4585707.8,58.90774850607263,53.3183978227082,NaN,NaN,110.900298654353,140.9800771831637,0.18344650165807289,0.28893710289757024,0.10549060123949736,215375987,208443620.6,75.94605841105903,54.48916653616295,NaN,NaN,11.636104646778918,1.6586526516446225
2021-01-29T09:30:00-05:00,36.87,37.29,36.55,36.76,5590866,4747003.45,54.02243371434918,53.904900683857356,NaN,NaN,70.68062870275726,127.4181100886404,0.13481254032970294,0.274006276651626,0.13919373632192308,209785121,209845338,77.50510442216203,57.67589212541741,NaN,NaN,11.167844211275385,3.0171085887347315
2021-02-01T09:30:00-05:00,36.99,37.605,36.52,37.59,3729395,4729274.6,61.36572939216192,55.40485926417265,NaN,NaN,96.50587314621106,115.64415428791285,0.1489622776785993,0.3253965834201722,0.1764343057415729,213514516,210836043.8,78.56268158371661,61.172795015791316,NaN,NaN,13.132302358126493,4.462136270076412
2021-02-02T09:30:00-05:00,37.78,37.94,37.51,37.75,3017377,4631792.8,62.605605013615026,56.96629227374262,NaN,NaN,123.90864088824969,105.63099866825969,0.15862451850223921,0.3747149538693719,0.2160904353671327,216531893,211750454.6,79.51975352848396,64.74327929659836,NaN,NaN,15.099198221564142,5.981716548860374
2021-02-03T09:30:00-05:00,37.7,37.73,37.09,37.6,3472212,4583783.4,60.64077007983762,57.969400122200454,NaN,NaN,92.07237047351879,98.81356237301793,0.14482255966344953,0.3971186349464446,0.2522960752829951,213059681,213653439.6,81.38257970391314,67.86469698538777,NaN,NaN,16.108725969421947,7.428432180369169
2021-02-04T09:30:00-05:00,37.65,38.04,37.53,37.81,3040197,4366619.3,62.41902342630778,58.922232034514295,NaN,NaN,110.56757770777057,98.74701818370144,0.13968149560861048,0.4268979447937582,0.2872164491851477,216099878,213798217.8,81.52029578624857,70.48759659736488,NaN,NaN,17.476217378733946,8.863830065849852
2021-02-05T09:30:00-05:00,37.92,38.01,37.78,37.94,2019438,4295899.35,63.51786732554579,59.54902921296887,NaN,NaN,113.22028369118084,107.25494918138615,0.1348146401993382,0.45573474943432046,0.32092010923498226,218119316,215465056.8,83.07277596002442,72.76091592428165,NaN,NaN,18.924967740837772,10.301135447990983
2021-02-08T09:30:00-05:00,37.96,38.03,37.69,38.02,2589968,4254404.2,64.21136403402528,60.41957764035169,NaN,NaN,104.67038898186257,108.88785234851647,0.12687662903335362,0.4795158955266743,0.35263926649332067,220709284,216904010.4,84.29906902299504,74.71065864798045,NaN,NaN,20.320060148847404,11.732410405256186
2021-02-09T09:30:00-05:00,38.1,38.31,37.98,38.19,1682236,4136015.4,65.7033327715761,60.90591053241371,NaN,NaN,119.15859934519145,107.9378440399048,0.12288421284102286,0.5062445325445992,0.38336031970357637,222391520,218075935.8,85.23710180153871,76.3801299283813,NaN,NaN,21.921293966397684,13.187965199704971
2021-02-10T09:30:00-05:00,38.38,38.705,38.2313,38.45,3329149,4083849.1,67.90694297528228,61.650955419633206,NaN,NaN,141.91481717162668,117.9063333795264,0.1270376199588617,0.5421573446521535,0.4151197246932918,225720669,220608133.4,87.03893872781937,78.01313032956978,NaN,NaN,23.93155055571555,14.722763107706482
2021-02-11T09:30:00-05:00,38.5,38.61,38.18,38.38,2301131,4047686.6,66.66503240072711,62.24933726873629,NaN,NaN,125.98048514941448,120.98891486785517,0.11472956935960998,0.5585316863928043,0.4438021170331943,223419538,222072065.4,87.9542830785479,79.58807020490791,NaN,NaN,25.288033447406644,16.232087441949364
2021-02-12T09:30:00-05:00,38.29,38.46,38.0207,38.37,1826295,3949373.65,66.47798974223727,62.625605180875596,NaN,NaN,104.1955761894857,119.18397336751613,0.09631657225830226,0.5641978323560721,0.46788126009776987,221593243,222766850.8,88.37393680518213,81.03722154019347,NaN,NaN,26.37573455485327,17.68117988664992
2021-02-16T09:30:00-05:00,38.43,38.47,37.77,37.96,3341400,3905795.8,59.15028512239802,62.25697402769635,NaN,NaN,72.48244786754817,112.74638514465327,0.04929576221797971,0.5295009628702445,0.4802052006522648,218251843,222275362.6,86.08910764681856,82.04420408377221,NaN,NaN,25.375707553122375,18.780398124717415
2021-02-17T09:30:00-05:00,37.94,38.055,37.72,37.99,3277299,3903753.35,59.5020441566904,62.36401204720188,NaN,NaN,48.18316575596904,98.55129842680878,0.014776454879608658,0.4986757692517756,0.48389931437216693,221529142,222102887,85.25609001447874,82.98269832092771,NaN,NaN,24.630599830433393,19.616141225533983
2021-02-18T09:30:00-05:00,37.84,38.03,37.82,37.97,2932073,3830138,59.1364452652111,62.380347529997486,NaN,NaN,44.936310370006666,79.15559706648477,-0.013322155348936604,0.46724662018599616,0.48056877553493277,218597069,220678167,78.49904372608175,83.1650544148579,NaN,NaN,23.90800839632323,20.229265107075303
2021-02-19T09:30:00-05:00,38.15,38.36,37.985,38.09,2447993,3819091.8,60.69684660473873,62.85709130788245,NaN,NaN,68.48711631514806,67.65692329963149,-0.026958584618369252,0.4468705447619712,0.47382912938034044,221045062,220203271.8,76.32751514772507,83.08094089525527,NaN,NaN,23.665982440416045,20.72022472612398
2021-02-22T09:30:00-05:00,38.03,38.45,37.88,38.31,4293126,3915988.7,63.452260298269664,63.00612922974729,NaN,NaN,74.5135960212925,61.72052726599285,-0.02437234443692582,0.44336369883418314,0.46773604327110896,225338188,220952260.8,77.38986294288723,82.99716813519602,NaN,NaN,24.15907271419979,21.211488724420526
2021-02-23T09:30:00-05:00,38.54,38.69,38.305,38.45,5986098,3926070.95,65.12770457925703,63.186279198721714,NaN,NaN,112.20242928648355,69.66452354977993,-0.016803487915302007,0.44673168337698144,0.46353517129228344,231324286,223566749.4,80.65362488666442,83.07815894649464,NaN,NaN,25.025731262468653,21.75638051557026
2021-02-24T09:30:00-05:00,38.45,38.765,38.31,38.63,3779949,3945125.8,67.2090881075983,63.655444772133194,NaN,NaN,117.7660352541466,83.58109744941544,-0.00391739086611953,0.458638432709634,0.46255582357575353,235104235,226281768,83.34263439149456,83.21816285275044,NaN,NaN,26.34244980473797,22.41153327116565
2021-02-25T09:30:00-05:00,38.64,38.9,37.74,38,6790184,3863880.85,54.86591239220199,63.11593684112563,NaN,NaN,50.49483461418519,84.69280229825114,-0.04005744013303325,0.412484023409462,0.45254146354249525,228314051,228225164.4,84.95464682776895,83.46347364143047,NaN,NaN,23.90993130109296,22.625590132583834
2021-02-26T09:30:00-05:00,38.12,38.12,37.3167,37.34,8008549,3672746.75,45.44895006601335,61.825299894016176,NaN,NaN,-75.95508946258313,55.804361142704906,-0.10685483792108819,0.318972916141135,0.4258277540622232,220305502,228077252.4,84.28608030486734,83.55013823749069,NaN,NaN,18.449951560565996,22.029070336581285
2021-03-01T09:30:00-05:00,37.76,38.02,37.375,37.38,4504641,3618435.5,46.05327986837917,60.52829388218431,NaN,NaN,-93.67849667901083,22.165942602644243,-0.14445012939865254,0.24526509231390747,0.38971522171256,224810143,227971643.4,83.7791182236842,83.51299889468275,NaN,NaN,14.340253305975423,20.93066790363759
2021-03-02T09:30:00-05:00,37.4,37.42,36.85,37.15,7480459,3805988.7,43.09684125248032,58.91354448796318,NaN,NaN,-191.82830970750518,-38.64020519615351,-0.17867283724368965,0.16637417515794795,0.3450470124016376,217329684,225172723,71.50403440789005,82.53206550942215,NaN,NaN,9.956343224732874,19.362907235222632
2021-03-03T09:30:00-05:00,37.15,37.15,36.635,36.69,7743558,4042297.75,37.8617562808021,56.767459724071735,NaN,NaN,-218.73354543678877,-105.94012133434057,-0.2232584952502702,0.06597389333879988,0.2892323885890701,209586126,220069101.2,55.527875875100364,80.28127530565651,NaN,NaN,4.349223552090583,17.218095280489482
2021-03-04T09:30:00-05:00,36.81,37.12,36.07,36.42,11162910,4426832.65,35.16189654119374,54.51723573410508,NaN,NaN,-230.4440303139042,-162.12789431995847,-0.2593679883908007,-0.03497759689943081,0.2243903914913699,198423216,214090934.2,43.318587654091445,77.09301134676676,NaN,NaN,-1.2121357299404583,14.585205136142347
2021-03-05T09:30:00-05:00,36.7,37,35.89,36.84,9431770,4746411.3,42.08074222866805,52.774575197421555,NaN,NaN,-175.74686483879202,-182.08624939520024,-0.2436465261608826,-0.08016776620973332,0.16347875995114927,207854986,211600831,39.42960750451603,73.59698782529061,NaN,NaN,-3.733427387581641,11.968257632753206
2021-03-08T09:30:00-05:00,36.93,37.48,36.67,37.02,5381455,4914512.15,44.79940296189937,51.749512185957364,NaN,NaN,-93.84287294152084,-182.11912464770225,-0.21102348986430758,-0.10030060237923522,0.11072288748507238,213236441,209286090.6,36.17815453940752,70.03191974618981,NaN,NaN,-4.9091433185304245,9.557200353998402
2021-03-09T09:30:00-05:00,37.21,37.695,37.21,37.44,4163396,4993183.55,50.62332241107957,51.11531777555659,NaN,NaN,-40.442511298881854,-151.84196496597758,-0.15371982331503015,-0.0814268916587153,0.07229293165631484,217399837,209300121.2,36.21249050801078,66.52880549572782,NaN,NaN,-4.0033323050913605,7.619981402699865
2021-03-10T09:30:00-05:00,37.48,38.04,37.38,37.81,4908363,5154489.9,55.11595300337105,50.82813975685373,NaN,NaN,-2.061954786109279,-108.50764683584168,-0.086791293376178,-0.03619618506390765,0.05059510831227034,222308200,211844536,42.277372940609844,63.94154329676553,NaN,NaN,-1.7374294294289299,6.283208426681465
2021-03-11T09:30:00-05:00,37.92,38.65,37.825,38.37,4092682,5192666.55,60.91271346739845,50.84355881847228,NaN,NaN,67.45732481216704,-48.92737581062744,-0.005015418623837073,0.044325835032474004,0.049341253656311077,226400882,217440069.2,52.88631468418346,62.26717183508399,NaN,NaN,2.26182643329508,5.708725284769125
2021-03-12T09:30:00-05:00,38.33,39.03,38.31,39.03,3621596,5258689.8,66.41757055992599,51.055366694304894,NaN,NaN,125.21291945824323,11.264581048779613,0.0881728552693041,0.1595573227429412,0.07138446747363711,230022478,221873567.6,59.27328782887271,60.97313075551152,NaN,NaN,7.746908074308053,5.999894254703258
2021-03-15T09:30:00-04:00,39.06,39.5799,38.8415,39.47,4585823,5396666.2,69.50135811472812,51.367770518267115,NaN,NaN,167.2336354176086,63.47988272060552,0.16938826673261193,0.28311980088940203,0.1137315341567901,234608301,226147939.6,64.29840381464702,59.80490067893884,NaN,NaN,13.341682782734527,7.0487211872791535
2021-03-16T09:30:00-04:00,39.53,39.66,39.2899,39.47,3814732,5420332.8,69.50135811472812,51.53150409020497,NaN,NaN,161.81594012349825,103.93157300508156,0.2103760317033912,0.3767015737860291,0.1663255420826379,234608301,229589632.4,67.74900184257646,58.69106978258754,NaN,NaN,17.58088948523898,8.553316658416271
2021-03-17T09:30:00-04:00,39.4,39.45,39.06,39.41,4914813,5502208.5,68.506475355442,52.50583001615068,NaN,NaN,125.29135901327494,129.4022357649584,0.21969269146283713,0.4409414064111843,0.22124871494834716,229693488,231066690,69.12805418807055,57.56059887975194,NaN,NaN,20.628220342912236,10.278302899058552
2021-03-18T09:30:00-04:00,39.19,39.2699,38.86,39.16,4146965,5562953.1,64.37174370193412,53.85745813300217,NaN,NaN,93.80683626144719,134.6721380548144,0.19604404113898516,0.4663037663720786,0.27025972523309344,225546523,230895818.2,68.7617497701851,56.45171812727465,NaN,NaN,21.924762521325373,11.94208284509667
2021-03-19T09:30:00-04:00,39.17,39.3094,38.58,38.64,5718710,5726488.95,56.70540224153222,54.61832401679881,NaN,NaN,65.9971317591113,122.82898051498803,0.13529548117046697,0.43937907669617715,0.3040835955257102,219827813,228856885.2,64.37803031342557,55.06592613368474,NaN,NaN,20.62038578197855,13.181840407508366
2021-03-22T09:30:00-04:00,38.28,38.8,38.16,38.68,4372018,5730433.55,57.1283670573479,55.62057586000363,NaN,NaN,39.0808564231564,97.19842471609758,0.08990748244598362,0.4164679485831897,0.3265604661372061,224199831,226775191.2,60.160974811256835,54.25570759106809,NaN,NaN,19.709221361382877,14.11432340091901
2021-03-23T09:30:00-04:00,38.76,39.07,38.6,38.8,4453823,5653819.8,58.44011622011788,57.090458712811916,NaN,NaN,59.26223333877742,76.68768335915341,0.06142699558549497,0.40334421061907477,0.3419172150335798,228653654,225584261.8,57.82720693400392,54.41994552384692,NaN,NaN,19.33654279007592,14.860354742227141
2021-03-24T09:30:00-04:00,38.78,39.03,38.505,38.63,10398018,5984723.25,55.83378160415222,58.56702193159466,NaN,NaN,50.039202436269754,61.63725204375238,0.026389676735956213,0.37490431095352506,0.34851463421756884,218255636,223296691.4,53.53158518890976,55.1494453477625,NaN,NaN,18.27273955333003,15.347838286670411
2021-03-25T09:30:00-04:00,38.63,39.005,38.22,38.96,5725289,5931478.5,59.60035434466323,59.81842279702289,NaN,NaN,47.20419112110162,52.31672301568328,0.02092806127061242,0.37467471080583437,0.35374664953522195,223980925,222983571.8,52.951763161690614,56.11531360898927,NaN,NaN,18.435643431724603,15.788953307392438
2021-03-26T09:30:00-04:00,39.14,39.93,39.04,39.91,4550764,5758589.25,68.04819770251035,61.47905099278081,NaN,NaN,105.60587666289123,60.23847199643929,0.07380948289947697,0.4460085031595682,0.3721990202600912,228531689,224724347,55.816977704268396,57.51808669219361,NaN,NaN,21.44707538792984,16.597256461754924
2021-03-29T09:30:00-04:00,39.77,40,39.34,39.82,5335637,5800139.05,66.6267832399985,62.6221553377036,NaN,NaN,102.75140076818865,72.97258086544574,0.09394846127032636,0.48963459684799915,0.3956861355776728,223196052,224523591.2,55.39797408847348,58.888478376512374,NaN,NaN,23.367309904968224,17.56440695364254
2021-03-30T09:30:00-04:00,39.76,39.82,39.55,39.65,4534682,5652850.2,63.91114571481139,63.25038338852077,NaN,NaN,93.06544329604948,79.73322285690014,0.08718985135683133,0.504673449773712,0.41748359841688065,218661370,222525134.4,51.27185436527405,59.53094133541696,NaN,NaN,24.100862725988126,18.49818634969191
2021-03-31T09:30:00-04:00,39.6,39.8963,39.27,39.49,5083877,5519866.15,61.37558314848144,63.28344550859812,NaN,NaN,80.45326063932494,85.8160344975112,0.0643661050295738,0.4979412297038479,0.4335751246742741,213577493,221589505.8,49.41614395804627,59.283071997835734,NaN,NaN,23.94648404585012,19.276514592000225
2021-04-01T09:30:00-04:00,39.68,40.12,39.47,40.12,6082756,5265858.45,66.93765540650342,63.32059442621078,NaN,NaN,109.15410901992186,98.20601807727523,0.08293875197117279,0.5372485646382401,0.4543098126670673,219660249,220725370.6,47.69901283327263,58.456338069578585,NaN,NaN,25.588436156715698,20.178217672673863
2021-04-05T09:30:00-04:00,40.37,40.37,39.94,40.33,5234467,5055993.3,68.56276431379405,63.253552011858346,NaN,NaN,131.5853177735624,103.40190629940946,0.09949179439381262,0.5786745556593331,0.4791827612655205,224894716,219997976,46.2423873164218,57.16662260541965,NaN,NaN,27.44497611582525,21.21632602169549
2021-04-06T09:30:00-04:00,40.24,40.43,40.08,40.43,4270395,5000440.3,69.33570678330925,63.24171977389985,NaN,NaN,133.62179956849857,109.57598605947146,0.1066645450493291,0.6125134425771819,0.5058488975278528,229165111,221191787.8,48.995340663712525,55.82707537835794,NaN,NaN,29.182669698746583,22.354375118417074
2021-04-07T09:30:00-04:00,40.45,40.5741,40.115,40.48,3063163,4945428.65,69.73636913715416,63.32956932973644,NaN,NaN,133.16241967692312,117.59538133564618,0.10414790984481959,0.6360337848338773,0.5318858749890577,232228274,223905168.6,54.6765570924194,54.79482558581143,NaN,NaN,30.713766372355884,23.548573868979762
2021-04-08T09:30:00-04:00,40.53,40.7,40.245,40.28,4042677,4902144.35,66.02042991689166,63.44733263080483,NaN,NaN,125.83885393023502,126.67249999382821,0.07949829136589437,0.6312587391964257,0.5517604478305314,228185597,226826789.4,59.860933594936206,54.159053001865075,NaN,NaN,30.968667211103046,24.608587203568803
2021-04-09T09:30:00-04:00,40.35,40.39,40.16,40.34,1887039,4791862.2,66.59549923044267,64.15376813001272,NaN,NaN,103.21407119221847,125.48449242828751,0.05867972139565736,0.6251100995751031,0.5664303781794457,230072636,228909266.8,63.10083169219327,54.06782452891991,NaN,NaN,31.337158105148944,25.56981161808025
2021-04-12T09:30:00-04:00,40.43,40.585,40.09,40.58,2946861,4758125.45,68.8653191690782,64.99212185227917,NaN,NaN,107.27292978839347,120.62201483125372,0.052707158782244634,0.6323143266572515,0.5796071678750069,233019497,230534223,65.44465749700439,54.445230435044735,NaN,NaN,32.287485670656146,26.529479339876808
2021-04-13T09:30:00-04:00,40.58,40.86,40.48,40.82,7557899,4906729.25,70.98829184438164,65.88842011115516,NaN,NaN,127.15580434492952,119.32881578653992,0.056232747290099416,0.6498981019876311,0.5936653546975317,240577396,232816680,68.4738401161564,55.205704233769914,NaN,NaN,33.71401206418403,27.555841157634983
2021-04-14T09:30:00-04:00,40.8,41.01,40.52,40.57,3027991,4867392.2,65.94412388202693,66.61058741671762,NaN,NaN,109.59997442466985,114.61632673608929,0.0341279546592117,0.6363252980215464,0.6021973433623347,237549405,233880906.2,69.80303768063217,56.36795084032152,NaN,NaN,33.52352145923182,28.40836691500596
2021-04-15T09:30:00-04:00,40.8,41.35,40.7,41.34,3786354,4810969.25,72.4397541949952,67.52768740602706,NaN,NaN,135.6267808071739,116.57391211147706,0.06213353801167598,0.6798642658769296,0.6177307278652536,241335759,236510938.6,72.84957770172011,57.789223307466486,NaN,NaN,35.42526601789772,29.410781072561925
2021-04-16T09:30:00-04:00,41.52,41.55,41.29,41.4,3173767,4762309.35,72.87392577974998,67.87238226868702,NaN,NaN,144.85503309018648,124.90210449107067,0.07462707906284194,0.7110145766938061,0.6363874976309641,244509526,239398316.6,75.74297691993539,59.21250896572842,NaN,NaN,37.0739026335643,30.50551272413369
2021-04-19T09:30:00-04:00,41.41,41.545,41.165,41.53,3291584,4640953.05,73.83568095434916,68.38730353399778,NaN,NaN,130.74899377434767,129.5973172882615,0.08104018670979862,0.7376877310182124,0.6566475443084138,247801110,242354639.2,78.29363232699956,60.84791312562313,NaN,NaN,38.71996878962488,31.67900644777529
2021-04-20T09:30:00-04:00,41.45,42.12,41.4,41.99,5042095,4674456.9,76.94990256584217,69.31864330907142,NaN,NaN,159.23212812956237,136.01258204518808,0.10418113287812436,0.7868739604060693,0.6826928275279449,252843205,244807801,80.15810682888203,62.911216873023704,NaN,NaN,41.16612208773035,33.034308682054586
2021-04-21T09:30:00-04:00,42.06,42.26,41.93,42.18,4182556,4660893.55,78.10891429714454,70.51388124826164,NaN,NaN,169.8260763177904,148.0578024238122,0.11912545841653865,0.8315996505486183,0.7124741921320796,257025761,248703072.2,82.69925652736336,65.28858205654635,NaN,NaN,43.55236905287381,34.53688873502876
2021-04-22T09:30:00-04:00,42.13,42.37,41.93,42,4074693,4344727.3,74.29744410444444,71.0395804409717,NaN,NaN,145.7155476483821,150.07555579205382,0.10426484807114045,0.8428052522210052,0.7385404041498648,252951068,251026134,84.01415015074868,67.88252043636608,NaN,NaN,44.403224097095666,35.946365215324036
2021-04-23T09:30:00-04:00,42.11,42.36,41.98,42.24,3551670,4236046.35,75.98043035687802,71.56941372976341,NaN,NaN,136.23831735717616,148.35221264545174,0.09806787720568289,0.8611252506569684,0.7630573734512855,256502738,253424776.4,85.25985997099185,70.66948276883535,NaN,NaN,45.62826363984973,37.32949356168485
2021-04-26T09:30:00-04:00,42.41,42.57,42.22,42.33,2893556,4153185.95,76.59923041747803,72.08823684648976,NaN,NaN,130.2175256163025,148.24591901384275,0.0878297970745423,0.8728446197944635,0.7850148227199212,259396294,255743813.2,86.36604984352839,73.33881913882222,NaN,NaN,46.81605471078789,38.68471658298528
2021-04-27T09:30:00-04:00,42.47,42.47,42.22,42.33,3715187,4072163.45,76.59923041747803,72.57844122365576,NaN,NaN,111.70380206860176,138.74025380165062,0.06965175340581153,0.8720795144771856,0.802427761071374,259396294,257054431,86.96158312397633,75.64489242679055,NaN,NaN,47.78630111350072,39.984942944487486
2021-04-28T09:30:00-04:00,42.4,42.48,42.15,42.18,2246342,3957746.45,72.96575423232582,73.07453581761534,NaN,NaN,95.38947112634753,123.85293276336206,0.03771861749350802,0.8495760329382591,0.8118574154447511,257149952,257079269.2,86.97319629827948,77.5814826198865,NaN,NaN,47.63190057565569,41.0773654632258
2021-04-29T09:30:00-04:00,42.41,42.5801,42.2,42.49,4262058,3916655.5,75.54730011070082,73.71395016620521,NaN,NaN,97.90375356912277,114.29057394751017,0.0281082009920548,0.8469926666848195,0.8188844656927647,261412010,258771457.6,87.77226717068476,79.34372801120732,NaN,NaN,48.21470660738389,42.09698562667696
2021-04-30T09:30:00-04:00,42.34,42.81,42.3,42.77,4592323,3842133.85,77.62555531240187,74.33968131929976,NaN,NaN,105.07924094359058,108.05875866479305,0.03101443227755296,0.857652506039706,0.826638073762153,266004333,260671776.6,88.61672350257939,80.9988755830341,NaN,NaN,49.32791554649223,43.129975615222
2021-05-03T09:30:00-04:00,42.87,42.87,42.48,42.54,5074333,3834127.15,72.19744837059318,74.42604964260057,NaN,NaN,95.37458546346811,101.09017063422617,0.008995809750099504,0.8378828359497774,0.8288870261996779,260930000,260978517.8,88.75175844841333,82.44729832105247,NaN,NaN,48.69545286070178,43.92504379314769
2021-05-04T09:30:00-04:00,42.45,42.72,42.02,42.28,4892370,3865225.9,66.5335606352414,74.46815226783018,NaN,NaN,64.47224502761857,91.64385922602953,-0.02942600888033342,0.7921045150992612,0.8215305239795946,256037630,260306785,86.33639804865065,83.62825263305379,NaN,NaN,46.452159282445834,44.28606029161885
2021-05-05T09:30:00-04:00,42.22,42.23,41.48,41.66,5972412,4010688.35,55.377108894655464,73.24939188923449,NaN,NaN,10.856117062793627,74.73718841331873,-0.09902218897158666,0.6977527877651113,0.796774976736698,250065218,258889838.2,81.30963231981103,84.23254224863172,NaN,NaN,40.65719169763977,43.767650492478985
2021-05-06T09:30:00-04:00,41.68,41.91,41.51,41.86,4116440,4014376.5,57.833384305065465,72.17506749818558,NaN,NaN,1.6421420580826291,55.484866111110705,-0.13195333218684346,0.6318333115031436,0.763786643689987,254181658,257443767.8,76.41951189601906,84.28086617549482,NaN,NaN,36.67795057991361,42.75483621925536
2021-05-07T09:30:00-04:00,41.82,42.39,41.82,42.37,3863485,4113198.8,63.37040710234976,71.42754793732848,NaN,NaN,43.84613087331014,43.23824409705461,-0.12009301154560947,0.6136703792579752,0.7337633908035847,258045143,255851929.8,71.33363299857636,83.78372336632174,NaN,NaN,35.002190776971155,41.64731544178619
2021-05-10T09:30:00-04:00,42.58,42.938,42.465,42.56,3873285,4159520,65.20360730853277,70.58852684752067,NaN,NaN,96.62061898568747,43.487450801498476,-0.10092794287627094,0.607603462208246,0.708531405084517,261918428,256049615.4,71.58653184769867,83.17146801052294,NaN,NaN,34.24132075843366,40.589316201307255
2021-05-11T09:30:00-04:00,42.11,42.218,41.675,42.06,5546212,4058935.65,57.1043028268987,69.08819745678882,NaN,NaN,-4.960298057927968,29.60094218438917,-0.12199321706456423,0.5560398837538116,0.6780331008183759,256372216,256116532.6,71.67761779603775,82.38420810114255,NaN,NaN,30.83027685965577,39.19516772392847
2021-05-12T09:30:00-04:00,41.89,42,41.02,41.04,5444028,4179737.5,44.861856793958495,66.98565550603982,NaN,NaN,-125.11476186012595,2.4067663998052438,-0.20007695224990762,0.42793691050599136,0.628013862755899,250928188,256289126.6,71.92758300169743,81.5208818762103,NaN,NaN,22.928461852633856,36.87135259945781
2021-05-13T09:30:00-04:00,41.12,41.7982,41.11,41.56,10719372,4526388.4,50.668337310140835,65.17764885984431,NaN,NaN,-110.2558065639883,-19.972823324608946,-0.21107025760659837,0.3641760407476511,0.5752462983542495,261647560,257782307,74.06053946555585,80.7209304115363,NaN,NaN,18.75412911247017,34.28317781560243
2021-05-14T09:30:00-04:00,41.77,42.11,41.62,41.95,3828615,4559130.8,54.53539134037434,63.60166035433691,NaN,NaN,-40.91423809781854,-36.92489711883468,-0.18725151855600597,0.341181900159242,0.528433418715248,265476175,259268513.4,76.01402870869227,79.98150033047658,NaN,NaN,16.88490176574175,31.797709808479475
2021-05-17T09:30:00-04:00,41.91,42.075,41.82,41.97,3583387,4573720.95,54.73136691190927,62.03967010393914,NaN,NaN,-37.29959881748459,-63.708940679469094,-0.16604763367660313,0.32087387661949407,0.4869215102960972,269059562,260696740.2,77.74829622080775,79.32340840882169,NaN,NaN,15.547042648773582,29.47618592852149
2021-05-18T09:30:00-04:00,41.95,42.299,41.675,42.05,4545495,4548890.95,55.556607089287816,60.79615959372213,NaN,NaN,-27.93192108763666,-68.30326528541083,-0.14338671544249848,0.3076881159929741,0.45107483143547256,273605057,264143308.4,81.26807638204795,78.91589984337658,NaN,NaN,14.75915857463144,27.373753449394343
2021-05-19T09:30:00-04:00,41.73,41.89,41.33,41.89,7500945,4714810.4,53.45763156069986,59.21832612586492,NaN,NaN,-88.93611276024329,-61.0675354654343,-0.1359899116959148,0.2810874418155791,0.4170773535114939,266104112,267178493.2,83.71158580921032,78.62585117469983,NaN,NaN,13.475557552210818,25.38829689265384
2021-05-20T09:30:00-04:00,41.82,42.57,41.745,42.41,5260900,4774120.75,58.893292925835624,57.88030738396734,NaN,NaN,28.404947771452033,-33.33538459834623,-0.09484215195740198,0.2985246635647414,0.39336681552214336,271365012,269121983.6,85.05585049248717,78.37150310255038,NaN,NaN,14.08274658678505,23.77321827752973
2021-05-21T09:30:00-04:00,42.51,42.57,42.27,42.34,4565173,4824795.9,57.9127702700617,56.859973233929374,NaN,NaN,57.54325733164475,-13.643885512453574,-0.0721332376302889,0.3032002684842823,0.37533350611457117,266799839,269386716.4,85.23460666292648,78.12027797501561,NaN,NaN,14.273259066777591,22.41608124742228
2021-05-24T09:30:00-04:00,42.58,42.995,42.51,42.8,9873087,5173772.45,62.34898864543272,56.56107523465732,NaN,NaN,125.56703991531074,18.929442234105494,-0.02818410513799502,0.3401033746920774,0.36828747983007243,276672926,270909389.2,86.25314353716529,78.11433122419523,NaN,NaN,15.837508238875403,21.476285103344154
2021-05-25T09:30:00-04:00,42.9,43.079,42.61,42.92,4333799,5204703.05,63.431851958102335,57.136414024903516,NaN,NaN,131.16179304284765,50.74818506020235,0.005140330039751506,0.3747128923797618,0.3695725623400103,281006725,272389722.8,87.1790947733375,78.53357854230426,NaN,NaN,17.438762632796966,20.899496178980268
2021-05-26T09:30:00-04:00,43,43.3,42.89,43.02,4738368,5329304.35,64.35195434303787,57.60202617047298,NaN,NaN,145.82570855820464,97.70054932389193,0.028770419688993742,0.40553558695125247,0.3767651672622587,285745093,276317919,89.24860586592081,79.44994239729725,NaN,NaN,19.024108138843637,20.63158360181789
2021-05-27T09:30:00-04:00,43.16,43.18,42.904,42.97,4288034,5330603.15,63.491743073694025,57.610693025569,NaN,NaN,122.75450827510768,116.57046142462306,0.03544732984659421,0.4210743295705015,0.3856269997239073,281457059,278336328.4,90.13018043619866,80.79255292855598,NaN,NaN,20.093928640174084,20.55477575015449
2021-05-28T09:30:00-04:00,43.228,43.41,43.15,43.26,3534175,5277695.75,66.30507250852537,57.68936911128276,NaN,NaN,145.74351968599166,134.21051389549245,0.0527655149359903,0.45158389339389515,0.39881837845790485,284991234,281974607.4,91.48545460124629,82.21390455380937,NaN,NaN,21.838115734881004,20.73811003368685
2021-06-01T09:30:00-04:00,43.48,44,43.28,44,5512307,5299594.45,72.19344285920337,58.76716482787595,NaN,NaN,183.37573336930896,145.7722525862921,0.10444328255359675,0.5293724816499008,0.42492919909630406,290503541,284740730.4,92.34598715581177,83.6902166509361,NaN,NaN,25.391301175598564,21.402851625388525
2021-06-02T09:30:00-04:00,44.11,44.62,43.98,44.61,4599033,5284927.6,75.9278991744638,60.98616785505491,NaN,NaN,206.15877179608992,160.77164833694056,0.16641359320823346,0.6329461906065958,0.4665325973983624,295102574,287559900.2,93.11025156266713,85.20326440529108,NaN,NaN,29.81715439131303,22.604894877663455
2021-06-03T09:30:00-04:00,44.442,44.56,44.235,44.52,3447291,5158671.55,74.34151299822874,62.67710897563261,NaN,NaN,173.73911669666126,166.35432996463186,0.18653482943989874,0.6997011341982358,0.513166304758337,291655283,288741938.2,93.40748683210028,86.58518921718711,NaN,NaN,32.82011134202614,24.06421151542955
2021-06-04T09:30:00-04:00,44.67,44.73,44.34,44.56,3061328,5105915.95,74.59556304101585,64.1099783828213,NaN,NaN,156.7245572865954,173.1483397669294,0.18724223381039928,0.7472190970213362,0.5599768632109369,294716611,291393848.6,94.02978566977811,87.8720290001218,NaN,NaN,35.29751495530655,25.668969149697695
2021-06-07T09:30:00-04:00,44.62,45.15,44.62,44.98,5659722,5195727.8,77.15345789683867,65.71155631031625,NaN,NaN,158.26324990285377,175.65228581030186,0.19956829049736302,0.8094372263326406,0.6098689358352776,300376333,294470868.4,94.65968479220236,89.07998532665,NaN,NaN,38.26964802479694,27.46906613185473
2021-06-08T09:30:00-04:00,45.07,45.368,45.005,45.22,5577221,5280924.6,78.48646229163714,67.34940311048406,NaN,NaN,149.74104020564096,168.92534717756826,0.20658850511647042,0.8681045672308656,0.6615160621143952,305953554,297560871,95.20662033519952,90.07559560901798,NaN,NaN,41.1734647520922,29.426837363317226
2021-06-09T09:30:00-04:00,45.38,45.4684,45.23,45.27,2401834,5123705.7,78.76444524245794,69.15703265918107,NaN,NaN,135.20064709747953,154.73372223784617,0.19731889635092936,0.9081646825530569,0.7108457862021276,308355388,300211433.8,95.62092129843616,90.92626242967695,NaN,NaN,43.611381266600034,31.453200778071913
2021-06-10T09:30:00-04:00,45.29,45.81,45.175,45.73,3818579,5042433.25,81.1744923699373,70.74854690518832,NaN,NaN,130.18199424970084,146.0222977484541,0.2040405825699514,0.9658965144145668,0.7618559318446154,312173967,304315170.6,96.17250877951724,91.7203094501791,NaN,NaN,46.536716971783115,33.607988805744945
2021-06-11T09:30:00-04:00,45.78,45.78,45.27,45.44,4478131,4730371.2,75.36725632301119,71.99529590897043,NaN,NaN,110.69767801891317,136.81692189491767,0.172104643159684,0.9769867357942204,0.8048820926345364,307695836,306911015.6,96.47497558598772,92.52319294468349,NaN,NaN,47.269610731446434,35.559649080845155
2021-06-14T09:30:00-04:00,45.45,45.72,45.38,45.7,2745962,4676238.55,76.9587878767489,73.03885299692159,NaN,NaN,104.24267054886202,126.01280602411933,0.15232044144792045,0.9952826444444369,0.8429622029965165,310441798,308924108.6,96.693217854404,93.26891253877196,NaN,NaN,48.367877993514114,37.389396068369294
2021-06-15T09:30:00-04:00,45.7,45.7,45.24,45.28,2948316,4644485,69.18270903183893,73.44962850218849,NaN,NaN,84.4295246848551,112.95050291996213,0.09744665355954751,0.9647705199459509,0.8673238663864034,307493482,309232094.2,96.72660858586205,93.95087781109514,NaN,NaN,46.90047057335212,38.748120997652556
2021-06-16T09:30:00-04:00,45.38,45.505,44.83,44.87,6093075,4721864,62.53952526152407,73.32016928208036,NaN,NaN,59.467507931771415,97.80387508682051,0.023872043492954687,0.8971639207525968,0.8732918772596421,301400407,307841098,92.1984245982846,94.16157914912114,NaN,NaN,43.50503311714793,39.42767987186618
2021-06-17T09:30:00-04:00,44.77,45.07,44.67,45.04,4558662,4574749.85,64.07969459237364,73.36216581912892,NaN,NaN,46.01588160841975,80.9706525585643,-0.020607141185538524,0.847532950777719,0.8681400919632575,305959069,306598118.4,88.22388329524297,94.0254150676243,NaN,NaN,41.19398377075323,39.680009000278616
2021-06-18T09:30:00-04:00,44.79,45.045,44.33,44.33,9034642,4763436.95,54.079237234681656,72.48889187099722,NaN,NaN,17.294512303751993,62.29001941553205,-0.10063078085999755,0.7423516158882606,0.8429823967482581,296924427,304443836.6,81.65390873322826,93.3231617913373,NaN,NaN,35.71734666409581,39.11391438082393
2021-06-21T09:30:00-04:00,44.24,45.03,44.07,44.92,4818345,4776095.55,59.70667706298812,71.59698002841041,NaN,NaN,19.161168545552545,45.27371901487016,-0.11554570402282971,0.698550266719721,0.8140959707425507,301742772,302704031.4,76.68704422970566,92.20466586804402,NaN,NaN,32.90659203194733,38.227154045270126
2021-06-22T09:30:00-04:00,44.94,44.95,44.71,44.72,2428584,4403870.4,57.1499729884943,70.25569958655545,NaN,NaN,23.593925616262926,33.106599201151724,-0.13902248250766536,0.640317867607969,0.7793403501156344,299314188,301068172.6,72.23766998668624,90.71376718404538,NaN,NaN,29.82212261484899,37.02643526949568
2021-06-23T09:30:00-04:00,44.7,44.8442,44.523,44.58,5049449,4439652.9,55.362832926547945,68.9000795814354,NaN,NaN,1.5755252861275388,21.528202672022942,-0.16248905432787153,0.576229032205795,0.7387180865336666,294264739,299641039,68.50350721995028,88.93491149746323,NaN,NaN,26.786842829223556,35.5636363494568
2021-06-24T09:30:00-04:00,44.74,44.74,44.18,44.37,3268043,4366136.65,52.7006699485505,67.3361586462593,NaN,NaN,-34.50837069214279,5.423352211910428,-0.18881596338120565,0.5026981323071595,0.6915140956883652,290996696,296648564.4,61.34298133213039,86.60013975905984,NaN,NaN,23.460206925155386,33.83457500312802
2021-06-25T09:30:00-04:00,44.46,44.7,44.3,44.69,3278534,4315661.65,56.160075655542954,65.8366313433096,NaN,NaN,-32.126901334359914,-4.460930515711951,-0.1813018647251481,0.46488676478193014,0.6461886295070782,294275230,296118725,60.14424234210508,84.13475101262432,NaN,NaN,21.691291123291244,32.09982016315134
2021-06-28T09:30:00-04:00,44.78,44.78,44.35,44.71,3260927,4301999.25,56.37483314081713,64.25722926110818,NaN,NaN,-40.14412118953903,-16.321988462730268,-0.1717028550361066,0.43156006071194497,0.6032629157480516,297536157,295277402,58.19941276973866,81.49137904366283,NaN,NaN,20.333865774033498,30.418969536134508
2021-06-29T09:30:00-04:00,44.66,44.978,44.6,44.68,2851450,4168956.4,55.93222787690437,62.62635659214006,NaN,NaN,-27.959640798839462,-26.632701745750744,-0.16409979710488543,0.3981381693669448,0.5622379664718302,294684707,294351505.8,56.05129844025051,78.66497741093528,NaN,NaN,19.098703272867926,28.80178864138214
2021-06-30T09:30:00-04:00,44.66,44.92,44.28,44.33,6087709,4243390.2,50.91032143747193,60.46463009696396,NaN,NaN,-77.15336718340225,-42.378480239656696,-0.17819396371773732,0.33949551182465854,0.5176894755423959,288596998,293217957.6,53.45023593096936,75.61338649318186,NaN,NaN,16.563299740354825,27.05343308409252
2021-07-01T09:30:00-04:00,44.32,44.85,44.165,44.51,6331996,4387625.45,53.23578373821557,58.88381062662142,NaN,NaN,-78.90356073312441,-51.25751824785302,-0.17091918891476776,0.30404048939893613,0.4749596783137039,294928994,294004417.2,55.010150318513084,72.65161325979082,NaN,NaN,15.05979866614468,25.3400567386714
2021-07-02T09:30:00-04:00,44.66,44.8763,44.5,44.72,3993040,4434211.05,55.862757784141024,57.376951334292286,NaN,NaN,-43.5320349347536,-53.53854496793175,-0.1483280420142491,0.2895496257958925,0.4378776678101416,298922034,294933778,56.85030213281099,69.80569070824846,NaN,NaN,14.507693582808889,23.7925762878339
2021-07-06T09:30:00-04:00,44.7,45.16,44.41,45.12,5002393,4401344.6,60.423211494029005,56.75127293873443,NaN,NaN,-3.183029782543879,-46.146326686532724,-0.10485772932426574,0.3068055061548094,0.41166323547907513,303924427,296211432,59.31405483522839,67.13336544034605,NaN,NaN,15.361890554265651,22.588192611609863
2021-07-07T09:30:00-04:00,45.09,45.52,44.86,45.35,4634352,4354201.15,62.80312843785095,56.77010173704349,NaN,NaN,66.02125525455526,-27.350147475853777,-0.061189556509935905,0.33517628984165526,0.39636584635159117,308558779,298986246.4,64.10731172987093,65.1268573783165,NaN,NaN,16.795967758181224,21.760731918262913
2021-07-08T09:30:00-04:00,45.07,45.43,44.97,45.31,5252871,4496753,62.10368044529132,56.62895786939475,NaN,NaN,66.58402541133799,1.3973310430942718,-0.03677783243412469,0.3503935558089353,0.38717138824305997,303305908,301928028.4,68.36276690770114,63.70820620777779,NaN,NaN,17.777002754677724,21.191627752036457
2021-07-09T09:30:00-04:00,45.53,45.9399,45.35,45.91,4090453,4510346.7,67.88196651629185,57.61486710379548,NaN,NaN,161.48088550326653,49.47422029037246,0.015211748680088566,0.40618607409317065,0.3909743254130821,307396361,304421501.8,71.45228230199999,62.9795186055472,NaN,NaN,20.49220197057285,21.09170978325594
2021-07-12T09:30:00-04:00,45.89,46.36,45.85,46.31,3406677,4456774,71.05101425803694,58.42517690344183,NaN,NaN,214.4626052501274,101.07314832734866,0.06896301314759024,0.4771780918475699,0.40821507869997964,310803038,306797702.6,74.0527218281235,62.79135271971991,NaN,NaN,23.869372790452722,21.48851878428405
2021-07-13T09:30:00-04:00,46.15,46.24,45.56,45.71,4764635,4557707.65,61.28320349592816,58.72040765397282,NaN,NaN,147.2841654668149,131.16658737722042,0.05702589203389896,0.47949744374235337,0.4224715517084544,306038403,307220497.8,74.49784866359809,62.95279405378504,NaN,NaN,23.644818808148074,21.796561644836054
2021-07-14T09:30:00-04:00,45.75,46.245,45.61,46.11,3943005,4607442.1,64.76129001445068,59.39172601739445,NaN,NaN,153.30050556205575,148.6224374387205,0.0682300173219178,0.5077590733608517,0.4395290560389339,309981408,307505023.6,74.81101774509635,63.403330519866905,NaN,NaN,24.62284978304571,22.200317093151718
2021-07-15T09:30:00-04:00,46.07,46.25,46.015,46.18,4138725,4509724.6,65.34795818587295,60.29510374863177,NaN,NaN,145.9539931424276,164.49643098493843,0.07213594970174447,0.5296989931661145,0.45756304346437,314120133,309667868.6,77.11192808830776,64.52968385959386,NaN,NaN,25.578584139721105,22.68292667123306
2021-07-16T09:30:00-04:00,46.33,46.5451,46.18,46.23,4107202,4487151.6,65.78611698673706,60.98267812943135,NaN,NaN,139.4572626757358,160.09170641943228,0.06982199502927411,0.5448405372509626,0.4750185422216885,318227335,311834063.4,79.16472122505331,65.88828949409016,NaN,NaN,26.475947011622875,23.224786719860177
2021-07-19T09:30:00-04:00,45.81,45.92,45.13,45.51,8124926,4441665.8,55.00109113712371,60.8845537005961,NaN,NaN,41.45654018521946,125.4904934064507,0.014432097389415255,0.49305866395845754,0.4786265665690423,310102409,311693937.6,78.67317098525845,67.3507007951987,NaN,NaN,23.788164706141377,23.30526928932892
2021-07-20T09:30:00-04:00,45.74,46.48,45.67,46.33,4986236,4450060.35,62.53439848431209,61.35613731541093,NaN,NaN,102.82272596432841,116.59820550595342,0.026925165521162087,0.5122830234704949,0.48535785794933284,315088645,313503986,80.36883234534672,69.08766750270559,NaN,NaN,24.00870479159955,23.40576007536758
2021-07-21T09:30:00-04:00,46.41,46.47,46.115,46.19,4280549,4542658.6,60.66700797819563,62.0530434968912,NaN,NaN,99.68536442033059,105.87517727760837,0.019984729048103556,0.5103387692594623,0.49035404021135875,310808096,313669323.6,80.52118203032518,71.02130650980243,NaN,NaN,23.556715777826884,23.42732517571891
2021-07-22T09:30:00-04:00,46.03,46.03,45.62,45.86,4127640,4496568.15,56.392298961098604,62.27850886995427,NaN,NaN,49.55658440870595,86.59569553086405,-0.010943327838601469,0.4766748804131069,0.4876182082517084,306680456,312181388.2,74.88859100802631,72.44119513048194,NaN,NaN,21.775054251566562,23.191286472268573
2021-07-23T09:30:00-04:00,46.01,46.32,45.88,46.28,4996098,4582970.9,60.23288984611508,62.59066116009527,NaN,NaN,76.77484669659302,74.05921233503551,-0.007396870713959669,0.47837211985925876,0.48576899057321843,311676554,310871232,70.23010215568878,73.39689513211609,NaN,NaN,21.543064876297013,22.955826244272636
2021-07-26T09:30:00-04:00,46.17,46.299,45.88,46.28,3699704,4604029.4,60.232889846115086,62.577066756672856,NaN,NaN,70.093041669384,79.78651263186842,-0.009214927070870349,0.4742503317346305,0.48346525880550084,311676554,311186061,70.70173884664774,74.21030113293173,NaN,NaN,21.362105663295395,22.7281518755616
2021-07-27T09:30:00-04:00,46.26,46.69,46.095,46.65,3937354,4637850.75,63.51581724234494,62.62797309985099,NaN,NaN,99.53943148280219,79.12985373556317,0.009333487263621598,0.49513211788502787,0.48579863062140627,315613908,311291113.6,70.8675918665989,74.69317828555518,NaN,NaN,22.226387432783717,22.656471240879046
2021-07-28T09:30:00-04:00,46.68,46.7,46.22,46.37,6457229,4818139.7,59.511926259260875,62.442847800848824,NaN,NaN,88.55315386834266,76.90341162516559,-0.0018278820527680706,0.48351377805544615,0.4853416601082142,309156679,310960830.2,69.53484203907024,74.77689793779582,NaN,NaN,21.724359260489916,22.523312386537743
2021-07-29T09:30:00-04:00,46.49,46.74,46.18,46.23,7659297,4896719.1,57.558206388935695,61.705436363180524,NaN,NaN,79.57102510572544,82.90629976456948,-0.022087031717099748,0.4577328704618395,0.4798199021789393,301497382,309924215.4,65.37904010013409,74.34309492337682,NaN,NaN,20.73155488615198,22.267347029339778
2021-07-30T09:30:00-04:00,46.33,46.93,46.27,46.38,4998660,4830052.3,59.10721173462971,60.85230761150858,NaN,NaN,96.434898370432,86.83831009933729,-0.02842901242801238,0.4442836366439238,0.47271264907193616,306496042,308888113,61.427339501039405,73.44128190001368,NaN,NaN,20.35128859462088,21.993624395808506
2021-08-02T09:30:00-04:00,46.62,46.89,46.34,46.4,6819379,4971369.25,59.32039803955867,60.7121072217679,NaN,NaN,97.19669735627184,92.25904123671485,-0.03394702497717428,0.4302788678504683,0.4642258928276426,313315421,309215886.4,62.20560644335393,72.56326459856767,NaN,NaN,20.098545601043494,21.72289885369922
2021-08-03T09:30:00-04:00,46.53,46.665,46.2875,46.59,6669670,5054733.1,61.38022440599207,60.47060253544943,NaN,NaN,90.584201445765,90.46799522930742,-0.027732951923849725,0.4295597029228304,0.45729265484668014,319985091,310090123,64.27598253362027,71.81076208346224,NaN,NaN,20.445780077432254,21.54045331423251
2021-08-04T09:30:00-04:00,46.6,46.8,46.22,46.44,4374601,5041745.55,58.846849432403566,60.00623762448733,NaN,NaN,84.10453550805134,89.57827155724917,-0.03612598357166047,0.41213517538210453,0.448261158953765,315610490,311380885.2,67.13827590693111,71.09835835622104,NaN,NaN,20.057223345652595,21.328563318721095
2021-08-05T09:30:00-04:00,46.69,46.83,46.41,46.81,5469025,5052553.25,62.91303712930728,59.80101763467093,NaN,NaN,126.666530969492,98.99737273000247,-0.01996696526240005,0.4233024523757649,0.44326941763816496,321079515,315297311.8,73.9566289806417,70.72635176733449,NaN,NaN,20.859166850547123,21.261506680410527
2021-08-06T09:30:00-04:00,46.85,47.01,46.6317,46.73,3452565,5020658.85,61.49815785151441,60.265093828555976,NaN,NaN,141.21528695216512,107.95345044634905,-0.01793872009880182,0.42084601751466266,0.4387847376134645,317626950,317523493.4,76.89166285095217,70.59910118631262,NaN,NaN,21.14199333108684,21.244433344792856
2021-08-09T09:30:00-04:00,46.73,46.73,46.41,46.52,3556348,5028142.4,57.822066185404,59.928498664348254,NaN,NaN,69.65704042722719,102.44551906054012,-0.033129104071887294,0.39737335752360536,0.43050246159549266,314070602,317674529.6,77.08038737441976,70.36421225981785,NaN,NaN,20.373279972692497,21.119982863064234
2021-08-10T09:30:00-04:00,46.58,46.6,45.99,46.02,6752864,5127553.85,50.137454923371564,59.17638773186082,NaN,NaN,-29.56445255903241,78.41578825958064,-0.07674710075639657,0.3345685856499969,0.4113156864063935,307317738,315141059,67.17071860492959,69.41060772943244,NaN,NaN,17.366296090937595,20.58374189561757
2021-08-11T09:30:00-04:00,46.24,46.37,46.05,46.27,4074534,5134130.3,53.467423134171014,58.96746802993742,NaN,NaN,-26.92545556893313,56.20979004418375,-0.08785827686230363,0.301492840328514,0.3893511171908176,311392272,314297415.4,64.21033483033537,68.64787514531166,NaN,NaN,15.780832132680658,19.897611929483727
2021-08-12T09:30:00-04:00,46.37,46.44,46.11,46.43,3733149,5113851.5,55.515016603901834,58.63047708406504,NaN,NaN,-0.35937627432680563,30.80460859541999,-0.08355568433821442,0.2849065117680496,0.368462196106264,315125421,313106596.6,60.17869144303504,67.92991723726497,NaN,NaN,15.048764548072857,19.20491944642503
2021-08-13T09:30:00-04:00,46.58,46.76,46.385,46.74,4763340,5146658.4,59.255928280540715,58.560694115095444,NaN,NaN,84.76489140083928,19.51452948515482,-0.06005449938213536,0.2933940718785948,0.35344857126073015,319888761,313558958.8,61.17594003830427,67.249503036669,NaN,NaN,15.526108449561471,18.679375018301666
2021-08-16T09:30:00-04:00,46.67,46.98,46.6,46.79,4879828,4984403.5,59.84250341221887,58.29831455580073,NaN,NaN,131.0143500481801,31.78599140934541,-0.04220769581822498,0.30068895148794894,0.3428966473061739,324768589,315698556.2,65.56811061120824,66.87096866128394,NaN,NaN,16.08468304751109,18.308704736760156
2021-08-17T09:30:00-04:00,46.63,46.895,46.47,46.88,4916833,4980933.35,60.93276102231639,58.399802753161836,NaN,NaN,106.99915780187506,59.0987134815269,-0.02619160147139421,0.3101571454669312,0.3363487469383254,329685422,320172093,72.55835073092543,67.08693356784502,NaN,NaN,16.85683807071229,18.10129521303903
2021-08-18T09:30:00-04:00,46.77,46.79,46.33,46.39,5431518,5038481.8,52.56519696617794,58.04315922296485,NaN,NaN,19.61408200280641,68.4066209958748,-0.04911709938257747,0.27495237271010353,0.324069472092681,324253904,322744419.4,75.6229402108052,67.81864071860726,NaN,NaN,15.076530727814255,17.669186000864062
2021-08-19T09:30:00-04:00,46.25,46.8499,46.12,46.78,5385167,5101358.15,57.560601034399724,57.93268703009129,NaN,NaN,42.7133440228045,77.02116505530105,-0.038977148449583776,0.2753480365307013,0.31432518498028506,329639071,325647149.4,78.53593272037008,69.04068309141658,NaN,NaN,15.052125548464131,17.295320221949787
2021-08-20T09:30:00-04:00,46.76,47.2367,46.43,47,4420763,5072591.4,60.11244267625153,57.98926164699792,NaN,NaN,161.48927892414713,92.36604255996265,-0.019404133792052025,0.29007001774022,0.30947415153227203,334059834,328481364,80.93187724063681,70.37827386265107,NaN,NaN,15.817799779978198,17.0842458730967
2021-08-23T09:30:00-04:00,47.14,47.16,46.72,46.82,4653692,5120290.8,57.08787781768826,57.68266546211907,NaN,NaN,147.74514356977423,95.71220126428148,-0.02042754689311521,0.283939717915878,0.30436726480899323,329406142,329408874.6,81.65362562761091,71.61953408365041,NaN,NaN,15.547354069667449,16.864689901178238
2021-08-24T09:30:00-04:00,46.94,46.94,46.35,46.47,4291848,5138015.5,51.64637800941304,57.1683460747626,NaN,NaN,9.532740178530121,76.21891773961248,-0.04510919722584228,0.24798076827669036,0.29308996550253263,325114294,328494649,78.49960496682826,72.43105758792878,NaN,NaN,13.62789756486625,16.40229099599081
2021-08-25T09:30:00-04:00,46.47,46.655,46.26,46.42,4543658,5042336.95,50.89996559931625,56.3102695369061,NaN,NaN,-53.40332117980626,61.61543710308994,-0.06407740729379824,0.21299320638528485,0.2770706136790831,320570636,327757995.4,75.95375429250217,72.5737093959188,NaN,NaN,11.855538015922216,15.752754855981012
2021-08-26T09:30:00-04:00,46.47,46.595,46.275,46.45,2861386,4802441.4,51.35424170414921,55.58570409780858,NaN,NaN,-57.845781069487636,41.503612084631506,-0.07321874029812842,0.18554718830642258,0.258765928604551,323432022,326516585.6,71.73179821492361,72.20514763620247,NaN,NaN,10.531891615384689,15.006917250181537
2021-08-27T09:30:00-04:00,46.64,46.96,46.54,46.83,2530519,4679034.35,56.80568738755711,55.51310561224808,NaN,NaN,83.30280700259327,25.866317700320735,-0.05321851069983627,0.19224279022975566,0.24546130092959192,325962541,324897127,66.53590853983997,71.45197057658963,NaN,NaN,10.939783640222636,14.425898163044552
2021-08-30T09:30:00-04:00,46.87,47.415,46.77,47.4,6169790,4646554.9,63.42647264854128,56.462321164045925,NaN,NaN,206.3599122476927,37.58927143590445,-0.0037547074362300203,0.2407679166343044,0.24452262407053443,332132331,325442364.8,67.3922939124196,71.46779738426748,NaN,NaN,13.457374751664505,14.287537675704545
2021-08-31T09:30:00-04:00,47.24,47.74,47.12,47.68,4855623,4555852.55,66.16966985670317,57.36962450136967,NaN,NaN,244.86305440864413,84.65533428192725,0.043084753925006214,0.2983785664767922,0.25529381255178596,336987954,327817096.8,70.88685514401945,71.94469169238776,NaN,NaN,16.460607344763698,14.597976199855852
2021-09-01T09:30:00-04:00,47.75,48.55,47.74,48.5,9196173,4796931.15,72.64145008856242,58.59294117884543,NaN,NaN,325.1234477574253,160.36068806937354,0.12018726625288839,0.40552789536789646,0.28534062911500807,346184127,332939795,76.69021524293774,73.12408624952367,NaN,NaN,21.60753270518636,15.599341414903067
2021-09-02T09:30:00-04:00,48.5799,48.73,48.14,48.73,6576120,4852285.9,74.13600475174292,59.65580378393129,NaN,NaN,266.46680676324775,225.2232056359206,0.17428987878825286,0.5032029776003242,0.3289130988120713,352760247,338805440,81.28939102572897,74.56076132005401,NaN,NaN,26.214680607840744,17.115818442465592
2021-09-03T09:30:00-04:00,48.58,48.805,48.155,48.73,5537967,4956556,74.1360047517429,60.67676816532587,NaN,NaN,201.18985526479506,248.80061528836094,0.19606514679930037,0.5739945323111968,0.3779293855118964,352760247,344164981.2,84.33144675209466,75.90099961583162,NaN,NaN,29.763156548680435,18.92258102906771
2021-09-07T09:30:00-04:00,48.55,48.6,47.7336,48.19,7162299,5136853.55,64.53629602699269,60.93416352280274,NaN,NaN,125.63143553354833,232.65491994553207,0.16152835542518013,0.5798398297933716,0.41831147436819144,345597948,346858104.6,85.59851455570039,76.83243988902983,NaN,NaN,29.71208645128324,20.463938946527072
2021-09-08T09:30:00-04:00,48.01,48.63,47.91,48.48,6704460,5134433.35,67.00709999544554,61.96572802489328,NaN,NaN,120.66097507075618,207.8145040779545,0.14610723702031447,0.6009455206435845,0.45483828362327006,352302408,349920995.4,86.89635966590588,77.63768413582272,NaN,NaN,30.47733896550422,21.894424663523807
2021-09-09T09:30:00-04:00,48.21,48.26,47.44,47.45,4573300,5159371.65,52.90779335614559,61.6333846193037,NaN,NaN,51.56469744364491,153.10275401519843,0.05890352842248864,0.5284676941513808,0.4695641657288922,347729108,350229991.6,87.02341192822311,78.24393265066938,NaN,NaN,25.949571771753487,22.473731393270903
2021-09-10T09:30:00-04:00,47.5,47.52,46.83,46.85,6203577,5282893.05,46.738311878383385,60.67808956231312,NaN,NaN,-17.10973469460332,96.3874457236282,-0.04141341216106453,0.41779740052756154,0.45921081268862607,341525531,347983048.4,80.88202982334342,78.24037212086272,NaN,NaN,19.887546450723125,22.104276401478362
2021-09-13T09:30:00-04:00,47.33,47.505,46.911,47.11,5495203,5319486.2,49.487080996479115,60.135175503655326,NaN,NaN,-9.003159027986483,54.3488428650719,-0.0897131122899067,0.3470694223262427,0.4367825346161494,347020734,346835145.8,77.8590399951135,77.96933028997003,NaN,NaN,16.156010654326117,21.254524151885185
2021-09-14T09:30:00-04:00,47.33,47.39,46.77,47.01,5234603,5337224.95,48.45136499069994,59.90696028803296,NaN,NaN,-23.355634920293685,24.551428774303503,-0.12564734839526737,0.2797233491220652,0.40537069751733257,341786131,346072782.4,75.83192490636428,77.7787817142226,NaN,NaN,12.930397644804886,20.065363222302285
2021-09-15T09:30:00-04:00,47.11,47.44,46.83,47.19,4885917,5335679.15,50.461160480918515,59.875617065290264,NaN,NaN,-15.479865354455672,-2.676739310738868,-0.13379209758262378,0.2381305755390528,0.3719226731216766,346672048,344946710.4,72.81623697345017,77.55467333429031,NaN,NaN,10.978545872008391,18.767246457974586
2021-09-16T09:30:00-04:00,47.19,47.479,46.85,47.28,4612937,5294750.1,51.47978035070212,59.88458411147261,NaN,NaN,-14.446286321059622,-15.878936063679774,-0.12953062402048332,0.21000939309607247,0.3395400171165558,351284985,345657885.8,73.53213068720328,77.68326851088172,NaN,NaN,9.720339902511478,17.47483123576557
2021-09-17T09:30:00-04:00,47.02,47.33,46.7731,46.85,8711761,5461079.8,46.55442149051094,59.152350833112166,NaN,NaN,-42.9039135517459,-21.037771835108273,-0.15060652256499418,0.15128186391031306,0.30188838647530725,342573224,345867424.4,73.75146973804536,78.19866573932497,NaN,NaN,7.095367877943507,15.992050756076704
2021-09-20T09:30:00-04:00,46.07,46.615,45.7201,46.27,13017852,5890934.25,40.873862268915325,57.54145009171032,NaN,NaN,-125.66152951986588,-44.36944593348416,-0.19568794849467575,0.05727845085696259,0.25296639935163834,329555372,342374352,64.20019077797153,77.97065837257867,NaN,NaN,2.9230784287412503,14.125054709314497
2021-09-21T09:30:00-04:00,46.46,46.83,46.26,46.28,6982623,6007380.8,41.00751675037401,55.744153441258234,NaN,NaN,-91.94830612854179,-58.08798017513377,-0.21535389701363358,-0.016225971915403647,0.19912792509822994,336537995,341324724.8,61.61787277046372,77.30858820303898,NaN,NaN,-0.31601829398307435,12.062044280271987
2021-09-22T09:30:00-04:00,46.6,46.93,46.35,46.67,6432412,6114409,46.12267775097538,53.849955417144876,NaN,NaN,-71.28376226769255,-69.24875955778114,-0.19331744780974283,-0.0425188846639486,0.15079856314579423,342970407,340584396.6,59.79110278184027,76.10150874153202,NaN,NaN,-1.5435497336036936,10.118387992575462
2021-09-23T09:30:00-04:00,46.78,46.92,46.37,46.44,4571524,6115802.3,43.715301245726074,51.67704802385796,NaN,NaN,-80.72611921708639,-82.5047261369865,-0.18542427270293393,-0.08098177773287318,0.10444249497006075,338398883,338007176.2,53.81036135119758,74.13872090763691,NaN,NaN,-3.293524375018877,8.202400511490556
2021-09-24T09:30:00-04:00,46.35,46.52,45.78,45.91,5211766,6233321.3,38.70228790122627,49.14606824882105,NaN,NaN,-132.1966265910728,-100.36326874485188,-0.20553228080171565,-0.15247285603208383,0.05305942476963183,333187117,336129954.8,49.89539906251557,71.67900321552412,NaN,NaN,-6.424012428237957,6.1129129486721965
2021-09-27T09:30:00-04:00,45.87,46.14,45.105,45.15,6701102,6441850.45,32.87970473892683,46.88488315681635,NaN,NaN,-177.63302784522128,-110.75756840992297,-0.2563464060844607,-0.26737358283594403,-0.01102717675148334,326486015,335516083.4,48.64892985811898,69.03974716569688,NaN,NaN,-11.224338099595073,3.6361627989197296
2021-09-28T09:30:00-04:00,44.87,45.08,44.53,44.88,12068990,6736810.45,31.090182158543996,44.3193890256091,NaN,NaN,-198.07368685921134,-131.98264455605687,-0.2918878497444153,-0.37588698893200245,-0.08399913918758717,314417025,331091889.4,40.74814339631113,65.74344600358297,NaN,NaN,-15.697062798900491,0.8742734278025552
2021-09-29T09:30:00-04:00,45.05,45.38,45,45.17,5975953,6792826.95,35.17144471104088,43.052506979530186,NaN,NaN,-142.3006973527168,-146.1860315730617,-0.2795903680478169,-0.4334870992473583,-0.1538967311995414,320392978,326576403.6,34.57611122604712,61.99721023914183,NaN,NaN,-18.061120003674468,-1.8307827766941625
2021-09-30T09:30:00-04:00,45.38,45.395,44.45,44.45,6342879,6650162.25,30.3632612457112,41.882860505767894,NaN,NaN,-150.0841399036157,-160.05763571036758,-0.30177162649462447,-0.531111264317822,-0.2293396378231975,314050099,321706646.8,29.403530168081645,58.32017454948027,NaN,NaN,-21.778024435398173,-4.680388727937592
2021-10-01T09:30:00-04:00,44.74,45.25,44.4,44.93,8294802,6736096.35,36.58714605853327,40.96143658162891,NaN,NaN,-127.68797460828362,-159.15590531380974,-0.26713171791845186,-0.5632542852212623,-0.29612256730281045,322344901,319538203.6,27.435340386468823,54.71848172029137,NaN,NaN,-22.76353193220395,-7.2636948999756425
2021-10-04T09:30:00-04:00,44.84,45.16,44.65,44.98,10456445,6982020.25,37.21662503595227,40.158955156289785,NaN,NaN,-109.17646198545641,-145.46459214185677,-0.22552603212977196,-0.5780301074650254,-0.3525040753352534,332801346,320801269.8,30.35944216787624,51.47044723897079,NaN,NaN,-23.331453153304484,-9.559088936165477
2021-10-05T09:30:00-04:00,45.06,45.06,44.43,44.63,5480520,6897931.3,34.62553143169018,39.02783879563062,NaN,NaN,-110.67489435670613,-127.98483364135572,-0.20674841701361463,-0.6109395966022717,-0.4041911795886571,327320826,323382030,36.03148874898188,48.842965222937345,NaN,NaN,-24.614318597357975,-11.709836030621547
2021-10-06T09:30:00-04:00,44.46,45.1001,43.95,45.06,8996456,7012531.1,40.1395844481017,38.217824802587735,NaN,NaN,-99.49229896021697,-119.42315396285576,-0.1530143487136461,-0.5954591154807147,-0.4424447667670686,336317282,326566890.8,42.27941322618979,46.61062826143638,NaN,NaN,-23.95521235892031,-13.459175506092798
2021-10-07T09:30:00-04:00,45.3,45.72,45.05,45.11,7269898,7147361,40.76522621279461,37.80431085417943,NaN,NaN,-50.07807090086327,-99.42194016230528,-0.1040890430271012,-0.5725560705509452,-0.46846702752384395,343587180,332474307,51.70236903149976,45.03569249668312,NaN,NaN,-23.241019619399268,-14.856581807993722
2021-10-08T09:30:00-04:00,45.11,45.17,44.55,44.62,5464425,7110403.4,36.715327426642226,37.507272651159916,NaN,NaN,-79.37517311919287,-89.75937986448712,-0.0949668204321818,-0.5871755530640712,-0.4922087326318894,338122755,335629877.8,55.84870863529826,44.43915805792074,NaN,NaN,-23.84619705480995,-16.140812557538897
2021-10-11T09:30:00-04:00,44.6,44.8757,44.34,44.68,4151946,7043240.55,37.533679322825236,37.259141406335,NaN,NaN,-82.56154919498401,-84.43639730639264,-0.075954437494134,-0.5871517794995569,-0.5111973420054229,342274701,337524548.8,58.17069797446631,44.19293128677807,NaN,NaN,-24.095259349368025,-17.27716209922877
2021-10-12T09:30:00-04:00,44.75,45.48,44.66,45.28,5663256,7064673.2,45.16938771871828,37.191049261173774,NaN,NaN,-39.4752413997153,-70.19646671499447,-0.017105100198746004,-0.5325787172538554,-0.5154736170551094,347937957,341647975,62.760836848947235,44.40505514871428,NaN,NaN,-21.95430643327908,-17.94532557552167
2021-10-13T09:30:00-04:00,45.2,45.59,44.8526,45.54,9279245,7284339.6,48.128355303560376,37.50626740816194,NaN,NaN,-19.013673590069075,-54.1007416409649,0.04196926909816778,-0.4630120306823997,-0.5049812997805675,357217202,345827959,66.74472246591795,45.328938085480026,NaN,NaN,-19.26003947123865,-18.133141846338383
2021-10-14T09:30:00-04:00,45.82,46.235,45.71,46.18,4392542,7273319.85,54.620237625237365,38.64326381701987,NaN,NaN,56.559217509456985,-32.77328395890085,0.12224296383666922,-0.352177594984731,-0.4744205588214002,361609744,349432471.8,69.75002755845462,46.747125835189955,NaN,NaN,-14.754450713021894,-17.650471684436027
2021-10-15T09:30:00-04:00,46.48,46.6,45.92,46.2,5210165,7098240.05,54.81056979160371,40.20975417792537,NaN,NaN,86.28625433086152,0.35900153111002736,0.1717503373298485,-0.25973263715908956,-0.4314829744889381,366819909,355171902.6,73.80876455783562,48.544256885169716,NaN,NaN,-11.1282743105055,-16.718729202445953
2021-10-18T09:30:00-04:00,46.03,46.47,45.93,46.28,4251262,6659910.55,55.61253402632909,41.96135073991002,NaN,NaN,84.50282044306702,33.77187545872023,0.202816324452341,-0.1779625689235118,-0.3807788933758528,371071171,360931196.6,77.12544539867368,51.14263559962419,NaN,NaN,-7.928797934371564,-15.463024735578184
2021-10-19T09:30:00-04:00,46.52,46.7,46.41,46.49,3509733,6486266.05,57.73301042446755,43.57289114801192,NaN,NaN,116.32798703859224,64.93252114638173,0.22852911435497714,-0.09511750043213141,-0.32364661478710854,374580904,366259786,79.6882879156863,54.36493393459841,NaN,NaN,-4.599949665121352,-13.911156868370066
2021-10-20T09:30:00-04:00,46.58,47.21,46.51,47.2,5596364,6444463.65,63.995581023199016,45.975199703546764,NaN,NaN,156.85265930399564,100.10578772519469,0.2809266848443429,0.027511741268320122,-0.2534149435760228,380177268,370851799.2,81.60135687041137,58.09335012762197,NaN,NaN,0.4606859975356486,-11.858036458954963
2021-10-21T09:30:00-04:00,47.18,47.39,47.025,47.35,5528784,6492326.65,65.16973666622846,48.01681331838213,NaN,NaN,170.88283641429743,122.97051150616278,0.3109248111291527,0.1352410703354181,-0.1756837407937346,385706052,375671060.8,83.37146625747901,62.08878768983698,NaN,NaN,4.967961583560431,-9.454322452881335
2021-10-22T09:30:00-04:00,47.49,47.795,47.41,47.69,5378198,6500648.25,67.73796680321763,50.196909158901086,NaN,NaN,174.13490964005476,140.54024256800142,0.33672754397365845,0.24522568917333842,-0.09150185480032,391084250,380523929,84.94244872622063,65.98757387257587,NaN,NaN,9.62122635484199,-6.729244051778004
2021-10-25T09:30:00-04:00,47.73,47.945,47.355,47.83,4933114,6412248.85,68.75944641549899,52.63504594345886,NaN,NaN,148.01512757854758,153.24270399509754,0.345017060646131,0.3397694710073438,-0.005247589638787228,396017364,385513167.6,86.36834052731552,69.58306328531398,NaN,NaN,13.772268664529921,-3.800456520876872
2021-10-26T09:30:00-04:00,47.89,48.219,47.83,48.05,9546226,6286110.65,70.34824102974714,54.792807127862105,NaN,NaN,145.5010078198018,159.07730815133945,0.3462141319820282,0.42752007533874803,0.08130594335671983,405563590,391709704.8,87.90079796345245,72.84173362368988,NaN,NaN,17.759656011726797,-0.7204404447906336
2021-10-27T09:30:00-04:00,48.29,48.32,47.7,47.7,7158346,6345230.3,64.70991823180424,56.50314227207708,NaN,NaN,119.68817227734529,151.64441074600936,0.3057378831121905,0.463478297246958,0.15774041413476747,398405244,395355300,88.70528497345454,75.48479904811522,NaN,NaN,19.597819728902703,2.1821681514512714
2021-10-28T09:30:00-04:00,47.69,48.4,47.672,48.4,6690330,6362602.85,69.90513600495488,58.8738428848137,NaN,NaN,120.03187652042634,141.47421876723516,0.3075751448618777,0.5422093452121146,0.2346342003502369,405095574,399233204.4,89.50469691248617,77.8887982107715,NaN,NaN,22.934143960456645,5.146736124166324
2021-10-29T09:30:00-04:00,48.22,48.36,47.61,47.82,7925208,6344123.15,61.7885444144933,60.60633324850427,NaN,NaN,95.19462043450969,125.68616092612615,0.2534497473643048,0.5514463845556179,0.2979966371913131,397170366,400450427.6,89.7499305094413,80.14445767755542,NaN,NaN,23.178158950323578,7.722653670760217
2021-11-01T09:30:00-04:00,47.94,48.025,47.145,47.93,6767126,6159657.2,62.67371853934738,61.85664259283492,NaN,NaN,73.52511179910553,110.78815777023775,0.21054190679455287,0.5611740206845042,0.3506321138899513,403937492,402034453.2,90.07493908656477,82.09546498024238,NaN,NaN,23.645928831899603,9.9974072652087
2021-11-02T09:30:00-04:00,48.1701,48.548,47.92,48.38,6617383,6216500.35,66.13033029180531,63.14249794913813,NaN,NaN,97.53790998878259,101.1955382040339,0.19813245159565407,0.5982976783845189,0.4001652267888648,410554875,403032710.2,90.28402239769494,83.77684354679788,NaN,NaN,25.13519632305559,12.159948559186827
2021-11-03T09:30:00-04:00,48.44,48.76,48.16,48.66,4814517,6007403.4,68.10926130912885,64.10599964084466,NaN,NaN,102.46432523848016,97.75076879626086,0.1941887308582122,0.64290114036163,0.44871240950341784,415369392,406425539.8,90.9795565266885,85.29323847310029,NaN,NaN,26.98633261534023,14.2780034243516
2021-11-04T09:30:00-04:00,48.58,48.7,47.91,48.11,4620608,5874938.9,60.61714496132136,64.52075501011021,NaN,NaN,78.90743097504298,89.52587968718419,0.14234664846380018,0.6266457200831681,0.4842990716193679,410748784,407556181.8,91.20549545630222,86.53586210870505,NaN,NaN,26.17933115322041,15.978193099904287
2021-11-05T09:30:00-04:00,48.58,48.85,48.1383,48.22,5731432,5888289.25,61.528632316261245,64.94333345939108,NaN,NaN,83.53587868833428,87.19413133794912,0.10499566986640074,0.6155436589523688,0.5105479890859681,416480216,411418151.8,91.94743087529001,87.5945753570348,NaN,NaN,25.808570964108057,17.38253279479054
2021-11-08T09:30:00-05:00,48.36,48.42,47.77,48.21,5791935,5970288.7,61.389531471260185,65.20451353416199,NaN,NaN,61.5141999554504,84.7919489692181,0.07078800837909649,0.5990329995598387,0.5282449911807422,410688281,412768309.6,92.19532700993193,88.48793529233805,NaN,NaN,25.470815002865148,18.53800168165834
2021-11-09T09:30:00-05:00,48.31,48.48,48.2,48.39,4410417,5907646.75,63.010548533832164,65.13415407063579,NaN,NaN,75.2272785970246,80.3298226908665,0.052307755236188025,0.5936296852259773,0.5413219299897892,415098698,413677074.2,92.36568285750948,89.25681571998791,NaN,NaN,25.640952769376895,19.552708979903848
2021-11-10T09:30:00-05:00,48.24,48.56,48.145,48.15,5063097,5696839.35,59.42796135979317,64.72402726303326,NaN,NaN,67.35784067611714,73.30852577839389,0.017731263601566294,0.5634860094917471,0.5457547458901808,410035601,412610316,89.88545807579504,89.72210084986763,NaN,NaN,24.766828136849508,20.2975831451818
2021-11-11T09:30:00-05:00,48.21,48.21,47.81,48.17,4191945,5686809.5,59.63393109041117,64.14516756926137,NaN,NaN,40.00757915182183,65.52855541374966,-0.008569302201097528,0.5350431181388089,0.5436124203399064,414227546,413306068.4,90.07269232176047,90.08854682097763,NaN,NaN,24.101385444407818,20.84098347364266
2021-11-12T09:30:00-05:00,48.33,48.35,48.01,48.19,3902847,5621443.6,59.85341860645946,63.50902272575855,NaN,NaN,50.015752799845316,58.824530236051864,-0.028284427731507855,0.5082568856755216,0.5365413134070295,418130393,413636103.8,90.1656902865255,90.35978608949263,NaN,NaN,23.60140277977251,21.235329088804065
2021-11-15T09:30:00-05:00,48.21,48.46,48.01,48.46,3591660,5588463.5,62.7945748098837,62.96947513862545,NaN,NaN,66.44436503014806,59.81056325099139,-0.026819545535876177,0.5030168814871843,0.5298364270230604,421722053,415842858.2,90.78715152952695,90.56595420135508,NaN,NaN,23.930738266197,21.620387542717342
2021-11-16T09:30:00-05:00,48.49,48.58,48.065,48.16,4936716,5659812.65,57.7335340240784,62.471161980930745,NaN,NaN,55.46383862881255,55.85787525734899,-0.048471177574547,0.46924745505487664,0.5177186326294236,416785337,416180186,90.88200480725669,90.72143418948382,NaN,NaN,22.83096340396566,21.7933269514671
2021-11-17T09:30:00-05:00,48.06,48.54,47.46,48.48,15340252,6147007.05,61.31509730468245,61.85758778805414,NaN,NaN,23.26323656587243,47.03895443530004,-0.0437993513795325,0.462969443405008,0.5067687947845405,432125589,420598183.6,92.03819196702155,90.90239812195061,NaN,NaN,22.85507185069707,21.94500479421424
2021-11-18T09:30:00-05:00,48.53,48.58,48.25,48.47,5484721,6144803.9,61.140739222884065,61.811315988653476,NaN,NaN,100.33114666414983,59.103667937765636,-0.043833397861083534,0.4519770474581861,0.49581044531926965,426640868,423080848,92.60561634176877,91.1063756814026,NaN,NaN,22.82778387416416,22.071116091349943
2021-11-19T09:30:00-05:00,48.52,48.59,48.09,48.21,5099657,6130876.85,56.63162039584968,61.379737549832214,NaN,NaN,49.3020523595075,58.96092784969808,-0.06266972016968397,0.4174732951071647,0.48014301527684866,421541211,423763011.6,92.75833425092786,91.29804676457138,NaN,NaN,21.556567362850288,21.997609130135707
2021-11-22T09:30:00-05:00,48.22,48.42,47.85,47.97,5416945,6155068.4,52.76335738927139,60.424953771079785,NaN,NaN,-46.89644637927561,36.29276556781334,-0.0908843233197022,0.36653761112722094,0.45742193444692314,416124266,422643454.2,89.49160752943314,91.24144570255268,NaN,NaN,19.352091785361598,21.619678080882263
2021-11-23T09:30:00-05:00,48.12,48.615,47.895,48.48,9784674,6166990.8,59.14898356773364,59.7849339324087,NaN,NaN,56.49927492707879,36.49985282746659,-0.0754276034739772,0.36313743010445165,0.43856503357842885,425908940,424468174.8,90.10336875336642,91.17886086160111,NaN,NaN,19.213088220949192,21.275879529463253
2021-11-24T09:30:00-05:00,48.47,49.195,48.34,49.13,5086781,6063412.55,65.54245420111931,60.13674173525141,NaN,NaN,262.90247519081873,84.42770055245585,-0.024302423523750838,0.4081870041737403,0.43248942769749116,430995721,424242201.2,89.40918600689788,91.05055304378652,NaN,NaN,21.179268242600436,21.26207791705428
2021-11-26T09:30:00-05:00,48.47,48.59,47.73,47.8,6829206,6070356.35,48.73512058952994,59.22291946905632,NaN,NaN,-81.57102595676332,48.04726602827322,-0.07980459442616239,0.33273368466478814,0.41253827909095053,424166515,423747330.6,87.81362532371185,90.75528121867379,NaN,NaN,16.57960770651755,20.59315360126332
2021-11-29T09:30:00-05:00,48.17,48.76,47.8086,48.4,7173448,6032768.35,54.41434015764448,58.72469151808377,NaN,NaN,25.285789825797274,43.24401352153118,-0.07587922563464933,0.3176892470476389,0.39356847268228823,431339963,425707081,88.67549980193705,90.5038649895313,NaN,NaN,15.07301971514569,19.80456304610366
2021-11-30T09:30:00-05:00,48.18,48.3,47.37,47.39,11022299,6245527,45.31402965437342,57.46065445526529,NaN,NaN,-251.8904553076547,2.245211735855358,-0.1374850952265988,0.2217121036490397,0.3591971988756385,420317664,426545760.6,89.03296895220471,90.26581399629525,NaN,NaN,10.083266011068973,18.41580632681299
2021-12-01T09:30:00-05:00,47.9,48.43,46.74,46.77,12299797,6529647.7,40.802866662562806,56.13029054832026,NaN,NaN,-290.9696211725605,-67.2485674840725,-0.21173294877207016,0.09453101291055077,0.30626396168262093,408017867,422967546,77.75563629648101,89.39939815491566,NaN,NaN,4.387364025870101,16.411743140964006
2021-12-02T09:30:00-05:00,47.09,48.34,46.98,48.05,10097164,6793780.05,51.530973599582715,55.55150787040395,NaN,NaN,-119.73933304208417,-143.77692913065306,-0.16827621429908668,0.09591869380876261,0.2641949081078493,418115031,420391408,70.80234241436627,88.0229445901018,NaN,NaN,4.053797727305154,14.64632236758417
2021-12-03T09:30:00-05:00,48.11,48.34,47.4,47.81,11826463,7154072.8,49.711825389001824,54.82710835487126,NaN,NaN,-88.9584973008772,-145.25442339947585,-0.14994191167454227,0.07676751851467145,0.22670943018921372,406288568,416815818.6,62.45430670769213,86.04356004875658,NaN,NaN,3.1105976066093097,12.998361687444905
2021-12-06T09:30:00-05:00,48.16,48.9001,48.14,48.5,8711173,7303059.85,54.66677131371871,54.24655096228804,NaN,NaN,97.91316425180108,-130.7289485142751,-0.08862280177253587,0.11593092797354387,0.20455372974607974,414999741,413547774.2,55.95991192968384,83.55590007733919,NaN,NaN,4.2445770482337855,11.74782102470046
2021-12-07T09:30:00-05:00,48.88,49.435,48.76,49.36,7763624,7401644.3,59.96194342103355,54.40572306207055,NaN,NaN,230.8073362713584,-34.18939019847248,0.007474895651592928,0.21389734931057092,0.206422453658978,422763365,414036914.4,56.68591018609283,81.11332189011321,NaN,NaN,7.197827987940142,11.097822019448987
2021-12-08T09:30:00-05:00,49.36,49.7,49.19,49.57,6931610,7527703.95,61.1551147232443,54.39429573482497,NaN,NaN,244.31927531778038,72.8683890995957,0.07883501958780442,0.30496622814373353,0.2261312085559291,429694975,418372336,62.57480895114075,79.00879453183602,NaN,NaN,9.854756943914673,10.920241294372657
2021-12-09T09:30:00-05:00,49.46,49.47,48.895,48.94,3572475,7453172.85,55.78421465634348,54.01168683721493,NaN,NaN,140.19719161775367,124.85569403156326,0.07716277753131454,0.32258468047007227,0.24542190293875774,426122500,419973829.8,64.49511988356788,77.00090192767881,NaN,NaN,10.146399969228517,10.80969253363778
2021-12-10T09:30:00-05:00,49.14,49.23,48.8817,49.19,3683699,7427760.55,57.383678365537925,54.06540526362123,NaN,NaN,118.12883766544383,166.27316102482746,0.08578659961562574,0.35265515245828993,0.2668685528426642,429806199,424677356,69.45263720601918,75.33620928161392,NaN,NaN,10.908028177714064,10.823740482791534
2021-12-13T09:30:00-05:00,49.05,50.075,48.98,49.85,5105678,7487902.1,61.35785265905128,54.67929778289122,NaN,NaN,164.87947582171964,179.66642333881117,0.12638143738349933,0.42484534957203834,0.298463912188539,434911877,428659783.2,72.90258845726464,74.15127934788758,NaN,NaN,12.881245758751517,11.117669807928674
2021-12-14T09:30:00-05:00,49.74,49.85,48.93,49.3,8920642,7754351.2,56.61936876429329,54.49861101121691,NaN,NaN,108.47763104281923,155.20048229310333,0.10737961784524741,0.4326884344950983,0.3253088166498509,425991235,429305357.2,73.42651525767911,72.96007552676706,NaN,NaN,12.945583636258995,11.378800354833006
2021-12-15T09:30:00-05:00,49.46,50.1,49.41,50.03,8196066,7917318.7,60.93193709192898,54.16928836056046,NaN,NaN,140.89821146329183,134.51626952220562,0.13346174468271715,0.4921359975032473,0.35867425282053017,434187301,430203822.4,74.17489967661542,71.87191221746117,NaN,NaN,14.447762691240213,11.817223545748321
2021-12-16T09:30:00-05:00,50.14,50.55,49.905,50.22,7161623,7508387.25,61.99104800064939,55.116140318497564,NaN,NaN,152.9199210259599,137.06081540384687,0.15166862272560971,0.5482600312275423,0.3965914085019326,441348924,433249107.2,76.58221700649622,71.06966876623149,NaN,NaN,15.974843953064674,12.411169318222086
2021-12-17T09:30:00-05:00,50.1701,50.645,49.98,50.05,8626678,7665485.1,60.41296543893237,55.54461355287526,NaN,NaN,131.36088822961005,139.70722551668013,0.14066497031557862,0.5724226213964059,0.43175765108082725,432722246,433832316.6,77.02393816258179,70.2374143634204,NaN,NaN,16.72743163280181,13.027778220304905
2021-12-20T09:30:00-05:00,49.05,49.5,48.77,49.3,9760367,7898520.6,53.894542209505786,56.15750730681329,NaN,NaN,34.60103209320755,113.65153677097769,0.07459470402648266,0.5250010311139306,0.45040632708744793,422961879,431442317,71.10478916268102,68.95683009274015,NaN,NaN,15.3419852508234,13.35837922466469
2021-12-21T09:30:00-05:00,49.64,49.89,49.375,49.58,6024148,7928880.75,55.81146007124481,57.22954969314771,NaN,NaN,67.23433633721723,105.40287782985729,0.04303544082315647,0.5042006281163935,0.4611651872932371,428986027,432041275.4,71.69191018700322,68.52370679920602,NaN,NaN,14.786796557803527,13.562438843684523
2021-12-22T09:30:00-05:00,49.73,50.1,49.675,50.07,4529994,7666146.75,59.022319342199125,57.76464581762031,NaN,NaN,89.39104760708616,95.10144505861618,0.04806501741798225,0.5212464590657149,0.4731814416477326,433516021,431907019.4,71.34199022984734,68.56225307174039,NaN,NaN,15.291681519129627,13.809473511605253
2021-12-23T09:30:00-05:00,50.17,50.19,49.63,49.92,5264620,7675038.7,57.64153138033195,58.33105338842961,NaN,NaN,78.52938946469799,80.2233387463638,0.034811256498033516,0.5166955122702745,0.48188425577224103,428251401,429287514.8,64.70589576858504,68.72308086180416,NaN,NaN,15.300144283040082,14.022426478953086
2021-12-27T09:30:00-05:00,50.06,50.94,49.96,50.94,5183417,7592749.25,63.83693431112976,58.98606503110183,NaN,NaN,130.5913403314658,80.06942916673495,0.08537996265067327,0.5886092090855826,0.5032292464349093,433434818,429430029.2,64.89720385046131,69.3614588561454,NaN,NaN,17.265200109009047,14.485679854675366
2021-12-28T09:30:00-05:00,50.94,51.18,50.77,51.16,5593156,7513734.65,65.02514226491657,59.34772209137919,NaN,NaN,149.8861617240909,103.1264550929116,0.12205173032080818,0.6557939093359195,0.5337421790151113,439027974,432643248.2,68.97984640675831,70.2395971576215,NaN,NaN,19.22590800140416,15.162855304208051
2021-12-29T09:30:00-05:00,51.26,51.62,51.02,51.47,4404673,7182853.35,66.68616487196252,59.74279710200192,NaN,NaN,162.95715590671855,122.27101900681187,0.15355618068171206,0.7256874048672515,0.5721312241855394,443432647,435532572.2,72.11988385119756,70.92138822191129,NaN,NaN,21.358257320644938,16.047912735127607
2021-12-30T09:30:00-05:00,51.52,51.87,51.44,51.7,3665874,6751157.2,67.90408868959204,60.6085023900911,NaN,NaN,172.09419597330503,138.81164868005564,0.17471494261180331,0.7905249024502936,0.6158099598384903,447098521,438249072.2,74.71172422009485,71.65114567452035,NaN,NaN,23.487127851192305,17.110657751708278
2021-12-31T09:30:00-05:00,51.72,52.17,51.66,51.81,3979136,6445255.8,68.49727771653289,61.40233091516217,NaN,NaN,168.3515458061739,156.77607994835085,0.180223719845648,0.8410896096455502,0.6608658897999022,451077657,442814323.4,78.35369960020178,72.2869358455334,NaN,NaN,25.413126323238572,18.29672469049832
2022-01-03T09:30:00-05:00,51.98,51.98,50.55,51.33,8441161,6275990.7,63.02359284531981,61.52131235703849,NaN,NaN,104.48853813843441,151.55551950974456,0.1375714226915863,0.832830168164385,0.6952587454727988,442636496,444654659,79.62743861922543,72.76728228567346,NaN,NaN,25.5543967750133,19.333534988286175
2022-01-04T09:30:00-05:00,51.47,51.69,51.08,51.13,7440765,6212470.3,60.841952951172594,61.82292551324416,NaN,NaN,93.92410534933322,140.36310823479303,0.08452399381144482,0.8009137377371047,0.7163897439256599,435195731,443888210.4,77.5799708440644,73.06395768470098,NaN,NaN,25.063950380464,20.15216575859729
2022-01-05T09:30:00-05:00,50.96,50.96,49.44,49.47,14980777,6573327.95,46.46495513512474,60.78956965918672,NaN,NaN,-25.04175120929457,102.76332681159037,-0.06562450482195437,0.6343591128982169,0.6999836177201713,420214954,439244671.8,66.43449367122729,72.51107154145897,NaN,NaN,19.746681061957712,20.094239373363067
2022-01-06T09:30:00-05:00,49.51,49.675,48.88,49.53,9807142,6717104.55,46.95288196653864,59.71541494246451,NaN,NaN,-76.99198759319604,52.946090098290185,-0.158847087122035,0.5014247588176275,0.6602718459396625,430022096,435829386.8,59.64712914416411,71.30142240843524,NaN,NaN,15.730183369026573,19.470802801314996
2022-01-07T09:30:00-05:00,49.37,49.599,49.04,49.27,6141083,6845534.95,45.03732150301308,58.617154661327426,NaN,NaN,-83.85818481366826,2.504143974321761,-0.23156233387411007,0.3708189285970249,0.602381262471135,423881013,430390058,50.7535423282552,69.42496556312621,NaN,NaN,11.838029889330544,18.3804066710315
2022-01-10T09:30:00-05:00,48.85,48.98,48.25,48.98,6870657,7004882.85,42.933359849314186,57.834213064170875,NaN,NaN,-130.5433441096443,-44.50223247529398,-0.28899887912221023,0.24113266356837215,0.5301315426905824,417010356,425264830,44.08366751406857,67.49488544536817,NaN,NaN,7.956043602776465,16.891211946995067
2022-01-11T09:30:00-05:00,48.88,48.985,48.175,48.9,7442409,7121719.4,42.34566631900083,56.87237065329631,NaN,NaN,-123.81225488362406,-88.04950452188544,-0.31978771534825173,0.1303968985052677,0.45018461385351943,409567947,420139273.2,38.61788493859059,65.13245507048156,NaN,NaN,4.612031370619541,15.137043293227135
2022-01-12T09:30:00-05:00,48.84,49.35,48.84,49.03,4686821,6910028.35,43.69445905131516,55.777523489661746,NaN,NaN,-89.04904282572507,-100.85096284517155,-0.31812971184869254,0.052522474042653755,0.3706521858913463,414254768,418947236,37.454789284040025,62.71194071720961,NaN,NaN,2.1825771322330825,13.286405270227984
2022-01-13T09:30:00-05:00,49.2,49.3,48.7756,48.86,5481168,6774283.45,42.30081381372338,54.68175794918971,NaN,NaN,-88.98748979339989,-103.2500632852123,-0.3146417902730049,-0.022650051949909766,0.2919917383230951,408773600,414697536.8,33.57269387094422,60.488140581663835,NaN,NaN,-0.2604092455120902,11.351146053693688
2022-01-14T09:30:00-05:00,48.58,48.64,47.73,48.29,5737398,6703072.2,37.93219221801657,52.83141922825305,NaN,NaN,-129.80351167953108,-112.43912865838487,-0.3349996873526583,-0.12675787086772772,0.20824181648493054,403036202,410528574.6,30.25930612546277,58.01400502987822,NaN,NaN,-3.7238466926467586,9.197575661359338
2022-01-18T09:30:00-05:00,47.99,48.12,47.48,47.96,8948473,6719161.95,35.63748877784916,50.73230112203395,NaN,NaN,-136.71708668501577,-113.67387717345919,-0.3531567156232783,-0.23320407804416732,0.11995263757911095,394087729,405944049.2,27.09272989324478,55.02206813605583,NaN,NaN,-7.370946710935102,6.830643893888704
2022-01-19T09:30:00-05:00,48.21,48.5,47.34,47.34,7152460,6588766.6,31.751151110039913,48.236942996182336,NaN,NaN,-130.7073511317478,-115.05289642308392,-0.3866846674532497,-0.36340319673745114,0.02328147071579853,386935269,401417513.6,24.379919219970546,51.612070662396754,NaN,NaN,-11.819588075773249,4.166325041079853
2022-01-20T09:30:00-05:00,47.43,48.0609,46.87,46.92,7586766,6666897.5,29.411291413256166,45.48745747644406,NaN,NaN,-136.20426312256154,-124.48394048245123,-0.4144443604097865,-0.49477397979643456,-0.0803296193866481,379348503,394436260.6,20.903460845959458,47.768623278529944,NaN,NaN,-16.353476341912483,1.2349248435095195
2022-01-21T09:30:00-05:00,47.15,47.465,46.775,46.89,10920606,6986428.1,29.245506070835916,42.68375950175142,NaN,NaN,-129.85302956854704,-132.65704843748068,-0.4112999200589609,-0.5944545194603492,-0.18315459940138834,368427897,386367120,17.752500769119294,43.43996621916691,NaN,NaN,-20.077505630448467,-1.8097080813416215
2022-01-24T09:30:00-05:00,46.47,47.085,45.3531,46.99,19972349,7721814.55,30.648802529903918,40.37127447922171,NaN,NaN,-139.18389459706825,-134.53312502098808,-0.37971647241123685,-0.6578001899154344,-0.2780837175041976,388400246,383439928.8,16.765216187422467,38.94980747403813,NaN,NaN,-22.799598643271914,-4.808263875903092
2022-01-25T09:30:00-05:00,46.43,47.2,45.99,46.86,10908906,8008089,29.8207794787119,38.15547637404595,NaN,NaN,-116.35866986250707,-130.46144165648633,-0.3457762744885069,-0.7103040606148312,-0.3645277861263243,377491340,380120651,15.699030515175949,34.529740307688954,NaN,NaN,-25.328792070314993,-7.739767903676221
2022-01-26T09:30:00-05:00,47.1,47.67,45.745,46.08,12858515,8371356.95,25.38871934038525,36.650030960135986,NaN,NaN,-113.72227770388618,-127.06442697091401,-0.35283149981843814,-0.805567160899372,-0.4527356610809338,364632825,375660162.2,14.375956976516761,30.81127340092392,NaN,NaN,-29.030982836211184,-10.7813700368955
2022-01-27T09:30:00-05:00,46.43,46.715,45.0699,45.25,8784263,8590336.45,21.693905436219723,34.84581835082749,NaN,NaN,-136.3467243978803,-127.0929192259778,-0.3875987244921325,-0.9372340666960994,-0.5496353422039669,355848562,370960174,13.121136488753137,27.48798821125171,NaN,NaN,-33.6125946888647,-14.042973558605386
2022-01-28T09:30:00-05:00,45.35,46.82,44.8,46.82,6455371,8729811.3,39.59981182267921,34.45742480223222,NaN,NaN,-104.16563532184162,-121.95544037663672,-0.2838669290576745,-0.9044690035260601,-0.6206020744683856,362303933,369735381.2,12.807406121283421,24.777549910753727,NaN,NaN,-31.438542093295908,-16.52805477784689
2022-01-31T09:30:00-05:00,46.57,47.41,46.42,47.34,4557241,8758716.55,44.15468088246789,34.54466201888606,NaN,NaN,-55.980775441481356,-105.31481654551935,-0.16512597997351686,-0.8270095494352816,-0.6618835694617647,366861174,365427566.8,11.743818042005017,22.46756066274919,NaN,NaN,-28.047284234863874,-18.173658985992173
2022-02-01T09:30:00-05:00,47.34,47.41,46.71,47.02,8057605,8739538.75,42.0530039983553,34.52375756741138,NaN,NaN,-50.41684262887473,-92.12645109879288,-0.09643266301537756,-0.7824243982309866,-0.6859917352156091,358803569,361690012.6,10.898185522725726,20.487582133044555,NaN,NaN,-26.08940219818299,-19.304479444876577
2022-02-02T09:30:00-05:00,47.28,47.9345,47.24,47.83,6716585,8703329.75,48.70814589167142,34.881878056008254,NaN,NaN,-6.906257060183799,-70.7632469700524,0.00962450018394656,-0.6739611099856759,-0.6835856101696225,365520154,361867478.4,11.22505519544437,18.61402969814486,NaN,NaN,-22.069756943644613,-19.699519087557725
2022-02-03T09:30:00-05:00,47.55,47.71,47.28,47.34,4484017,8178491.75,45.31745899782387,35.09735271201543,NaN,NaN,-14.9672238131397,-46.487346853104285,0.050556007457476126,-0.6203906008477773,-0.6709466083052534,361036137,362904993.4,13.229186382117845,17.16092202037155,NaN,NaN,-19.96710566427766,-19.73774574137486
2022-02-04T09:30:00-05:00,47,47.3,46.34,46.69,5447946,7960531.95,41.21844283991803,35.33208489929411,NaN,NaN,-57.70591207680509,-37.195402204096936,0.03819626446470137,-0.6232012777243767,-0.6613975421890781,355588191,361561845,12.825517807231975,15.915651426212206,NaN,NaN,-19.613791911039733,-19.720038051326984
2022-02-07T09:30:00-05:00,46.6899,47.01,46.56,46.7,5403407,7923648.15,41.30640100221163,35.73700720103428,NaN,NaN,-53.84511561810678,-36.76827023942202,0.03511511748591223,-0.6175036453316878,-0.6526187628176,360991598,360387929.8,12.46744873767976,14.870988486528992,NaN,NaN,-19.31340042138361,-19.661946961335072
2022-02-08T09:30:00-05:00,46.57,46.715,46.18,46.28,4875971,7823913.85,38.687948302717814,36.23249271479699,NaN,NaN,-78.84293042517567,-42.453487798682204,0.010489503650987553,-0.6395068832538655,-0.6499963869048531,356115627,359850341.4,12.298120845432493,14.008002888347704,NaN,NaN,-19.878613449194102,-19.692899316743507
2022-02-09T09:30:00-05:00,46.83,47.425,46.81,47.4,4927423,7698164.55,48.130564051758924,37.56958361754719,NaN,NaN,1.1039601438673101,-40.85144435787198,0.07190644532401524,-0.560113330249834,-0.6320197755738493,361043050,358954920.6,12.005639492985807,13.372444220278155,NaN,NaN,-17.201278565410128,-19.33695349512445
2022-02-10T09:30:00-05:00,46.63,47.215,45.785,46.05,8187069,7873176.95,40.11162129210761,38.345734704780874,NaN,NaN,-81.15255597706981,-54.088510790658006,0.02624009733524768,-0.5992196539047896,-0.6254597512400373,352855981,357318889.4,11.468939281979274,12.923618399768154,NaN,NaN,-17.69718036430045,-19.102700190721023
2022-02-11T09:30:00-05:00,46.22,46.33,45.14,45.42,9040107,8051123.9,37.012516638961856,38.80028571257073,NaN,NaN,-151.30209110756692,-72.80774659681036,-0.03826116518478617,-0.67328620772102,-0.6350250425362338,343815874,354964426,10.72581441920832,12.49223255918143,NaN,NaN,-19.19482752941181,-19.11586123910542
2022-02-14T09:30:00-05:00,45.46,45.69,44.73,44.93,6979352,8113221.6,34.76283323379934,39.15328955221984,NaN,NaN,-189.88438895519084,-100.01560126422717,-0.10216484660612724,-0.7627311007938928,-0.6605662541877656,336836522,350133410.8,9.38247137776925,12.04104976365238,NaN,NaN,-21.163942090381884,-19.408444217859202
2022-02-15T09:30:00-05:00,45.35,45.54,44.99,45.15,5395084,7935552.15,36.62534773455839,39.95590586608934,NaN,NaN,-154.26236607563172,-115.09948839431839,-0.11680064353416642,-0.8065670586054736,-0.6897664150713072,342231606,347356606.6,8.707418768615284,11.636154177373701,NaN,NaN,-22.10948103250628,-19.79430661995164
2022-02-16T09:30:00-05:00,45.22,45.38,44.79,45.27,5675233,7861690.8,37.670646510872615,41.09710165713597,NaN,NaN,-144.20307194057528,-144.1608948112069,-0.10590460636866827,-0.8221471730321426,-0.7162425666634743,347906839,344729364.4,8.112682544607893,11.278407467077614,NaN,NaN,-22.540612480144205,-20.186636028550577
2022-02-17T09:30:00-05:00,45.15,45.32,44.775,44.88,5008408,7732772.9,35.61465356110132,40.812447495594704,NaN,NaN,-137.8938960216411,-155.50916282012116,-0.11188252902703111,-0.8560957279472632,-0.7442131989202321,342898431,342737854.4,7.684230325158666,10.912466338782988,NaN,NaN,-23.520612850341692,-20.662918431663595
2022-02-18T09:30:00-05:00,44.74,45.19,44.541,44.68,6225991,7498042.15,34.57257526634022,40.12801138015701,NaN,NaN,-132.54865249522254,-151.75847509765228,-0.11574299117573583,-0.8888919378899018,-0.773148946714166,336672440,341309167.6,7.382992458213252,10.600978797083574,NaN,NaN,-24.63093129961961,-21.229777412800168
2022-02-22T09:30:00-05:00,44.6,44.87,44.29,44.56,6832377,6841043.55,33.93106291245209,39.54787273116392,NaN,NaN,-130.17608090548123,-139.81681348771036,-0.1127046834993789,-0.9140298010883896,-0.8013251175890107,329840063,339909875.8,7.089834798573577,10.328953745358422,NaN,NaN,-25.726983399769143,-21.872235410938593
2022-02-23T09:30:00-05:00,44.95,45.2,43.92,43.98,5917606,6591478.55,30.942514299655016,38.27889904601989,NaN,NaN,-126.17612632807669,-134.19956553819935,-0.1346008822416238,-0.9695762203910405,-0.8349753381494167,323922457,336248046,6.376304500916277,9.982614410034987,NaN,NaN,-27.560233562716736,-22.684806575478326
2022-02-24T09:30:00-05:00,43.16,44.875,43,44.74,11608864,6528996,38.57675578383029,37.79742024502035,NaN,NaN,-120.31272349228657,-129.4214958485416,-0.08515525947230684,-0.9414194124898003,-0.8562641530174935,335531321,333772942.4,5.941072270424584,9.462034830628326,NaN,NaN,-26.90317269286525,-23.2874303065336
2022-02-25T09:30:00-05:00,44.92,45.895,44.71,45.86,6193386,6399452.15,47.74474720023977,38.263584842186184,NaN,NaN,-29.811365291558076,-107.80498970252502,0.02958245868495213,-0.8192860796613033,-0.8488685383462554,341724707,333538197.6,5.899939605425374,8.967350673356426,NaN,NaN,-23.302012231592194,-23.28951343868483
2022-02-28T09:30:00-05:00,45.27,45.53,44.59,45.07,8591830,6506275.1,42.88271860046622,38.37617895634723,NaN,NaN,-53.972906756717066,-92.08984055482391,0.05727009423339058,-0.7772809205545173,-0.8345510147879078,333132877,332830285,5.770197472213312,8.488975582965965,NaN,NaN,-21.82158297938878,-23.07980908735682
2022-03-01T09:30:00-05:00,45.29,45.54,44.73,44.98,9027961,6729811.1,42.35356472466028,38.63800870077169,NaN,NaN,-47.93296011049369,-75.64121639582639,0.07348682737891943,-0.7426924805642585,-0.816179307943178,324104916,331683255.6,5.556966239671894,8.007464539697352,NaN,NaN,-20.82049401009291,-22.757049790604835
2022-03-02T09:30:00-05:00,45.14,45.985,45.122,45.78,5481470,6601004.35,48.44353238381976,38.66036358163318,NaN,NaN,-5.128768379279275,-51.4317448060669,0.13829394263152417,-0.6433118796537727,-0.7816058222852968,329586386,332816041.4,9.12842885203203,7.801949493914939,NaN,NaN,-17.991118079627707,-22.076202403322387
2022-03-03T09:30:00-05:00,46.04,46.455,45.67,46.28,5774901,6553920.15,51.86614594783102,39.49997248561342,NaN,NaN,44.35382109344703,-18.498435888920216,0.21069877295193762,-0.5182323560953748,-0.7289311290473124,335361287,332782034.6,9.117282205469579,7.63397398844996,NaN,NaN,-14.542353892811516,-20.99993833039226
2022-03-04T09:30:00-05:00,45.93,46.71,45.83,46.67,6193771,6639407.85,54.40851025391375,40.742543458109985,NaN,NaN,77.64525198479228,2.992887566349856,0.2765699548924727,-0.38321868543172144,-0.6597886403241942,341555058,332748104.8,9.10533560419087,7.518225501662998,NaN,NaN,-10.896818004384652,-19.556635426676888
2022-03-07T09:30:00-05:00,46.58,46.72,45.82,45.82,7882172,6761119.15,48.407322560082086,41.71714983855875,NaN,NaN,57.25725334076873,25.238919585847015,0.25512863439655553,-0.3408778473284997,-0.5960064817250552,333672886,332856106.6,9.511783963850874,7.5274621149545435,NaN,NaN,-9.619008551309246,-18.13697444448151
2022-03-08T09:30:00-05:00,45.83,46.31,45.37,45.41,10469377,7014417.65,45.78410267109566,42.37134661973999,NaN,NaN,22.9761014353398,39.4207318950137,0.2075838006629963,-0.3365267308963098,-0.5441105315593061,323203509,332675825.2,9.435933807200513,7.579498903424918,NaN,NaN,-9.389029563508183,-16.88726803291389
2022-03-09T09:30:00-05:00,46.19,46.61,46.05,46.17,6229331,7082085.65,51.07653442635651,43.32891004227455,NaN,NaN,86.35877526444082,57.71824062375773,0.22036371048466874,-0.2686558934534702,-0.4890196039381389,329432840,332645116,9.422150710119482,7.673032343818603,NaN,NaN,-7.498679049239593,-15.546041035246134
2022-03-10T09:30:00-05:00,45.72,46.4,45.47,46.33,5638540,7117641.5,52.13586117737352,44.50899630057971,NaN,NaN,77.01846129466914,64.25116866400215,0.23149120512983323,-0.19965559752584738,-0.4311468026556806,335071380,332587134.6,9.394249124761444,7.795176543790229,NaN,NaN,-5.658403416103748,-14.13352137536865
2022-03-11T09:30:00-05:00,46.56,46.88,45.855,45.87,4363463,6926461.2,48.8602599032467,45.52954520321589,NaN,NaN,95.2033964650286,67.76279756004942,0.2009051094490516,-0.1800154158443661,-0.3809205252934177,330707917,330417706.4,8.392803948056326,7.867305935921877,NaN,NaN,-5.093003861895665,-12.842018873443937
2022-03-14T09:30:00-04:00,46.22,46.24,45.41,45.59,4846257,6716768.7,46.92754755550538,46.45786553486255,NaN,NaN,39.285678813704166,64.1684826546365,0.15680639325903367,-0.18491253371962557,-0.34171892697865924,325861660,328855461.2,7.751942359233908,7.914599333111901,NaN,NaN,-5.194206800371509,-11.749474291576448
2022-03-15T09:30:00-04:00,46.12,46.31,45.54,45.95,4988497,6617225.95,49.6833755020962,47.79649847789407,NaN,NaN,55.995077097019426,70.77227778697242,0.1470358672435409,-0.15792409292423315,-0.30495996016777405,330850157,330384790.8,14.624626125463848,8.503765163436727,NaN,NaN,-4.480117938627305,-10.710994812583714
2022-03-16T09:30:00-04:00,46.31,46.6692,45.5,46.46,6868216,6690882.55,53.37686426166419,48.85364908345364,NaN,NaN,80.1982501321532,69.5401727605149,0.16853129798954225,-0.09429583768084626,-0.2628271356703885,337718373,332041897.4,21.45322388453971,9.61177599301638,NaN,NaN,-2.7773709397928505,-9.57761997361359
2022-03-17T09:30:00-04:00,46.32,47.14,46.27,47.12,4499766,6632109.2,57.70384186190827,49.56501298785853,NaN,NaN,135.4479636572503,81.22607323303114,0.21768533136634866,0.009279528537547321,-0.20840580282880133,342218139,333471249.2,26.885429673409433,11.110739569300955,NaN,NaN,0.02518510928237928,-8.205790676057024
2022-03-18T09:30:00-04:00,47.29,47.44,46.93,47.23,4727855,6618081.55,58.39685703234806,50.673165732992935,NaN,NaN,155.7381282406171,93.33301958814884,0.2460026413800518,0.0990974988962634,-0.1469051424837884,346945994,336718864.6,37.46735705051526,13.374822396322523,NaN,NaN,2.510927407603145,-6.6748309498198575
2022-03-21T09:30:00-04:00,46.95,47.22,46.49,46.72,3979349,6505749.45,53.98071880943096,51.50367673904799,NaN,NaN,105.41321422598473,106.55852667060496,0.21964781533324054,0.12765462668276228,-0.09199318865047826,342966645,340139861.6,46.28633776746601,16.28406321973639,NaN,NaN,3.3849099221024908,-5.237725110973808
2022-03-22T09:30:00-04:00,46.89,47.07,46.68,46.75,2853305,6306795.85,54.200127193244136,51.9148620825783,NaN,NaN,101.19707919733247,115.59892709066756,0.19436803376985481,0.15096685356184025,-0.043401180208014555,345819950,343133820.2,52.588288738126984,19.388338925886025,NaN,NaN,4.159029565589192,-3.8953315857505224
2022-03-23T09:30:00-04:00,46.62,46.8,46.1636,46.22,3976846,6209757.85,49.69254242206613,51.75960468788081,NaN,NaN,47.57590192209201,109.07445744865531,0.1349063813805568,0.12523179651768146,-0.009674584862875348,341843104,343958766.4,54.183352622592636,22.60734395568053,NaN,NaN,3.5567315077204222,-2.8307511438261015
2022-03-24T09:30:00-04:00,46.29,46.58,46.09,46.58,3758919,5817260.6,52.57749953390791,51.62881820788039,NaN,NaN,44.60298529263023,90.90546177573131,0.11362751451021923,0.13235980827489868,0.01873229376467946,345602023,344635543.2,55.50586498062237,25.921667482568495,NaN,NaN,3.85398461054286,-1.8757888932019642
2022-03-25T09:30:00-04:00,46.76,47.16,46.6,47.13,4003197,5707751.15,56.666142727024834,52.218733934090594,NaN,NaN,117.10597865412485,83.17903185843286,0.12926272727800006,0.18031070286217954,0.05104797558417948,349605220,345167388.4,56.56688093783034,29.28274583785274,NaN,NaN,5.304813790714971,-0.8499885097852593
2022-03-28T09:30:00-04:00,47.16,47.76,47.16,47.73,3705602,5463439.75,60.6517410535621,53.280708104266765,NaN,NaN,182.0481576285956,98.50602053895503,0.17011161361739638,0.26368749260592494,0.09357587898852857,353310822,347236223.8,60.51158335081845,32.931006519539736,NaN,NaN,7.775879042829182,0.38227828344537507
2022-03-29T09:30:00-04:00,48.09,49.2,48.09,49.13,5108347,5267459.05,68.03851207898094,54.49227793659708,NaN,NaN,282.06702446865626,134.6800095932198,0.27528898823660697,0.4376871142842873,0.1623981260476803,358419169,349756067.6,64.71511480167888,36.880503954651125,NaN,NaN,12.62534649470875,2.1312880279115713
2022-03-30T09:30:00-04:00,48.94,48.99,48.5899,48.86,3881448,5187457.95,65.48526345143244,55.44580667045843,NaN,NaN,221.36656398768253,169.4381420063379,0.30806970341986073,0.5474852553225062,0.2394155519026455,354537721,352294991,68.36872295572684,41.09296637114865,NaN,NaN,15.68319416815092,4.067274619374335
2022-03-31T09:30:00-04:00,49.1,49.22,48.29,48.32,5624177,5179921.75,60.58814473007609,56.283512729517675,NaN,NaN,166.30039667097952,193.77762428200776,0.2758222533665844,0.584193368610876,0.3083711152442916,348913544,352957295.2,69.26283043190958,45.440825405709596,NaN,NaN,16.674224505517362,5.868267460251911
2022-04-01T09:30:00-04:00,48.55,49.31,48.3,49.28,6746742,5207570.3,65.5241358634612,57.611840465800235,NaN,NaN,161.04509105493446,202.56544676216967,0.2996047147841125,0.6828770087244322,0.38327229394031975,355660286,354168308.4,70.88347788146204,49.95022080015446,NaN,NaN,19.189276222159776,7.771268711953034
2022-04-04T09:30:00-04:00,49.26,49.43,48.695,49.13,5056055,5066264.45,64.17176384109315,58.64672534715716,NaN,NaN,140.87071448194422,194.3299581328394,0.28573845671920933,0.7404453648393314,0.4547069081201221,350604231,353626990.2,69.12889957219684,53.84338318920682,NaN,NaN,20.74774508061954,9.625051050333964
2022-04-05T09:30:00-04:00,48.94,49.81,48.94,49.17,5239171,4804754.15,64.38287304855173,59.43286883193485,NaN,NaN,132.06680942533004,164.32991512417416,0.2604757032038385,0.7803015371249202,0.5198258339210817,355843402,353111836.8,67.41858499916003,57.12662326882256,NaN,NaN,22.051372134171498,11.400239776596468
2022-04-06T09:30:00-04:00,48.96,49.96,48.75,49.9,6810864,4833830.8,68.07944934223043,60.17398365195785,NaN,NaN,124.58949566848543,144.97450146033475,0.2728346736286772,0.8608691759569282,0.588034502328251,362654266,354735145.8,69.94219867095373,60.20210676864715,NaN,NaN,24.334516460847052,13.247993588632266
2022-04-07T09:30:00-04:00,49.62,49.71,49.14,49.49,6015857,4852696.65,64.05819827549622,60.57836516932558,NaN,NaN,104.37709022996144,132.58984017213112,0.23475235195132127,0.8814749422674026,0.6467225903160814,356638409,356280118.8,72.15293401593034,62.67964798046251,NaN,NaN,25.02606100872645,14.93057464864572
2022-04-08T09:30:00-04:00,49.49,49.83,49.25,49.67,5033809,4886213.95,65.03466222619005,61.367932556236944,NaN,NaN,98.60010796055009,120.10084355325425,0.20416811738170926,0.901932737043218,0.6977646196615087,361672218,357482505.2,73.76985248877946,64.64275617484205,NaN,NaN,25.877478079616523,16.494417995927265
2022-04-11T09:30:00-04:00,49.56,49.79,48.85,48.99,5041363,4895969.25,58.561860188363625,61.679484913031196,NaN,NaN,70.73356457607369,106.07341357208013,0.12453828334166439,0.8534374738385893,0.7288991904969249,356630855,358687830,75.3170657719146,66.26624024868401,NaN,NaN,24.660180976804,17.66095556462394
2022-04-12T09:30:00-04:00,48.89,49.26,48.63,48.84,6728962,4982992.5,57.20922545974351,62.21639084429386,NaN,NaN,48.63575071129788,89.38720182927369,0.05188145909127706,0.7937510143610211,0.7418695552697441,349901893,357499528.2,70.87822437723531,67.45873108830135,NaN,NaN,23.26589066130956,18.46166057843617
2022-04-13T09:30:00-04:00,48.91,49.105,48.62,49.04,8414958,5060329.6,58.58285385750126,62.645344724550526,NaN,NaN,44.44871370348873,73.35904543627434,0.009621907070681113,0.7538969391080954,0.7442750320374143,358316851,356632045.2,67.73961090920756,68.3325700832003,NaN,NaN,22.48429984053478,19.036323330164542
2022-04-14T09:30:00-04:00,49.15,49.38,48.7341,48.76,5098862,5090284.4,55.878422462360746,62.58907899136024,NaN,NaN,42.61799477579961,61.007226345441985,-0.042024316966785435,0.6917446358289325,0.733768952795718,353217989,355947961.2,65.28451572048519,68.95525828196136,NaN,NaN,21.054275200726924,19.324602168816313
2022-04-18T09:30:00-04:00,48.67,48.97,48.38,48.64,5247902,5116286.75,54.71268337743049,62.16486058592228,NaN,NaN,19.516016457016942,45.19040804473535,-0.08653993663915327,0.6255940319967763,0.7121339686359296,347970087,353207535,56.457029947869906,68.66564732460789,NaN,NaN,19.536439333777412,19.354864620953613
2022-04-19T09:30:00-04:00,48.91,49.79,48.9,49.66,5908850,5212761.8,61.97436642114868,61.73170732464854,NaN,NaN,73.3032662150026,45.70434837252115,-0.051303270523468725,0.6480048804815937,0.6993081510050624,353878937,352657151.4,54.8528320192096,67.9611985544315,NaN,NaN,20.249517353260973,19.482672154140378
2022-04-20T09:30:00-04:00,49.8,50.74,49.71,50.6,6241949,5382194,67.19489521043045,61.853823878862684,NaN,NaN,145.31146710924216,65.03949165211,0.027084936427718698,0.7331643215397108,0.7060793851119921,360120886,354700950,59.4594943660307,67.32482508373893,NaN,NaN,22.573894292552932,19.924275316770743
2022-04-21T09:30:00-04:00,50.8,50.97,50.24,50.27,6083062,5487504.8,63.879245925131805,62.08890253565239,NaN,NaN,163.47543228899244,88.84483536921076,0.04730028875430814,0.7652047460548772,0.7179044573005691,354037824,353845144.6,56.8439521047909,66.4377623460876,NaN,NaN,23.444619250766934,20.427181593055913
2022-04-22T09:30:00-04:00,50.2,50.2,49.33,49.37,8511106,5725114.15,55.793352441347466,61.39384657692998,NaN,NaN,69.57263915137703,94.23576424432625,-0.00648957467757838,0.709792488953596,0.7162820636311744,345526718,352306890.4,52.38355742760047,65.11633945652605,NaN,NaN,21.551304976401912,20.587770647819628
2022-04-25T09:30:00-04:00,49.31,49.45,48.34,49.14,8143985,5932153.55,53.91512215715382,60.66122931379146,NaN,NaN,-27.424084436021687,84.84774406571852,-0.061072094291726664,0.6399419457665161,0.7010140400582427,337382733,350189419.6,46.925119057690814,63.53035513406133,NaN,NaN,19.433509509138126,20.422876199436555
2022-04-26T09:30:00-04:00,49.05,49.38,48.36,48.37,8830291,6188388,48.07965898672995,59.49671402366133,NaN,NaN,-85.61538122326276,53.06401457806544,-0.14761247237814457,0.516498449585562,0.6641109219637066,328552442,345124120.6,36.99438098855817,61.357197704732634,NaN,NaN,15.682489025802933,19.74567803177461
2022-04-27T09:30:00-04:00,48.47,48.86,48.03,48.08,13001269,6583034.1,46.05775976463212,57.92373619669002,NaN,NaN,-137.42131191811293,-3.482541227405574,-0.2186779100919256,0.3907635343487996,0.6094414444407252,315551173,336210178,26.404283446025275,58.247346617237746,NaN,NaN,11.991280631287973,18.637906974562235
2022-04-28T09:30:00-04:00,48.43,49.105,47.78,48.96,9532546,6865589,52.575146364269045,57.10351820303094,NaN,NaN,-88.12374315414678,-53.80237631603342,-0.2011535094467709,0.35799955763226166,0.5591530670790326,325083719,330419357,21.99859205531392,54.66489362005086,NaN,NaN,10.855689244155773,17.52616158450417
2022-04-29T09:30:00-04:00,48.62,48.67,46.49,46.6,11520511,7160405.7,38.974975386099416,55.24211200016732,NaN,NaN,-251.91795037277578,-118.10049422086396,-0.33533213366015546,0.1399879000038382,0.47532003366399367,313563208,324026655,18.357146207691514,50.70684317140172,NaN,NaN,4.416790085192177,15.6533942274596
2022-05-02T09:30:00-04:00,46.73,46.89,44.4579,45.39,17231318,7684634.5,34.103888969837755,53.495114055986896,NaN,NaN,-338.9137746406596,-180.39843226179156,-0.48340680652431967,-0.12893847449140594,0.3544683320329137,296331890,315816486.4,14.937320528559738,46.3940042254478,NaN,NaN,-2.7478199930005136,13.024649338822442
2022-05-03T09:30:00-04:00,45.62,46.26,45.22,45.94,13431521,8103407.8,37.90292268056496,52.11609242890271,NaN,NaN,-232.0939375290487,-209.69414352294876,-0.5190080642239635,-0.29429174824704063,0.22471631597692285,309763411,312058680.2,13.681044576672775,42.30849138255048,NaN,NaN,-6.817632379105144,10.190037664832786
2022-05-04T09:30:00-04:00,45.93,46.55,45.155,46.48,14707110,8576804.75,41.47073643910498,50.89379832758869,NaN,NaN,-169.05970047486596,-216.02182123429935,-0.4817021397889981,-0.37741135875932486,0.10429078102967329,324470521,313842549.8,17.239400478212005,38.701333494622226,NaN,NaN,-8.729680247495653,7.487220820214438
2022-05-05T09:30:00-04:00,46.22,46.58,44.96,45.29,13591584,8915840.75,36.494547273690166,49.50923581411222,NaN,NaN,-157.43814121906942,-229.88470084728388,-0.5099617060325425,-0.533161351511005,-0.023199645478462372,310878937,311001593.4,16.10103149449445,35.18822747848003,NaN,NaN,-12.13664569686857,4.683811317774008
2022-05-06T09:30:00-04:00,44.9,45.08,44.33,44.83,16154870,9422791.4,34.7583089943149,48.0839233581754,NaN,NaN,-162.95509861783552,-212.09213049629585,-0.5300858379899532,-0.6858069429659039,-0.15572110497595068,294724067,307233765.2,14.713367893017505,32.20653733170486,NaN,NaN,-15.403033850519025,1.8142620080178613
2022-05-09T09:30:00-04:00,44.42,44.42,42.6,42.74,18004997,10071350.8,28.194954245064267,45.6711082027408,NaN,NaN,-183.21160819533213,-180.95169720723032,-0.6468705162682814,-0.9643092503113024,-0.31743873404302103,276719070,303311201.2,13.416942074546839,29.246830907086093,NaN,NaN,-20.8426394304689,-1.4224381974802474
2022-05-10T09:30:00-04:00,43.26,43.57,41.52,41.79,27771157,11207840.5,25.809310228161493,42.71499498972158,NaN,NaN,-177.7895848858447,-170.09082667858954,-0.7438916210345398,-1.2473032603361958,-0.503411639301656,248947913,291148101.6,10.366696153113224,25.74020246330627,NaN,NaN,-26.043548238838643,-4.939739631960018
2022-05-11T09:30:00-04:00,41.91,42.6695,41.66,41.73,25360854,12139435.1,25.6616271404028,39.985165076526656,NaN,NaN,-155.73119371983364,-167.4251253275831,-0.7649460938999971,-1.4595942566766524,-0.6946481627766553,223587059,270971409.2,7.372469419910388,22.20652512867195,NaN,NaN,-29.997433159468706,-8.519410135889832
2022-05-12T09:30:00-04:00,41.71,42.04,41.37,42.04,20802705,12758822.45,27.95540264957559,37.9967400914001,NaN,NaN,-137.63050201003645,-163.46359748577646,-0.7119264408565669,-1.584556213847364,-0.872629772990797,244389764,257673574.6,6.11821728792863,18.901857975838244,NaN,NaN,-32.39180553598738,-11.929752335903768
2022-05-13T09:30:00-04:00,42.51,43.12,42.1202,43.09,8949178,12951338.25,35.24379190399971,36.663073644746234,NaN,NaN,-98.87123050397189,-150.64682386300376,-0.5664102429793967,-1.580642576715043,-1.0142323337356463,253338942,249396549.6,5.491928332780731,15.942344352630384,NaN,NaN,-32.05072118071976,-14.804176456591767
2022-05-16T09:30:00-04:00,42.96,43.14,42.695,42.74,7445551,13061220.7,34.00874301385599,35.65800821811238,NaN,NaN,-87.42479440899733,-131.48946110573678,-0.4586009681311016,-1.5874835438995234,-1.1288825757684218,245893391,243231413.8,5.075197293276332,13.66240266011025,NaN,NaN,-32.159084696811036,-17.283449062337375
2022-05-17T09:30:00-04:00,43.25,43.3,42.59,43.2,7254797,13128518.05,37.12719340431245,35.02011062094668,NaN,NaN,-76.13237829168952,-111.15801978690578,-0.32733965040262136,-1.5380571387716984,-1.210717488369077,253148188,244071468.8,6.120522466852449,12.213562590169335,NaN,NaN,-31.289867122945626,-19.284365928138556
2022-05-18T09:30:00-04:00,43.13,43.18,41.8,41.94,9546476,13293744.4,32.584982205519324,33.59224175246457,NaN,NaN,-87.21696022924975,-97.455173088789,-0.2972802902018945,-1.582317851121445,-1.2850375609195506,243601712,248074399.4,11.141909593939204,11.438085271499716,NaN,NaN,-31.955632622475775,-21.094546884472443
2022-05-19T09:30:00-04:00,41.65,42.35,41.59,41.86,8204636,13399823.1,32.31466173004594,33.11650506274646,NaN,NaN,-88.2724846498974,-87.5835696167612,-0.25624571248446637,-1.6053447015251336,-1.3490989890406673,235397076,246275861.8,10.860821871832101,10.902633533224048,NaN,NaN,-32.56421800243355,-22.73307132989546
2022-05-20T09:30:00-04:00,42.31,42.43,41.69,42.35,9859497,13467242.65,35.826296452554104,33.23953416865477,NaN,NaN,-75.1511989301349,-82.83956330199379,-0.17352307723524119,-1.5660028355847189,-1.3924797583494777,245256573,244659388,10.60194012828758,10.59296350463318,NaN,NaN,-32.0302840722187,-24.061244578798778
2022-05-23T09:30:00-04:00,42.68,43,42.11,42.9,8100172,13465052,39.61339525510382,33.36171078112183,NaN,NaN,-54.15403266123443,-76.18541095244122,-0.06478307836722164,-1.4734586063085047,-1.408675527941283,253356745,246152058.8,12.671950608234482,10.520885364030448,NaN,NaN,-30.45501052578904,-24.9746397140831
2022-05-24T09:30:00-04:00,42.63,43.47,42.14,43.4,9706202,13508847.55,42.91168464411239,33.46463565290808,NaN,NaN,-38.37633297975508,-68.63420189005433,0.05152054010097151,-1.3442748528150688,-1.3957953929160403,263062947,248135010.6,15.472075859893408,10.394647891293406,NaN,NaN,-28.149745776456925,-25.428226294422217
2022-05-25T09:30:00-04:00,43.21,43.79,43.06,43.64,7668017,13242184.95,44.47926310687835,34.0349724981358,NaN,NaN,-14.747927395003105,-54.140395323205006,0.14975804261514836,-1.2085978396471049,-1.3583558822622532,270730964,253560861,22.769243572080555,10.870948753978128,NaN,NaN,-25.78701795365762,-25.47948224574156
2022-05-26T09:30:00-04:00,43.91,44.1164,43.5,43.59,7131215,13122118.4,44.20692038849796,34.709873312006025,NaN,NaN,5.703301124222397,-35.345238168381044,0.21267383005742402,-1.0925135946904732,-1.3051874247478972,263599749,259201395.6,29.57559610496088,11.932536483402654,NaN,NaN,-23.911053088563776,-25.255420937573305
2022-05-27T09:30:00-04:00,43.83,44.84,43.83,44.82,4540766,12773131.15,51.99398273534903,36.409803918454934,NaN,NaN,57.9192808208438,-8.731142218185282,0.33135438425525043,-0.8909944444288342,-1.2223488286840847,268140515,263778184,34.611212998023774,13.44641297793672,NaN,NaN,-19.84471112700447,-24.48246239320633
2022-05-31T09:30:00-04:00,44.35,44.55,43.97,44.22,15462009,12684665.7,48.44218775625497,38.02643802760446,NaN,NaN,50.93550908224521,12.28676613051065,0.3612242346968866,-0.7708185353129764,-1.132042770009863,252678506,263642536.2,34.53240090154924,15.172534745682148,NaN,NaN,-17.384238382533475,-23.468430391681636
2022-06-01T09:30:00-04:00,44.39,44.42,43.26,43.74,9317769,12478978.1,45.74967665455833,39.461298707187,NaN,NaN,33.82145098698914,26.72632292385949,0.34069824621474454,-0.7061699622414324,-1.046868208456177,243360737,259702094.2,32.23606729231766,16.94850602228267,NaN,NaN,-16.076709822833905,-22.412470310417675
2022-06-02T09:30:00-04:00,43.53,44.42,42.905,44.4,8401566,12163700.9,49.875153827306235,41.026995219882046,NaN,NaN,55.388931668472196,40.75369473655455,0.36163674499149057,-0.5948222772168137,-0.9564590222083043,251762303,255908362,30.156846774831763,18.665550985632894,NaN,NaN,-13.72057483898444,-21.170770957355785
2022-06-03T09:30:00-04:00,44,44.31,43.74,43.84,6905108,11829377.1,46.63467221984001,41.84062952815635,NaN,NaN,74.23364037287574,54.45976258628523,0.32878495722540957,-0.5454778256765422,-0.8742627829019518,244857195,252159851.2,28.220012427589083,20.28898556383349,NaN,NaN,-12.659416459675931,-19.95486317197295
2022-06-06T09:30:00-04:00,44.15,44.22,43.59,43.71,7605591,11401913.15,45.889294001526885,42.68924031298999,NaN,NaN,72.09995210890767,57.29589684389801,0.29063283296274045,-0.5109717416985262,-0.8016045746612667,237251604,245982069,25.332385117707744,21.73592755129287,NaN,NaN,-11.99937263529504,-18.818364523876106
2022-06-07T09:30:00-04:00,43.5,44.25,43.2,44.22,4812831,10742304.85,49.31210952695722,43.55959146460747,NaN,NaN,70.31806202439164,61.17240743232728,0.29133945169383346,-0.4374302600439748,-0.7287697117378082,242064435,243859254.8,24.40814915584302,23.042186600506486,NaN,NaN,-10.454556377778996,-17.623534788719375
2022-06-08T09:30:00-04:00,43.97,44.04,43.06,43.16,5418827,9624688.35,43.196136390132914,44.31753104922273,NaN,NaN,23.536401330002814,59.11539750093002,0.215507181856893,-0.45938573441669206,-0.674892916273585,236645608,242516229,23.81613097238214,23.947488127538122,NaN,NaN,-10.891499363215765,-16.66181544221886
2022-06-09T09:30:00-04:00,43.01,43.34,42.16,42.17,5533862,8633338.75,38.40524289390288,44.7525725609268,NaN,NaN,-62.205152419383076,35.596580683358965,0.09965312436909257,-0.5503265108122193,-0.6499796351813119,231111746,238386117.6,22.045295490076697,24.74637910026988,NaN,NaN,-12.791993839162789,-16.10898378463942
2022-06-10T09:30:00-04:00,41.61,41.73,41.15,41.17,8566787,8021542.85,34.270559191277684,44.64144847083562,NaN,NaN,-171.56410002934052,-13.562967397084293,-0.03607785940050001,-0.6950769594319368,-0.6589991000314368,222544959,233923670.4,20.289870455519093,25.43837412364356,NaN,NaN,-15.797446687818214,-16.064478485093534
2022-06-13T09:30:00-04:00,40.1,40.26,39.02,39.19,13192798,8233723.85,27.87214868592686,43.8027880016087,NaN,NaN,-268.1420064041116,-81.61135909968814,-0.23961115483138562,-0.9585130435706688,-0.7189018887392832,209352161,228343781.8,18.324944650625866,25.8421594123858,NaN,NaN,-20.903035467051343,-16.75570091108751
2022-06-14T09:30:00-04:00,39.32,39.4,38.63,38.91,9800838,8351488.2,27.101559835531774,42.67349337242437,NaN,NaN,-230.91963355031604,-141.85889821462968,-0.36593592321295787,-1.1763217927554805,-0.8103858695425227,199551323,219841159.4,15.812085814820904,25.866445837737764,NaN,NaN,-25.120258388110965,-17.950637693519433
2022-06-15T09:30:00-04:00,39.3,40.36,39.17,39.8,9429226,8460209.65,33.404110606028866,41.88241105093511,NaN,NaN,-151.36894406274703,-176.83996729317965,-0.36174502086051263,-1.2625671456181635,-0.9008221247576509,208980549,214308147.6,14.425782715552927,25.27048434798579,NaN,NaN,-26.522014369610986,-19.175120075818224
2022-06-16T09:30:00-04:00,38.93,39.31,38.66,38.85,8397977,8402784.7,30.3843889975482,40.89508738015299,NaN,NaN,-160.08784365323655,-196.41650553995035,-0.39256912997561977,-1.3915335372271755,-0.9989644072515558,200582572,208202312.8,13.064552142252651,24.0911240649352,NaN,NaN,-28.71290543437298,-20.537660841326048
2022-06-17T09:30:00-04:00,39.03,39.64,38.7441,39.08,14302162,8707661,31.98743166904238,39.466048018273945,NaN,NaN,-128.39269357221193,-187.7822242485246,-0.3675245314302289,-1.458370071539342,-1.090845540109113,214884734,206670267.8,12.73971682700315,22.528874338433727,NaN,NaN,-29.931760277447662,-21.879675046486277
2022-06-21T09:30:00-04:00,39.18,39.82,39.14,39.49,6031800,8516276.15,34.86670057028361,38.49637036213313,NaN,NaN,-99.35696731583089,-154.02521643086848,-0.29645054628307554,-1.4614087229629575,-1.164958176679882,220916534,208983142.4,16.130034733296668,21.214419612129973,NaN,NaN,-30.040155232563443,-23.045457930211587
2022-06-22T09:30:00-04:00,39.12,40.685,39.08,40.13,5776484,8400091.75,39.194031064831506,38.028109962866935,NaN,NaN,-72.28470962625671,-122.29823164605662,-0.18489831565812542,-1.3960810712525387,-1.2111827555944132,226693018,214411481.4,23.629794037490257,20.59968580821373,NaN,NaN,-28.800183956045405,-23.867561648187845
2022-06-23T09:30:00-04:00,40.32,41.055,40.28,40.92,7414732,8285518.25,44.12848641947924,37.617633719450716,NaN,NaN,-40.829710427435515,-100.1903849189943,-0.04382878698718384,-1.2659687393283932,-1.2221399523412093,234107750,219436921.6,29.88106078307436,20.579986808802488,NaN,NaN,-26.20233873905165,-24.20110123259696
2022-06-24T09:30:00-04:00,41.21,41.83,41.1,41.81,6781803,8241207.55,49.1363042502574,37.79632172162338,NaN,NaN,-9.958848951427413,-70.16458597863249,0.11482817550758595,-1.0786047329567268,-1.1934329084643127,240889553,227498317.8,38.56787349434124,21.31911974214193,NaN,NaN,-22.38056788415756,-23.94102503996276
2022-06-27T09:30:00-04:00,41.73,42.17,41.47,41.66,4742985,8121796.05,48.34973294157845,37.972067360198494,NaN,NaN,-0.06045587204729469,-44.498138438599554,0.2095594536460308,-0.9314835914067743,-1.141043045052805,236146568,231750684.6,42.60701501116177,22.553021877388648,NaN,NaN,-19.539690887187522,-23.312263018137727
2022-06-28T09:30:00-04:00,41.87,42.18,41.02,41.09,3487356,8069125.55,45.377104216774185,37.690995552328275,NaN,NaN,-7.31304681193928,-26.08935433782124,0.23197633395241812,-0.8510726276122824,-1.0830489615647005,232659212,234099220.2,44.76696425926875,24.00722295620477,NaN,NaN,-18.001020837063574,-22.553514135127134
2022-06-29T09:30:00-04:00,40.75,40.92,40.27,40.83,4473069,7519678.55,44.04682033491547,37.75175869124132,NaN,NaN,-32.18367920044496,-18.06914825265888,0.22714757554696874,-0.7991144921309896,-1.0262620676779584,228186143,234397845.2,45.05014582359078,25.523938302719674,NaN,NaN,-17.107247098469795,-21.77547598703323
2022-06-30T09:30:00-04:00,40.65,41.36,40.33,40.86,4305196,7269049.9,44.2499090173901,38.169234842918975,NaN,NaN,-19.724721634620693,-13.848150494095915,0.22348431736265584,-0.7469066709746386,-0.9703909883372944,232491339,234074563,44.78246676971302,27.14802196555084,NaN,NaN,-16.319257369459,-20.996016184522624
2022-07-01T09:30:00-04:00,40.78,41.71,40.72,41.59,4894170,7093680.1,49.092003354427966,39.22790942600113,NaN,NaN,8.861893627562566,-10.084001978297922,0.2649066048915938,-0.6392577322228021,-0.9041643371143959,237385509,233373754.2,44.169769761024455,28.853729058801225,NaN,NaN,-14.248900311895376,-20.032142488433017
2022-07-05T09:30:00-04:00,41.18,41.42,40.415,41.42,4563358,6976592.6,48.045475230119116,40.66886132201488,NaN,NaN,3.7942948259583096,-9.3130518386968,0.27437654108853826,-0.5611936607537231,-0.8355702018422614,232822151,232708870.8,43.56084356750259,30.656293267149557,NaN,NaN,-12.801508334332407,-18.99919475213293
2022-07-06T09:30:00-04:00,41.59,41.9599,41.28,41.39,5866365,6889631.3,47.85161275866058,42.15100795938122,NaN,NaN,39.09121723792981,-0.03219902872299372,0.2716320460833932,-0.49603014423801994,-0.7676621903214131,226955786,231568185.6,42.47886799623463,32.56106342296483,NaN,NaN,-11.646763459334984,-17.948847424590365
2022-07-07T09:30:00-04:00,41.59,41.84,41.28,41.42,3019354,6799957.45,48.07723595036789,43.19908834111972,NaN,NaN,49.577806834120516,16.3200981781901,0.26458560864738545,-0.4369301795121814,-0.7015157881595668,229975140,231925985,42.95747429004496,34.5990413925714,NaN,NaN,-10.61595266278369,-16.901291030046554
2022-07-08T09:30:00-04:00,41.26,41.505,41.02,41.23,3067652,6682398.7,46.699172940674835,44.36443005134306,NaN,NaN,43.12298187655217,28.889638880424673,0.24056925277011365,-0.4008042221969248,-0.6413734749670384,226907488,230809214.8,41.78873119424443,36.65076846771366,NaN,NaN,-10.063249676867981,-15.924427979592473
2022-07-11T09:30:00-04:00,41.11,41.35,40.83,41.23,3716817,6591546.45,46.699172940674835,45.415268713602515,NaN,NaN,42.18965578585828,35.555191312083814,0.21875250797217993,-0.3679328400018136,-0.5866853479739935,226907488,228713610.6,39.610895520637506,38.570138374401836,NaN,NaN,-9.592407473797461,-15.019853621621756
2022-07-12T09:30:00-04:00,41,41.425,40.68,40.97,3978332,6362123.7,44.66724695849464,46.115307741331875,NaN,NaN,35.11921578528103,41.82017550394836,0.1823669327906513,-0.35872668198567936,-0.5410936147763307,222929156,226735011.6,37.61751925642917,40.10495869748273,NaN,NaN,-9.667760808630742,-14.255268934051612
2022-07-13T09:30:00-04:00,40.49,41.09,40.24,40.75,5314603,5968213.95,42.96377441359235,46.38457512338622,NaN,NaN,4.075334335683099,34.816998923499014,0.1408943443689974,-0.364975684315084,-0.5058700286840814,217614553,224866765,35.786251173677,40.97327706435321,NaN,NaN,-10.152112496225579,-13.669103728647894
2022-07-14T09:30:00-04:00,40.04,40.53,39.99,40.35,4305807,5693462.4,39.978434866178986,46.088142869579066,NaN,NaN,-41.891210761588226,16.523195404357267,0.0865990700175322,-0.3976211911621661,-0.4842202611796983,213308746,221533486.2,32.72522825334933,41.176431883658566,NaN,NaN,-11.349802549387624,-13.33777498875357
2022-07-15T09:30:00-04:00,40.85,41.245,40.63,41,3126677,5378334.95,46.48570937969448,45.898814664538854,NaN,NaN,20.014109536441076,11.901420936335048,0.09392420275294555,-0.3668150077385164,-0.46073921049146194,216435423,219439073.2,30.934737124301037,40.631207857227125,NaN,NaN,-10.732888821715227,-12.965648393462377
2022-07-18T09:30:00-04:00,41.29,41.3,40.45,40.6,4191173,5167994.75,43.369627758893216,45.54309286577562,NaN,NaN,-10.450583945873111,1.3733729899887723,0.07226519803701958,-0.3704077129451875,-0.44267291098220707,212244250,216506425.6,28.57703520530822,39.6290664425233,NaN,NaN,-11.039298982953651,-12.690455620532559
2022-07-19T09:30:00-04:00,40.99,41.79,40.91,41.72,3414861,4623629.7,52.891664194857675,46.07984714992444,NaN,NaN,75.33496541585032,9.41652291610263,0.13041304029843281,-0.279656610609166,-0.41006965090759884,215659111,215052416.6,27.459584615217096,38.39282503937675,NaN,NaN,-8.432068348523899,-12.082114581674178
2022-07-20T09:30:00-04:00,41.61,42.1,41.38,41.51,3630301,4503554.75,51.154850643271274,46.587563600521285,NaN,NaN,100.51086070920415,28.703628190806842,0.1503593315774231,-0.22212048643581994,-0.37247981801324304,212028810,213935268,26.59897806947086,37.07488448551104,NaN,NaN,-6.791195577834512,-11.326269009697082
2022-07-21T09:30:00-04:00,41.58,41.95,41.23,41.94,5243625,4476911.8,54.45292401313498,47.316350385931635,NaN,NaN,100.8157329649531,57.24501693611511,0.1858166187512011,-0.14020904457424166,-0.32602566332544275,217272435,214728005.8,28.315847012272727,35.89869735997959,NaN,NaN,-4.400100980702561,-10.336816434126437
2022-07-22T09:30:00-04:00,42.17,42.51,41.94,42.26,3791559,4295753.15,56.79110557418383,47.866286258771346,NaN,NaN,175.1748379524537,88.27716261931764,0.2216937113889491,-0.04890852408925639,-0.2706022354782055,221063994,215653720,30.364176402557675,34.912583548660535,NaN,NaN,-1.6876096835659387,-9.101215469760652
2022-07-25T09:30:00-04:00,42.26,42.5499,42.065,42.29,3131312,4113228.6,57.013898679904706,48.50688793375603,NaN,NaN,164.56334802523943,123.27994901354013,0.23694078615897451,0.025573747220512644,-0.21136703893846187,224195306,218043931.2,35.489825706698454,34.33608227288881,NaN,NaN,0.5924869948904615,-7.71640083195335
2022-07-26T09:30:00-04:00,42.33,42.645,42.21,42.37,3006408,4026399.75,57.641128062631196,49.206139026896786,NaN,NaN,163.8749633593671,140.9879486022435,0.2411089357563636,0.09001913075699264,-0.15108980499937097,227201714,220352451.8,40.077457607470876,34.16455295940569,NaN,NaN,2.6694491840950416,-6.232707972517866
2022-07-27T09:30:00-04:00,42.43,42.69,42.1,42.6,5155975,4109830.7,59.47207290140556,50.0200559519709,NaN,NaN,146.34298667705625,150.1543737958139,0.24713764193729587,0.15783224742224888,-0.08930539451504699,232357689,224418227.6,47.199329276539345,34.46754260129814,NaN,NaN,4.958608649047372,-4.633948455151403
2022-07-28T09:30:00-04:00,43.05,44.23,42.88,44.17,5374749,4154914.7,69.2446319446774,51.63044588082823,NaN,NaN,253.06755525976573,180.60473825477644,0.33896886703874085,0.3344056892833791,-0.004563177755361761,237732438,228510228.2,53.224867974075075,35.284409514143185,NaN,NaN,10.525771719303632,-2.4682741445149694
2022-07-29T09:30:00-04:00,44.18,44.54,43.99,44.34,3523319,4115820.85,70.08576700570639,53.30091688547334,NaN,NaN,237.0914945306688,192.98806957041947,0.3896481962057551,0.4824970675018321,0.09284887129607701,241255757,232548580.8,58.28437731034749,36.61822964197961,NaN,NaN,15.27178373748184,0.06601983862743177
2022-08-01T09:30:00-04:00,44.14,44.24,43.77,43.94,4102894,4076257.05,65.54352415934832,54.79207954267718,NaN,NaN,166.18514178604332,193.31242832258025,0.37461346463426826,0.5611157020889124,0.1865022374546441,237152863,235140092.2,61.185840947391405,38.30168119133406,NaN,NaN,17.87740279672177,2.610503118355194
2022-08-02T09:30:00-04:00,43.98,44.07,43.33,43.36,3477370,4021957.65,59.51993109657189,55.974662162890006,NaN,NaN,115.80080057723929,183.69759576615468,0.3068375790079097,0.5700492112145312,0.2632116322066215,233675493,236434848,62.58598320482399,40.21594776498741,NaN,NaN,18.231002035509245,4.842002963662916
2022-08-03T09:30:00-04:00,43.63,43.96,43.53,43.54,3208271,3889052.95,60.72623724868613,57.456648047354804,NaN,NaN,106.01358561688303,175.63171555412003,0.2573595632967836,0.584911086327601,0.3275515230308174,236883764,237340063,63.57528035901773,42.41952291539231,NaN,NaN,18.879656603050066,6.847382055003937
2022-08-04T09:30:00-04:00,43.63,43.755,43.31,43.58,3236416,3899906.05,61.00433965600045,58.49369306709094,NaN,NaN,86.90089872699252,142.3983842475654,0.2124229698642886,0.5930802353611782,0.38065726549688955,240120180,237817611.4,64.11437287039155,44.789496897255916,NaN,NaN,19.484435693041362,8.652675431866426
2022-08-05T09:30:00-04:00,43.26,43.76,43.1,43.72,3320200,3912533.45,62.018091703924924,59.82572620602178,NaN,NaN,77.3051321620965,110.44111177385096,0.1785861138806894,0.6038899078477513,0.4253037939670619,243440380,238254536,64.63016405238761,47.36472038633302,NaN,NaN,20.269748432757947,10.312257289136642
2022-08-08T09:30:00-04:00,44.13,44.51,43.81,44.04,4055155,3929450.35,64.30243160596405,60.6407810211008,NaN,NaN,101.5218176873977,97.50844695412182,0.1645602878052148,0.6310041537235804,0.4664438659183656,247495535,240323070.4,67.04514501473186,50.19226041486979,NaN,NaN,21.584832405899157,11.922625162959859
2022-08-09T09:30:00-04:00,44.2,44.39,43.94,44.39,2368392,3848953.35,66.66399824346249,61.748577278257315,NaN,NaN,96.22959600429188,93.59420603953234,0.1652263521836792,0.6729768061479646,0.5077504539642854,249863927,243560757.2,70.44646065438532,53.32422345664939,NaN,NaN,23.394121159653196,13.561410305344621
2022-08-10T09:30:00-04:00,44.89,45.07,44.62,44.99,3617192,3764082.8,70.29226344727853,62.87995866641044,NaN,NaN,119.84187397618868,96.35986371139346,0.19064392435005784,0.7460553594018577,0.5554114350517999,253481119,246880228.2,73.46979929166875,56.54950576232054,NaN,NaN,26.09750209326334,15.352280560761582
2022-08-11T09:30:00-04:00,45.22,45.31,44.635,44.78,2815458,3689565.35,67.52222996902972,63.646467551756565,NaN,NaN,111.59281993763727,101.2982479535224,0.17811600718878995,0.7780564440377873,0.5999404368489973,250665661,248989324.4,75.20538795874606,59.75244944490542,NaN,NaN,27.55649971643308,17.095740440143224
2022-08-12T09:30:00-04:00,45.06,45.569,44.99,45.54,2392584,3652860.7,71.84629335706134,64.70592431441061,NaN,NaN,129.1851218872475,111.67424589855261,0.203958498055828,0.8548885594187823,0.6509300613629543,253058245,250912897.4,76.70236478625355,62.69620223630221,NaN,NaN,30.22241186839718,18.970979215608075
2022-08-15T09:30:00-04:00,45.5,45.865,45.39,45.74,3296554,3608129.75,72.86995731673098,65.7936978325606,NaN,NaN,142.33553684497508,119.83698973006808,0.21629335683121143,0.9212967574019686,0.7050034005707572,256354799,252684750.2,78.01883808728233,65.40630084200303,NaN,NaN,32.72316475986211,20.93557715050151
2022-08-16T09:30:00-04:00,45.52,45.815,45.4299,45.56,3279002,3601336.8,70.38936125814965,66.57350414375661,NaN,NaN,128.8247729540514,126.35602512002,0.19477159125589438,0.9484678896406251,0.7536962983847307,253075797,253327124.2,78.49331885094377,67.64158581160335,NaN,NaN,34.07184105620674,22.81218627988797
2022-08-17T09:30:00-04:00,45.14,45.7008,45.11,45.43,3331280,3586385.75,68.57375774837998,66.52558455830679,NaN,NaN,105.79782859687184,123.54721604415663,0.15590431530002968,0.9485766925097678,0.7926723772097382,249744517,252579803.8,76.42643935149053,69.29884090999016,NaN,NaN,34.67740659459875,24.507217753418082
2022-08-18T09:30:00-04:00,45.51,45.58,44.86,45.12,1654879,3406948.45,64.31365378566392,66.11329075687519,NaN,NaN,82.6562207996389,117.75989621655694,0.09636017934879715,0.9131226013957345,0.8167624220469374,248089638,252064599.2,74.96097496205522,70.49002645654072,NaN,NaN,33.98158870554217,25.86069931800724
2022-08-19T09:30:00-04:00,45.02,45.08,44.535,44.68,3202381,3377489.55,58.73610874505463,65.62704679871135,NaN,NaN,45.59197454166252,101.04126674743995,0.01846166949170347,0.8398395089115667,0.8213778394198632,244887257,250430401.6,70.35286383684904,71.14481380578769,NaN,NaN,31.71962356781383,26.697688496551038
2022-08-22T09:30:00-04:00,44.34,44.37,43.71,43.75,3430408,3392444.35,49.05289531224587,64.87940138554521,NaN,NaN,-28.110126590787765,66.95213406028738,-0.09817017088821256,0.6986651258095975,0.7968352966978101,241456849,247450811.6,62.775556361034724,71.15835474551703,NaN,NaN,26.42434951566755,26.65864007071054
2022-08-23T09:30:00-04:00,43.64,43.71,42.93,43.09,2799992,3382123.55,43.56396851245931,63.65352504724329,NaN,NaN,-96.96603829891855,21.79397180969339,-0.21551075974482714,0.5274468470167761,0.7429576067616033,238656857,244567023.6,56.43964741383656,70.64866667800409,NaN,NaN,19.97093238927228,25.703253259076504
2022-08-24T09:30:00-04:00,43.17,43.665,43.09,43.43,3277090,3288179.3,46.86266406278342,62.6434053620135,NaN,NaN,-92.08876099071404,-17.78334610782379,-0.2628355344194375,0.41441318873730637,0.6772487231567439,241933947,243004909.6,53.30137358079538,69.87630958589008,NaN,NaN,15.741168038988917,24.28009822763542
2022-08-25T09:30:00-04:00,43.63,44.11,43.45,44.1,1713949,3105139.3,52.72652742636408,61.97972219933059,NaN,NaN,-45.899233706483166,-43.4944370090482,-0.24213602589863403,0.3745786907834514,0.6167147166820854,243647896,242116561.2,51.5460498810208,68.94173000222102,NaN,NaN,14.027927551310876,22.815502416731913
2022-08-26T09:30:00-04:00,44.13,44.13,42.96,42.98,2725623,3065254.5,43.9878668645369,60.52868186065722,NaN,NaN,-87.82242311146247,-70.1773165396732,-0.2935670582127978,0.2497558939160882,0.543322952128886,240922273,241323564.4,49.964251964822815,67.7216662129418,NaN,NaN,9.327534200016558,20.888649814344006
2022-08-29T09:30:00-04:00,42.74,43.04,42.5,42.61,2492980,2984758.8,41.53860088671899,58.734010620889826,NaN,NaN,-131.49538950996677,-90.854369123509,-0.33897966985044,0.11959836481583608,0.45857803466627606,238429293,240718053.2,48.73447230280403,66.17080990211456,NaN,NaN,4.74931789937053,18.583030969347796
2022-08-30T09:30:00-04:00,42.69,42.76,41.87,42,3539375,2987859.05,37.80157788916047,56.41324736673853,NaN,NaN,-156.75978465104558,-102.8131183939344,-0.3927830839415107,-0.032400820260612306,0.3603822636808984,234889918,239964665.4,47.17853028098492,64.29286211563715,NaN,NaN,-0.34090748876092475,15.879611189617979
2022-08-31T09:30:00-04:00,42.23,42.46,41.75,41.85,4646682,3059779.6,36.921938817012425,54.227512284451585,NaN,NaN,-151.46266421791873,-114.68789903937534,-0.4187738691246703,-0.16308507272493955,0.25568879639973074,230243236,237626523.2,42.62963653535904,61.966022728252355,NaN,NaN,-4.615000554982658,12.951809511817888
2022-09-01T09:30:00-04:00,41.53,42.01,41.24,42,5343201,3165118.85,38.4640239853486,51.84306447218639,NaN,NaN,-149.85815238439133,-135.47968277495698,-0.40586998791920303,-0.251648688499273,0.15422129941992999,235586437,236014231.4,39.78126043837838,59.32880098911841,NaN,NaN,-7.563052250755682,10.021114974307379
2022-09-02T09:30:00-04:00,42.35,42.445,41.185,41.28,3911273,3194672.5,34.14855256238177,49.07724984687574,NaN,NaN,-137.78277305025128,-145.47175276271474,-0.4238604338315324,-0.37560424286948546,0.04825619096204689,231675164,234164809.6,36.748085676202386,56.3808901026127,NaN,NaN,-11.538833752685553,6.941122299022674
2022-09-06T09:30:00-04:00,41.39,41.92,41.26,41.71,6399459,3311887.7,38.58055564660266,46.805192303193806,NaN,NaN,-118.45586032689323,-142.86384692610005,-0.3859153794990252,-0.4341380334117346,-0.048222653912709426,238074623,234093875.6,36.632716132095304,53.39084705126639,NaN,NaN,-13.449308478226948,4.028203616558443
2022-09-07T09:30:00-04:00,41.72,42.58,41.695,42.51,4618464,3424391.3,45.87865134189398,45.18411327415909,NaN,NaN,-75.07983546220453,-126.52785708833183,-0.2904080648880497,-0.4112327350227716,-0.12082467013472187,242693087,235654509.4,41.01996925886098,50.861813473221424,NaN,NaN,-12.706523823483145,1.6375282679810734
2022-09-08T09:30:00-04:00,42.26,42.75,42.14,42.63,4505162,3468789.8,46.89792570044824,43.94013269664369,NaN,NaN,-56.52650298461448,-107.54062484167098,-0.20656260462369708,-0.3790279259143432,-0.17246532129064612,247198249,239045512,49.24305587060133,49.02481925240328,NaN,NaN,-11.797445090035474,-0.28175364030700467
2022-09-09T09:30:00-04:00,42.79,43.195,42.52,43.04,2909098,3473471.8,50.339231146584915,43.34035572532442,NaN,NaN,-30.751784533262345,-83.71935127144516,-0.11544396584488817,-0.3167702785967563,-0.20132631275186816,250107347,241949694,55.026268766557436,47.93006246166817,NaN,NaN,-9.961023401442182,-1.6645064633263158
2022-09-12T09:30:00-04:00,43.2,43.475,43.11,43.4,2802365,3493960.85,53.20670017346622,43.637056072554444,NaN,NaN,-2.6603635540890447,-56.69486937221272,-0.027470992330102223,-0.23566505316449593,-0.2081940608343937,252909712,246196603.6,61.868416197729815,47.86526673571782,NaN,NaN,-7.5392457846771554,-2.503754937805007
2022-09-13T09:30:00-04:00,42.56,42.717,41.6,41.75,4139495,3536107.9,41.40585356744434,43.482905005053375,NaN,NaN,-76.115069681155,-48.22671124306508,-0.07429224182640762,-0.3010593631174032,-0.2267671212909956,248770217,248335722.4,64.77529820762138,48.46067036384529,NaN,NaN,-9.302571049299704,-3.4750143823042494
2022-09-14T09:30:00-04:00,41.6,41.69,40.95,41.24,4143922,3579353.9,38.55913192364456,42.889795566543455,NaN,NaN,-114.92395060310174,-56.195534271244526,-0.13022398784193145,-0.3895471060934099,-0.25932311825147847,244626295,248722364,65.29035029176144,49.31702584320001,NaN,NaN,-11.70465349378577,-4.650677112515895
2022-09-15T09:30:00-04:00,41.19,41.2823,40.29,40.34,6227226,3724151.2,34.103228467181,41.559559926601814,NaN,NaN,-148.71814229297652,-74.63386213291695,-0.21352606410608932,-0.5262306983840901,-0.31270463427800077,238399069,246962528,60.92379397103168,49.98686470677222,NaN,NaN,-15.310892957929505,-6.173565090432125
2022-09-16T09:30:00-04:00,40.03,40.38,39.865,40.35,6045585,3943686.5,34.194222878701595,40.86001392761357,NaN,NaN,-165.7699992934853,-101.63750508496153,-0.2510557574647053,-0.6265243311088824,-0.3754685736441771,244444654,245829989.4,58.22502772235548,50.57692011802454,NaN,NaN,-18.032580091760046,-7.867710090621828
2022-09-19T09:30:00-04:00,39.62,39.91,39.27,39.91,4129628,3990048.85,32.09424324619383,40.18541695329035,NaN,NaN,-183.1451078527465,-137.73445394469303,-0.28607458129912977,-0.7330618002680893,-0.44698721896895954,240315026,243311052.2,52.639792028676915,50.85587152701547,NaN,NaN,-20.950426232625276,-9.736669539479463
2022-09-20T09:30:00-04:00,39.54,39.56,38.67,38.86,6259205,4131488.7,27.719356677509694,39.46525829531529,NaN,NaN,-196.67844203319905,-161.84712841510185,-0.35596064923920845,-0.89193803051797,-0.5359773812787616,234055821,240368173,46.9708734929691,50.841038899300045,NaN,NaN,-25.015374199562768,-11.919341633777078
2022-09-21T09:30:00-04:00,39.17,39.415,38.27,38.29,9215785,4452278.35,25.673413739080246,38.66179221832014,NaN,NaN,-183.0431390776252,-175.47096611000651,-0.41259350217574764,-1.051719258998446,-0.6391257568226985,224840036,236410921.2,40.63391765320133,50.698487550574505,NaN,NaN,-29.046375432626153,-14.366060747898375
2022-09-22T09:30:00-04:00,38.16,38.18,37.775,37.93,6380343,4607441,24.446162732014628,37.66051641451056,NaN,NaN,-181.76699750759087,-182.0807371529294,-0.443608615520971,-1.1936365262239121,-0.7500279107029412,218459693,232423046,35.4443454216005,50.38870790651894,NaN,NaN,-32.7047486802329,-16.98587330966045
2022-09-23T09:30:00-04:00,37.54,37.75,37.015,37.46,7329990,4888243.05,22.90662305100939,36.85752144941254,NaN,NaN,-172.0666817858132,-183.34007365139496,-0.46295003174920923,-1.3287154503894527,-0.8657654186402435,211129703,225760055.8,28.82116363442364,49.82249918924903,NaN,NaN,-36.22780437663305,-19.73472060494225
2022-09-26T09:30:00-04:00,37.24,37.27,36.055,36.45,10027161,5253319.95,19.992806823283928,35.529825104889774,NaN,NaN,-171.9534734995336,-181.1017467807524,-0.5073670734767862,-1.4999742604862263,-0.9926071870094401,201102542,217917559,23.301902373044612,48.8702982064597,NaN,NaN,-40.30296642474072,-22.673041436342032
2022-09-27T09:30:00-04:00,36.79,37.055,35.902,35.97,10794505,5668396.2,18.770760935385496,33.59354721871059,NaN,NaN,-153.8664096869691,-172.53934031150638,-0.5301928627350891,-1.6553482654283016,-1.1251554026932125,190308037,209168002.2,18.943347194753997,47.29339663045205,NaN,NaN,-44.03758506210998,-25.725119097166026
2022-09-28T09:30:00-04:00,36.24,36.8,35.92,36.65,7304238,5856639.35,25.69955301907966,32.079377741469976,NaN,NaN,-127.65699499786233,-161.4621114955538,-0.463052200837317,-1.7039706537398587,-1.2409184529025417,197612275,203722450,16.833002866776127,44.978392844464544,NaN,NaN,-44.9269246987681,-28.46823418310918
2022-09-29T09:30:00-04:00,36.33,36.33,35.42,35.63,7684179,6008514.2,22.587233802439016,30.097092216888136,NaN,NaN,-129.07133567917245,-150.92297912987013,-0.4504765735945677,-1.8040141698957513,-1.3535375963011835,189928096,198016130.6,14.953133589435879,42.11602604609872,NaN,NaN,-46.735982211731574,-31.077912472912377
2022-09-30T09:30:00-04:00,35.79,36.27,35.72,36.01,7700886,6126398.45,26.174259471427746,28.166203595313956,NaN,NaN,-107.91944672015428,-138.09353211673834,-0.3823890315555134,-1.8315238857455753,-1.449134854190062,197628982,195315986.4,14.147984698576579,38.7074237961592,NaN,NaN,-47.01970307143801,-33.35531112984461
2022-10-03T09:30:00-04:00,36.58,36.9,35.99,36.68,11619980,6511833.8,32.1443864634862,27.504670230745518,NaN,NaN,-82.68912549784801,-120.24066251640122,-0.2636982937702681,-1.7787577214028971,-1.515059427632629,209248962,196945270.4,17.05035638124255,35.29849937998928,NaN,NaN,-45.307756124232135,-35.062803271899966
2022-10-04T09:30:00-04:00,37.09,37.6,36.98,37.26,8889923,6636357,36.90138948527861,27.386260056576525,NaN,NaN,-55.05365373424153,-100.47811132585572,-0.12465498583137546,-1.6708781599218483,-1.5462231740904728,218138885,202511440,26.226256565855806,32.508206970996014,NaN,NaN,-42.34247073138127,-36.10275576611158
2022-10-05T09:30:00-04:00,36.77,36.83,35.98,36.57,7074165,6759142.05,33.86020343813381,27.3689011259303,NaN,NaN,-72.70707552863767,-89.48812743201078,-0.06090828029592665,-1.622358524460381,-1.5614502441644544,211064720,205201929,30.24306408355895,30.31672626474796,NaN,NaN,-40.80514815029354,-36.774526106709004
2022-10-06T09:30:00-04:00,36.45,36.58,35.32,35.37,8933021,6980535,29.332606434985436,27.021642808522,NaN,NaN,-87.03438814325114,-81.08073792482654,-0.08010592030569819,-1.6615826445465771,-1.581476724240879,202131699,207642649.6,33.766207732682815,28.569667694057056,NaN,NaN,-40.96446971910825,-37.3730894799089
2022-10-07T09:30:00-04:00,35.03,35.26,34.3345,34.53,6487567,7159458.45,26.646624283079944,26.63252716829958,NaN,NaN,-113.14111241614577,-82.12507106402482,-0.12712816062180554,-1.7403869250181359,-1.6132587643963303,195644132,207245679.6,33.4701172196434,27.200405207697518,NaN,NaN,-42.00345678148224,-38.034570522990805
2022-10-10T09:30:00-04:00,34.62,34.92,34.09,34.14,7805123,7409596.35,25.48002341723921,26.472574792565972,NaN,NaN,-119.76515264821829,-89.54027649409888,-0.16011763830850678,-1.8134058122819638,-1.653288173973457,187839009,202963689,30.37594354273719,26.01505306839524,NaN,NaN,-43.21368532100425,-38.774444065564154
2022-10-11T09:30:00-04:00,34.04,34.73,33.71,34.46,8847578,7645000.5,28.255507361597864,26.65701005131723,NaN,NaN,-118.5609420904937,-102.2417341653493,-0.1369068075093145,-1.8244216833601001,-1.6875148758507856,196686587,198673229.4,27.620671548031325,25.085535489454525,NaN,NaN,-43.32134599965094,-39.42400148471941
2022-10-12T09:30:00-04:00,34.4,34.43,33.83,34,8899459,7882777.35,26.7151678574553,26.819081845991565,NaN,NaN,-120.93425943721152,-111.88717094706408,-0.1291532017067043,-1.848956377984166,-1.7198031762774617,187787128,194017711,24.973605035707436,24.337625461890735,NaN,NaN,-43.88080598800849,-40.060687842332136
2022-10-13T09:30:00-04:00,33.29,34.81,33.125,34.64,14575833,8300207.7,32.249116593298325,27.486402813297918,NaN,NaN,-113.321787044212,-117.14465072725625,-0.061000545433015585,-1.7960538580687313,-1.7350533126357157,202362961,194063963.4,25.050456212636206,24.068289217477343,NaN,NaN,-42.64809999844555,-40.43031815034834
2022-10-14T09:30:00-04:00,35.07,35.15,33.7,33.77,9014753,8448666.1,29.03896108683952,28.13255668926617,NaN,NaN,-105.34823048404193,-115.58607434083547,-0.0547892490893882,-1.803539873997451,-1.7487506249080629,193348208,193604778.6,24.77908756625952,24.173802445564124,NaN,NaN,-42.58165119628089,-40.73765144262442
2022-10-17T09:30:00-04:00,34.38,35.165,34.32,35.03,7687789,8626574.15,38.575406278108154,29.54717421374636,NaN,NaN,-66.01950142790417,-104.83694409677264,0.04832929614864301,-1.688339004722259,-1.736668300870902,201035997,196244176.2,29.50621036429382,24.928292671959827,NaN,NaN,-39.333918539175166,-40.537118170703096
2022-10-18T09:30:00-04:00,35.68,35.965,35.16,35.49,7743440,8700785.9,41.65802390070644,30.687064991005418,NaN,NaN,-20.40205988937446,-85.20516765654881,0.15561749975553796,-1.5421464261764797,-1.6977639259320176,208779437,198662746.2,33.62260513771285,26.127549977026735,NaN,NaN,-35.701125826397195,-39.84626212151654
2022-10-19T09:30:00-04:00,35.17,35.27,34.4,34.6,7615381,8620765.7,37.7143512052508,31.76757337692054,NaN,NaN,-60.85568479923901,-73.18945272895431,0.17338640961592255,-1.4810309139121145,-1.654417323528037,201164056,201338131.8,37.93970786043911,27.769448139241252,NaN,NaN,-33.88572720302786,-38.994757133161016
2022-10-20T09:30:00-04:00,34.61,34.96,34.325,34.43,7603494,8681923.25,36.99394662968177,32.54040817393869,NaN,NaN,-65.50897969689606,-63.62689125949112,0.17966842006504757,-1.4298317984467275,-1.609500218511775,193560562,199577652,36.268129717240974,29.34945849771728,NaN,NaN,-32.66465504189861,-38.090456834409245
2022-10-21T09:30:00-04:00,34.5,34.68,33.96,34.67,9826990,8806773.25,38.77208795293461,33.013815423185,NaN,NaN,-67.49439999999751,-56.056125162682235,0.20417709262587103,-1.3542788527294363,-1.5584559453553073,203387552,201585520.8,39.53995522776386,30.95585841532594,NaN,NaN,-31.138694730867645,-37.09734796247473
2022-10-24T09:30:00-04:00,35,35.145,34.38,34.65,6076365,8609233.45,38.67413713467629,33.14044025528484,NaN,NaN,-41.35795333129901,-51.123815543361204,0.22176714528741437,-1.2812470137460394,-1.5030141590334538,197311187,200840558.8,38.745197387687924,31.850068474028237,NaN,NaN,-29.93061446668552,-36.0735288916477
2022-10-25T09:30:00-04:00,34.7,36.06,34.68,36.02,7176708,8428343.6,48.30775710798838,34.172408374560156,NaN,NaN,28.562305244500468,-41.33094251658622,0.3222997419288891,-1.1001394816223424,-1.4224392235512315,204487895,199982250.4,37.80241360565242,32.39002201132063,NaN,NaN,-25.8087667417534,-34.607134298805654
2022-10-26T09:30:00-04:00,36.04,36.29,35.72,35.95,8945019,8510382.65,47.89376980500686,35.49820575813312,NaN,NaN,64.47800543188185,-16.264204470362046,0.3769170112308715,-0.9512929595126423,-1.3282099707435138,195542876,198858014.4,36.547955613586815,32.58871828852806,NaN,NaN,-22.61562426089356,-32.89406143624679
2022-10-27T09:30:00-04:00,36.13,36.39,35.815,35.97,8435574,8547952.4,48.03080520584229,37.02564725261614,NaN,NaN,68.07586293907347,10.452764056831862,0.4047768350091292,-0.8222389269821022,-1.2270157619912314,203978450,200941592,40.48950549777189,33.090103165537236,NaN,NaN,-19.97653547846437,-31.048700585135013
2022-10-28T09:30:00-04:00,35.87,36.92,35.66,36.82,5460275,8435921.85,53.614239565302455,39.03523412033495,NaN,NaN,96.31935062451977,43.215514181735315,0.4664512449960787,-0.643951705746133,-1.1104029507422117,209438725,202151826.6,42.71539647098079,33.97149266041178,NaN,NaN,-15.957108183816146,-28.892758813518032
2022-10-31T09:30:00-04:00,36.48,36.97,36.32,36.73,7154671,8212656.4,52.96537250916156,40.80022448801807,NaN,NaN,110.91697127564318,73.67049910312376,0.485035167308262,-0.5041089916068842,-0.9891441589151462,202284054,203146400,44.55090640224766,35.180795149998666,NaN,NaN,-12.831136264679962,-26.598241306541166
2022-11-01T09:30:00-04:00,37.1,37.3,36.565,36.67,6000876,8068204.05,52.50912159051437,42.64264975466515,NaN,NaN,129.62207346795006,93.88245274781367,0.47644564348700036,-0.3935871045563957,-0.870032748043396,196283178,201505456.6,42.15113671591708,36.40776169858507,NaN,NaN,-10.353982207903444,-24.277632863878633
2022-11-02T09:30:00-04:00,36.47,36.95,35.645,35.71,14000239,8414507.75,45.72259904447838,43.60504135832087,NaN,NaN,73.17650062965399,95.6221517873681,0.3927527936662015,-0.37909175596064415,-0.7718445496268457,182282939,198853469.2,38.53814958176288,37.3711683678084,NaN,NaN,-9.989371178437635,-22.236452623101346
2022-11-03T09:30:00-04:00,35.43,35.98,35.03,35.69,10969611,8516337.25,45.59039967354489,44.78728697165696,NaN,NaN,30.39769584758305,88.08651836907002,0.32546739251170365,-0.3650103089872161,-0.6904777014989197,171313328,192320444.8,31.398277181819267,37.84396762606267,NaN,NaN,-9.727063162989046,-20.449396985942446
2022-11-04T09:30:00-04:00,36.01,36.365,35.46,36.19,7524196,8568168.7,49.51995077594681,45.56904015007401,NaN,NaN,60.31227676293764,80.88510359675358,0.3044364533908882,-0.30993213476030945,-0.6143685881511977,178837524,186200204.6,26.453740994362704,37.625934099639025,NaN,NaN,-8.408269554261716,-18.72923592427377
2022-11-07T09:30:00-05:00,36.42,36.56,35.96,36.18,6479870,8501906.05,49.443039989958244,46.12511272787771,NaN,NaN,71.84542451781009,73.07079424518697,0.28025851075018116,-0.2640454497134712,-0.5443039604636524,172357654,180214924.6,22.690481686847008,36.845068138862885,NaN,NaN,-7.338484284792522,-17.10198569006216
2022-11-08T09:30:00-05:00,36.28,36.77,36.165,36.4,6225574,8370805.85,51.2373668515932,47.09104241690217,NaN,NaN,82.46293800539263,63.63896715267549,0.2694148318177678,-0.2075354206914426,-0.4769502525092104,178583228,176674934.6,20.805299745479957,35.62118184493723,NaN,NaN,-5.946861538344918,-15.508396525531127
2022-11-09T09:30:00-05:00,36.298,36.74,35.93,36,7752934,8313479.6,47.908078916695445,47.87062329454601,NaN,NaN,59.213071478963826,60.84628132253746,0.22731625215239293,-0.19280493731871928,-0.4201211894711122,170830294,174384405.6,19.666728725212238,34.43536748836375,NaN,NaN,-5.604420837430951,-14.09354285580253
2022-11-10T09:30:00-05:00,37.345,38.86,37.19,38.76,11979157,8183645.8,64.87003792272591,49.73476257810251,NaN,NaN,214.08408376176783,97.58355890537442,0.36898030127011455,0.041104187116530966,-0.3278761141535836,182809451,176683630.2,24.153676051966812,33.336347547235384,NaN,NaN,0.809890688498311,-11.96448092090241
2022-11-11T09:30:00-05:00,38.88,39.2,38.635,38.74,7291384,8097477.35,64.70561845995117,51.59415410133643,NaN,NaN,235.01752938750514,132.5246094302879,0.4401428563351326,0.22230245626533218,-0.21784040006980043,175518067,176019738.8,23.741330885045272,32.264642797046626,NaN,NaN,5.639280116276628,-9.44965791559112
2022-11-14T09:30:00-05:00,38.52,38.57,37.71,37.71,6304079,8028291.85,56.73081468516479,52.195801071134746,NaN,NaN,143.37542574070088,146.83060967486605,0.39792696698458785,0.2795683086609344,-0.11835865832365346,169213988,175391005.6,23.335037079661276,31.23125875947583,NaN,NaN,7.118890287293329,-7.082722458036198
2022-11-15T09:30:00-05:00,38.26,38.42,37.75,38.18,9588655,8120552.6,59.2017687132157,53.00351527886395,NaN,NaN,130.46905794245413,156.43183366227836,0.38168023153444564,0.3587416310944036,-0.022938600440042048,178802643,175434888.6,23.433526228873035,30.29451380342485,NaN,NaN,9.130151783753625,-4.766597566351937
2022-11-16T09:30:00-05:00,38.13,38.31,37.81,37.91,7771186,8128342.85,57.18157664054264,53.65714180991397,NaN,NaN,108.10277138941366,166.20977364436834,0.3344671416830007,0.39514532666370883,0.060678184980708136,171031457,175475121.2,23.530520495339488,29.08315773182253,NaN,NaN,10.100726677953984,-2.6426941028796627
2022-11-17T09:30:00-05:00,37.382,37.6902,37.255,37.57,4402561,7968296.2,54.65246738643946,53.73130093999519,NaN,NaN,63.588839501147945,136.11072479224435,0.2650903742578643,0.39204115280303853,0.12695077854517423,166628896,172239010.2,21.20376671734374,27.54661274941989,NaN,NaN,10.114573664319977,-0.8202272789939999
2022-11-18T09:30:00-05:00,38.07,38.2,37.67,38.05,5865809,7770237.15,57.50971644277133,54.055896935253024,NaN,NaN,85.22605839945565,106.15243059463447,0.2371849776447034,0.42343200060105346,0.18624702295635007,172494705,171634337.8,20.790094105287892,25.84941187106562,NaN,NaN,10.990985871269507,0.8670888853293581
2022-11-21T09:30:00-05:00,37.988,38.37,37.83,38.32,4836867,7708262.25,59.07186939865786,54.5246646358347,NaN,NaN,87.67986323271123,95.01331809303653,0.22279357788111825,0.46473899530774787,0.24194541742662962,177331572,173257854.6,25.0198138252546,24.625745950304008,NaN,NaN,12.175225737985636,2.482537007137398
2022-11-22T09:30:00-05:00,38.47,38.53,38.2191,38.51,5547234,7626788.55,60.18128852290315,55.55742817000789,NaN,NaN,93.30028715346629,87.57956393523895,0.2120137057535757,0.5069625496185992,0.2949488438650235,182878806,174073087.2,27.12419728069149,23.810463643084624,NaN,NaN,13.471497092423817,4.0523884478926
2022-11-23T09:30:00-05:00,38.45,38.73,38.22,38.57,3604485,7359761.85,60.54500092463251,56.625613973657,NaN,NaN,89.13176123708834,83.7853619047739,0.19528304947354397,0.5390526557069535,0.3437696062334095,186483291,177163454,34.61563927150699,24.04027522091946,NaN,NaN,14.639192157586345,5.564788977848849
2022-11-25T09:30:00-05:00,38.69,38.84,38.58,38.8,2254116,7050688.95,61.97870360503264,57.51552489002028,NaN,NaN,95.59528927983585,90.18665186051147,0.18610351889842514,0.5763990048564409,0.3902954859580158,188737407,181585156.2,43.55615912302264,25.26187651582374,NaN,NaN,16.021721543359437,7.0586364872075045
2022-11-28T09:30:00-05:00,38.57,38.74,37.625,37.71,7298258,7142588.1,52.282593703014854,57.71835015523861,NaN,NaN,41.96694914893061,81.53483001040647,0.09747460998297397,0.5121387484367332,0.41466413845375927,181439149,183374045,46.72975844526797,26.97896771285381,NaN,NaN,14.434020010888258,8.112262704876184
2022-11-29T09:30:00-05:00,37.788,38.39,37.65,38.34,4954340,7032571.55,56.51682896085618,58.09545459161453,NaN,NaN,45.23495940063994,73.0458492439922,0.07323866118485933,0.5062124649348334,0.4329738037499741,186393489,185186428.4,49.80879317937257,29.050645815274713,NaN,NaN,14.326788407690117,9.00005209099246
2022-11-30T09:30:00-05:00,38.24,39.27,38.01,39.24,8120276,7138541.55,61.739952552604734,59.08344556560805,NaN,NaN,89.67573481079421,72.32093877545779,0.10769730428062846,0.5675954341007596,0.4598981298201312,194513765,187513420.2,53.52324857231385,31.46896866149626,NaN,NaN,15.888290397607912,9.984086134794667
2022-12-01T09:30:00-05:00,39.63,39.84,38.84,39.16,9814106,6929234.9,61.0381057865483,58.80973612730965,NaN,NaN,117.16623291443759,77.92783311092762,0.11435142697829498,0.6028374135429999,0.48848598656470493,184699659,187156693.8,52.87720607032183,33.520649377093044,NaN,NaN,16.921569861555692,10.97515523861767
2022-12-02T09:30:00-05:00,38.68,39.17,38.49,38.97,5460817,6653795.2,59.31354622083366,58.424588110229834,NaN,NaN,87.00244056280602,76.20926336752166,0.09594882179333086,0.6084220138063685,0.5124731920130376,179238842,185256980.8,49.45381987411843,35.35725573345541,NaN,NaN,17.269747633915955,11.874382723660283
2022-12-05T09:30:00-05:00,38.61,38.82,38.23,38.31,7165476,6635859.2,53.64370454793898,58.20408024328514,NaN,NaN,44.27950594524719,76.67177472678497,0.03259285120606337,0.5532142560206168,0.5206214048145534,172073366,183383824.2,46.27267959524058,36.9956587702825,NaN,NaN,15.865872021429725,12.44459548048449
2022-12-06T09:30:00-05:00,38.39,38.46,37.84,38.02,5249529,6574342.15,51.322243403038954,57.64125700684394,NaN,NaN,-5.481160407022809,66.52855076525243,-0.0320795433432165,0.4805219756355328,0.5126015189787493,166823837,179469893.8,40.42178633662325,38.20910592083609,NaN,NaN,14.00326984201817,12.667263246417873
2022-12-07T09:30:00-05:00,37.9,38.505,37.84,38.1,6159838,6571055.35,51.94012037340873,57.26686727347724,NaN,NaN,-13.51137099353872,45.891129604385846,-0.07050116175933663,0.42447506677957847,0.4949762285389151,172983675,175163875.8,35.155143932015804,39.03943616631297,NaN,NaN,12.646267212077511,12.664263812940678
2022-12-08T09:30:00-05:00,38.23,38.685,38.12,38.38,4460961,6406456.7,54.13449301382766,57.229869104004955,NaN,NaN,10.894431220763124,24.63676926565095,-0.07753095835904977,0.3980625305901029,0.47559348894915265,177444636,173712871.2,33.56798215233168,39.92259441166925,NaN,NaN,12.090639953164404,12.582317547258354
2022-12-09T09:30:00-05:00,38.27,38.715,38.16,38.3,6077035,6111350.6,53.384496080313895,56.93521050668657,NaN,NaN,9.020090616332046,9.040299276356162,-0.08731410588830035,0.3664508565887772,0.45376496247707754,171367601,172138623,31.88599972591679,40.715159098857036,NaN,NaN,11.42412385796159,12.416861305930246
2022-12-12T09:30:00-05:00,38.34,38.64,37.98,38.62,4945103,5994036.55,56.00983672656111,56.71649388725109,NaN,NaN,19.219477031139533,4.028293493534635,-0.07258407964333485,0.363034862922909,0.43561894256624384,176312704,172986490.6,33.80966848598152,41.34300586033753,NaN,NaN,11.545419589597374,12.292369632168407
2022-12-13T09:30:00-05:00,39.82,40,38.99,39.47,10763834,6217024.3,62.11353425364005,56.85451143944658,NaN,NaN,211.83520511685666,47.491566598310534,-0.009273047668642898,0.4240276329804402,0.4333006806490831,187076538,177037030.8,42.20695671468053,42.42034581990817,NaN,NaN,13.447597672333911,12.457402209334909
2022-12-14T09:30:00-05:00,39.42,39.9095,38.935,39.09,10786503,6276916.7,58.22407369355109,56.68873092294076,NaN,NaN,148.4623160158495,79.88630400018818,0.0026941572699852867,0.4366683772365647,0.4339742199665794,176290035,177698302.8,43.46788846838162,43.05264933397065,NaN,NaN,13.936790006951572,12.668743323280147
2022-12-15T09:30:00-05:00,38.59,38.99,38.4,38.64,6033249,6190019.85,53.918284189892525,56.112986679002184,NaN,NaN,32.49880752620374,84.2071792612763,-0.02262067153674263,0.4056983805456511,0.42831905208239374,170256786,176260732.8,41.35545809318409,42.89545640326789,NaN,NaN,13.080309410287327,12.727538478566887
2022-12-16T09:30:00-05:00,38.12,38.14,37.1235,37.5,8016236,6370703.6,44.86623588103625,55.58324683457514,NaN,NaN,-161.7679780271028,50.04956553258933,-0.1139587426132892,0.2858706238157822,0.3998293664290714,162240550,174435322.6,38.77842396892578,42.327503940672024,NaN,NaN,9.296481736009023,12.237387515344334
2022-12-19T09:30:00-05:00,37,37.05,36.42,36.64,4543875,6304606.9,39.481300102356784,54.366423344682325,NaN,NaN,-269.85083428202284,-7.7644967300431516,-0.2237621293521193,0.12012670473892229,0.3438888340910416,157696675,170712116.8,34.109621624702726,41.2061345439099,NaN,NaN,4.1627216103065345,11.08386381462465
2022-12-20T09:30:00-05:00,36.46,36.78,36.12,36.56,4333963,6279461.7,39.01222985559158,52.74301458060995,NaN,NaN,-236.1448360179549,-97.36050495700547,-0.2890953663081194,-0.017480373794107606,0.2716149925140118,153362712,163969351.6,27.623323077392754,39.356139865701245,NaN,NaN,-0.0018690876336671393,9.500187685730605
2022-12-21T09:30:00-05:00,36.888,37.31,36.76,36.93,4082570,6206228.5,42.419586853685935,51.41312037111978,NaN,NaN,-141.0865808752479,-155.27028433522494,-0.29375384313517106,-0.09557731140495207,0.19817653173021899,157445282,160200401,24.786089225297644,37.34963151962808,NaN,NaN,-2.404068744212114,7.7995796243102165
2022-12-22T09:30:00-05:00,36.6,36.83,36.095,36.75,4206160,6236312.25,41.213253736280336,50.12024233650883,NaN,NaN,-157.16130094928425,-193.20230603032255,-0.2945685413967111,-0.17003414501566994,0.1245343963810412,153239122,156796868.2,22.535102535396476,35.42686599543366,NaN,NaN,-4.726865208838082,6.010087505289031
2022-12-23T09:30:00-05:00,36.63,37.1,36.475,37.08,3935110,6320361.95,44.33848361719385,49.45558369859846,NaN,NaN,-108.82673206103726,-182.61405683710944,-0.2597129360527196,-0.2001067736848583,0.0596061623678613,157174232,155783604.6,21.89751911240188,33.68578310380233,NaN,NaN,-5.7651899537082905,4.327905011146556
2022-12-27T09:30:00-05:00,37.1,37.1878,36.72,37.05,4259721,6168435.1,44.10891058292797,48.94034564001911,NaN,NaN,-87.01488203046024,-146.04686638679692,-0.2267094845442595,-0.22378069331246309,0.0029287912317964154,152914511,154827171.8,21.285345116010802,32.31889444518715,NaN,NaN,-6.674963211158238,2.756066693674443
2022-12-28T09:30:00-05:00,37.14,37.34,36.425,36.46,4730881,6157262.15,39.749867477848476,48.06961329033623,NaN,NaN,-92.96814966235156,-117.41152911567625,-0.23181819760541278,-0.2868439557749696,-0.05502575816955678,148183630,153791355.4,20.61323696177132,31.2801868044554,NaN,NaN,-8.760126991364944,1.1108961672402449
2022-12-29T09:30:00-05:00,36.721,37.365,36.62,37.27,4143152,5958405.95,47.43079908703459,47.590778009851014,NaN,NaN,-59.62349932727385,-101.11891280608143,-0.17067397997399159,-0.2683682331370463,-0.09769425316305468,152326782,152767655.4,19.94300718624521,30.306974306877798,NaN,NaN,-8.272662278902857,-0.22961218220876956
2022-12-30T09:30:00-05:00,37.04,37.18,36.53,36.93,5087853,5722093.3,44.846386043313686,46.98091300720814,NaN,NaN,-67.54115246107517,-83.19488310843961,-0.1442103027074559,-0.27795713154737456,-0.13374682883991865,147238929,151567616.8,19.156677093162088,29.397736975966748,NaN,NaN,-8.649836561445376,-1.4325013792425703
2023-01-03T09:30:00-05:00,37.23,37.56,36.61,37.07,7060342,5802069.55,46.147575528533544,46.2764657787776,NaN,NaN,-46.93755652838252,-70.81704800190867,-0.10990982287627787,-0.271134107435266,-0.16122428455898813,154299271,150992624.6,18.77469882885147,28.323810571886035,NaN,NaN,-8.575923204420729,-2.452990211410879
2023-01-04T09:30:00-05:00,37.4,38.26,37.27,37.92,7586940,5823142.75,53.34447195580929,45.6501041860754,NaN,NaN,14.946113735889712,-50.424848848638675,-0.026934426823938346,-0.19489231808891105,-0.1679578912649727,161886211,152786964.6,23.875852238127422,27.014445966417952,NaN,NaN,-6.2443815586273335,-2.994617546727515
2023-01-05T09:30:00-05:00,37.62,37.62,36.75,36.81,6581089,5889720.75,44.904866594973086,44.69873225046268,NaN,NaN,-43.91244961634634,-40.613708839437635,-0.042821475721021074,-0.22148473591624906,-0.178663260195228,155305122,154211263,27.754402064889717,25.892054080454248,NaN,NaN,-6.95436134799826,-3.5602952326233357
2023-01-06T09:30:00-05:00,37.11,38.01,36.83,37.88,6329647,5898211.2,52.67715714645615,44.61008031878866,NaN,NaN,1.5167698061432542,-28.38565501275421,0.019379341454287186,-0.154439083377369,-0.1738184248316562,161634769,156072860.4,32.58886288795273,25.26586870865201,NaN,NaN,-4.802015959506906,-3.7376839078924173
2023-01-09T09:30:00-05:00,38.06,38.31,37.73,37.86,3965627,5873444.5,52.52799538029557,45.15734885445004,NaN,NaN,38.860717870877814,-7.105280946363616,0.057658027651636246,-0.1017458902671109,-0.15940391791874714,157669142,158158903,37.62577003847122,25.183536285048117,NaN,NaN,-3.2113075809015004,-3.6624872897508576
2023-01-10T09:30:00-05:00,37.8,37.99,37.47,37.97,5196657,5829425.6,53.31105817809634,46.14518871700286,NaN,NaN,28.62313035004085,8.006856429321058,0.08710103560595903,-0.05052762341129835,-0.13762865901725738,162865799,159872208.6,41.492469388354756,25.710882553880403,NaN,NaN,-1.705528867014346,-3.3829218007884987
2023-01-11T09:30:00-05:00,38.21,39.36,38.21,39.35,4733069,5818823.9,61.81984739134978,47.77430425527131,NaN,NaN,129.68953333702788,30.955540349548688,0.19031247265341827,0.10026193179951548,-0.0900505408539028,167598868,161014740,43.98619286306199,26.87965896714249,NaN,NaN,2.644822378776783,-2.52181548942203
2023-01-12T09:30:00-05:00,39.44,39.87,39.06,39.79,5102349,5535749.65,64.06832940159342,49.320643008693274,NaN,NaN,182.16703753603923,76.1714377800258,0.2739276532356094,0.252359025690609,-0.02156862754500044,172701217,164493959,50.855455818700996,28.74175658095702,NaN,NaN,6.918070804262196,-1.173260304609998
2023-01-13T09:30:00-05:00,39.34,39.72,39.25,39.56,3795956,5186222.3,62.01248273874936,50.80630222315535,NaN,NaN,173.0745301053294,110.48298983986304,0.2974948626848738,0.3502999508110918,0.05280508812621801,168905261,165948057.4,53.42616957176128,30.94826136926879,NaN,NaN,9.679045458964348,0.37706909018633694
2023-01-17T09:30:00-05:00,39.58,39.825,39.47,39.57,5463216,5157720.65,62.069472003640094,52.0728013936158,NaN,NaN,166.66286341523988,136.04341894873545,0.29682792343538905,0.42383999242045434,0.12701206898506529,174368477,169287924.4,58.76193520894608,33.581433947593375,NaN,NaN,11.881998853209657,2.020630484903954
2023-01-18T09:30:00-05:00,39.78,39.82,38.9038,38.96,7466655,5130241.6,56.50115456691722,52.95796167818646,NaN,NaN,113.82510597325339,153.08381407337794,0.24076296888595866,0.4279657800925136,0.18720281120655496,166901822,170095129,59.956009309874034,36.343624247155034,NaN,NaN,12.111776841555418,3.4622228215684485
2023-01-19T09:30:00-05:00,38.79,39.26,38.74,38.77,7253667,5265731.2,54.850578306590585,54.03658388023946,NaN,NaN,81.1157116458958,143.36904973515155,0.1791693004408376,0.41116443675760195,0.23199513631676436,159648155,168504986.4,56.48614820306563,38.90597505010463,NaN,NaN,11.815051380537136,4.6554840442782615
2023-01-20T09:30:00-05:00,38.8,39.26,38.28,39.22,4262500,5262158.05,57.981434297745615,54.79020068100454,NaN,NaN,71.35986236394038,121.20761470073175,0.15777412487887343,0.42921279241535615,0.2714386675364827,163910655,166746874,52.844684935452534,41.256094889333724,NaN,NaN,12.478171274955404,5.773010791517853
2023-01-23T09:30:00-05:00,39.25,39.589,38.94,39.33,7002222,5408140.65,58.734721408278794,55.7822246356449,NaN,NaN,85.48963732558424,103.69063614478273,0.14063855149562138,0.44723685690600945,0.3065983054103881,170912877,167148397.2,53.58069090141773,43.71495301849484,NaN,NaN,13.236400735364093,6.839209354924459
2023-01-24T09:30:00-05:00,39.3,39.65,38.54,39.5,7089709,5552318.1,59.93029517009157,56.766704610041906,NaN,NaN,72.60036628834098,84.87813671940296,0.13057960542967184,0.4698228121974779,0.33924320676780606,178002586,167875219,54.95136530094212,46.299000623644176,NaN,NaN,14.203094124492216,7.891192893434138
2023-01-25T09:30:00-05:00,39.25,39.61,39.15,39.54,8163146,5763719.9,60.22232468413756,57.25797980492249,NaN,NaN,77.7263395375081,77.6583834322539,0.11688954521294342,0.48535513828398535,0.36846559307104193,186165732,171728001,61.4496038384891,48.98284002367001,NaN,NaN,15.08518792439561,8.918906469285776
2023-01-26T09:30:00-05:00,39.76,39.99,39.55,39.99,4497424,5775605.05,63.4496268091087,58.5826055345036,NaN,NaN,95.93440890494144,80.62212288406302,0.12754005581856637,0.5278906628442499,0.40035060702568354,190663156,177931001.2,69.16232578072234,51.940548860515165,NaN,NaN,16.755924899003283,10.038480530673992
2023-01-27T09:30:00-05:00,39.87,40.52,39.86,40.35,3519935,5715057.75,65.83756825196804,59.52263489918302,NaN,NaN,114.50034643069439,89.25021969741383,0.1468541679658436,0.583918316982988,0.4370641490171444,194183091,183985488.4,74.52063408789714,54.935675374796915,NaN,NaN,18.882331767588795,11.30188785023325
2023-01-30T09:30:00-05:00,40.03,40.495,39.83,39.86,3806503,5698225.3,60.08361687032264,60.06232214847067,NaN,NaN,96.22818597041064,91.3979294263791,0.11600625544440557,0.5820719683226514,0.46606571287824583,190376588,187878230.6,77.25690227424109,57.76647053449476,NaN,NaN,19.140222823359235,12.421649989251247
2023-01-31T09:30:00-05:00,39.85,40.645,39.76,40.59,4274942,5657579.75,64.99232429111778,60.896698299400775,NaN,NaN,113.80448564516063,99.63875329774302,0.13292800434439433,0.6322257183087387,0.4992977139643444,194651530,191208019.4,79.30427287701625,60.46731364082772,NaN,NaN,20.853303237194478,13.626171881814566
2023-02-01T09:30:00-05:00,40.42,41.17,39.99,40.89,7920987,5700612,66.79927620076178,61.25237178578734,NaN,NaN,135.0782303380404,111.10913145784949,0.15115922027993167,0.6882467393142591,0.5370875190343274,202572517,194489376.4,81.10904447985087,63.11894589916978,NaN,NaN,22.8310933825062,14.941160667627656
2023-02-02T09:30:00-05:00,41.31,42.21,41.24,41.83,7014574,5671993.7,71.7241032790667,61.799212777035436,NaN,NaN,203.70896706593106,132.66404309004741,0.20975425672368342,0.7992803399389317,0.5895260832152482,209587091,198274163.4,82.95534510196669,65.41179513368876,NaN,NaN,26.238771794181893,16.555105114278263
2023-02-03T09:30:00-05:00,41.23,41.26,40.41,40.96,7467168,5716297.65,62.48563995987226,61.83300972140135,NaN,NaN,121.73582925481577,134.1111396548717,0.17458886136078533,0.8077621599162299,0.6331732985554446,202119923,199861529.8,83.67594939694077,67.57249369263015,NaN,NaN,26.119770440223178,17.921485875127537
2023-02-06T09:30:00-05:00,40.38,40.744,40.19,40.7,5384418,5669036.2,59.998425444910616,61.68507782434924,NaN,NaN,83.47960455651929,131.56142337209343,0.1210305235139032,0.7844614529478235,0.6634309294339203,196735505,201133313.2,84.25045886576814,69.39310252526029,NaN,NaN,25.215518256216253,18.963490500997352
2023-02-07T09:30:00-05:00,40.391,40.755,40.01,40.54,7056726,5823591.15,58.45638316821026,61.824737010155886,NaN,NaN,64.79107947879007,121.75874213881931,0.06485737555618809,0.7445026488791555,0.6796452733229674,189678779,200138763,81.82521912577468,70.95518894068177,NaN,NaN,24.010406651686004,19.6844785225243
2023-02-08T09:30:00-05:00,40.38,40.61,40.235,40.43,4347799,5781148.25,57.36479391618954,62.004323839412955,NaN,NaN,56.023264982492165,105.94774906770968,0.013033064628656055,0.6959366041087875,0.6829035394801315,185330980,196690455.6,73.88384200298842,72.19788135496198,NaN,NaN,22.70861759777275,20.116498390416936
2023-02-09T09:30:00-05:00,40.72,40.85,39.93,40.04,3476892,5718339.4,53.546946024074906,61.6875746770079,NaN,NaN,34.604369151091696,72.1268294847418,-0.05124741434444946,0.6188442715495697,0.6700916858940191,181854088,191143855,63.250323354563854,72.94114124204135,NaN,NaN,20.457561081248695,20.16522163196433
2023-02-10T09:30:00-05:00,39.83,40.23,39.615,40.12,4253504,5675897.15,54.22001396192502,61.36509557369692,NaN,NaN,0.8442985464062904,47.948523343059904,-0.08985438398834522,0.5577737059085877,0.6476280898969329,186107592,187941388.8,58.055033859061254,73.26073716758732,NaN,NaN,18.797756276105982,19.96986943827028
2023-02-13T09:30:00-05:00,40.27,40.555,40.22,40.49,2943115,5633255.1,57.30145676292953,61.17732140175678,NaN,NaN,45.6976827337754,40.39213897851112,-0.09163393539558862,0.5330856706524472,0.6247196060480358,189050707,186404429.2,55.690786386078116,73.31355295938275,NaN,NaN,18.22437498496276,19.720513087797777
2023-02-14T09:30:00-05:00,40.348,40.63,39.855,40.07,4544914,5587340,52.944979155601544,60.65751100686135,NaN,NaN,15.554038256624803,30.544730734078076,-0.12044458963395943,0.4741638690055865,0.5946084586395459,184505793,185369832,54.0938255090064,72.78814022156256,NaN,NaN,16.45821114149427,19.25446995261156
2023-02-15T09:30:00-05:00,39.83,40.195,39.72,40.18,3873031,5407658.8,53.93282567807006,59.977739497501446,NaN,NaN,-8.205773896638641,17.69892295825192,-0.1305896339382947,0.4313714162166775,0.5619610501549722,188378824,185979400.8,54.9141530149082,71.77041359543297,NaN,NaN,15.265703465260867,18.68464616870432
2023-02-16T09:30:00-05:00,39.53,40.1526,39.26,39.81,4807223,5285336.6,50.12129425533665,58.85514849774206,NaN,NaN,-56.17690880001021,-0.4573326319684611,-0.15883845400378105,0.3634129826502459,0.522251436654027,183571601,186322903.4,55.397839605848624,70.40449970385808,NaN,NaN,13.137652389987952,17.89221848603055
2023-02-17T09:30:00-05:00,39.64,39.74,39.24,39.61,7192500,5431836.6,48.14080437637811,58.00209046246031,NaN,NaN,-97.49303194350026,-20.12479872994977,-0.1857424923457497,0.2900733212218398,0.4758158135675895,176379101,184377205.2,51.99519082873548,68.60009174346483,NaN,NaN,10.775241322623105,16.87550746268663
2023-02-21T09:30:00-05:00,39.4,39.4,38.655,38.83,4220845,5292767.75,41.288606901127395,56.3089677917467,NaN,NaN,-174.91161396867153,-64.24665807043917,-0.24698419371181074,0.1670855714278261,0.41406976513963684,172158256,180998715,46.638454001494566,66.26681896664185,NaN,NaN,6.478389869479317,15.3902049493713
2023-02-22T09:30:00-05:00,38.95,38.98,38.3,38.48,7049609,5290762.75,38.63145880018736,54.296980834562824,NaN,NaN,-209.04205478822288,-109.16587667940868,-0.2985331634687386,0.040903310803713566,0.33943647427245216,165108647,177119285.8,41.36817780666147,63.42818563284261,NaN,NaN,2.018179610824269,13.479915615293153
2023-02-23T09:30:00-05:00,38.71,38.93,38.47,38.85,9331686,5349189.75,42.82076617505053,52.23245675570452,NaN,NaN,-169.06676672717543,-141.33807524551605,-0.29467549924187797,-0.028907899779895274,0.2657675994619827,174440333,174331587.6,38.04150894825408,60.220054479006,NaN,NaN,-0.529727636120091,11.478538007948405
2023-02-24T09:30:00-05:00,38.37,38.49,37.944,38.13,8158988,5532267.95,37.46158941052933,50.44502457360859,NaN,NaN,-193.04053447309596,-168.7108003801332,-0.32518188386387276,-0.14070975536785824,0.18447212849601452,166281345,170873536.4,34.351255890687824,56.696862085702215,NaN,NaN,-4.525642909081045,9.19222644837277
2023-02-27T09:30:00-05:00,38.67,38.77,38.02,38.19,4816137,5597078.05,38.15620293007903,48.884865822549195,NaN,NaN,-145.10692230941382,-178.2335784533159,-0.3251088604021357,-0.22191394700665512,0.10319491339548059,171097482,169817212.6,33.288951778286815,53.05675443659641,NaN,NaN,-7.509088863431312,6.806324260972187
2023-02-28T09:30:00-05:00,38.22,38.68,38.07,38.21,4202184,5616862.1,38.401802625640755,47.45239578379424,NaN,NaN,-122.6839263835837,-167.78804093629836,-0.30768480208271587,-0.28141108920791424,0.026273712874801625,175299666,170445494.6,34.58472105008073,49.68243314547541,NaN,NaN,-9.854165490007038,4.426254296546584
2023-03-01T09:30:00-05:00,37.97,38.01,37.375,37.62,7279134,5767071.7,34.099628142531486,45.790598228532936,NaN,NaN,-146.96395046468447,-155.37242007159065,-0.3185263482154973,-0.37188422239457,-0.0533578741790727,168020532,171027871.6,35.8289585333151,46.96422718335589,NaN,NaN,-13.257082779151228,1.9000632857326112
2023-03-02T09:30:00-05:00,37.35,38.17,37.3,38.11,5067201,5624382.4,40.10142951508166,44.830204192176275,NaN,NaN,-115.69565694918153,-144.6981981159919,-0.2768668329581584,-0.3994414153767707,-0.12257458241861231,173087733,170757351.6,35.491262947399065,44.98143715427268,NaN,NaN,-14.391213165612166,-0.4272619216023572
2023-03-03T09:30:00-05:00,38.4,38.835,38.29,38.75,4420235,5494665.45,46.903320861037045,44.307583256398566,NaN,NaN,-55.2360529437536,-117.13730181012343,-0.1942808450755783,-0.3654256387630852,-0.1711447936875069,177507968,173002676.2,40.50366450370757,43.72776791460456,NaN,NaN,-13.215097473381137,-2.2540955718564684
2023-03-06T09:30:00-05:00,38.96,38.96,38.53,38.6,4248484,5333731.25,45.59642789234586,43.47150976564259,NaN,NaN,-44.053537864548545,-96.92662492115036,-0.1403453800517666,-0.3465765187522152,-0.20623113870044857,173259484,173435076.6,41.44721791186752,42.71037016644666,NaN,NaN,-12.656865834276132,-3.740205609344992
2023-03-07T09:30:00-05:00,38.6,38.67,37.6,37.63,5386064,5333813.55,38.18653629305002,42.41733527546034,NaN,NaN,-90.71045629885089,-90.53193090420379,-0.15920550272403822,-0.40523801710549634,-0.24603251438145812,167873420,171949827.4,39.15048077210314,41.642988399524995,NaN,NaN,-14.585714993955143,-5.2895640928607275
2023-03-08T09:30:00-05:00,37.65,38.39,37.62,38.16,4472970,5204625.75,43.58153243539412,41.67795718669777,NaN,NaN,-77.67363948183667,-76.67386870763424,-0.12661445341280153,-0.40430058114746004,-0.2776861277346585,172346390,172814999,41.19466597923147,40.66302503983381,NaN,NaN,-14.397177505783656,-6.590651723278288
2023-03-09T09:30:00-05:00,38.25,38.29,37.21,37.29,5683556,5271413.6,37.75615713736018,40.79473310684231,NaN,NaN,-107.36040665377017,-75.00681864855196,-0.15253943233012918,-0.46836041814732,-0.3158209858171908,166662834,171530019.2,39.09402329290197,39.498466731766186,NaN,NaN,-16.251508135459524,-7.970774067875608
2023-03-10T09:30:00-05:00,37.25,37.34,35.95,36.1,11736217,5684379.85,31.545097741713192,39.60932549008053,NaN,NaN,-185.68931193437984,-101.09747044667722,-0.23385607806324005,-0.6081410833962408,-0.3742850053330008,154926617,167013749,32.76923731736041,38.12518433809653,NaN,NaN,-20.197798677607658,-9.717491869265901
2023-03-13T09:30:00-04:00,35.87,37.22,35.815,36.68,16935967,6318503,36.986112296702956,39.30200444690735,NaN,NaN,-157.92862487954312,-123.87248784967615,-0.2321381242394689,-0.6644576606323369,-0.432319536392868,171862584,166734369,32.41981863083997,37.10956752590692,NaN,NaN,-21.36161685281535,-11.380938295487251
2023-03-14T09:30:00-04:00,37.25,37.41,36.625,37.06,7718978,6557296.15,40.33233369168133,39.42349551058549,NaN,NaN,-112.1024542575672,-128.1508874414194,-0.19070019306085406,-0.6706947777189356,-0.47999458465808154,179581562,169075997.4,38.35314285475695,36.89420788648517,NaN,NaN,-21.108420386171804,-12.770578594156472
2023-03-15T09:30:00-04:00,36.45,37.205,36.45,37.08,14961576,7078129.25,40.511387399932666,39.25853988379136,NaN,NaN,-112.10015529081292,-135.03619060321464,-0.1490785090650647,-0.6663427209894124,-0.5172642119243477,194543138,173515347,47.72377702552776,37.5857984634333,NaN,NaN,-20.856234978254605,-13.925672363313348
2023-03-16T09:30:00-04:00,36.81,37.25,36.42,37.08,8070306,7287993,40.511387399932666,39.476382597320175,NaN,NaN,-101.61954805325574,-133.88801888311176,-0.11046010301370868,-0.6553393406914836,-0.5448792376777749,194543138,179091407.8,56.63930580381052,39.177802028656345,NaN,NaN,-20.657599333035897,-14.887376216130855
2023-03-17T09:30:00-04:00,36.94,36.96,36.21,36.23,8694691,7482366.4,35.29137909340716,39.271752323272175,NaN,NaN,-127.09444680127656,-122.16904585649111,-0.12974178738031783,-0.7070564719031722,-0.5773146845228544,185848447,185275773.8,63.977218144094415,41.369821054785454,NaN,NaN,-22.12353249181416,-15.921112826942755
2023-03-20T09:30:00-04:00,36.06,36.4932,35.87,36.36,4962801,7370881.45,36.63613920474616,39.14563350749399,NaN,NaN,-130.16610748214592,-116.61654237701165,-0.12146633063496737,-0.7291475978165636,-0.6076812671815962,190811248,189065506.6,67.59607946904997,43.72777522756896,NaN,NaN,-22.896390934691244,-16.917581128049683
2023-03-21T09:30:00-04:00,36.61,36.64,35.764,36.15,4952551,7407466.75,35.357849920613276,39.235506491642695,NaN,NaN,-118.7695591179961,-117.94996334909743,-0.11777356418870188,-0.7548982224174736,-0.6371246582287717,185858697,190320933.6,68.71723878571642,46.07693810274049,NaN,NaN,-23.90875746225854,-17.916320604365232
2023-03-22T09:30:00-04:00,35.89,35.92,34.804,34.83,8042018,7457087.2,28.602312362937283,38.41414098077524,NaN,NaN,-171.0400777163794,-129.73794783421073,-0.18771589722122095,-0.8717695297552979,-0.6840536325340769,177816679,186975641.8,62.51067549434087,48.006896141807765,NaN,NaN,-27.11374100288946,-19.230237804154406
2023-03-23T09:30:00-04:00,34.94,35.425,34.51,34.62,7493995,7365202.65,27.69571046885548,37.042168809905114,NaN,NaN,-169.8870427419488,-143.39144677194932,-0.22887934204793248,-0.9701528100939925,-0.74127346804606,170322684,182131551,54.79320239494904,49.02757741975358,NaN,NaN,-29.964857822910112,-20.763754949690934
2023-03-24T09:30:00-04:00,34.41,35.52,34.34,35.51,8241959,7369351.2,36.8338039412035,36.416267099109234,NaN,NaN,-133.48938252202942,-144.6704339160999,-0.17912578897228304,-0.9651807042614138,-0.7860549152891307,178564643,180674790.2,52.68660379254315,49.83039069694469,NaN,NaN,-29.456678445969548,-22.00560116344502
2023-03-27T09:30:00-04:00,35.73,35.84,35.34,35.39,5108921,7383990.4,36.170035814076094,36.272231350611094,NaN,NaN,-96.42432568703347,-137.92207755707742,-0.13904296298180507,-0.9598586190163871,-0.8208156560345821,173455722,177203685,47.95554691215221,50.459323992662476,NaN,NaN,-29.26001378032405,-23.041945822999168
2023-03-28T09:30:00-04:00,35.11,35.47,35,35.27,5117808,7429771.6,35.481453430917114,35.69365427886273,NaN,NaN,-103.5753330548838,-134.88323234445494,-0.10680586230921052,-0.9543229839210952,-0.8475171216118846,168337914,173699528.4,43.690306906611504,50.637584058903904,NaN,NaN,-29.304130704817606,-23.936543663258945
2023-03-29T09:30:00-04:00,35.62,36.13,35.62,36.11,4108681,7271248.95,43.578625265467636,36.10954485944184,NaN,NaN,-50.02272750159647,-110.67976230149836,-0.0196678429256808,-0.8721019252689857,-0.8524340823433049,172446595,172625511.6,42.44425595223149,50.876886391713164,NaN,NaN,-26.789384117839134,-24.344092299627544
2023-03-30T09:30:00-04:00,36.5,36.6756,36.43,36.58,4383862,7237082,47.54538366940251,37.252422425705355,NaN,NaN,-3.4952612825362297,-77.40140600961585,0.07374538111336948,-0.760252355951593,-0.8339977370649625,176830457,173927066.2,44.50965573010781,51.7154877069094,NaN,NaN,-23.420787603164378,-24.212191628704236
2023-03-31T09:30:00-04:00,36.74,37.4,36.705,37.38,6971546,7364647.55,53.533727574107736,38.43439494551999,NaN,NaN,51.428696589006115,-40.417790187408755,0.18708665471654096,-0.6001394186692863,-0.7872260733858273,183802003,174974538.2,46.183427365487525,52.69860261652708,NaN,NaN,-18.50587329274139,-23.397003294995258
2023-04-03T09:30:00-04:00,37.29,37.555,36.825,37.03,6451986,7474822.65,50.801228794482036,39.18217316714861,NaN,NaN,61.5870730051399,-8.815510448974072,0.23316018514602466,-0.4957758419532965,-0.7289360270993211,177350017,175753397.2,47.452629736045154,53.348565965190524,NaN,NaN,-15.334372336621712,-22.245198872370466
2023-04-04T09:30:00-04:00,37.05,37.215,36.805,37.04,5639931,7487516,50.87837629234025,39.92267237374915,NaN,NaN,58.30272249980772,23.560100661964224,0.25709928649792324,-0.40756191897691707,-0.6646612054748403,182989948,178683804,52.03599079461931,53.656581234411355,NaN,NaN,-12.794865956684887,-20.895151312986812
2023-04-05T09:30:00-04:00,36.97,37.23,36.82,36.85,4476445,7487689.75,49.296678417116226,40.55019316069083,NaN,NaN,62.31043337963522,46.026732838210556,0.25256051522548895,-0.34896056144297916,-0.6015210766684681,178513503,179897185.6,53.83168063010453,53.45603657914664,NaN,NaN,-11.136730616988318,-19.501091213558457
2023-04-06T09:30:00-04:00,36.98,37.105,36.65,37.1,4053394,7406181.65,51.435998853994555,41.70338028644708,NaN,NaN,66.70234204619459,60.0662535039567,0.25791443056809205,-0.279128038458353,-0.537042469026445,182566897,181044473.6,55.52707700708102,52.85245506935997,NaN,NaN,-9.127810893145803,-18.019194024928076
2023-04-10T09:30:00-04:00,36.88,37.3,36.71,37.29,3814570,7010099.3,53.05709100661778,42.876305415152196,NaN,NaN,75.98982067822638,64.97847832180075,0.2647713301515859,-0.20607830633696267,-0.47084963648854855,186381467,181560366.4,56.304110025115925,52.045885823364685,NaN,NaN,-6.982018267781615,-16.442454631050012
2023-04-11T09:30:00-04:00,37.38,37.77,37.21,37.47,9963376,6661469.75,54.60313790916037,44.25096884290556,NaN,NaN,104.61416838853978,73.58389739848073,0.27096917707563944,-0.13213816514399923,-0.4031073422196387,196344843,185359331.6,61.62175610692667,51.53906563202255,NaN,NaN,-4.7379915789014895,-14.77038848074308
2023-04-12T09:30:00-04:00,37.85,37.88,37.295,37.36,6764782,6613759.95,53.444727642567585,46.02542707716486,NaN,NaN,102.18869433688853,82.36109176589689,0.257304325110406,-0.08147693583163118,-0.3387812609420372,189580061,186677354.2,63.290903766095624,51.59479622286217,NaN,NaN,-3.1429166701147344,-13.109321079224745
2023-04-13T09:30:00-04:00,37.41,37.412,36.8891,37.24,4650758,6098219.05,52.1450631948562,47.77180941473635,NaN,NaN,68.73243254591641,83.64549159915313,0.23068162716348467,-0.050429226987681375,-0.28111085415116605,184929303,187960514.2,64.89179181802847,52.31612403879642,NaN,NaN,-2.113988709375376,-11.538559312103407
2023-04-14T09:30:00-04:00,37.3,37.44,36.34,36.6,4853409,5937374.2,45.75444238861428,48.40899787526569,NaN,NaN,33.68639220279882,77.04230163047399,0.16362185293315315,-0.07658353798472461,-0.24020539091787776,180075894,187462313.6,63.729708361259895,53.104917222276185,NaN,NaN,-2.930125559192241,-10.308783061687526
2023-04-17T09:30:00-04:00,36.62,37.43,36.62,37.43,4601021,5732690.7,53.682359179185944,49.65987811563068,NaN,NaN,62.23485310981995,74.29130811679269,0.16817132537273569,-0.02999123420195815,-0.19816255957469384,184676915,187121403.2,62.899635210458484,54.172352100726634,NaN,NaN,-1.3062394135246098,-9.022705397664252
2023-04-18T09:30:00-04:00,37.5,37.5,37.1615,37.37,3479406,5658520.95,53.07845089628741,50.91680650601427,NaN,NaN,72.23030008490915,67.81453445606657,0.1601845781946421,0.0020681631686088053,-0.1581164150260333,181197509,184091936.4,55.9282897402742,55.04649373170254,NaN,NaN,-0.16232354471917076,-7.7569365615292405
2023-04-19T09:30:00-04:00,37.13,37.69,37.06,37.59,5605712,5691179,55.07413568725337,51.737914393284676,NaN,NaN,75.08375390012878,62.393546368714624,0.1622629027249023,0.04471221338009457,-0.11755068934480772,186803221,183536568.4,54.73072495391202,55.92409866039401,NaN,NaN,1.3716265335597049,-6.452856119373677
2023-04-20T09:30:00-04:00,37.36,37.39,36.9843,37.14,4243598,5501258,50.356249113718704,51.93869049645012,NaN,NaN,47.42962081135225,58.13298402180179,0.12741320526741137,0.0417158172394565,-0.08569738802795487,182559623,183062632.4,53.674493817860785,56.57872995237637,NaN,NaN,1.351178321426725,-5.337994056402191
2023-04-21T09:30:00-04:00,37.23,37.34,36.88,37.18,3252899,5289203.2,50.76003367845503,51.740569503903494,NaN,NaN,39.94536773893455,59.384779129028935,0.10222487257260766,0.0420837026878047,-0.06014116988480296,185812522,184209958,55.89361440952195,57.272314741235974,NaN,NaN,1.4459422961842412,-4.368860291746986