time,open,high,low,close,Volume,Volume MA,RSI,RSI-based MA,Upper Bollinger Band,Lower Bollinger Band,CCI,Smoothing Line,Histogram,MACD,Signal,OnBalanceVolume,Smoothing Line,RSI,RSI-based MA,Upper Bollinger Band,Lower Bollinger Band,True Strength Index,Signal
2018-06-19T09:30:00-04:00,49.7,50.06,49.58,49.96,16588,NaN,NaN,NaN,NaN,NaN,NaN,NaN,NaN,NaN,NaN,NaN,NaN,NaN,NaN,NaN,NaN,NaN,NaN
2018-06-20T09:30:00-04:00,50.45,50.889,50.45,50.58,189989,NaN,NaN,NaN,NaN,NaN,NaN,NaN,NaN,NaN,NaN,189989,NaN,NaN,NaN,NaN,NaN,NaN,NaN
2018-06-21T09:30:00-04:00,50.77,50.85,50.2,50.27,428740,NaN,NaN,NaN,NaN,NaN,NaN,NaN,NaN,NaN,NaN,-238751,NaN,NaN,NaN,NaN,NaN,NaN,NaN
2018-06-22T09:30:00-04:00,50.59,50.61,50.19,50.49,181638,NaN,NaN,NaN,NaN,NaN,NaN,NaN,NaN,NaN,NaN,-57113,NaN,NaN,NaN,NaN,NaN,NaN,NaN
2018-06-25T09:30:00-04:00,50.23,50.23,49.015,49.45,2509603,NaN,NaN,NaN,NaN,NaN,NaN,NaN,NaN,NaN,NaN,-2566716,NaN,NaN,NaN,NaN,NaN,NaN,NaN
2018-06-26T09:30:00-04:00,49.72,49.78,49.35,49.5322,104005,NaN,NaN,NaN,NaN,NaN,NaN,NaN,NaN,NaN,NaN,-2462711,-1027060.4,NaN,NaN,NaN,NaN,NaN,NaN
2018-06-27T09:30:00-04:00,49.82,50,49.1,49.1,144983,NaN,NaN,NaN,NaN,NaN,NaN,NaN,NaN,NaN,NaN,-2607694,-1586597,NaN,NaN,NaN,NaN,NaN,NaN
2018-06-28T09:30:00-04:00,49.1,49.79,48.97,49.59,336481,NaN,NaN,NaN,NaN,NaN,NaN,NaN,NaN,NaN,NaN,-2271213,-1993089.4,NaN,NaN,NaN,NaN,NaN,NaN
2018-06-29T09:30:00-04:00,49.8,49.84,49.4204,49.53,152346,NaN,NaN,NaN,NaN,NaN,NaN,NaN,NaN,NaN,NaN,-2423559,-2466378.6,NaN,NaN,NaN,NaN,NaN,NaN
2018-07-02T09:30:00-04:00,49.11,49.84,48.94,49.84,321297,NaN,NaN,NaN,NaN,NaN,NaN,NaN,NaN,NaN,NaN,-2102262,-2373487.8,NaN,NaN,NaN,NaN,NaN,NaN
2018-07-03T09:30:00-04:00,50,50,49.189,49.23,97459,NaN,NaN,NaN,NaN,NaN,NaN,NaN,NaN,NaN,NaN,-2199721,-2320889.8,NaN,NaN,NaN,NaN,NaN,NaN
2018-07-05T09:30:00-04:00,49.59,50,49.33,49.9799,324879,NaN,NaN,NaN,NaN,NaN,NaN,NaN,NaN,NaN,NaN,-1874842,-2174319.4,NaN,NaN,NaN,NaN,NaN,NaN
2018-07-06T09:30:00-04:00,50.14,50.8164,49.93,50.77,199770,NaN,NaN,NaN,NaN,NaN,NaN,NaN,NaN,NaN,NaN,-1675072,-2055091.2,NaN,NaN,NaN,NaN,NaN,NaN
2018-07-09T09:30:00-04:00,51.2,51.2,50.65,51.06,118112,NaN,NaN,NaN,NaN,NaN,NaN,NaN,NaN,NaN,NaN,-1556960,-1881771.4,NaN,NaN,NaN,NaN,NaN,NaN
2018-07-10T09:30:00-04:00,51.21,51.21,50.87,51.039,1153296,NaN,58.953762405815375,NaN,NaN,NaN,NaN,NaN,NaN,NaN,NaN,-2710256,-2003370.2,NaN,NaN,NaN,NaN,NaN,NaN
2018-07-11T09:30:00-04:00,50.7,51.23,50.65,50.97,227517,NaN,58.23557749299459,NaN,NaN,NaN,NaN,NaN,NaN,NaN,NaN,-2937773,-2150980.6,NaN,NaN,NaN,NaN,NaN,NaN
2018-07-12T09:30:00-04:00,51.3,51.77,51.14,51.77,361366,NaN,63.74954047932951,NaN,NaN,NaN,NaN,NaN,NaN,NaN,NaN,-2576407,-2291293.6,NaN,NaN,NaN,NaN,NaN,NaN
2018-07-13T09:30:00-04:00,51.78,51.7998,51.4486,51.69,80077,NaN,62.85584873873433,NaN,NaN,NaN,NaN,NaN,NaN,NaN,NaN,-2656484,-2487576,NaN,NaN,NaN,NaN,NaN,NaN
2018-07-16T09:30:00-04:00,51.78,51.78,51.45,51.54,200891,NaN,61.12555647145402,NaN,NaN,NaN,NaN,NaN,NaN,NaN,NaN,-2857375,-2747659,NaN,NaN,NaN,NaN,NaN,NaN
2018-07-17T09:30:00-04:00,50.81,51.68,50.72,51.55,172559,366079.8,61.20223502364129,NaN,NaN,NaN,89.7115727374126,NaN,NaN,NaN,NaN,-2684816,-2742571,20.3701335555171,NaN,NaN,NaN,NaN,NaN
2018-07-18T09:30:00-04:00,51.59,51.6,51.23,51.4,147833,372642.05,59.312369360523846,NaN,NaN,NaN,89.54533081326244,NaN,NaN,NaN,NaN,-2832649,-2721546.2,20.988114757316268,NaN,NaN,NaN,NaN,NaN
2018-07-19T09:30:00-04:00,51.43,51.47,51.0062,51.04,258442,376064.7,54.92850268380371,NaN,NaN,NaN,62.746104164110314,NaN,NaN,NaN,NaN,-3091091,-2824483,20.16306653324662,NaN,NaN,NaN,NaN,NaN
2018-07-20T09:30:00-04:00,51.05,51.186,50.84,50.87,158390,362547.2,52.93867161322642,NaN,NaN,NaN,40.819870518198776,NaN,NaN,NaN,NaN,-3249481,-2943082.4,19.22533950563512,NaN,NaN,NaN,NaN,NaN
2018-07-23T09:30:00-04:00,50.93,51.1,50.65,51.08,94753,358202.95,55.10237094789862,NaN,NaN,NaN,35.95279152735282,63.75513395206739,NaN,NaN,NaN,-3154728,-3002553,18.754333974047057,NaN,NaN,NaN,NaN,NaN
2018-07-24T09:30:00-04:00,52.11,52.11,51.16,51.44,211201,243282.85,58.615084170246625,NaN,NaN,NaN,82.3708391386811,62.28698723232109,NaN,NaN,NaN,-2943527,-3054295.2,18.333486896410136,NaN,NaN,NaN,NaN,NaN
2018-07-25T09:30:00-04:00,51.53,51.875,51.38,51.81,612027,268683.95,61.91328230377741,NaN,NaN,NaN,87.00567351505893,61.77905577268039,NaN,0.6014303297162584,NaN,-2331500,-2954065.4,21.98551871134849,NaN,NaN,NaN,NaN,NaN
2018-07-26T09:30:00-04:00,49.75,50.02,49.57,49.8562,833638,303116.7,42.60455150188642,NaN,NaN,NaN,-87.75342685810463,31.679149568237392,NaN,0.4496261019141983,NaN,-3165138,-2968874.8,21.830182329421575,NaN,NaN,NaN,NaN,NaN
2018-07-27T09:30:00-04:00,49.77,49.83,48.638,48.91,1111208,341853.05,36.644308674188245,56.29869013339432,NaN,NaN,-146.6994358240862,-5.824711700219604,NaN,0.2500868795403406,NaN,-4276346,-3174247.8,19.746562247636774,NaN,NaN,NaN,NaN,NaN
2018-07-30T09:30:00-04:00,49.02,49.02,47.869,48.14,251253,346798.4,32.64227416731592,54.41929811635864,NaN,NaN,-191.14088516117747,-51.24344703792566,NaN,0.02947823660309723,NaN,-4527599,-3448822,17.36077678573075,NaN,NaN,NaN,NaN,NaN
2018-07-31T09:30:00-04:00,48.37,48.77,48.14,48.46,1211405,391303.8,35.781195620999114,52.815413696930385,NaN,NaN,-163.19283878632854,-100.35618262292759,NaN,-0.11817216155689181,NaN,-3316194,-3523355.4,16.768519385509677,NaN,NaN,NaN,NaN,NaN
2018-08-01T09:30:00-04:00,48.56,48.779,48.119,48.26,1250389,448950.3,34.693017940502784,50.73994780129991,NaN,NaN,-152.2305155861138,-148.20342044316212,NaN,-0.2484603975904136,NaN,-4566583,-3970372,13.74082775823419,NaN,NaN,NaN,NaN,NaN
2018-08-02T09:30:00-04:00,48.09,48.66,47.9,48.58,190710,442241.85,37.94484539607054,48.96059041968107,NaN,NaN,-134.80623881377713,-157.61398283429662,NaN,-0.3221795523449913,NaN,-4375873,-4212519,12.431412150912081,NaN,NaN,NaN,NaN,NaN
2018-08-03T09:30:00-04:00,48.86,48.93,48.65,48.91,117156,438111.15,41.19660849639166,47.53709413574804,NaN,NaN,-91.32773439003454,-146.5396425474863,NaN,-0.3499403766986404,NaN,-4258717,-4208993.2,12.562067670226213,18.161453018656577,NaN,NaN,NaN,NaN
2018-08-06T09:30:00-04:00,48.91,49.41,48.82,49.4,110254,437718.25,45.74296914520803,46.4328608587171,NaN,NaN,-61.59926209419615,-120.63131793409002,-0.32453128813138776,-0.32861406669994153,-0.004082778568553793,-4148463,-4133166,15.482701104711666,17.8123507007419,NaN,NaN,NaN,NaN
2018-08-07T09:30:00-04:00,49.68,49.799,49.42,49.46,128846,386495.75,46.29055475860636,45.50273124429442,NaN,NaN,-37.78992477312509,-95.55073513144934,-0.23943314100894653,-0.303374204829737,-0.06394106382079044,-4019617,-4273850.6,14.514040310603605,17.349916811690996,NaN,NaN,NaN,NaN
2018-08-08T09:30:00-04:00,49.55,49.6,49.3584,49.42,114201,380829.95,45.95755315256513,44.86194913492023,NaN,NaN,-39.07070762504516,-72.91877353923562,-0.17551355820060177,-0.28333301157154267,-0.10781945337094088,-4133818,-4187297.6,17.9165610764,17.189452136201954,NaN,NaN,NaN,NaN
2018-08-09T09:30:00-04:00,49.46,49.885,49.46,49.69,306361,378079.7,48.64314975628065,44.555126145138395,NaN,NaN,-22.91844017665974,-50.54121381181214,-0.10803555267492798,-0.24286389421460086,-0.13482834153967288,-3827457,-4077614.4,22.145508960711027,17.398035668707372,NaN,NaN,NaN,NaN
2018-08-10T09:30:00-04:00,49.53,49.53,49.15,49.27,177577,382954.7,44.904888839975655,43.826734566001036,NaN,NaN,-39.15169107493623,-40.10600514879249,-0.08565245843619268,-0.24189391458491372,-0.15624145614872104,-4005034,-4026877.8,24.09365190196266,17.779415520701345,NaN,NaN,-17.80310518703371,NaN
2018-08-13T09:30:00-04:00,49.33,49.61,49.17,49.2,261036,385961.95,44.293911104972956,42.8037936327672,NaN,NaN,-34.281793960066274,-34.64251152196651,-0.0701759381301422,-0.2439613788113988,-0.1737854406812566,-4266070,-4050399.2,23.79636602352703,18.169621172638266,NaN,NaN,-17.146680755577744,NaN
2018-08-14T09:30:00-04:00,49.44,49.63,49.11,49.55,189801,386824.05,48.09653030898794,41.816882775996525,NaN,NaN,-23.201325626027188,-31.724791692546933,-0.03287626536916324,-0.21488077239271064,-0.1820045070235474,-4076269,-4061729.6,23.64501754926539,18.288156803918046,NaN,NaN,-15.558520461559633,NaN
2018-08-15T09:30:00-04:00,49.24,49.2999,48.49,48.86,551847,407024.75,42.0084232605222,41.77430218732765,NaN,NaN,-58.71912801975826,-35.654475771489544,-0.05014901262647575,-0.2446907728066421,-0.19454176018016633,-4628116,-4160589.2,22.311628259625024,18.322545798932577,NaN,NaN,-15.755149795155651,NaN
2018-08-16T09:30:00-04:00,49.19,49.2347,48.76,48.84,177579,402981.6,41.84309089527844,42.145643774548375,NaN,NaN,-49.99486112181737,-41.069759960521075,-0.057849095052983024,-0.26685312899639513,-0.2090040339434121,-4805695,-4356236.8,19.917770188235224,18.334774937546747,NaN,NaN,-15.96023973756757,NaN
2018-08-17T09:30:00-04:00,48.66,48.81,48.4,48.61,226924,406408.3,39.898361911491776,42.66393575627523,NaN,NaN,-75.74121167555298,-48.38766408064443,-0.07241542518471228,-0.29952331542430244,-0.22710789023959016,-5032619,-4561753.8,17.761936048668005,18.3634291706137,NaN,NaN,-16.64851372778257,NaN
2018-08-20T09:30:00-04:00,48.85,48.85,48.3707,48.69,145778,408959.55,40.92678721759276,43.03147801317478,NaN,NaN,-68.27475007948235,-55.18625530452764,-0.07057327007592318,-0.31532447783449413,-0.24475120775857095,-4886841,-4685908,16.59348484977201,18.350926703775293,NaN,NaN,-16.96268858332765,NaN
2018-08-21T09:30:00-04:00,48.95,49.23,48.81,48.99,384889,417643.95,44.74511391989592,43.74948486884572,NaN,NaN,-18.89431437915588,-54.32485305515338,-0.04434242632048979,-0.3001792406591832,-0.25583681433869343,-4501952,-4771044.6,15.82471601122964,18.49977586470354,NaN,NaN,-16.23297144443294,NaN
2018-08-22T09:30:00-04:00,48.85,49.03,48.75,48.93,501855,412135.35,44.13073217183993,44.19133392425782,NaN,NaN,-19.689907942657324,-46.5190090397332,-0.027073582798049778,-0.28967879283625564,-0.26260521003820586,-5003807,-4846182.8,15.157281509710145,18.6944808189034,NaN,NaN,-15.770097498863167,NaN
2018-08-23T09:30:00-04:00,48.88,49.17,48.7199,48.73,283725,384639.7,42.05772004973436,44.25284189235372,NaN,NaN,-18.553059773124325,-40.230648769994595,-0.02519997547456987,-0.2941051793814182,-0.26890520390684836,-5287532,-4942550.2,14.322912609304737,18.82025545740901,NaN,NaN,-15.886333798468396,NaN
2018-08-24T09:30:00-04:00,48.96,49.44,48.88,49.44,330882,345623.4,50.87916082717567,44.61971272677999,NaN,NaN,53.51904493733395,-14.378597447417206,0.025057488378423476,-0.23758334343381904,-0.2626408318122425,-4956650,-4927356.4,15.116294111006653,18.794083529287224,NaN,NaN,-13.486159686693181,NaN
2018-08-27T09:30:00-04:00,49.75,50.019,49.6609,49.92,299237,348022.6,55.78060754721978,45.297573640252374,NaN,NaN,149.2350797304689,29.123368514573066,0.08827126308866662,-0.15230175295140924,-0.24057301604007586,-4657413,-4881470.8,17.597997284829603,19.014366170303365,NaN,NaN,-9.884816848853626,NaN
2018-08-28T09:30:00-04:00,50.06,50.06,49.631,49.7,150238,294964.25,53.16225552870006,45.81219523854772,NaN,NaN,121.69970876380575,57.24217314316538,0.11141847917627565,-0.1012999170697313,-0.21271839624600694,-4807651,-4942610.6,16.889443023744732,18.941000595113703,NaN,NaN,-7.5990593724962405,-14.976487453677853
2018-08-29T09:30:00-04:00,49.83,50.02,49.67,49.98,270866,245988.1,55.993526247503205,46.33722213077791,NaN,NaN,126.75491922807284,86.53113857731141,0.13989422387831751,-0.03785061639811005,-0.17774484027642756,-4536785,-4849206.2,22.052869578569172,18.934383496389284,NaN,NaN,-4.815226114265557,-13.524878690904668
2018-08-30T09:30:00-04:00,49.81,50.035,49.48,49.67,344409,253673.05,52.229200903560645,46.86038727817684,NaN,NaN,90.44217210626911,108.33018495319011,0.13224577260758882,-0.012437624516941526,-0.14468339712453035,-4881194,-4767938.6,26.340761391477884,19.094891317068946,NaN,NaN,-3.4971871268798727,-12.09235132461541
2018-08-31T09:30:00-04:00,49.62,49.62,49.0419,49.18,234969,259563.7,46.86597534252929,47.044106152288,NaN,NaN,-0.4389047363134115,97.53859501846064,0.09056772524365264,-0.03147374056996455,-0.12204146581361719,-5116163,-4799841.2,25.742100353377793,19.233872340629713,NaN,NaN,-3.933352979727114,-10.926780132488512
2018-09-04T09:30:00-04:00,49.05,49.05,48.3999,48.57,343694,271235.7,41.194794913391235,46.55112505260252,NaN,NaN,-110.39953285010715,45.61167250234543,0.021880876599931917,-0.09469037006370229,-0.1165712466636342,-5459857,-4960330,22.92001061795591,19.182086131250465,NaN,NaN,-6.116121912239691,-10.239543243881537
2018-09-05T09:30:00-04:00,48.52,48.52,47.76,47.94,773599,303473.35,36.308104961639906,46.14395945982522,NaN,NaN,-183.3636865376414,-15.401006557944005,-0.06146011155315542,-0.19339638610507848,-0.13193627455192306,-6233456,-5245491,18.945656339848668,18.941659565552154,NaN,NaN,-9.641893198747413,-10.154164666005233
2018-09-06T09:30:00-04:00,47.91,47.98,47.17,47.58,599592,327742.9,33.83795572479423,45.57216409050492,NaN,NaN,-214.61956528172647,-83.67590345990386,-0.132246308882312,-0.29724416065481307,-0.16499785177250106,-6833048,-5704743.6,14.565238477373612,18.559335871919185,NaN,NaN,-13.362620058763333,-10.612515436399248
2018-09-07T09:30:00-04:00,47.28,47.95,47.23,47.68,755726,350211.15,35.1576118990464,45.23353908961597,NaN,NaN,-180.00353970237893,-137.76504582163346,-0.16179513567236367,-0.36724177136295566,-0.205446635690592,-6077322,-5943969.2,12.892991926368282,18.211554148897772,NaN,NaN,-15.927472233987464,-11.37179497891185
2018-09-10T09:30:00-04:00,47.98,47.98,47.5587,47.78,310874,356876,36.52114488042652,44.918850351246945,NaN,NaN,-138.67263181698698,-165.4117912377682,-0.16357941533968867,-0.40992090486520283,-0.24634148952551416,-5766448,-6074026.2,12.080921781135757,17.889228215423753,NaN,NaN,-17.613935987715347,-12.263529408740922
2018-09-11T09:30:00-04:00,47.72,48.36,47.66,48.26,615753,374611.85,42.74482564810966,44.775972617547936,NaN,NaN,-87.80359145584971,-160.8926029589167,-0.12324433704362037,-0.4003969108300396,-0.2771525737864192,-5150695,-6012193.8,14.827587687411196,17.818004763722435,NaN,NaN,-17.215278710415227,-12.970922166122966
2018-09-12T09:30:00-04:00,48.13,48.25,47.85,48.12,713288,400786.2,41.467796919381,44.58576295665801,NaN,NaN,-79.95572432566985,-140.2110105165224,-0.09791014541155302,-0.3995402555508605,-0.30163011013930746,-5863983,-5938299.2,18.119763947026485,18.029610652102175,NaN,NaN,-17.258017239011732,-13.583364319392789
2018-09-13T09:30:00-04:00,48.31,48.52,48.21,48.46,754494,410918.55,45.70982848592938,44.84662784495765,NaN,NaN,-39.570945293492116,-105.20128651887553,-0.05245064345407918,-0.36719341445690645,-0.31474277100282727,-5109489,-5593587.4,31.434123840474186,19.251840025757136,NaN,NaN,-16.039653993153205,-13.934262844215706
2018-09-14T09:30:00-04:00,48.64,48.64,48.25,48.37,1190839,461581.55,44.78458537793108,44.411301027154465,NaN,NaN,-33.82119727075078,-75.96481803254989,-0.024082098903056293,-0.34484539463164765,-0.32076329572859136,-6300328,-5638188.6,30.737678014852364,20.367653161746116,NaN,NaN,-15.295887262998775,-14.128780618327573
2018-09-17T09:30:00-04:00,48.42,48.42,47.86,47.9,810780,490774.35,40.2074587832921,43.29893325830249,NaN,NaN,-67.68716566934874,-61.76772480302223,-0.032108785605701906,-0.3608992777357187,-0.3287904921300168,-7111108,-5907120.6,26.871681605951167,21.03005918468337,NaN,NaN,-15.972458749513585,-14.392163208497003
2018-09-18T09:30:00-04:00,47.95,48.41,47.9,48.24,430348,505002.85,44.61712395054018,42.68856671700536,NaN,NaN,-50.60489707900375,-54.327985927653046,-0.010761035875277658,-0.3422417869741139,-0.33148075109883623,-6680760,-6213133.6,23.28316841387712,21.48675385540711,NaN,NaN,-15.242021216261184,-14.513571495320457
2018-09-19T09:30:00-04:00,48.29,48.42,47.99,48.37,2385315,605024.15,46.24939062327844,41.99255702956073,NaN,NaN,-38.903527743411196,-46.11754661120133,0.014501774393425204,-0.3133535331070547,-0.3278553075004799,-4295445,-5899426,33.14036762207405,22.278718001371743,NaN,NaN,-14.164942722216889,-14.463767384877091
2018-09-20T09:30:00-04:00,48.77,48.95,48.52,48.9,4554248,807643.8,52.40780043941418,42.005314139264556,NaN,NaN,16.12420691878928,-34.97851616874504,0.0663881635509101,-0.24487010306184231,-0.3112582666127524,258803,-4825767.6,54.627597189293176,24.299206272644263,NaN,NaN,-11.319552769677363,-14.014593868419986
2018-09-21T09:30:00-04:00,49.02,49.04,48.42,48.55,7975818,1192248.45,48.459241172524415,42.119118841407065,NaN,NaN,4.848084238357881,-27.244659866923307,0.07593086970039631,-0.216344679487257,-0.2922755491876533,-7717015,-5109105,50.05573873446405,26.03589472843614,NaN,NaN,-10.075976663893785,-13.451934267773385
2018-09-24T09:30:00-04:00,48.21,48.62,48.01,48.55,6769350,1514171.85,48.459241172524415,42.63800785991658,NaN,NaN,-20.678447966416055,-17.84291632633677,0.08059625177390017,-0.19153023447027806,-0.27212648624417823,-7717015,-5230286.4,48.197827810925915,27.841453099362564,NaN,NaN,-9.077989084295881,-12.827084955848028
2018-09-25T09:30:00-04:00,48.54,48.65,48.25,48.57,3994551,1698937.55,48.715312973494015,43.52423700362044,NaN,NaN,-2.8103471197122563,-8.284006334478473,0.08305271268419212,-0.1683105953889381,-0.25136330807313023,-3722464,-4638627.2,56.65671407441956,30.535100080403346,NaN,NaN,-8.188033010251948,-12.164363249334302
2018-09-26T09:30:00-04:00,48.65,49.25,48.6001,48.76,5688601,1975855.7,51.19601456401007,44.76409834927871,NaN,NaN,57.75886168152226,11.048471550508225,0.09465560178023164,-0.1330438058478407,-0.22769940762807234,1966137,-3386310.8,68.41360336046372,34.38141185776693,NaN,NaN,-6.742455832217716,-11.389805046889077
2018-09-27T09:30:00-04:00,49.06,49.53,48.89,49.18,3649353,2144780.05,56.235530853669765,46.26966398889466,NaN,NaN,120.52371075187315,31.928372317125003,0.12584537566279957,-0.07039268804957288,-0.19623806371237246,5615490,-2314973.4,74.72887520412881,38.798260663321244,NaN,NaN,-3.9856427493664337,-10.332067575814413
2018-09-28T09:30:00-04:00,49.07,49.12,48.7984,49,2306627,2242890.95,53.67734277310353,47.49510669551445,NaN,NaN,100.87528368362072,51.13381220617757,0.12909938462533507,-0.03486383293070361,-0.16396321755603868,3308863,-109797.8,82.4894433010641,43.82744077188756,NaN,NaN,-2.3562669528858224,-9.192667486824615
2018-10-01T09:30:00-04:00,49.17,49.22,48.5699,48.8,7636941,2612989.55,50.90634750787543,48.078072542640584,NaN,NaN,89.85269724423412,73.2400412483076,0.11310261992684961,-0.02258494264747668,-0.1356875625743263,-4328078,567989.6,84.10514272556455,48.77583756032708,NaN,NaN,-1.732703813998,-8.126958390706527
2018-10-02T09:30:00-04:00,48.77,48.9625,48.58,48.76,5823514,2886980.55,50.346552282713866,48.71226935430722,NaN,NaN,70.62523229602435,87.92715713145493,0.09583146254769352,-0.015898234389709387,-0.11172969693740291,-10151592,-717836,70.76520902963792,52.53622649479933,NaN,NaN,-1.3652752029007609,-7.161003649591417
2018-10-03T09:30:00-04:00,49.03,49.19,48.85,48.98,5146373,3105619.25,53.38288932117232,49.26034512825314,NaN,NaN,101.83854929500237,96.74309465415095,0.09504109643916689,0.0070716736115556955,-0.0879694228276112,-5005219,-2112107.2,59.70653924957207,54.55568473830632,NaN,NaN,-0.2172743701260546,-6.169042323953509
2018-10-04T09:30:00-04:00,48.93,48.93,47.87,48.28,5292234,3340251.35,44.13498031834062,49.21394476685381,NaN,NaN,-19.866006520581415,68.66515119966003,0.045693134714644285,-0.03085300443430583,-0.07654613914895012,-10297453,-5294695.8,43.135882726366646,55.44127078912877,NaN,NaN,-1.936075666741176,-5.564332801494604
2018-10-05T09:30:00-04:00,48.35,48.53,47.48,47.82,2648640,3434897.05,39.31501026332456,49.150198443998995,NaN,NaN,-107.74731599973836,26.940631262988212,-0.016290790108344694,-0.09690962678438098,-0.08061883667603628,-12946093,-8545687,33.046523784432864,55.88233094473461,NaN,NaN,-4.9924071772841785,-5.482629140893115
2018-10-08T09:30:00-04:00,47.6,47.83,47.01,47.66,2170015,3527854.1,37.769918474221306,48.661112338547646,NaN,NaN,-187.19304766644805,-28.468517719148224,-0.06376296288811575,-0.16032254028618098,-0.09655957739806523,-15116108,-10703293,28.31330591854828,56.24162648078255,NaN,NaN,-7.973905335330871,-5.838525740098508
2018-10-09T09:30:00-04:00,47.66,48.12,47.57,47.63,1991429,3596637.9,37.472549884574434,48.034195142925924,NaN,NaN,-125.83815952904423,-67.76119608416192,-0.0912092558987547,-0.2105711472715086,-0.11936189137275391,-17107537,-12094482,25.752113175391756,55.71389402030524,NaN,NaN,-10.465333938236403,-6.499498339832494
2018-10-10T09:30:00-04:00,47.53,47.54,45.71,45.75,4050865,3763516.75,24.470473823378214,46.03867181320908,NaN,NaN,-301.4399991285639,-148.41690576887518,-0.2225197291221441,-0.39751155277543404,-0.17499182365328994,-21158402,-15325118.6,21.001152220962155,53.312005093995886,NaN,NaN,-18.46082592334515,-8.208259423191445
2018-10-11T09:30:00-04:00,45.66,46.27,44.93,45.36,8841290,4167856.55,22.710081034469923,44.19944608906233,NaN,NaN,-289.33052062676865,-202.30980859011262,-0.3164512597706022,-0.5705558983665426,-0.25410463859594046,-29999692,-19265566.4,16.90462167345632,50.94406816106676,NaN,NaN,-25.333324065644252,-10.654697229256131
2018-10-12T09:30:00-04:00,46.44,46.5,45.59,46.37,5877552,4402192.2,35.62584732746886,43.28277510012979,NaN,NaN,-174.56834608232924,-215.6740146066308,-0.29196436153520156,-0.6190600905149424,-0.3270957289797408,-24122140,-21500775.8,15.104741133534873,48.58027625553883,NaN,NaN,-26.103728804345838,-12.861701739983232
2018-10-15T09:30:00-04:00,46.21,46.68,46,46.19,1576938,4440500.1,34.51874407477946,42.26873446450732,NaN,NaN,-133.78734388142257,-204.9928738496257,-0.2698163039945439,-0.6643661089729207,-0.3945498049783768,-25699078,-23617369.8,13.625328766414029,45.50660587639557,NaN,NaN,-27.082260402857163,-14.893210120393793
2018-10-16T09:30:00-04:00,46.69,47.505,46.61,47.41,3707728,4604369.1,46.62552194789551,41.94227070621343,NaN,NaN,-58.34871415359802,-191.49498477453648,-0.16033552898493192,-0.5949692162095417,-0.43463368722460977,-21991350,-24594132.4,12.992890858408245,41.547983554820185,NaN,NaN,-23.129415888039237,-16.069810944343143
2018-10-17T09:30:00-04:00,47.74,47.74,47.11,47.6,4571077,4713657.2,48.23084020159211,41.37050708820788,NaN,NaN,-32.22695810987438,-137.65237657079857,-0.0672222183451664,-0.5186614601560677,-0.45143924181090134,-17420273,-23846506.6,16.1991546045479,37.367289226278686,NaN,NaN,-19.594725230170873,-16.573370128032817
2018-10-18T09:30:00-04:00,47.49,47.49,46.377,46.73,21297459,5550817.75,42.00149264267253,40.5365177931771,NaN,NaN,-68.57567289987833,-93.5014070254205,-0.05674238150159666,-0.5223672186878972,-0.4656248371863005,-38717732,-25590114.6,14.826872747405332,32.534248472445924,NaN,NaN,-18.952209838422032,-16.913204372374132
2018-10-19T09:30:00-04:00,47,47.41,46.54,46.72,3544398,5329246.75,41.934449538843765,39.89566793824626,NaN,NaN,-60.00310966228293,-70.58835974141125,-0.043592457273072927,-0.5201154087776416,-0.4765229515045687,-42262130,-29218112.6,12.461387509897264,27.416837385612546,NaN,NaN,-18.496742327815173,-17.13942408029428
2018-10-22T09:30:00-04:00,46.99,47.12,46.51,46.69,2711722,5126365.35,41.71930398272727,39.279435916818635,NaN,NaN,-61.47997279754493,-56.12688552463571,-0.03063531200550773,-0.5148170915114534,-0.48418177950594565,-44973852,-33073067.4,10.537629124640176,23.114867392398423,NaN,NaN,-18.212316087208375,-17.292694366996294
2018-10-23T09:30:00-04:00,46.03,46.79,45.6378,46.59,2779554,5065615.5,40.96484407133364,38.39243268468731,NaN,NaN,-82.8821477191458,-61.03357223774526,-0.02287564421581001,-0.5127763347757082,-0.48990069055989816,-47753406,-38225478.6,8.621795646083015,19.465957135006345,NaN,NaN,-18.210004977954426,-17.423738739990313
2018-10-24T09:30:00-04:00,46.58,46.58,44.32,44.37,3552503,4958810.6,28.59971851685731,37.282771127438494,NaN,NaN,-148.40005870745838,-84.26819235726205,-0.15402173829815635,-0.6824278634325935,-0.5284061251344372,-51305909,-45002605.8,6.856113091158093,16.874545018205737,NaN,NaN,-22.917636817366436,-18.208581322472615
2018-10-25T09:30:00-04:00,45.17,46.15,45.17,45.84,3391689,4945927.4,41.246260292699354,37.42071755810814,NaN,NaN,-98.54847986151113,-90.26275374958861,-0.12951815172550685,-0.6903038147913207,-0.5607856630658139,-47914220,-46841903.4,6.468911476378622,14.976144139059002,NaN,NaN,-21.856049705370108,-18.729648234315114
2018-10-26T09:30:00-04:00,44.43,45.6,44.04,44.6,5229234,5092057.75,35.52949992872169,37.26068766200102,NaN,NaN,-148.05279733752488,-107.872691284637,-0.18139155013137231,-0.7875251007300292,-0.6061335505986569,-53143454,-49018168.2,6.034645908476406,13.384811281196729,NaN,NaN,-23.333793420355818,-19.387383260892356
2018-10-29T09:30:00-04:00,45.3,45.6,43.07,43.91,3490983,4884759.85,32.804821939621476,36.927278523075806,NaN,NaN,-164.75595332884842,-128.5278873908977,-0.24290413065831395,-0.9097637139215493,-0.6668595832632354,-56634437,-51350285.2,5.600742487898913,11.945427660661524,NaN,NaN,-25.52499490220235,-20.264184923936643
2018-10-30T09:30:00-04:00,43.84,45.17,43.665,45.11,6283632,4907765.75,41.243915026688434,38.125381466169394,NaN,NaN,-121.64845928469391,-136.2811497040073,-0.18606476041721032,-0.8994405337847482,-0.7133757733675379,-50350805,-51869765,5.505777621628781,10.838615189280565,NaN,NaN,-23.981295270010328,-20.795200687661456
2018-10-31T09:30:00-04:00,45.99,46.55,45.79,46.04,3577212,4829307.7,46.818408181810526,39.84740483383657,NaN,NaN,-19.539497574415062,-110.50903747739865,-0.07483098400838928,-0.8069145033780245,-0.7320835193696352,-46773593,-50963301.8,8.42365383561534,10.232831772291929,NaN,NaN,-20.61612581910868,-20.769618563582487
2018-11-01T09:30:00-04:00,46.19,46.41,45.74,46.31,2550117,4692201.85,48.35049781951485,40.756308440411296,NaN,NaN,-10.750604305918234,-92.94946236628007,0.0227159908567931,-0.7036885307986438,-0.7264045216554369,-44223476,-50225153,10.838109853770831,9.928072395165929,NaN,NaN,-17.53829477697943,-20.30800087978205
2018-11-02T09:30:00-04:00,46.45,46.7484,45.54,45.84,2628601,4691199.9,45.8730785746712,41.5673323332607,NaN,NaN,-13.138034233531307,-65.96650974548136,0.059293924497453965,-0.6522871160336194,-0.7115810405310734,-46852077,-48966877.6,14.954384889069004,10.023004975355567,NaN,NaN,-15.950609632887252,-19.685516415939937
2018-11-05T09:30:00-05:00,45.93,45.93,45.32,45.65,2439542,4704676.25,44.872121200579805,41.44208942273815,NaN,NaN,-43.06731459679756,-41.62878199907119,0.07347397156266955,-0.6197385760777365,-0.6932125476404061,-49291619,-47498314,19.6186390794378,10.49627270542911,NaN,NaN,-15.027983219066273,-19.020154530672272
2018-11-06T09:30:00-05:00,45.7,46.18,45.57,45.92,2040281,4707118.85,46.65350871176643,41.329422887750596,NaN,NaN,-11.478544206365132,-19.59479898340543,0.10206077905567046,-0.565636573820818,-0.6676973528764885,-47251338,-46878420.6,21.573878558086392,10.880181559253288,NaN,NaN,-13.735048175475647,-18.265139337072753
2018-11-07T09:30:00-05:00,46.39,46.79,46.17,46.76,2705818,4639866.5,51.864851517222036,42.03394852164699,NaN,NaN,55.67141016456171,-4.552617435610074,0.17432234840906136,-0.4497944173651618,-0.6241167657742231,-44545520,-46432806,23.02341888883231,11.465649140783785,NaN,NaN,-10.972521336299282,-17.223336765533688
2018-11-08T09:30:00-05:00,46.79,46.79,46.05,46.32,1295743,4262589.15,49.15604025119868,42.54977642967235,NaN,NaN,33.60818642732547,4.31914071103867,0.18808641592330388,-0.38900874587009326,-0.5770951617933971,-45841263,-46756363.4,22.69541104650115,12.196650821969778,NaN,NaN,-9.518038139763592,-16.122579818995103
2018-11-09T09:30:00-05:00,45.74,45.91,45.01,45.37,2234494,4080436.25,43.83297086659893,42.700752635663186,NaN,NaN,-57.848797666861515,-4.623011975627373,0.1314881518716866,-0.41273497195378894,-0.5442231238254756,-48075757,-47001099.4,22.435051985551013,13.046466740606263,NaN,NaN,-9.935320212320367,-15.23868558947014
2018-11-12T09:30:00-05:00,45.32,45.37,44.5,44.69,1203739,4061776.3,40.45592210761408,42.66440106682607,NaN,NaN,-99.51616696381083,-15.912782449030027,0.050686197200594085,-0.4808653773247329,-0.531551574525327,-49279496,-46998674.8,22.444544339506635,14.033805932993667,NaN,NaN,-11.362266481875714,-14.684911431242366
2018-11-13T09:30:00-05:00,44.89,45.29,44.46,44.55,2186090,3985694.4,39.77645827990106,43.4627396213292,NaN,NaN,-95.93898457251025,-32.80487052225905,-0.006704375499262616,-0.5399320438994053,-0.5332276684001427,-51465586,-47841524.4,21.461305073380103,15.07703393172381,NaN,NaN,-12.709963676850089,-14.402776037757755
2018-11-14T09:30:00-05:00,45.03,45.15,44.4099,44.77,2137620,3864021.55,41.4408603708625,43.47663962691228,NaN,NaN,-86.02974016177153,-61.145100587525704,-0.023422999276756507,-0.5625064174960883,-0.5390834182193318,-49327966,-48798013.6,20.37069635473121,16.070018565891854,NaN,NaN,-13.337690358298582,-14.250620940692158
2018-11-15T09:30:00-05:00,44.56,45.18,44.1357,45.1,3853098,2991803.5,43.94347552699718,44.077637883931956,NaN,NaN,-74.74015087748091,-82.81476804848697,-0.006699486758397932,-0.5474577766673292,-0.5407582899089313,-45474868,-48724734.6,20.70316663426196,17.117770046305107,NaN,NaN,-13.155845507066202,-14.094224450174165
2018-11-16T09:30:00-05:00,44.84,45.05,44.45,44.88,2092140,2919190.6,42.63531136735733,44.7798157001988,NaN,NaN,-68.34328269992423,-84.91366505509953,-0.004976210866366904,-0.5469785534918898,-0.5420023426255229,-47567008,-48622984.8,21.19517381322811,18.231657998114336,NaN,NaN,-13.365845690842917,-13.990170341698272
2018-11-19T09:30:00-05:00,44.73,44.76,43.39,43.52,2358029,2901505.95,35.58327326015373,44.37548414544632,NaN,NaN,-141.07784973799752,-93.22600160993686,-0.08548592461967797,-0.6488597484001204,-0.5633738237804424,-49925037,-48752093,21.01698072015118,19.33960107658022,NaN,NaN,-15.741213109095122,-14.240319308469251
2018-11-20T09:30:00-05:00,42.74,43.42,42.38,42.95,5028155,3013936,33.11130897402019,43.39640563060416,NaN,NaN,-202.89842033167918,-114.61788876177066,-0.16270643680380414,-0.7667568697851976,-0.6040504329813935,-54953192,-49449614.2,20.036876682852466,20.169116994240017,NaN,NaN,-18.516915059623816,-14.851261558634189
2018-11-21T09:30:00-05:00,43.39,43.86,43.32,43.46,3187427,2995682.2,37.307831803571446,42.60764377232248,NaN,NaN,-127.33869812328327,-122.87968035407297,-0.16452339651256864,-0.8097046786221043,-0.6451812821095356,-51765765,-49937174,19.357355438790975,20.77763453602717,NaN,NaN,-19.581750827712398,-15.527045739931076
2018-11-23T09:30:00-05:00,43.19,43.33,42.89,42.89,667072,2859451.35,34.688380774505035,41.80873678659633,NaN,NaN,-149.96544126053683,-137.92473843068416,-0.18753171713179106,-0.8795959285242745,-0.6920642113924834,-52432837,-51328767.8,17.52999551258125,20.961606723420903,NaN,NaN,-21.286103377900716,-16.349768259641024
2018-11-26T09:30:00-05:00,43.39,43.88,43.28,43.87,2563735,2726176.4,42.20215012674973,41.61802456703703,NaN,NaN,-91.33482796848436,-142.5230474843962,-0.1232714364040084,-0.8461535068974939,-0.7228820704934855,-49869102,-51789186.6,16.959545583633812,20.771671473720613,NaN,NaN,-20.41191872637584,-16.930075469174568
2018-11-27T09:30:00-05:00,43.72,44.15,43.53,44.01,2122395,2657747,43.207335809429004,41.37186935972722,NaN,NaN,-72.93773140685639,-128.89502381816797,-0.06100739419453416,-0.7991413132366532,-0.738133919042119,-47746707,-51353520.6,19.62482627550702,20.632453453536375,NaN,NaN,-19.407181346855555,-17.28394773741471
2018-11-28T09:30:00-05:00,44.24,44.93,43.73,44.93,2707439,2478937.35,49.43122076140004,41.19803859145423,NaN,NaN,-25.965664193284123,-93.50847259048896,0.04665828637583247,-0.6798110610723285,-0.7264693474481609,-45039268,-49370735.8,30.55008109196355,21.170072182331463,NaN,NaN,-16.56542001432003,-17.181300919829756
2018-11-29T09:30:00-05:00,44.69,45.305,44.535,45.08,2247728,2412463.15,50.38591093156563,41.285886497194724,NaN,NaN,11.382324767104901,-65.76426801241132,0.1278908765980491,-0.5666057517005996,-0.6944966282986487,-42791540,-47575890.8,38.67606102005129,22.311547180442187,NaN,NaN,-13.985460395356897,-16.72475227347649
2018-11-30T09:30:00-05:00,45.16,45.16,44.64,45.01,5563462,2563130.4,49.91234611412774,41.720127586303924,NaN,NaN,14.288775360602282,-32.91342468818352,0.17396599605685092,-0.47703913322758495,-0.6510051292844359,-48355002,-46760323.8,41.99707913716058,23.708834834128588,NaN,NaN,-12.01859139325572,-16.052443576302096
2018-12-03T09:30:00-05:00,45.98,45.98,44.9,45.08,5790400,2721220.35,50.414240077304584,42.431436012710385,NaN,NaN,51.426372293932225,-4.361184635700221,0.20412772929674416,-0.3958454676635057,-0.5999731969602499,-42564602,-45299423.8,47.48342433740651,25.497326262550008,NaN,NaN,-10.254662996385617,-15.224189207742599
2018-12-04T09:30:00-05:00,45,45.26,43.65,43.75,3268035,2762645,41.836466740601516,42.578579474188984,NaN,NaN,-38.810140784242265,2.464333488822592,0.13292415472121255,-0.43381800355873423,-0.5667421582799468,-45832637,-44916609.8,48.84876613776955,27.45357348143497,NaN,NaN,-11.147150718568678,-14.64175513786061
2018-12-06T09:30:00-05:00,43.1,44.24,42.97,44.24,3560387,2838650.3,45.5146249680569,42.86956265970287,NaN,NaN,-65.95944725141311,-5.534423122803199,0.11776456512864386,-0.419536451869142,-0.5373010169977859,-42272250,-44363206.2,50.83856152385418,29.62984956494375,NaN,NaN,-10.794751908828427,-14.09218324799887
2018-12-07T09:30:00-05:00,44.09,44.45,43.21,43.4,2625902,2834654.5,40.756416081034686,42.641915556419825,NaN,NaN,-68.87565187950938,-21.58601845212606,0.053381048164713896,-0.4705747067918935,-0.5239557549566074,-44898152,-44784528.6,49.26723042084496,31.670139835413966,NaN,NaN,-11.972955299863344,-13.789436398265224
2018-12-10T09:30:00-05:00,43.52,43.94,42.9071,43.73,3379488,2938841.75,43.26574299174825,42.686946386733474,NaN,NaN,-76.48581865522456,-39.74093725529143,0.036065017958348045,-0.47887448250867237,-0.5149395004670204,-41518664,-43417261,54.213065984214694,34.02856070477015,NaN,NaN,-12.1843695179135,-13.560141129643549
2018-12-11T09:30:00-05:00,44.26,44.36,43.53,43.77,4425853,3048409.7,43.57770192512488,43.25797700565998,NaN,NaN,-33.73465422930265,-56.7731425599384,0.030568389541427377,-0.4767290135402362,-0.5072974030816636,-37092811,-42322902.8,57.762355672953156,36.65323034425601,NaN,NaN,-12.26553755322812,-13.375197761584202
2018-12-12T09:30:00-05:00,44.18,44.8299,44.18,44.24,3352640,3155854.75,47.24809638991626,44.26774753536684,NaN,NaN,28.10382026240864,-43.390350350608216,0.06013999942911008,-0.432122403795276,-0.4922624032243861,-33740171,-39904409.6,64.34103446017826,39.81781304263641,NaN,NaN,-11.278591738134217,-13.075682615377062
2018-12-13T09:30:00-05:00,44.38,44.54,43.76,44.04,1984075,3145754,45.880350194074715,44.88007027754565,NaN,NaN,-3.0001111524495943,-30.79848313081552,0.06724660306475594,-0.4082041493934412,-0.4754507524581971,-35724246,-38594808.8,67.31017235803829,43.24301425115407,NaN,NaN,-10.835674198711736,-12.755681412996301
2018-12-14T09:30:00-05:00,43.59,44.14,43.52,43.61,1910821,3134414.05,42.998336765812304,45.47363856263902,NaN,NaN,-41.393448140164466,-25.302042382946535,0.04506870480639946,-0.41911487145019777,-0.46418357625659723,-37635067,-37142191.8,70.26744108278773,47.009974649025956,NaN,NaN,-11.263407885898205,-12.542499480553715
2018-12-17T09:30:00-05:00,43.45,43.84,42.44,42.76,3275012,3105509.75,37.92668615307907,45.16824827880539,NaN,NaN,-123.28892952800994,-34.66266455750362,-0.021207689328228085,-0.4906931879168823,-0.46948549858865424,-40910079,-37020474.8,70.50819002470658,50.834877823388304,NaN,NaN,-13.170809954190672,-12.632258119644709
2018-12-18T09:30:00-05:00,42.99,43.42,42.7,42.95,3597411,3180773.3,39.640496220995544,44.91347402248872,NaN,NaN,-114.75029336926124,-50.86579238549533,-0.045231141266963926,-0.5260244251723591,-0.4807932839053952,-37312668,-37064446.2,70.2867737979973,54.45358836070904,NaN,NaN,-14.255916139078328,-12.864209265278083
2018-12-19T09:30:00-05:00,42.89,43.57,41.79,42.03,5714136,3348578.65,34.65164527800728,43.85779005938924,NaN,NaN,-159.2665015426068,-88.33985674649841,-0.1122464344826627,-0.6211013270087236,-0.5088548925260609,-43026804,-38921772.8,61.5014476966584,56.664400261044385,NaN,NaN,-16.779538635161693,-13.423542032404313
2018-12-20T09:30:00-05:00,41.78,42.21,40.7669,41.29,9067038,3550522.8,31.245398635587932,42.490610609676544,NaN,NaN,-240.84484217728775,-135.90880295146604,-0.1909521166960293,-0.7475450383960975,-0.5565929217000682,-52093842,-42195692,49.70725060205143,57.4523423740444,NaN,NaN,-20.057291393749235,-14.371220512596445
2018-12-21T09:30:00-05:00,41.26,41.61,39.5,39.81,7990226,3790662.75,25.785936902697628,40.767295666002966,NaN,NaN,-260.95934000742994,-179.82198132491914,-0.31964907906153517,-0.9561542705269872,-0.636505191465452,-60084068,-46685492.2,38.73628701413675,57.21942865097127,NaN,NaN,-24.999620758590158,-15.88956340488126
2018-12-24T09:30:00-05:00,39.53,40.16,38.97,38.97,3888462,3951732.25,23.29776557384426,38.830404630041514,NaN,NaN,-247.5397913447723,-204.6721536882716,-0.4313612501526741,-1.1757067541562947,-0.7443455040036205,-63972530,-51297982.4,31.13387596835456,56.051603767467554,NaN,NaN,-29.990128743049425,-17.903929881762426
2018-12-26T09:30:00-05:00,39.27,41.18,39.041,41.16,4103965,4028743.75,39.648431332852724,38.67411638663088,NaN,NaN,-146.3179434077945,-210.98568369597825,-0.33222086560688635,-1.1596215860122285,-0.8274007204053422,-59868565,-55809161.8,25.800514193096774,54.405300057133786,NaN,NaN,-28.25661936387232,-19.38288552206384
2018-12-27T09:30:00-05:00,40.59,41.35,39.75,41.35,3768743,4111061.15,40.826974168767734,38.33928418668165,NaN,NaN,-109.25627934325635,-200.98363925610818,-0.232997415941538,-1.1186474903322647,-0.8856500743907267,-56099822,-58423765.4,23.308333556932993,52.43885520235369,NaN,NaN,-26.542658326067315,-20.40571020835005
2018-12-28T09:30:00-05:00,41.51,41.84,40.96,41.22,2631927,4107285.55,40.24784705533548,38.30295782770314,NaN,NaN,-74.0867220274776,-167.63201522614617,-0.1588139640391132,-1.0841675294396182,-0.9253535654005051,-58731749,-59751346.8,22.13897255641423,50.5011224977515,NaN,NaN,-25.420371788941303,-21.122090434148802
2018-12-31T09:30:00-05:00,41.54,41.68,40.76,41.28,5303616,4260079.95,40.66617954824295,38.11727472459561,NaN,NaN,-69.07672941766276,-129.25549310819272,-0.09172659148602613,-1.0400118047580378,-0.9482852132720117,-53428133,-58420159.8,26.140329887258858,48.49592706225466,NaN,NaN,-24.411377314389206,-21.59198855989743
2019-01-02T09:30:00-05:00,40.6,42.035,40.52,41.83,4671336,4215473.65,44.50186142060828,38.18328611713014,NaN,NaN,-52.02192719370889,-90.15192027798003,-0.001124016194026689,-0.949690233514545,-0.9485662173205183,-48756797,-55377013.2,34.435485644138026,46.82972206019644,NaN,NaN,-22.37783223525126,-21.704251942090835
2019-01-03T09:30:00-05:00,41.56,41.88,41.06,41.13,3433651,4097636.2,40.8796984657018,37.72840055111482,NaN,NaN,-50.05706701550903,-70.89974499952294,0.019698377987276472,-0.9239432448364227,-0.9436416228236991,-52190448,-53841389.8,38.2068954580996,44.962997845762246,NaN,NaN,-21.753523992445388,-21.7112908064272
2019-01-04T09:30:00-05:00,41.81,43.01,41.67,42.9,2647862,4066627.55,51.60582281589465,38.13736288124482,NaN,NaN,11.687834167009388,-46.71092229746979,0.1532770952464101,-0.7520452537656865,-0.9053223490120966,-49542586,-52529942.6,41.311719792826736,43.105965519675706,NaN,NaN,-17.468977558719644,-21.10524605675469
2019-01-07T09:30:00-05:00,42.95,43.57,42.81,43.39,4050946,4091155.5,54.0891232832734,38.929561918206325,NaN,NaN,51.78233069439306,-21.537111753095665,0.2684909150792131,-0.5697087051630803,-0.8381996202422933,-45491640,-49881920.8,47.0922987834035,41.450598212576836,NaN,NaN,-13.202926319950556,-19.976343237211243
2019-01-08T09:30:00-05:00,43.81,44.18,43.49,44.12,2144764,4067098.6,57.58136512429794,40.33346755900767,NaN,NaN,85.81095375063653,9.44042488056418,0.3808585683855831,-0.3621264097603145,-0.7429849781458976,-43346876,-47865669.4,51.04610195229984,40.06044906454779,NaN,NaN,-8.505017892617987,-18.33758247369792
2019-01-09T09:30:00-05:00,44.26,44.29,43.79,44.18,1840750,3990161.7,57.865055255129356,41.635221775731516,NaN,NaN,90.72575525404311,37.98996137011458,0.4419259131125721,-0.19057758675518244,-0.6325034998677546,-41506126,-46415535.2,53.724618636411385,38.877437981577366,NaN,NaN,-4.728069376034718,-16.39336631688889
2019-01-10T09:30:00-05:00,43.99,44.33,43.66,44.27,1340450,3835891.55,58.3153938666452,43.325489532062804,NaN,NaN,89.59603955904736,65.92058268502585,0.46854525852067075,-0.046821926716916096,-0.5153671852375868,-40165676,-44010580.8,57.84415387283359,38.61620270844702,NaN,NaN,-1.5513568000119606,-14.27307924304933
2019-01-11T09:30:00-05:00,43.99,44.12,43.66,44.05,1227913,3729655.2,56.71953574580074,45.14507075422086,NaN,NaN,84.89671893228771,80.56235963808152,0.45132645004706007,0.04879087732123821,-0.40253557272582186,-41393589,-42380781.4,60.41591605167453,39.3811073834201,NaN,NaN,0.6417703321258819,-12.142386446595728
2019-01-14T09:30:00-05:00,43.76,44.0621,43.55,43.89,2344916,3747697.25,55.52934759837588,47.26960008962645,NaN,NaN,80.76182831498394,86.35825916219969,0.41033376995492654,0.11038163971783632,-0.2999521302370902,-43738505,-42030154.4,60.96760474471964,40.96905864989031,NaN,NaN,2.1494222752209695,-10.1006994863362
2019-01-15T09:30:00-05:00,44.11,44.72,44.03,44.62,2459685,3775140.45,59.68584987851035,49.86874896853117,NaN,NaN,108.71357650074142,90.93878371222067,0.4124514788703625,0.21561221835086286,-0.1968392605194996,-41278820,-41616543.2,61.64666488233881,43.14854357231775,NaN,NaN,4.679878041143333,-7.989188410981981
2019-01-16T09:30:00-05:00,44.67,44.78,44.37,44.43,20343791,4628579.4,58.16211250906823,51.19115476683228,NaN,NaN,103.06943576364783,93.40751981414162,0.3818266195650747,0.2804440139368438,-0.1013826056282309,-61622611,-45639840.2,52.143695543616744,45.03019938306918,NaN,NaN,6.380756023403963,-5.936339206069704
2019-01-17T09:30:00-05:00,44.33,44.73,44.19,44.61,3311023,4614260,59.224163105922,52.50523969091473,NaN,NaN,94.06179458456036,94.30067081924422,0.3550270340689221,0.34240118695792177,-0.012625847111000371,-58311588,-49269022.6,45.35228069294871,46.60476703564173,NaN,NaN,8.102800726754342,-3.93074778709484
2019-01-18T09:30:00-05:00,44.94,45.2752,44.76,44.97,3375757,4497341.05,61.33801375971327,54.01168016979886,NaN,NaN,102.34542212917711,97.79041145862209,0.34270793570633806,0.41575907252192223,0.07305113681558414,-54935831,-51977471,41.054755995298926,47.95589442413349,NaN,NaN,10.169601776586022,-1.9164121351404315
2019-01-22T09:30:00-05:00,44.66,44.72,43.76,44.04,4343193,4261148.8,53.60666385982261,54.936000477768836,NaN,NaN,60.994789146566646,93.83700362493863,0.2570048266049881,0.39430717007181926,0.13730234346683118,-59279024,-55085574.8,36.750996442216085,48.713799178059006,NaN,NaN,9.855329707815347,-0.23473472900389192
2019-01-23T09:30:00-05:00,44.29,44.37,43.44,43.84,2540467,3988660.85,52.08618665504791,55.47773799451453,NaN,NaN,43.90824037651466,80.87593640009328,0.1757998684542122,0.3570521790345964,0.1812523105803842,-61819491,-59193709,31.979161739431774,48.538347470579986,NaN,NaN,9.162505606918847,1.1077281761279278
2019-01-24T09:30:00-05:00,43.82,44.09,43.59,44.04,2878743,3938174.9,53.50635367894384,56.379641938317526,NaN,NaN,40.00757772307693,68.2635647919791,0.12679754433288443,0.33974924099648973,0.2129516966636053,-58940748,-58657336.4,33.19873420249135,48.18062166660796,NaN,NaN,8.962963970030954,2.2299047181140743
2019-01-25T09:30:00-05:00,44.43,44.74,44.35,44.6,3341106,3900031.95,57.320849703557435,56.787858144579154,NaN,NaN,71.13964182739642,63.67913424054632,0.12323335187778359,0.3669933865108348,0.2437600346330512,-55599642,-58114947.2,34.47806101910142,47.692503182770444,NaN,NaN,9.850996973077777,3.318632183108889
2019-01-28T09:30:00-05:00,44.18,44.27,43.8211,44.21,4328163,3928002.95,53.99820325681923,56.78136385697528,NaN,NaN,39.91377294457358,51.19280440362561,0.08742808656296919,0.3530451428367627,0.2656170562737935,-59927805,-59113342,33.21700817658456,46.701410996569095,NaN,NaN,9.678343669401745,4.22716239543644
2019-01-29T09:30:00-05:00,44.18,44.19,43.55,43.69,1138073,3853310.25,49.849117543918155,56.22906045837673,NaN,NaN,14.201532626901521,41.834153099692585,0.02479614997580759,0.296612243743553,0.2718160937677454,-61065878,-59470712.8,32.75518896236231,45.394917211573556,NaN,NaN,8.327416901119905,4.812913039105506
2019-01-30T09:30:00-05:00,43.95,44.4035,43.51,44.32,2578227,3717040.8,54.41874949432021,55.982895761176074,NaN,NaN,31.114666141279233,39.27543825264549,0.021966843113166212,0.2992746476592032,0.277307804546037,-58487651,-58804344.8,34.58156985565486,44.02755658437666,NaN,NaN,8.471717146912093,5.335599340220733
2019-01-31T09:30:00-05:00,45.5,46.32,45.41,46.13,4798832,3723415.6,64.44297393573709,56.42058005182549,NaN,NaN,234.92486740555412,78.25889618914097,0.1320237593592853,0.4423375037451436,0.3103137443858583,-53688819,-57753959,37.46478224798196,42.57188718260154,NaN,NaN,12.0527631925042,6.295194176261228
2019-02-01T09:30:00-05:00,46.03,46.36,45.91,45.97,4395141,3771490.1,63.12147214355989,56.877861223094,NaN,NaN,225.88471416102894,109.20791065586748,0.18104450129632732,0.5366193710062674,0.3555748697099401,-58083960,-58250822.6,36.64210413063685,40.87375775967028,NaN,NaN,14.4293900437105,7.457222157325409
2019-02-04T09:30:00-05:00,46.01,46.4,45.86,46.4,3703092,3824251.6,65.18760947789318,57.56773707163095,NaN,NaN,201.62697159175312,141.55055038530338,0.22647898796078625,0.6386736046609229,0.4121946167001367,-54380868,-57141435.2,39.81965239187637,39.36318973446719,NaN,NaN,17.043154363304403,8.826641043893837
2019-02-05T09:30:00-05:00,46.36,46.95,46.33,46.91,2388556,3741132.1,67.51242905367641,58.12677844128567,NaN,NaN,202.9766818014635,179.30558022021577,0.27187315010968194,0.7520360543372391,0.48016290422755714,-51992312,-55326722,44.70490960447154,38.15306435747667,NaN,NaN,19.963968471332024,10.417687819242149
2019-02-06T09:30:00-05:00,46.53,46.53,45.76,45.86,3748888,3821338.3,58.80528774219539,58.17271952936618,NaN,NaN,114.86733164246655,196.05611332045322,0.2146871911843602,0.7485218932080073,0.5338347020236471,-55741200,-54777431.8,46.130370369765785,37.72354113077303,NaN,NaN,19.679403276638624,11.740790027441644
2019-02-07T09:30:00-05:00,45.45,45.5892,44.93,45.42,2341508,3846376.2,55.570933304437204,57.91177454354584,NaN,NaN,45.88355476928656,158.24785079319972,0.13464324153239304,0.7021387539391384,0.5674955124067453,-58082708,-55656209.6,44.168617003665624,37.63899372439567,NaN,NaN,18.398978154130276,12.691959759825734
2019-02-08T09:30:00-05:00,45.1,45.73,45.06,45.73,2600366,3909372,57.350754145820126,57.626970285410614,NaN,NaN,54.85846727131863,124.04260141525768,0.09202475091321838,0.6825264510482683,0.5905017001350499,-55482342,-55135886,45.64260924446315,37.9666975279074,NaN,NaN,17.90447689815316,13.43660506530108
2019-02-11T09:30:00-05:00,45.92,46.02,45.23,45.26,2061105,3951031.6,53.82985827196572,57.64291274342083,NaN,NaN,48.42615901424672,93.40243889975639,0.025110423866340326,0.6218897299679753,0.596779306101635,-57543447,-55768401.8,44.11780787251435,38.49289834435728,NaN,NaN,16.400254363033913,13.859983536405771
2019-02-12T09:30:00-05:00,45.69,45.94,45.67,45.78,2442958,3955933.7,56.97692306630642,57.992251058510725,NaN,NaN,65.06141235700598,65.81938501086486,0.00959795227380722,0.608776746443894,0.5991787941700868,-55100489,-56390037.2,42.61114844752762,39.252325966364126,NaN,NaN,16.083420249652388,14.177617352583859
2019-02-13T09:30:00-05:00,45.97,46.17,45.77,45.81,3620721,4013985.5,57.158354783788916,58.25310828028538,NaN,NaN,67.44918539208724,56.335755760789006,-0.0041761736906952285,0.5939585770567177,0.598134750747413,-51479768,-55537750.8,45.36600282723186,40.12141658241701,NaN,NaN,15.881007006971537,14.420958731782099
2019-02-14T09:30:00-05:00,45.57,46.1881,45.38,45.98,2103275,3101959.7,58.2332226070847,58.31827777339447,NaN,NaN,56.399134644434376,58.438871735818566,-0.007194684570100973,0.5891413950347868,0.5963360796048878,-49376493,-53796507.8,50.58501478108081,41.27191327970126,NaN,NaN,16.011942376507406,14.6482421096
2019-02-15T09:30:00-05:00,46.3,46.3,45.94,46.18,2283498,3050583.45,59.51997634111373,58.71269013655836,NaN,NaN,73.06952717288405,62.08108371613164,-0.0013826209009201174,0.5946078034787377,0.5959904243796578,-47092995,-52118638.4,55.0417624593797,42.830824299900904,NaN,NaN,16.4735667250961,14.909002768956585
2019-02-19T09:30:00-05:00,46.05,46.4,45.98,46.23,4218764,3092733.8,59.85297503470357,59.42725138590017,NaN,NaN,71.66240262564874,66.72833243841204,0.0000900995372087321,0.5961030488011687,0.59601294926396,-42874231,-49184795.2,61.568679760890525,44.88893078551007,NaN,NaN,16.946587408589693,15.200086288904172
2019-02-20T09:30:00-05:00,46.28,46.38,45.8201,46.07,3566312,3053889.75,58.20298362956041,59.69755382413161,NaN,NaN,58.49771994354831,65.41559395572051,-0.01463611349054339,0.5777178074007807,0.5923539208913241,-46440543,-47452806,64.81608138605071,47.048538751966916,NaN,NaN,16.925157878695014,15.446525087445721
2019-02-21T09:30:00-05:00,45.96,45.988,45.47,45.64,2631226,3058427.7,53.9023101146126,58.94464926547986,NaN,NaN,21.071426330026455,56.14004214330835,-0.05594094233593183,0.5224277429714093,0.5783686853073411,-49071769,-46971206.2,65.68437852464398,49.06422420029992,NaN,NaN,15.758306685103587,15.49106531568256
2019-02-22T09:30:00-05:00,45.83,46.09,45.72,46.07,4005449,3114763,57.300145281737265,58.5288402039211,NaN,NaN,41.239822800168476,53.10817977445517,-0.056728773674929456,0.5074577182136792,0.5641864918886087,-45066320,-46109171.6,67.24269413589019,51.24998062924658,NaN,NaN,15.636873223416018,15.51189501678734
2019-02-25T09:30:00-05:00,46.34,46.405,46.08,46.12,2410812,3068248.3,57.69066732468473,57.99334433583478,NaN,NaN,63.912310618352905,51.276736463548936,-0.05620145240143537,0.49393467638681443,0.5501361287882498,-42655508,-45221674.2,68.81293106913166,53.32092910619338,NaN,NaN,15.63720340114562,15.529796214552809
2019-02-26T09:30:00-05:00,45.98,46.3337,45.85,46.12,4704642,3087072.25,57.69066732468472,57.29178992662109,NaN,NaN,48.8986432599991,46.723984590419015,-0.05794025071416242,0.4777108153955467,0.5356510661097091,-42655508,-45177929.6,68.89208454046435,55.0485844587643,NaN,NaN,15.637481030716053,15.545179759718986
2019-02-27T09:30:00-05:00,45.91,46.08,45.56,45.89,4009836,3230660.4,55.00679003348196,57.02046866171299,NaN,NaN,-3.723936479244064,34.27965330586054,-0.07555426332729787,0.44120823695058675,0.5167625002778846,-46665344,-45222889.8,68.69909450464777,56.660636182684435,NaN,NaN,14.95580313378739,15.460983098871615
2019-02-28T09:30:00-05:00,45.85,46.07,45.81,45.92,2374184,3220458.25,55.29890469814877,57.00103804697809,NaN,NaN,-6.346620839089975,28.796043872037256,-0.08543040102119315,0.40997449900139316,0.4954049000225863,-44291160,-44266768,70.5861599271641,58.547603534362906,NaN,NaN,14.445235392664223,15.315876283699131
2019-03-01T09:30:00-05:00,46.22,46.3,46.01,46.28,7114185,3336225.9,58.759098773798186,57.101634091833674,NaN,NaN,65.35166566005066,33.618412444013686,-0.06868432294124416,0.4095494963460311,0.47823381928727526,-37176975,-42688899,73.43271527487518,60.53261110796376,NaN,NaN,14.858581510140706,15.25054845890507
2019-03-04T09:30:00-05:00,46.51,46.63,45.745,46.34,2906660,3261801.85,59.32423282955281,57.49408941737561,NaN,NaN,72.49727921550284,35.33540616344368,-0.05511856653671965,0.40933561111637573,0.4644541776530954,-34270315,-41011860.4,76.08211494857419,62.81577589911088,NaN,NaN,15.353951359446782,15.265320301839601
2019-03-05T09:30:00-05:00,46.35,46.76,46.12,46.63,2805884,3216941.45,62.032355992516884,57.85519176924779,NaN,NaN,133.65327791668344,52.286333094780545,-0.02945362447181854,0.42763714706332223,0.45709077153514077,-31464431,-38773645,79.0805465492412,65.42073290637614,NaN,NaN,16.49494483297915,15.440980949145251
2019-03-06T09:30:00-05:00,46.71,46.808,46.47,46.61,6131649,3404096.1,61.72712726519517,58.1815326607768,NaN,NaN,171.04582739928887,87.24028587048713,-0.017266890922967182,0.4355071578814318,0.452774048804399,-37596080,-36959792.2,81.14361934440451,67.97627694331705,NaN,NaN,17.390862029028217,15.719535389128533
2019-03-07T09:30:00-05:00,46.55,46.55,45.97,46.2,3377663,3385534.85,55.67879674788167,57.99907367083374,NaN,NaN,62.991733954618994,101.10795682922893,-0.03901642021768231,0.40400352353229607,0.4430199437499784,-40973743,-36296308.8,81.84877167151338,70.2094024354908,NaN,NaN,16.6371714409882,15.850626253679915
2019-03-08T09:30:00-05:00,45.7,46.2,45.56,46.17,2655109,3401214.9,55.252186776195586,57.694231559053875,NaN,NaN,-14.56549451459776,85.12452479429923,-0.05655675677845495,0.3723239977769097,0.4288807545553647,-43628852,-37586684.2,75.90368533243239,71.699539783566,NaN,NaN,15.8891599958386,15.856131073988298
2019-03-11T09:30:00-04:00,46.29,47.01,46.29,47,3593956,3450894.4,63.56895051906645,57.95965837936551,NaN,NaN,194.0557440850847,109.4362177682156,-0.015527264280512543,0.40947167420472397,0.4249989384852365,-40034896,-38739600.4,70.94534582983664,72.36930164563357,NaN,NaN,17.56090829113033,16.09967067643716
2019-03-12T09:30:00-04:00,47.09,47.35,47.07,47.21,8112516,3753464.95,65.32495441165082,58.46837057808626,NaN,NaN,263.7979030665756,135.46514279819405,0.0205302667997061,0.4506617719848691,0.430131505185163,-31922380,-38831190.2,70.55106015912399,72.77894298656739,NaN,NaN,19.4912339057354,16.58417970919405
2019-03-13T09:30:00-04:00,47.38,47.53,47.2,47.35,3486930,3805663.55,66.48477123615076,59.36711780105327,NaN,NaN,230.3078215326914,147.31754162487456,0.04706724432660059,0.4889655605934138,0.4418983162668132,-28435450,-36999064.2,73.69981467504482,73.35147414016744,NaN,NaN,21.44571283753726,17.27868444181451
2019-03-14T09:30:00-04:00,47.2,47.3,47,47.14,3539793,3801617.15,63.07663592407031,59.77972427550562,NaN,NaN,148.77175356472873,164.4735455468965,0.043802353011081596,0.4966512575306652,0.4528489045195836,-31975243,-35199364.2,76.37232609129244,74.00359070841047,NaN,NaN,22.168764560740087,17.977267315946733
2019-03-15T09:30:00-04:00,47.12,47.16,46.757,47.02,6868919,4039899.35,61.14768445697834,60.02665407066946,NaN,NaN,101.38345149249957,187.66333474831598,0.027673133981790332,0.4874403219968215,0.4597671880150312,-38844162,-34242426.2,77.67156046015712,74.63634995062658,NaN,NaN,22.248298409815302,18.587414615070813
2019-03-18T09:30:00-04:00,46.82,46.87,46.515,46.62,2807178,4066083.35,55.099012622971074,59.841535877689914,NaN,NaN,44.22815768512696,157.69781746832442,-0.013605694660255685,0.4427600696897116,0.4563657643499673,-41651340,-34565715,76.14814828952805,75.15464021841683,NaN,NaN,20.57177502001412,18.870894672919857
2019-03-19T09:30:00-04:00,46.8,47.0699,46.515,46.7,3570831,4033686.7,56.035700382534515,59.915029474050804,NaN,NaN,53.42196891216482,115.62263063744226,-0.03782041820846238,0.40909024158938934,0.4469106597978517,-38080509,-35797340.8,70.47694442610879,75.28162949852118,NaN,NaN,19.43128303795551,18.950950153639237
2019-03-20T09:30:00-04:00,46.7,47.26,46.53,47.12,7390659,4224904.05,60.67403741379678,60.29896752516852,NaN,NaN,77.5918264040631,85.07943161171664,-0.028286109367787193,0.4115530230881177,0.4398391324559049,-30689850,-36248220.8,68.4666401093594,75.13023522582087,NaN,NaN,19.743593636034372,19.064184936838544
2019-03-21T09:30:00-04:00,46.97,47.7769,46.93,47.74,3183231,4252504.3,66.3224867913095,60.83920952641933,NaN,NaN,140.31004514372847,83.3870899275166,0.014729637451179722,0.45825117926987957,0.44352154181869985,-27506619,-35354496,70.2764892032871,74.9047905064217,NaN,NaN,21.815034899919706,19.457163502992994
2019-03-22T09:30:00-04:00,47.52,47.7173,46.83,46.97,5174553,4310959.5,55.63487408337951,60.57568390169267,NaN,NaN,85.06730942660023,80.12386151433672,-0.012264180106509426,0.4281913166855631,0.4404554967920725,-32681172,-34121898,72.61127114968046,74.65687309221502,NaN,NaN,20.048696015243475,19.541668147600205
2019-03-25T09:30:00-04:00,46.84,47.12,46.59,46.89,2408462,4310842,54.64952472016518,60.0483388108104,NaN,NaN,33.95877012129056,78.06998400156945,-0.037661435201855054,0.39337870278975373,0.4310401379916088,-35089634,-32809556.8,74.8742248987046,74.35642154574812,NaN,NaN,18.3446717612658,19.37066866383815
2019-03-26T09:30:00-04:00,47.13,47.54,46.91,47.12,2488623,4200041.05,57.00708371022103,59.71119284259796,NaN,NaN,77.98467707156263,82.982525633449,-0.040857315984862974,0.37996849301053004,0.420825808995393,-32601011,-31713657.2,76.61204471264112,74.0327376434793,NaN,NaN,17.67755493626535,19.128795274184892
2019-03-27T09:30:00-04:00,47.18,47.28,46.53,46.78,2465669,4122832.7,52.64982430428843,59.49483766805559,NaN,NaN,19.151574286673508,71.29447520997108,-0.066253218397751,0.33800928599820423,0.40426250439595524,-35066680,-32589023.2,72.30988493043863,73.35138859054538,NaN,NaN,15.73390615423508,18.64381111419206
2019-03-28T09:30:00-04:00,46.74,46.8,46.44,46.67,1891058,4098676.4,51.28409159706243,59.21140229811751,NaN,NaN,-31.45412541586232,36.941641098052926,-0.08940330194870671,0.2925083769600718,0.38191167890877853,-36957738,-34479247,63.95786236660116,72.49811552155744,NaN,NaN,13.740496880484379,17.943337652233822
2019-03-29T09:30:00-04:00,46.92,46.96,46.4,46.77,2542940,3870114.15,52.490627030629284,58.420093477514854,NaN,NaN,-23.69414148247747,15.189350916237391,-0.09632670650101421,0.26150329578251075,0.35783000228352496,-34414798,-34825972.2,62.53111517598665,71.89709904628243,NaN,NaN,12.449161015889818,17.15845527561325
2019-04-01T09:30:00-04:00,47.13,47.52,47.13,47.48,4249696,3937265.95,60.05502634700852,58.04367004432612,NaN,NaN,111.08851479987761,30.615299851954802,-0.05356828373519751,0.29086964761452805,0.34443793134972556,-30165102,-33841065.8,64.9246994486287,71.49521613838992,NaN,NaN,13.648386794734407,16.657016921201986
2019-04-02T09:30:00-04:00,47.62,47.8,47.4568,47.73,3323320,3963137.75,62.329410930472356,57.74685859392052,NaN,NaN,151.13140937579436,45.24464631280115,-0.011145753681383153,0.33050573924799664,0.3416514929293798,-26841782,-32689220,67.53659659298444,71.05498627538562,NaN,NaN,15.360730025252298,16.47183307892346
2019-04-03T09:30:00-04:00,47.95,48.33,47.81,47.91,2303606,3771735.6,63.92220254181972,57.807256209474055,NaN,NaN,188.1812460336166,79.05058066218976,0.02440055316249634,0.3721521843825002,0.34775163122000385,-24538176,-30583519.2,71.68731048277226,70.72034230334846,NaN,NaN,17.261411161236506,16.584629947825324
2019-04-04T09:30:00-04:00,48.11,48.3489,47.94,48.18,2788097,3742257.3,66.22883566824056,58.17019558170706,NaN,NaN,186.18785665038536,122.5789770754393,0.05946155631794109,0.4220785766174302,0.3626170202994891,-21750079,-27541987.4,76.38421308084733,70.62838891911204,NaN,NaN,19.577162057515736,17.012134534923955
2019-04-05T09:30:00-04:00,48.35,48.36,48.1697,48.32,2379713,3728487.5,67.39295863651196,59.048334582674265,NaN,NaN,185.64856913226603,164.447519198388,0.08394860359141443,0.4675527747887571,0.3836041711973427,-19370366,-24533101,79.93113308653952,70.89860211889858,NaN,NaN,21.839807064112758,17.701802039093785
2019-04-08T09:30:00-04:00,48.26,48.28,47.99,48.23,2340485,3665813.95,65.82214729932832,59.7473665053024,NaN,NaN,139.0369909511193,170.03721442863633,0.0856550501619252,0.4906729838997492,0.405017933737824,-21710851,-22842250.8,81.60327634477032,71.69334011308868,NaN,NaN,23.26895600498216,18.49710974850641
2019-04-09T09:30:00-04:00,48.12,48.44,48.11,48.36,4872773,3503826.8,67.0179849314527,60.2005056137064,NaN,NaN,135.1167289629652,166.8342783460705,0.08683826365073621,0.5135657633012443,0.42672749965050805,-16838078,-20841510,83.36906114751054,72.7577987586709,NaN,NaN,24.811158167055744,19.39911666544203
2019-04-10T09:30:00-04:00,48.47,48.6,48.3,48.57,2265200,3442740.3,68.91034580410991,60.38535268604928,NaN,NaN,135.17431392762714,156.2328919248726,0.09253898991137471,0.5424012370397264,0.4498622471283517,-14572878,-18848450.4,84.92167848137531,73.80388370710578,NaN,NaN,26.678019617853327,20.43895994435793
2019-04-11T09:30:00-04:00,48.66,48.72,48.515,48.6,2115284,3371514.85,69.18237317821063,61.35303119282293,NaN,NaN,127.94676850407893,144.58467429561134,0.0890742696041395,0.5612050841335261,0.4721308145293866,-12457594,-16989953.4,86.21411324790255,74.77551528555021,NaN,NaN,28.304441446510413,21.562600158951142
2019-04-12T09:30:00-04:00,48.97,49.06,48.795,49.02,4894102,3272774,72.7740151300367,62.6476376506709,NaN,NaN,141.73985220660578,135.8029309104793,0.10473232192663845,0.6030462169376847,0.4983138950110462,-7563492,-14628578.6,87.66126481454998,75.68887527953918,NaN,NaN,30.834999338416335,22.887228613160456
2019-04-15T09:30:00-04:00,49.03,49.065,48.69,48.98,2345662,3249698.2,71.91439796860182,63.71244581198381,NaN,NaN,121.11420051530102,132.21837282331563,0.10196050518436972,0.6257645264915084,0.5238040213071387,-9909154,-12268239.2,88.91397181920404,76.56758435857937,NaN,NaN,32.6967827436185,24.288593488940176
2019-04-16T09:30:00-04:00,49.12,49.17,48.84,49.03,2157025,3179007.9,72.35399606421336,65.11988665197846,NaN,NaN,116.46933348592437,128.48889372790745,0.09329370789982705,0.6404211561819224,0.5471274482820954,-7752129,-10451049.4,89.77469893351552,77.81507107308487,NaN,NaN,34.380301601774065,25.730266076487876
2019-04-17T09:30:00-04:00,49.22,49.245,49.0099,49.12,2826297,2950789.8,73.1681015018558,66.68303021660655,NaN,NaN,114.42289469680121,124.33860988174226,0.08372645017202718,0.6517855109971293,0.5680590608251022,-4925832,-8521640.2,90.60844844211195,79.71868436419278,NaN,NaN,36.03927161002743,27.20298115270781
2019-04-18T09:30:00-04:00,49.25,49.25,49.01,49.15,1755096,2879383.05,73.44877172201936,68.18004055170584,NaN,NaN,104.22418025545159,119.5940922320168,0.07007644339732122,0.6556546150717537,0.5855781716744325,-3170736,-6664268.6,91.3404530226131,81.77649421038038,NaN,NaN,37.52002845981271,28.676845053722797
2019-04-22T09:30:00-04:00,49.05,49.37,49.0019,49.37,2126751,2726992.95,75.47479180157123,69.2814523698889,NaN,NaN,105.04968615145577,112.25605902098683,0.06654864226255364,0.6687639745026246,0.602215332240071,-1043985,-5360367.2,91.8223305129157,83.69775357211516,NaN,NaN,39.39041525649673,30.2073550826905
2019-04-23T09:30:00-04:00,49.63,50.15,49.51,50.03,3929785,2803059.1,80.32517405058766,70.5668640213257,NaN,NaN,150.2299798863827,118.07921489520314,0.09747827095073391,0.7240631709284884,0.6265848999777545,2885800,-2801376.4,92.682905621367,85.49391850271392,NaN,NaN,42.74287790887002,31.998144057859005
2019-04-24T09:30:00-04:00,50.04,50.05,49.72,49.8,3311823,2844219.1,74.7752181111151,71.3420794191325,NaN,NaN,131.41662464651498,121.06867312732125,0.09136387336092422,0.7407897416789098,0.6494258683179855,-426023,-1336155.2,93.12877972587765,87.02545202007859,NaN,NaN,43.91196770941488,33.70011886522413
2019-04-25T09:30:00-04:00,50.66,50.67,50.2,50.36,3064706,2874170.95,78.6442141993792,72.2288921713567,NaN,NaN,161.5351018011536,130.49111454819172,0.11255924225489333,0.7901249211366022,0.6775656788817088,2638683,176747.8,93.56482024654342,88.25263824619974,NaN,NaN,46.24982260308552,35.49293368491861
2019-04-26T09:30:00-04:00,50.49,50.78,50.2299,50.76,2076597,2883447.9,80.89797085365407,73.19353590115257,NaN,NaN,159.96497947858234,141.63927439281787,0.13929337594936775,0.8516823988184186,0.7123890228690508,4715280,1753951,93.99280284656251,89.25704322905854,NaN,NaN,49.00500145232051,37.42322908026174
2019-04-29T09:30:00-04:00,50.87,51.34,50.87,51.22,1341001,2823350.95,83.10600754286898,74.42809734711976,NaN,NaN,188.1432869630189,158.25799455513052,0.1716092347018927,0.9269005662464167,0.755291331544524,6056281,3174004.2,94.35671697021836,90.16800327373338,NaN,NaN,52.12414716349021,39.52336023500867
2019-04-30T09:30:00-04:00,50.28,50.42,49.885,50.07,3197065,2770719.4,63.38122919600496,74.16832908030206,NaN,NaN,89.64765533447138,146.14152964474823,0.1025919889642829,0.8835313177498776,0.7809393287855947,2859216,3168687.4,94.33367475807843,90.95118996020253,NaN,NaN,47.20038305504558,40.620077780728224
2019-05-01T09:30:00-04:00,50.28,50.375,49.805,49.81,4262654,2817686.1,59.91863335693589,73.5260639055039,NaN,NaN,68.95607965580136,133.6494206466055,0.03024300745051789,0.8187430880987421,0.7885000806482242,-1403438,2973204.4,93.43027013585694,91.5589465069512,NaN,NaN,42.1467917148333,40.838179771314664
2019-05-02T09:30:00-04:00,49.85,49.97,49.19,49.61,4680813,2936546.45,57.324325964096815,72.67906053306722,NaN,NaN,26.784009338549907,106.69920215408479,-0.03664145844177047,0.742698257596011,0.7793397160377815,-6084251,1228617.6,85.55560171728477,91.51190996904994,NaN,NaN,37.32324718020805,40.33604654401372
2019-05-03T09:30:00-04:00,49.87,50.12,49.685,50.09,2050371,2899660.15,61.619369442748386,71.88230012683233,NaN,NaN,54.2452833903616,85.55526293644064,-0.053115152892751816,0.7129457749218417,0.7660609278145936,-4033880,-521214.4,78.41654502694877,90.85157284136413,NaN,NaN,34.84342207258741,39.55138590523853
2019-05-06T09:30:00-04:00,49.27,50.09,49.2601,50.01,3159766,2938662.8,60.52601075799202,71.06884389750306,NaN,NaN,31.900242691470098,54.30665408213089,-0.07274560569901001,0.6751289206908311,0.7478745263898411,-7193646,-3171199.8,69.02321892560562,89.43080477753567,NaN,NaN,32.56834524076467,38.55380866745655
2019-05-07T09:30:00-04:00,49.72,49.83,48.81,49.2,4342135,3038745.3,50.71409512444151,69.52313668751937,NaN,NaN,-26.25510427465413,31.12610216030577,-0.13974668534847123,0.573191169704252,0.7129378550527232,-11535781,-6050199.2,60.53869416546616,87.34251872267501,NaN,NaN,27.01094513002574,36.90482816210929
2019-05-08T09:30:00-04:00,49.22,49.41,49.07,49.12,3453555,2967784.4,49.854476986309606,67.85787779355178,NaN,NaN,-42.94098244833303,8.746689739478905,-0.18602104332180236,0.4804115509004703,0.6664325942222726,-14989336,-8767378.8,53.81514917512931,84.71442591789055,NaN,NaN,22.449278561324732,34.83974964771149
2019-05-09T09:30:00-04:00,48.73,49.15,48.46,48.97,4241518,3066600.3,48.2046008673394,66.05472273250322,NaN,NaN,-87.77442240928836,-14.16499661008875,-0.2209217722634612,0.3902803788929461,0.6112021511564073,-19230854,-11396699.4,48.232792804253705,81.63530733086486,NaN,NaN,18.27297525883801,32.47306759215814
2019-05-10T09:30:00-04:00,48.87,49.2878,48.17,49.11,2900464,3105859.3,49.87203507010577,64.22595439454139,NaN,NaN,-91.65387818941896,-43.344828926044855,-0.2278535290760504,0.32638523981134426,0.5542387688873947,-16330390,-13856001.4,43.66982444030032,78.19584261139234,NaN,NaN,15.385031131492374,30.031919526348744
2019-05-13T09:30:00-04:00,48.12,48.42,47.45,47.59,8210994,3271703.9,36.233492712233854,61.07654858465899,NaN,NaN,-192.60834844651262,-88.2465471536414,-0.3223094995153987,0.15135189449314623,0.47366139400854496,-24541384,-17325549,38.181898547599936,74.30291353469468,NaN,NaN,7.288662490220905,26.78288280690191
2019-05-14T09:30:00-04:00,47.87,48.28,47.54,47.86,5332139,3421027.75,39.40352084989934,58.54999878028643,NaN,NaN,-164.62311419588988,-115.92014913788856,-0.3517041865991588,0.034031160759596446,0.38573534735875525,-19209245,-18860241.8,36.02530759600716,70.2240940968468,NaN,NaN,2.1298922657679795,23.26102701531135
2019-05-15T09:30:00-04:00,47.61,49.08,47.61,48.93,7292697,3677811.35,50.00973966258889,56.50467917051569,NaN,NaN,-92.11797420246957,-125.75554748871586,-0.28692306761497105,0.027081512840041455,0.3140045804550125,-11916548,-18245684.2,37.54652979946765,66.2227876363414,NaN,NaN,1.6106105355518479,20.168110375345705
2019-05-16T09:30:00-04:00,48.96,49.61,48.882,49.36,4627211,3767857.05,53.52985264190326,54.54981358396206,NaN,NaN,-19.11601217939504,-112.0238654427372,-0.20669966031246634,0.05563000506442961,0.26232966537689595,-7289337,-15857380.8,43.19916259865038,62.59467047577624,NaN,NaN,2.5051779193931223,17.64483431020962
2019-05-17T09:30:00-04:00,48.94,49.51,48.88,49,3663042,3863254.35,50.33424472125512,52.208973382418215,NaN,NaN,-34.57036737000885,-100.60716327885521,-0.17094761351162324,0.048645148487366896,0.21959276199899014,-10952379,-14781778.6,45.587732166794645,59.111171561245975,NaN,NaN,2.0889078930267075,15.42255910775492
2019-05-20T09:30:00-04:00,48.5,48.58,48.06,48.19,3854146,3949624.1,43.97340134297574,50.8226999643447,NaN,NaN,-107.6722565763872,-83.61994490483012,-0.1932718598181747,-0.02199706277372826,0.17127479704444645,-14806525,-12834806.8,49.710186418839946,55.92377953701466,NaN,NaN,-0.5584404786321094,13.139559166842487
2019-05-21T09:30:00-04:00,48.58,48.81,48.38,48.72,3023917,3904330.7,48.554542886926065,50.01097921648685,NaN,NaN,-67.11019430433515,-64.11736092651917,-0.16487075246013178,-0.03481364353071825,0.13005710892941352,-11782608,-11349479.4,52.65705968906242,53.01140736224363,NaN,NaN,-1.0607692748549675,11.110940818028565
2019-05-22T09:30:00-04:00,48.57,48.99,48.57,48.67,2793666,3878422.85,48.1545104177854,49.35599239175032,NaN,NaN,-52.449652383134534,-56.183696562652166,-0.14280328033631212,-0.04844699149097664,0.09435628884533548,-14576274,-11881424.6,51.49330462757269,50.578386141549906,NaN,NaN,-1.5750733174257472,9.298653084392235
2019-05-23T09:30:00-04:00,48.18,48.32,47.71,47.99,2570184,3853696.75,42.96950392479083,48.02385914046765,NaN,NaN,-110.76594152881515,-74.51368243253619,-0.16574207207099997,-0.1128213012434145,0.05292077082758548,-17146458,-13852848.8,47.31940390213121,48.3571617754915,NaN,NaN,-3.7481389341109694,7.434825653177492
2019-05-24T09:30:00-04:00,48.27,48.42,47.95,47.98,3442275,3921980.65,42.896354907962525,46.764598008322686,NaN,NaN,-91.70745029407004,-85.94109901734842,-0.17255183424243395,-0.16276902197545695,0.009782812266976991,-20588733,-15780119.6,43.598801644376934,46.54113196968946,NaN,NaN,-5.456540094072288,5.593201974998951
2019-05-28T09:30:00-04:00,48.18,48.61,48.14,48.19,2793395,3994600.35,45.01330091206274,46.3573984217242,NaN,NaN,-66.75750179413545,-77.75814806089808,-0.15446208759544808,-0.1832947972273331,-0.028832709631885035,-17795338,-16377882.2,42.48306798803568,45.25144438558728,NaN,NaN,-6.219141594157343,3.905724322262338
2019-05-29T09:30:00-04:00,47.99,48.05,47.505,47.72,2512628,3960378.5,41.32113320699047,45.74787386605855,NaN,NaN,-117.57214815315271,-87.85053883066159,-0.16475806666977078,-0.23478029296909853,-0.07002222629932774,-20307966,-18082953.8,39.386821802591385,44.22084957326314,NaN,NaN,-7.9960992566726095,2.2054638109859166
2019-05-30T09:30:00-04:00,47.82,47.967,47.58,47.83,2520601,3873275.85,42.509676003673206,45.341093518653814,NaN,NaN,-103.99071135000187,-98.15875062403506,-0.15491617449161607,-0.2636674444138478,-0.10875126992223175,-17787365,-18725172,38.2558743771331,43.50821254275452,NaN,NaN,-9.096723122744859,0.5908656775958059
2019-05-31T09:30:00-04:00,47.27,47.3856,47.02,47.09,2484754,3763472.9,37.06993034707589,44.42665746700883,NaN,NaN,-155.45751986282488,-107.097066290837,-0.1868601119457695,-0.3423264098544436,-0.1554662979086741,-20272119,-19350304.2,37.138022658313425,43.0416552726126,NaN,NaN,-11.77321824903091,-1.1754320262080105
2019-06-03T09:30:00-04:00,46.63,46.63,45.31,45.61,7155262,4018717.45,29.060399785702913,43.91429368654233,NaN,NaN,-251.72014953688856,-139.0996061394007,-0.290119223133246,-0.5181153268252316,-0.22799610369198564,-27427381,-20718033.8,34.74580081492607,42.796219720278756,NaN,NaN,-17.21616062480322,-3.4669646831501826
2019-06-04T09:30:00-04:00,45.99,46.59,45.67,46.59,7110701,4216264.2,38.531245275663345,43.85198828838261,NaN,NaN,-180.9237059241463,-161.9328469654029,-0.27501159699016864,-0.5717605999296964,-0.2967490029395278,-20316680,-21222302.2,33.87931105155333,42.642934252817774,NaN,NaN,-18.369584790621442,-5.595910412788934
2019-06-05T09:30:00-04:00,46.72,46.72,46.17,46.61,5526442,4275479.55,38.71107877507123,43.044941082131345,NaN,NaN,-139.8993472133369,-166.39828677743972,-0.2471441099659445,-0.6056791403969584,-0.35853503043101387,-14790238,-20118756.6,37.549674170092494,42.64315885071954,NaN,NaN,-19.175150422445103,-7.535801842739815
2019-06-06T09:30:00-04:00,46.7,46.89,46.449,46.81,3175946,4261599.1,40.583100353591604,42.12017306153766,NaN,NaN,-106.69825032635397,-166.93979457271013,-0.20068937815374294,-0.6093967531231925,-0.4087073749694496,-11614292,-18884142,41.46453681926672,42.51925700933499,NaN,NaN,-19.21487136966654,-9.20424034658649
2019-06-07T09:30:00-04:00,47.01,47.73,46.97,47.57,3345617,4216804.05,47.18480432889913,41.89521303351223,NaN,NaN,-38.9735890187505,-143.64300840389527,-0.10882445178162026,-0.5447379396964749,-0.4359134879148546,-8268675,-16483453.2,48.256934667215084,42.709914330793595,NaN,NaN,-17.066464363523565,-10.32741520614893
2019-06-10T09:30:00-04:00,47.87,48.04,47.46,47.53,5163142,4329937.95,46.88951153382433,42.103506618572844,NaN,NaN,-11.392557939202668,-95.57749008435809,-0.04411910455661844,-0.4910623686106277,-0.44694326405400925,-13431817,-13684340.4,54.83734186860303,43.07613972006238,NaN,NaN,-15.470984932611378,-11.062210881357851
2019-06-11T09:30:00-04:00,48.05,48.17,47.6715,47.73,2869785,4062877.5,48.62088978887276,42.108245682997605,NaN,NaN,5.604492016419818,-58.27185049624485,0.01558797908530446,-0.4274582901973787,-0.44304626928268315,-10562032,-11733410.8,58.77275897467394,43.512975383320345,NaN,NaN,-13.644520956383454,-11.431112320647223
2019-06-12T09:30:00-04:00,47.71,47.9,47.325,47.5,2459445,3919242.8,46.7340809867474,42.00678643792346,NaN,NaN,-19.482023610583205,-34.18838577569411,0.041555180360968114,-0.391102293831473,-0.4326574741924411,-13021477,-11379658.6,59.46253812325075,44.08220634729735,NaN,NaN,-12.6616614321356,-11.606905050859849
2019-06-13T09:30:00-04:00,47.65,48.05,47.54,48.03,6500352,3879625.55,51.41312052717072,42.60990190952203,NaN,NaN,12.19489483661324,-10.409756743100662,0.09342034525960402,-0.31588204261793607,-0.4093023878775401,-6521125,-10361025.2,61.46202311049455,45.09239343360902,NaN,NaN,-10.405619961973203,-11.435292895304613
2019-06-14T09:30:00-04:00,48.11,48.26,47.94,48.12,2734861,3785008.05,52.181289000399005,43.27311148755321,NaN,NaN,43.8735148728585,6.1596640352211285,0.13050629843946376,-0.24616951482821037,-0.37667581326767413,-3786264,-9464543,63.18316429201197,46.49127647986866,NaN,NaN,-8.33815031546746,-10.992843955327878
2019-06-17T09:30:00-04:00,48.3,48.79,48.26,48.67,4248719,3814291.9,56.68791413791664,44.107012432257065,NaN,NaN,99.2122550326024,28.280626629582137,0.1854434961908566,-0.14487144302910338,-0.33031493921995997,462455,-6685688.6,67.95989079935343,48.31104953781993,NaN,NaN,-5.171337741994775,-10.161200210566006
2019-06-18T09:30:00-04:00,49.33,49.57,48.87,48.94,3843476,3813758.4,58.74348236047381,45.351465943220155,NaN,NaN,147.01972672499363,56.56367357129691,0.23039800040994574,-0.0423174387075278,-0.27271543911747353,4305931,-3712096,72.12727637202023,50.649653435636274,NaN,NaN,-1.8977273486851558,-8.98070408744017
2019-06-19T09:30:00-04:00,48.94,49.07,48.6,49,3319391,3828532.1,59.206804119214894,46.54411795147314,NaN,NaN,119.36446311109137,84.33297091563182,0.2528121232755643,0.04329971497698182,-0.20951240829858248,7625322,417263.8,76.66609705301074,53.39324076962754,NaN,NaN,0.9263163388715171,-7.565415455109929
2019-06-20T09:30:00-04:00,49.61,49.634,48.96,49.31,3340039,3855850.75,61.60591113801228,48.2966880079686,NaN,NaN,153.175168805736,112.52902570945639,0.27530159241722163,0.13461458222294453,-0.14068701019427707,10965361,3914561,79.6835828582747,56.432209355339054,NaN,NaN,4.049615409721823,-5.906125331562536
2019-06-21T09:30:00-04:00,49.11,49.48,49.06,49.4,10021093,4228396.2,62.299143151530046,50.67088396267053,NaN,NaN,136.01107845200247,130.95653842528517,0.28199199795371316,0.2118029872478644,-0.07018901070584876,20986454,8869104.6,83.03138667133308,59.88117977365384,NaN,NaN,6.855558680865623,-4.08302761550137
2019-06-24T09:30:00-04:00,49.49,49.62,49.32,49.52,5236915,4318128.2,63.25187963200247,52.4366435595519,NaN,NaN,132.66248981507212,137.64658538177912,0.2797009474976982,0.27943717366627396,-0.00026377383142421607,26223369,14021287.4,85.67490682682275,63.580865186173085,NaN,NaN,9.496981059617392,-2.14302637619869
2019-06-25T09:30:00-04:00,49.5,49.5,48.505,48.6,2431906,4300053.75,52.332783834552615,53.409622492372,NaN,NaN,76.20344802442304,123.483329641665,0.20489272966857758,0.25585213825429776,0.050959408585720185,23791463,17918393.8,87.28808697390137,67.13360895787372,NaN,NaN,8.85619543690722,-0.5717089743264174
2019-06-26T09:30:00-04:00,48.75,48.96,48.32,48.41,2380869,4293465.8,50.39780886029431,54.11067309999362,NaN,NaN,47.189156560305825,109.0482683315079,0.13467362922475445,0.21930144511666327,0.0846278158919088,21410594,20675448.2,88.29255324902662,70.47846727428514,NaN,NaN,7.75828341153704,0.6182899379397908
2019-06-27T09:30:00-04:00,48.74,48.84,48.52,48.75,1984694,4266670.45,53.697093375349304,54.57583660331149,NaN,NaN,52.60493098362433,88.93422076708556,0.10452831330956452,0.21528820752886446,0.11075989421929994,23395288,23161433.6,89.12684499718877,73.39774658356897,NaN,NaN,7.761887026691827,1.6388038077615104
2019-06-28T09:30:00-04:00,48.88,49.26,48.7201,49.22,6084861,4446675.8,57.86891014136342,55.360079360992856,NaN,NaN,72.2382082261976,76.17964672192458,0.10913879157811784,0.24718338369194726,0.1380445921138294,29480149,24860172.6,89.66862936023561,75.88569569011416,NaN,NaN,9.004070533716828,2.69098476861227
2019-07-01T09:30:00-04:00,49.77,49.89,49.43,49.62,2862199,4232022.65,61.0826249042739,56.250203297807225,NaN,NaN,107.55223973224415,71.15759670535898,0.1305758535703656,0.3012644090767864,0.1706885555064208,32342348,26083968.4,90.05315322554806,78.1200095651766,NaN,NaN,11.041900133555375,3.8839726778898562
2019-07-02T09:30:00-04:00,49.64,50.11,49.64,50.08,2336936,3993334.4,64.44175960635516,57.51503748492207,NaN,NaN,124.2446409483574,80.76583529014587,0.16496717708882525,0.37689752686745237,0.21193034977862713,34679284,28261532.6,90.71533651614745,80.35235230752637,NaN,NaN,13.839157877227729,5.306141992080981
2019-07-03T09:30:00-04:00,50.21,50.46,50.11,50.34,1260732,3780048.9,66.21670922452076,58.57243667758992,NaN,NaN,147.06310287582758,100.74062455325023,0.19253560442881434,0.4525998553146451,0.26006425088583074,35940016,31167417,91.52605568961334,82.49978320603486,NaN,NaN,16.711558478848467,6.9354872044763365
2019-07-05T09:30:00-04:00,50.19,50.48,49.8601,50.41,3006148,3771559,66.69867550054013,59.60939285617143,NaN,NaN,133.6779416901796,116.95522669456128,0.20181820639597448,0.5123370088807988,0.31051880248482433,38946164,34277592.2,92.30093402975629,84.57962390158802,NaN,NaN,19.193679695802636,8.686657560380093
2019-07-08T09:30:00-04:00,50.21,50.215,49.84,49.96,1152827,3661919.5,60.70317725888756,59.89619736481222,NaN,NaN,101.6279883137012,122.83318271206198,0.16550782823967236,0.5174035877844148,0.3518957595447424,37793337,35940229.8,92.68597065427358,86.34577246265374,NaN,NaN,19.617626691509244,10.24822457911283
2019-07-09T09:30:00-04:00,49.78,50.35,49.71,50.27,1714914,3489508.1,63.15993493741569,60.2116582631652,NaN,NaN,102.5986369191886,121.84246214945088,0.1506483021298693,0.540206137207079,0.3895578350772097,39508251,37373410.4,93.01046011406508,87.83742844422838,NaN,NaN,20.698735260247688,11.741154676417809
2019-07-10T09:30:00-04:00,50.6,50.895,50.4001,50.84,2294356,3460736.65,67.21815939376691,60.783897925633205,NaN,NaN,144.82842369353583,125.95921869848658,0.16626195006265,0.5973852726555222,0.4311233225928722,41802607,38798075,93.3273710785231,89.02751944605068,NaN,NaN,22.90508831951092,13.336002339716824
2019-07-11T09:30:00-04:00,50.95,51.07,50.66,50.87,5463254,3610927.1,67.42157154288655,61.19930224026708,NaN,NaN,144.06937582073837,125.36047328746872,0.16531661681981025,0.637769093617635,0.47245247679782476,47265861,41063244,93.80808461352409,90.0364124285685,NaN,NaN,24.739719956911475,14.965104856458916
2019-07-12T09:30:00-04:00,50.86,51.25,50.7801,51.24,2621837,3417001.35,69.90210362999055,61.7423708458714,NaN,NaN,146.81327292949823,127.98753953533246,0.1753632065957007,0.6916564850424507,0.51629327844675,49887698,43251550.8,94.23982006398568,90.83701481375796,NaN,NaN,27.062416271115236,16.693292201409818
2019-07-15T09:30:00-04:00,51.27,51.31,50.97,51.25,4075940,3484055.3,69.96865736403635,62.222140683873825,NaN,NaN,137.54025792077357,135.16999345674694,0.16839861473901807,0.7267915468705226,0.5583929321315045,53963638,46485611,94.81519351960789,91.48989243467119,NaN,NaN,28.970587367635247,18.447191510870592
2019-07-16T09:30:00-04:00,51.28,51.35,51.04,51.13,2540815,3398660.1,68.02477783668948,63.34299739831217,NaN,NaN,122.16170506828581,139.08260708656638,0.14245672840714252,0.7364638426404326,0.5940071142332901,51422823,48868525.4,95.19596544500291,92.05474089689271,NaN,NaN,30.052850956074394,20.10514286018542
2019-07-17T09:30:00-04:00,51.15,51.22,50.65,50.65,4760730,3444522.8,60.753932977434104,64.08272054953645,NaN,NaN,83.29245335290145,126.77541301843948,0.08268111142352463,0.6973585035126959,0.6146773920891713,46662093,49840422.6,95.3460883888303,92.55856483545014,NaN,NaN,28.947509227678577,21.368338055541585
2019-07-18T09:30:00-04:00,50.18,50.32,49.845,50.24,1813807,3369243.6,55.31529351172437,64.19830627356323,NaN,NaN,15.17962459241979,100.99746277277578,0.009111493642119939,0.6260667591418212,0.6169552654997013,44848286,49356907.6,93.7760609591372,92.89065168987501,NaN,NaN,26.35294388350568,22.0804246023936
2019-07-19T09:30:00-04:00,50.45,50.45,49.55,49.59,1979625,3301222.9,47.98186328397158,63.49208864089239,NaN,NaN,-14.398175979577696,68.75517299096059,-0.08458430192632416,0.511224888091796,0.5958091900181202,42868661,47953100.2,89.18434268254694,92.85605978432582,NaN,NaN,21.655694236916496,22.01974883589687
2019-07-22T09:30:00-04:00,49.74,49.8,49.455,49.78,2391482,2919742.35,50.06580203074213,62.70517272135441,NaN,NaN,-35.927249804306015,34.06167144594466,-0.13218348505359123,0.43057983370113107,0.5627633187547223,45260143,46212401.2,83.71083469708395,92.40303703229269,NaN,NaN,18.42115053509714,21.505663364354053
2019-07-23T09:30:00-04:00,49.94,49.98,49.5,49.97,2624714,2789132.3,52.1310342213748,61.825835193855816,NaN,NaN,-23.88184393986385,4.852961644314725,-0.1480937038086635,0.3776461889938929,0.5257398928025564,47884857,45504808,81.52060733110719,91.74627066193266,NaN,NaN,16.340247090649783,20.76774675382487
2019-07-24T09:30:00-04:00,49.6,50.46,49.56,50.41,1840743,2759574.15,56.60688307719816,61.13941904047563,NaN,NaN,4.599062259932756,-10.885716574279007,-0.12701590219328507,0.36697001506095006,0.49398591725423513,49725600,46117509.4,81.96073262654254,91.06303330028474,NaN,NaN,15.872941620606468,20.06848887765081
2019-07-25T09:30:00-04:00,50.49,50.64,49.98,50.28,2192551,2750158.25,54.97144582186196,60.3017597777129,NaN,NaN,14.535785824224899,-11.014484327917987,-0.11994623261913906,0.3440531264803113,0.46399935909945034,47533049,46654462,82.35730755933615,90.35277426668331,NaN,NaN,15.00660252474548,19.345362255807192
2019-07-26T09:30:00-04:00,51.17,51.87,51.14,51.72,5049654,2903406.25,66.51261293922843,60.71671946916582,NaN,NaN,162.61129254301528,24.387409376600615,-0.02156007866647397,0.43704926076635786,0.45860933943283183,52582703,48597270.4,83.74935983280052,89.71444492229237,NaN,NaN,18.223742954610373,19.18513092706479
2019-07-29T09:30:00-04:00,51.64,51.64,51.17,51.43,2582438,2728285.1,63.0100057426904,60.70601024097116,NaN,NaN,122.49496805810712,56.071852949083244,0.018548495210633065,0.4817949584461232,0.4632464632354901,50000265,49545294.8,84.39634059716137,89.09915067108496,NaN,NaN,19.579018309690102,19.241400553154122
2019-07-30T09:30:00-04:00,51.11,51.398,51.04,51.19,2099863,2690168.3,60.1852840321594,60.20366200085634,NaN,NaN,85.65497726842288,77.97921719074058,0.023175860620132938,0.4922162890106563,0.46904042839052335,47900402,49548403.8,84.39853427165842,88.46137661345176,NaN,NaN,19.734247402469315,19.311807245913435
2019-07-31T09:30:00-04:00,51.22,51.51,50.34,50.78,2090751,2677859.05,55.59968791537043,59.35924174174804,NaN,NaN,38.68517269532408,84.79643927781885,-0.0055801075171037495,0.46206529399414364,0.4676454015112474,45809651,48765214,81.29786222411519,87.56778929992255,NaN,NaN,18.362298877924783,19.176163193343626
2019-08-01T09:30:00-04:00,50.92,51.6,50.3308,50.54,4095730,2819608.95,53.0515908569854,58.15563368653339,NaN,NaN,28.696962276661075,87.62867456830608,-0.04289094596927534,0.4140317190496532,0.45692266501892853,41713921,47601388.4,76.7835196577909,86.32091069948005,NaN,NaN,16.43597480547126,18.78470770936186
2019-08-02T09:30:00-04:00,50.29,50.43,49.75,50.05,4656187,2902110.9,48.19516659480935,56.60038434587432,NaN,NaN,-66.10456819408107,41.885502420886816,-0.09946457440718115,0.3325919470099521,0.43205652141713324,37057734,44496394.6,66.21887908751322,84.27831681147329,NaN,NaN,13.220718769008405,17.989852146454226
2019-08-05T09:30:00-04:00,49.09,49.26,47.97,48.43,6248204,3156879.75,36.34824996074604,54.33777521187835,NaN,NaN,-218.02312702140088,-26.218116595014784,-0.23703332356895607,0.13576486695593815,0.3727981905248942,30809530,40658247.6,55.96778180145257,81.47630369407683,NaN,NaN,5.5331032083822995,16.210316583872523
2019-08-06T09:30:00-04:00,48.96,49.38,48.68,49.13,6548204,3398544.25,42.88173042961999,53.06118931560592,NaN,NaN,-142.14323503742224,-71.77775905618381,-0.26955943716325603,0.035848894070824144,0.3054083312340802,37357734,38549714,51.27195556877197,78.32815134978695,NaN,NaN,1.765646499285757,14.146792286074414
2019-08-07T09:30:00-04:00,48.55,49.305,48.1642,49.19,3323332,3449993.05,43.41783768220846,52.21137104206907,NaN,NaN,-136.88876041817284,-106.8925456788832,-0.2747707135361709,-0.0380550606861334,0.23671565285003746,40681066,37523997,49.11319812058273,75.1379468613188,NaN,NaN,-0.8714105432227335,12.001334739031964
2019-08-08T09:30:00-04:00,49.59,50.19,49.32,50.18,2456676,3299664.15,51.505735331508234,52.463076188321686,NaN,NaN,-40.0178599307901,-120.63551012037343,-0.20261171000937572,-0.016548984661682198,0.18606272534769353,43137742,37808761.2,49.7458120438761,72.32090895855659,NaN,NaN,-0.24117134280977848,10.252405298768858
2019-08-09T09:30:00-04:00,49.88,50.08,49.31,49.62,1841493,3260646.95,47.380110857014955,52.27124110448403,NaN,NaN,-55.56892935643773,-118.52838235284476,-0.1841967940009602,-0.04418326715350673,0.14001352684745347,41296249,38656464.2,51.67190088859074,70.03241368652134,NaN,NaN,-1.1879232833013498,8.6180726441874
2019-08-12T09:30:00-04:00,49.38,49.43,48.88,49.07,3759252,3244812.55,43.67951815780715,51.66756138565777,NaN,NaN,-98.55316650392227,-94.63439024934904,-0.19937497278854088,-0.10920518913822264,0.09016978365031825,37536997,40001957.6,54.64334527864629,68.11260925420271,NaN,NaN,-3.2409054114639755,6.923932921951489
2019-08-13T09:30:00-04:00,49.04,50.29,48.98,49.81,4091723,3322357.95,49.40529001478669,51.15316188119981,NaN,NaN,-39.39968180298237,-74.08567960246107,-0.1520337851578865,-0.09987244779703985,0.052161337360846625,41628720,40856154.8,56.473075780905,66.29206233665717,NaN,NaN,-2.9449289862502352,5.5140955064941
2019-08-14T09:30:00-04:00,49.11,49.15,47.97,48.04,4532857,3310964.3,39.15228777874792,50.02322202097737,NaN,NaN,-151.53529689472168,-77.01498689777084,-0.22782419357357347,-0.23261890460612022,-0.004794711032546743,37095863,40139114.2,54.48605785029713,64.30125878601152,NaN,NaN,-6.657156307910593,3.77534524729343
2019-08-15T09:30:00-04:00,48.2,48.37,47.78,48.12,3998562,3420202.05,39.76078459431816,48.11237713919807,NaN,NaN,-154.86753453128392,-99.9849218178696,-0.2582361070048921,-0.3275898447886618,-0.06935373778376977,41094425,39730450.8,53.334267698053345,62.12875220495816,NaN,NaN,-9.17712147616857,1.9249928582274298
2019-08-16T09:30:00-04:00,48.52,48.82,48.38,48.74,2509821,3446711.85,44.40128875622584,46.783183068736314,NaN,NaN,-93.8264653116959,-107.63642900892123,-0.22356130536698077,-0.34880536949249574,-0.12524406412551498,43604246,40192050.2,54.50415462560645,59.99359606413281,NaN,NaN,-9.598814134625675,0.2787347163912721
2019-08-19T09:30:00-04:00,49.31,49.71,49.27,49.5,2173748,3435825.15,49.53340462437102,46.022334539608565,NaN,NaN,-23.708079145281808,-92.66741153719315,-0.14046510769092824,-0.30082544873917527,-0.16036034104824703,45777994,41840249.6,58.504319511234435,58.144009295531085,NaN,NaN,-8.158237733933408,-0.9265470622265393
2019-08-20T09:30:00-04:00,49.33,49.51,49.06,49.17,2156604,3412419.65,47.483835587373825,45.44263080189453,NaN,NaN,-40.20833251523886,-92.82914167964444,-0.10061646221628226,-0.28613091881859987,-0.1855144566023176,43621390,42238783.6,59.433110875668135,56.58224134207058,NaN,NaN,-7.6935693516007,-1.8932645321371337
2019-08-21T09:30:00-04:00,49.5,49.59,49.3,49.36,2792315,3459998.25,48.79748657398255,45.13876621025147,NaN,NaN,-24.272410086987797,-67.37656431809765,-0.05654896600451778,-0.2562006641079648,-0.19965169810344705,46413705,44102352,63.54241103479811,55.63644786899966,NaN,NaN,-6.910448885330878,-2.6100051540219544
2019-08-22T09:30:00-04:00,49.48,49.575,48.8,49.25,1649072,3432824.3,48.04813215285052,45.12826375011155,NaN,NaN,-37.22649573515304,-43.84835655887149,-0.031163679466053862,-0.23860629743601436,-0.2074426179699605,44764633,44836393.6,65.04442055203349,55.55255797360826,NaN,NaN,-6.503771194382659,-3.166257445502055
2019-08-23T09:30:00-04:00,49,49.38,47.735,47.9,4020743,3381378.75,39.94150789395147,45.3849250310548,NaN,NaN,-102.23179623694455,-45.52942274392122,-0.09788165348843977,-0.3297946848305102,-0.23191303134207045,40743890,44264322.4,62.87048993228249,56.04560855438183,NaN,NaN,-8.771666102530059,-3.96703011079177
2019-08-26T09:30:00-04:00,48.35,48.63,48.1,48.62,3155211,3410017.4,45.24732513715562,45.55389608159306,NaN,NaN,-87.21918187773214,-58.231643290411284,-0.08650504425893668,-0.3400443366657413,-0.2535392924068046,43899101,43888543.8,61.41837629392065,56.77035289189244,NaN,NaN,-8.935016603331174,-4.676742466868827
2019-08-27T09:30:00-04:00,49.1,49.17,48.56,48.71,3139102,3461979.35,45.89081769713147,45.730537511230416,NaN,NaN,-46.75290347094825,-59.540557481553165,-0.0667846095564939,-0.337020054352422,-0.2702354447959281,47038203,44571906.4,63.08802420259222,57.76855475489312,NaN,NaN,-8.86445704093275,-5.274987406020816
2019-08-28T09:30:00-04:00,48.51,48.9,48.31,48.83,2155665,3465225.05,46.788793664801126,45.39361310646563,NaN,NaN,-55.58381617637854,-65.8028386994313,-0.040801458919106526,-0.32123726844481126,-0.28043580952570474,49193868,45127939,64.43661807623076,58.81789804291845,NaN,NaN,-8.542954971150243,-5.74183991532502
2019-08-29T09:30:00-04:00,49.34,49.74,49.22,49.59,2168997,3368888.4,52.199379674445005,45.73784659342492,NaN,NaN,64.1377725539847,-45.52998504160375,0.028681260667274555,-0.24458423369161153,-0.2732654943588861,51362865,46447585.4,67.4739178028326,59.946613536792874,NaN,NaN,-6.608672989113175,-5.865673211580471
2019-08-30T09:30:00-04:00,49.81,49.86,49.29,49.53,3045516,3288354.85,51.75198526149066,46.314451386545166,NaN,NaN,77.73883093089623,-9.535859608035599,0.06939041364355308,-0.18652747730444474,-0.25591789094799783,48317349,47962277.2,70.57977812940658,61.08493016899003,NaN,NaN,-5.175043582489853,-5.7670118359960965
2019-09-03T09:30:00-04:00,49.19,49.515,48.91,49.04,3142917,3133090.5,48.12438115216157,46.22295789635765,NaN,NaN,13.82755502259379,10.67348777202959,0.062331061207015315,-0.17800406443922867,-0.24033512564624399,45174432,48217343.4,71.08056540444011,62.12832228495682,NaN,NaN,-4.981882534567442,-5.654850507220575
2019-09-04T09:30:00-04:00,49.52,50.08,49.455,49.99,1865863,2898973.45,54.74730189271223,47.33688747592653,NaN,NaN,107.69422905988925,41.562914278197084,0.11745676872787131,-0.09351416473640484,-0.21097093346427614,47040295,48217761.8,71.08143498040508,63.31370636567881,NaN,NaN,-2.7601403087136926,-5.241320478862448
2019-09-05T09:30:00-04:00,50.48,50.895,50.39,50.84,3624927,2914053.2,59.7043632415508,48.76142880787172,NaN,NaN,198.13088195935157,92.30585390534311,0.2020196123092958,0.041553581922343596,-0.1604660303869522,50665222,48512032.6,71.72538854653737,64.62735785485624,NaN,NaN,0.7798099651536917,-4.381158986860143
2019-09-06T09:30:00-04:00,50.85,50.93,50.64,50.73,3445390,2963488.9,58.80659489039336,49.79037924602654,NaN,NaN,184.69217970049905,116.41673533464598,0.23887475766160488,0.1381274166900539,-0.10074734097155098,47219832,47683426,67.18849461396167,65.53338213973876,NaN,NaN,3.338731315870236,-3.2783175150415174
2019-09-09T09:30:00-04:00,51,51.2,50.61,50.89,6421849,3192506.7,59.754548330649556,50.52046093933215,NaN,NaN,172.40929789309536,135.3508287270858,0.2605819597346619,0.22498010869677643,-0.035601851037885504,53641681,48748292.4,69.82966974670401,66.3423357279866,NaN,NaN,5.711694116258763,-1.9940301391414774
2019-09-10T09:30:00-04:00,50.7,51.09,50.635,50.96,3638495,3186468.85,60.186221888327005,51.42777424654309,NaN,NaN,145.62464714896427,161.7102471523599,0.26531928828246426,0.2960472593151948,0.03072797103273056,57280176,51169441.2,74.79710785916846,67.4397640839509,NaN,NaN,7.781663832684181,-0.5975024288806692
2019-09-11T09:30:00-04:00,51,51.31,50.95,51.23,6274115,3295588.45,61.88443208193952,52.362556068540016,NaN,NaN,147.70875431849296,169.71315220408064,0.27133070671212767,0.3698913544228901,0.09856064771076248,63554291,54472240.4,79.70583562770159,68.59429441201543,NaN,NaN,10.019878694264824,0.9192663029972581
2019-09-12T09:30:00-04:00,51.54,51.65,51.311,51.38,4014555,3269673.35,62.83291333271044,53.41861186710144,NaN,NaN,145.18000249879577,159.12297631196947,0.2695490342857737,0.4354969405679796,0.1659479062822059,67568846,57852965.2,83.29285104508995,69.89775373294803,NaN,NaN,12.16766795923581,2.5261808253170512
2019-09-13T09:30:00-04:00,51.38,51.5,51.18,51.29,3569369,3248213.7,61.8386029858423,54.982690087950786,NaN,NaN,116.80326835931771,145.5451940437332,0.24704560561124814,0.47475491329626607,0.22770930768501793,63999477,61208894.2,85.94799459358379,71.546146923041,NaN,NaN,13.727556851128812,4.126377400433017
2019-09-16T09:30:00-04:00,50.99,51.23,50.9,51.1,2527631,3249104.2,59.69106972558459,56.014386129981425,NaN,NaN,86.38943341923435,128.34122114896098,0.20578901519461956,0.4849455766782924,0.27915656148367285,61471846,62774927.2,86.98726170878928,73.3724958812459,NaN,NaN,14.528438383618564,5.612386112316667
2019-09-17T09:30:00-04:00,51.09,51.16,50.81,51.15,4566945,3368764.05,60.083921916286,57.02817928849247,NaN,NaN,74.38258048371654,114.09280781591147,0.16978824947386323,0.49139187332600187,0.32160362385213864,66038791,64526650.2,88.0517533660609,75.15561939292222,NaN,NaN,15.307877352965004,6.997456289552144
2019-09-18T09:30:00-04:00,51.07,51.15,50.54,51.09,1751862,3348526.95,59.33658508863332,57.92445010448048,NaN,NaN,59.88247031481623,96.5275510151761,0.13156202769262876,0.4860561584679246,0.35449413077529585,64286929,64673177.8,88.13915666473211,76.84865786352945,NaN,NaN,15.796222841727015,8.25442293986284
2019-09-19T09:30:00-04:00,51.19,51.44,50.99,51.14,2358548,3326838.6,59.78547975004931,58.46631439559508,NaN,NaN,70.84246551625331,81.66004361866761,0.10066490142511769,0.480325257556693,0.3796603561315753,66645477,64488504,87.27264914342035,78.26285295928574,NaN,NaN,16.325027175079015,9.40736640203658
2019-09-20T09:30:00-04:00,51.12,51.12,50.41,50.69,6358067,3562288.35,54.00694899710636,58.62738323385334,NaN,NaN,36.1888247443031,65.53715489566468,0.04384292106986287,0.4344640074689039,0.39062108639904103,60287410,63746090.6,83.70974085786034,79.20070743988957,NaN,NaN,15.353593771425246,10.25682745480639
2019-09-23T09:30:00-04:00,50.52,50.65,50.26,50.51,2198374,3471169.9,51.8482099262951,58.89337100343431,NaN,NaN,11.220951476298596,50.503458507077525,-0.009118711130478296,0.37922269748594317,0.38834140861642147,58089036,63069528.6,80.48504929553553,79.87245628925355,NaN,NaN,13.949533122118735,10.78435683585101
2019-09-24T09:30:00-04:00,50.69,50.6997,49.48,49.75,5371164,3581967.55,43.87406455314973,58.11671119346556,NaN,NaN,-39.42119186200142,27.742704037933937,-0.09387787724684976,0.27099406205785925,0.364871939304709,52717872,60405344.8,69.18309748159609,79.73686075362433,NaN,NaN,10.310336682092714,10.716639671028396
2019-09-25T09:30:00-04:00,49.72,50.41,49.38,50.32,2181590,3534091.95,50.07572641552261,57.42895142017783,NaN,NaN,-44.33095118306451,6.900019738357784,-0.1090324465062078,0.22858138117194926,0.33761382767815706,54899462,58527851.4,62.52027786555843,79.07935284784011,NaN,NaN,8.831000466980855,10.447262641878748
2019-09-26T09:30:00-04:00,50.21,50.21,49.475,49.83,1809960,3516806.7,45.42864596539311,56.47338363982067,NaN,NaN,-78.92602969816703,-23.053679304526284,-0.147163992004541,0.15365883767248079,0.3008228296770218,53089502,55816656.4,54.376330321710846,78.16419825553648,NaN,NaN,6.108703389184477,9.827468462922424
2019-09-27T09:30:00-04:00,49.92,49.93,48.89,49.27,1852969,3501005.3,40.7718233320882,55.117474711351996,NaN,NaN,-130.29361111017218,-56.35016647542134,-0.2018299624082867,0.04853537666666341,0.2503653390749501,51236533,54006481,49.719549084083674,76.72776106534931,NaN,NaN,2.243689014368567,8.744071398843301
2019-09-30T09:30:00-04:00,49.37,49.605,49.2761,49.52,2466625,3472060.75,43.55366445382237,53.92943489460167,NaN,NaN,-116.99849637919314,-81.99405604651969,-0.211841390515278,-0.014436399069147399,0.1974049914461306,53703158,53129305.4,47.592558529191955,74.78457897035098,NaN,NaN,-0.10667602782105991,7.479678909319821
2019-10-01T09:30:00-04:00,49.65,49.79,48.94,49.02,2758916,3452860.7,39.552448328415736,52.334293197921404,NaN,NaN,-143.0889678326624,-102.72761124065187,-0.24071981949158175,-0.10349478291834657,0.13722503657323518,50944242,52774579.4,46.722092499134106,72.42859731831045,NaN,NaN,-3.4023782250002426,5.925099318702669
2019-10-02T09:30:00-04:00,48.64,48.69,48.07,48.28,4405531,3579844.1,34.50070092757001,50.310563740411375,NaN,NaN,-204.46182443847346,-134.75378589173368,-0.2946774542869613,-0.23112178128546645,0.06355567300149485,46538711,51102429.2,42.75253921793546,69.53286075922799,NaN,NaN,-8.005850372249878,3.9349636485665913
2019-10-03T09:30:00-04:00,48.32,48.79,47.7203,48.75,6945829,3745889.2,39.76307671325726,48.73374043522672,NaN,NaN,-160.17725656962622,-151.0040312660255,-0.2836346983032224,-0.29098769987753315,-0.00735300157431075,53484540,51181436.8,42.99896173246626,66.4650726977196,NaN,NaN,-10.137031982253346,1.9246785584494575
2019-10-04T09:30:00-04:00,48.93,49.48,48.84,49.41,2080304,3677634.9,46.28896302259098,47.77644709929861,NaN,NaN,-80.73686890121252,-141.09268282423358,-0.2196580191857307,-0.2819255255564741,-0.06226750637074342,55564844,52047099,45.75417211397058,63.51985201237541,NaN,NaN,-9.76737210379759,0.25438560669987953
2019-10-07T09:30:00-04:00,49.28,49.73,49.14,49.41,1365508,3424817.85,46.28896302259098,46.7910928926061,NaN,NaN,-59.584896657918314,-129.60996287997858,-0.16747615884597838,-0.27161270492821643,-0.10413654608223803,55564844,52419436.2,46.942112406498765,60.5834490866924,NaN,NaN,-9.480286591339334,-1.136281850162865
2019-10-08T09:30:00-04:00,49.08,49.21,48.61,48.61,2442402,3365013.2,40.17102523829207,45.422124331867444,NaN,NaN,-97.398741232034,-120.47191755985291,-0.1760949407691268,-0.32425522204364654,-0.14816028127451975,53122442,52855076.2,48.36684365548024,57.74256958603155,NaN,NaN,-11.228717457610001,-2.578058365512456
2019-10-09T09:30:00-04:00,48.91,49.08,48.745,48.9,4078280,3255221.45,43.10652956451588,44.230770747186476,NaN,NaN,-82.13582336136906,-96.00671734443202,-0.15240796701659837,-0.3386702400452677,-0.18626227302866932,57200722,54987478.4,54.76924490354011,55.42089785461153,NaN,NaN,-11.712960593378693,-3.8830443980647753
2019-10-10T09:30:00-04:00,48.84,49.37,48.78,49.18,3104286,3209708,45.868178815873094,43.649430019955524,NaN,NaN,-60.41118266408374,-76.05350256332352,-0.11000488983041082,-0.32376838531668284,-0.21376349548627202,60305008,56351572,58.32890748757032,53.60798118530511,NaN,NaN,-11.248254976075794,-4.935217337780635
2019-10-11T09:30:00-04:00,49.65,50.2,49.64,49.76,4104936,3236486.35,51.15704599877005,43.60006116798945,NaN,NaN,8.200793402657663,-58.26597010254949,-0.0386977384361136,-0.262135668531414,-0.2234379300953004,64409944,58120592,62.45552559512049,52.32015806384688,NaN,NaN,-9.152211995284507,-5.537645145995474
2019-10-14T09:30:00-04:00,49.71,49.775,49.53,49.65,1246315,3172420.55,50.15616211842525,44.04878242265199,NaN,NaN,-5.195366163351434,-47.3880640036361,0.003041899940739834,-0.2196355551693756,-0.22267745511011544,63163629,59640349,65.60661288254664,52.0646948782005,NaN,NaN,-7.767792909861229,-5.856237683690582
2019-10-15T09:30:00-04:00,49.73,50.61,49.66,50.5,2115804,3049863.5,57.13512269388604,44.553025013963655,NaN,NaN,62.411394657001125,-15.426036825829083,0.08531915732065126,-0.11602850845930135,-0.2013476657799526,65279433,62071747.2,69.951721369598,52.59551227134618,NaN,NaN,-4.236368866230757,-5.624827852624892
2019-10-16T09:30:00-04:00,50.38,50.65,50.35,50.59,2308543,3077697.55,57.80873510912102,45.437317095658514,NaN,NaN,96.57772817040863,20.31667348052646,0.13999561503967786,-0.02635314698035529,-0.16634876202003315,67587976,64149198,73.08099809009065,53.931559969087594,NaN,NaN,-1.2143398762421005,-4.994758141713065
2019-10-17T09:30:00-04:00,50.99,51.01,50.7,50.89,2047212,3062130.75,60.0617347558015,46.815167911638035,NaN,NaN,138.76652846807218,60.15221570695765,0.1875888270622377,0.06813727180776397,-0.11945155525447373,69635188,66015234,75.54461321509666,55.77620740701709,NaN,NaN,2.003141172835059,-3.995058239634762
2019-10-18T09:30:00-04:00,50.76,50.915,50.02,50.3,1958301,2842142.45,53.95908311591299,47.55841210178737,NaN,NaN,92.13269796060176,76.93859661854647,0.17102220940933716,0.0943262065071977,-0.07669600290213945,67676887,66668622.6,76.3604246665536,57.831054988257215,NaN,NaN,2.944111340311311,-3.003748299642466
2019-10-21T09:30:00-04:00,50.51,50.7131,50.4532,50.6,1429610,2803704.25,56.385712310943944,48.76078810053938,NaN,NaN,110.78305446615703,100.13428074444816,0.17151782955896266,0.1377012840465639,-0.03381654551239877,69106497,67857196.2,77.81053580033398,60.05165808120006,NaN,NaN,4.469055162677065,-1.936204947882533
2019-10-22T09:30:00-04:00,50.68,50.7299,50.085,50.11,2433876,2656839.85,51.60179391196394,49.9822947422818,NaN,NaN,74.74442452266459,102.60088671758085,0.13187487034149764,0.13102704241447327,-0.0008478279270243624,66672621,68135833.8,78.14893747274182,62.579972242257654,NaN,NaN,4.305567462816355,-1.044523174925549
2019-10-23T09:30:00-04:00,50.1,50.55,50.1,50.5,1980691,2646794.9,54.88282116550675,51.062276488871056,NaN,NaN,78.864485483023,99.05823818010373,0.12501095127381012,0.1554158611652383,0.030404909891428175,68653312,68348901,78.41995636440149,65.11004328739588,NaN,NaN,5.175746219273686,-0.15591326146851547
2019-10-24T09:30:00-04:00,50.24,50.25,49.76,49.93,2529501,2682771.95,49.59129492600007,51.29815733911456,NaN,NaN,34.153082610313426,78.13554900855198,0.07750223500605859,0.1272827036490014,0.04978046864294282,66123811,67646625.6,75.11307884731228,67.20710805406314,NaN,NaN,4.2627567677982325,0.47532531414101986
2019-10-25T09:30:00-04:00,50,50.58,49.9,50.32,1215131,2650880.05,52.93492135948424,51.772868648892654,NaN,NaN,58.43201264204149,71.39541194483992,0.06809694667935028,0.13490165199213067,0.06680470531278039,67338942,67579036.6,74.78621542921894,69.19597255568601,NaN,NaN,4.538246293291784,1.0557425968768432
2019-10-28T09:30:00-04:00,50.58,50.94,50.54,50.79,2883909,2671744.25,56.66540298555219,52.95103848798266,NaN,NaN,97.46142379851001,68.73108581131052,0.08801739594494194,0.17682645024395782,0.08880905429901588,70222851,67802307.4,75.17059269899181,71.11052605879398,NaN,NaN,5.943146615248781,1.7539431709299773
2019-10-29T09:30:00-04:00,50.69,50.77,50.24,50.33,1788727,2623234.8,52.29639790181124,53.60745765493233,NaN,NaN,61.330004020989826,66.04820171097556,0.0657233497320849,0.170963241464122,0.1052398917320371,68434124,68154608,75.7975600823456,72.6125485715658,NaN,NaN,5.760526062634201,2.326312155459152
2019-10-30T09:30:00-04:00,50.45,50.61,50.095,50.47,3901457,2598031.1,53.47219403989114,54.150601599505045,NaN,NaN,51.05525465260207,60.486355544891374,0.05627956780774894,0.17558935149172328,0.11930978368397434,72335581,68891061.8,77.0993565492532,73.95329493311458,NaN,NaN,5.9654587707699,2.846190243360687
2019-10-31T09:30:00-04:00,50.84,50.84,50.17,50.62,4059965,2453737.9,54.75884989075691,54.40787330607554,NaN,NaN,63.61935513074006,66.3796100489767,0.055895045361012086,0.18917859038523943,0.13328354502422735,76395546,70945408.8,80.28497809463678,75.2268272545086,NaN,NaN,6.507338989322345,3.369211492783781
2019-11-01T09:30:00-04:00,50.91,50.96,50.56,50.95,3451286,2522287,57.5406777207978,54.935338706245,NaN,NaN,93.125264268527,73.31826037427382,0.07256863192225732,0.223994334927049,0.1514257030047917,79846832,73446986.8,83.32654294224926,76.49253654448736,NaN,NaN,7.779127147614428,3.999199443473873
2019-11-04T09:30:00-05:00,51.12,51.3146,51.03,51.23,4650494,2686536.3,59.799375797295795,55.1256424993457,NaN,NaN,134.25207364976436,80.67639034452468,0.09570357199772714,0.2710551680019506,0.17535159600422348,84497326,76301881.8,85.98409477095221,77.63770607315551,NaN,NaN,9.514219596156126,4.7870594652856235
2019-11-05T09:30:00-05:00,51.27,51.37,51.15,51.25,1886958,2658764.1,59.96320866624571,55.27953346771175,NaN,NaN,145.25523991348834,97.46143752302439,0.10486487109924053,0.30643268487827413,0.2015678137790336,86384284,79891913.8,88.47232553147096,78.73708660468267,NaN,NaN,10.981788256702307,5.672020721202292
2019-11-06T09:30:00-05:00,51.25,51.2699,50.84,51.07,2288286,2569264.4,57.684672814432645,55.10974332904255,NaN,NaN,112.13442756679508,109.677272105863,0.09178497129871252,0.31629902790242426,0.22451405660371174,84095998,82243997.2,89.7555358152028,79.75215250469026,NaN,NaN,11.622958896582979,6.5221547462566765
2019-11-07T09:30:00-05:00,51.28,51.75,51.2,51.39,1976291,2512864.65,60.55434526176961,55.58083348231803,NaN,NaN,166.7495458716223,130.30331025403945,0.09715002426411085,0.3459515869338503,0.24880156266973946,86072289,84179345.8,90.67531093137995,80.77464438074928,NaN,NaN,12.975058976377083,7.443998207702449
2019-11-08T09:30:00-05:00,51.38,51.69,51.31,51.53,1537567,2384496.2,61.775686605187296,55.965831646192555,NaN,NaN,152.03323671765915,142.08490474386585,0.10208616729939951,0.37640927179398886,0.27432310449458935,87609856,85731950.6,91.34653691212173,81.74150160301984,NaN,NaN,14.454453188054512,8.445491776324172
2019-11-11T09:30:00-05:00,51.25,51.36,51.16,51.29,1133405,2378850.7,58.43541405533042,56.45394737071873,NaN,NaN,98.72498893448594,134.97948780081018,0.08201132984945791,0.3768372668064117,0.2948259369569538,86476451,86127775.6,91.51424418947539,82.69616636850081,NaN,NaN,14.842803308430023,9.359393423767864
2019-11-12T09:30:00-05:00,51.34,51.53,51.21,51.35,6800967,2613108.85,59.03181150353613,56.75030382343512,NaN,NaN,102.50841864956061,126.43012354802462,0.06627082926119698,0.37766447353345,0.311393644272253,93277418,87506402.4,92.08929390407305,83.67254762133449,NaN,NaN,15.325803276365788,10.21173768842471
2019-11-13T09:30:00-05:00,51.23,51.455,51.12,51.33,1471417,2571252.55,58.72930784657557,57.40301903204766,NaN,NaN,82.08927697327432,120.42109342932046,0.04881569236804717,0.372413259732312,0.3235975673642648,91806001,89048403,92.68629459582736,84.927777317657,NaN,NaN,15.657170414816182,10.989656649337778
2019-11-14T09:30:00-05:00,51.3,51.66,51.23,51.56,1526834,2545233.65,61.192203576431254,57.992824904686735,NaN,NaN,99.16419617624771,106.90402349024558,0.0470440368933186,0.3824026134809131,0.3353585765875945,93332835,90500512.2,93.20625274405084,86.24349426871642,NaN,NaN,16.583740256100537,11.788811450303887
2019-11-15T09:30:00-05:00,51.84,52.01,51.67,51.99,2798538,2587245.5,65.3548713818677,58.61350121870927,NaN,NaN,140.29289168608523,104.55595448393078,0.06785166672705739,0.42017315999641625,0.35232149326935885,96131373,92204815.6,93.76639995300418,87.5717662154316,NaN,NaN,18.578525346538974,12.75877057833747
2019-11-18T09:30:00-05:00,51.91,52.26,51.63,52.17,1833092,2607419.6,66.95286597447449,59.660391795328074,NaN,NaN,139.10454886739169,112.63186647051195,0.08561172119196858,0.4593361447593196,0.373724423567351,97964465,94502418.4,94.43281003087193,88.90285549746919,NaN,NaN,20.737982174635647,13.89865794923721
2019-11-19T09:30:00-05:00,52.32,52.32,51.94,52.2,2134392,2592445.4,67.22420966852715,60.64267862594493,NaN,NaN,142.36895836261064,120.60397441312197,0.09076282705217559,0.4871779573825705,0.39641513033039494,100098857,95866706.2,94.78904432659006,90.16640462442182,NaN,NaN,22.62001213395931,15.144565689911795
2019-11-20T09:30:00-05:00,51.96,52.14,51.48,51.88,2428605,2614841.1,61.43017498276813,61.11920184680287,NaN,NaN,92.54172614658215,122.69446424778353,0.0651978095434243,0.4779123922596753,0.412714582716251,97670252,97039556.4,95.08048059597144,91.22322623165999,NaN,NaN,22.74790893091403,16.230757581483545
2019-11-21T09:30:00-05:00,51.93,52.2,51.735,52.02,1376251,2557178.6,62.93532012046614,61.504533446779185,NaN,NaN,108.51909515974062,124.56544404448212,0.05092820779922003,0.47637484246527606,0.42544663466605603,99046503,98182290,95.35317111271426,92.08227110097893,NaN,NaN,23.259952623997577,17.234928301842693
2019-11-22T09:30:00-05:00,52.11,52.14,51.81,52.04,1625044,2577674.25,63.15651651308811,61.744329212192916,NaN,NaN,101.92833214379942,116.89253213602494,0.036712194585080904,0.4713368778974072,0.4346246833123263,100671547,99090324.8,95.56360688067686,92.76652196595929,NaN,NaN,23.746900676883495,18.165210069705665
2019-11-25T09:30:00-05:00,52.21,52.265,52.09,52.2,2358770,2551417.3,64.9582014412997,62.101114410411014,NaN,NaN,117.05783817357208,112.48318999726102,0.03212579494384249,0.4747819269921294,0.4426561320482869,103030317,100103495.2,95.79255946451309,93.28939581831943,NaN,NaN,24.641623382561164,19.090411971542164
2019-11-26T09:30:00-05:00,52.31,52.39,52.12,52.37,2146633,2569312.6,66.8150356872604,62.75328318704157,NaN,NaN,121.11070618337472,108.23153956141384,0.03438043263445645,0.48563167284135744,0.451251240206901,105176950,101119113.8,96.01459419469235,93.7364714168544,NaN,NaN,25.916125086986437,20.06551384517706
2019-11-27T09:30:00-05:00,52.53,52.8,52.45,52.74,3416729,2545076.2,70.4812826575667,63.46235014388422,NaN,NaN,155.58136619806206,120.83946757170983,0.0534898809615183,0.5181135914087989,0.46462371044728057,108593679,103303799.2,96.44873352298036,94.14885874482584,NaN,NaN,28.116601789872014,21.215669265847765
2019-11-29T09:30:00-05:00,52.62,52.75,52.51,52.56,2396350,2461895.45,66.62496483641681,63.808727160400615,NaN,NaN,133.03313963989194,125.74227646774008,0.046940219847076414,0.5232989852561261,0.47635876540904964,106197329,104733964.4,96.70200623153357,94.53139226764097,NaN,NaN,28.94291890511354,22.319562071457163
2019-12-02T09:30:00-05:00,52.61,52.7,51.75,52.06,4503338,2514498.05,57.25394940806193,63.72433682845287,NaN,NaN,61.671170082672624,117.69084405551473,0.004122631414955169,0.4815120546777436,0.47738942326278844,101693991,104938453.2,96.73783069000358,94.90450558910727,NaN,NaN,26.858868243820705,22.968034381794812
2019-12-03T09:30:00-05:00,51.56,52.005,51.3,51.96,3963891,2480167.9,55.570467740716154,63.477097988251444,NaN,NaN,-9.865768424102972,92.30612273597971,-0.03366475327889268,0.4353084816641726,0.46897323494306525,97730100,103878409.8,91.20692298679452,94.84147909501596,NaN,NaN,24.638036137192497,23.20660606113734
2019-12-04T09:30:00-05:00,52.25,52.405,52.08,52.23,4519583,2611799.15,59.06987478916095,63.50142419843611,NaN,NaN,67.4341156699376,81.57080463329225,-0.042629162179555036,0.41568678221862143,0.45831594439817647,102249683,103292956.4,88.20735816604882,94.52155506431748,NaN,NaN,23.733719895948724,23.281908037538965
2019-12-05T09:30:00-05:00,52.46,52.47,52.11,52.45,3688610,2681815.35,61.71584748775737,63.53882733495941,NaN,NaN,80.1662470527121,66.48778080422225,-0.03615168182660977,0.4131263421149143,0.44927802394152405,105938293,102761879.2,85.46166621412267,93.96837031217976,NaN,NaN,23.74224379298962,23.34767028831763
2019-12-06T09:30:00-05:00,52.8,52.83,52.63,52.76,5192737,2842637.65,65.13598366447624,63.52319249800287,NaN,NaN,142.0666682453626,68.29448652531639,-0.014509097933034898,0.43114165152523043,0.4456507494582653,111131030,103748619.4,86.3140806951185,93.43606179375935,NaN,NaN,24.787931115709444,23.55342183508789
2019-12-09T09:30:00-05:00,52.67,53.05,52.54,52.56,3016126,2916565.6,61.32931184110871,63.12151005990531,NaN,NaN,123.18003235498166,80.59625897977821,-0.01700980032538163,0.4243884990515383,0.44139829937691993,108114904,105032802,87.35333280764317,92.93038484924303,NaN,NaN,24.519988413002945,23.691502774790038
2019-12-10T09:30:00-05:00,52.54,52.59,52.24,52.38,6432184,3181504.55,58.041619456631025,62.46561075905559,NaN,NaN,59.21299188007784,94.41201104061437,-0.03319683382491034,0.399902257095782,0.4330990909206923,101682720,105823326,87.95946278981717,92.4425575966164,NaN,NaN,23.308811451272785,23.636832585716146
2019-12-11T09:30:00-05:00,52.5,52.66,52.42,52.62,1436471,2913279.75,61.04050456555107,62.4377771578258,NaN,NaN,86.2601121219498,98.17721033101681,-0.030234562367542572,0.3953058879612641,0.42554045032880666,103119191,105997227.6,88.09464059456647,91.94356902508746,NaN,NaN,23.161454332591404,23.568921406698326
2019-12-12T09:30:00-05:00,52.64,53.06,52.4,52.68,2866774,2983047.6,61.77603647806999,62.35497118336894,NaN,NaN,109.05963302752721,103.95588752597982,-0.026843433515315707,0.391986158434662,0.4188295919499777,105985965,106006762,88.10252717469812,91.42566588665774,NaN,NaN,23.251552875288276,23.523583045068317
2019-12-13T09:30:00-05:00,52.67,52.785,52.335,52.56,2834403,3048426.05,59.36217320325486,62.08394666123799,NaN,NaN,66.50144568360321,88.84284301362796,-0.03478727160667611,0.37534550244163256,0.41013277404830867,103151562,104410868.4,78.7044163753379,90.22143799341926,NaN,NaN,22.64391257383413,23.397915834892004
2019-12-16T09:30:00-05:00,52.85,53.15,52.85,53.08,5780780,3197538.15,65.62953560192219,62.13189910128245,NaN,NaN,158.0715964493166,95.82115583249495,-0.00849662619212499,0.3995119913081524,0.4080086175002774,108932342,104574356,78.9521164828471,89.01854920901454,NaN,NaN,24.00736122781798,23.48497946245286
2019-12-17T09:30:00-05:00,53.08,53.21,52.94,53.03,3222547,3267010.9,64.59790524822958,61.973532641351674,NaN,NaN,144.07427635172382,112.79341272682413,0.0015166283296322858,0.4099044029123178,0.4083877745826855,105709795,105379771,80.17548897491193,87.8871845504588,NaN,NaN,24.80735807865546,23.673890693338944
2019-12-18T09:30:00-05:00,53.21,53.5711,53.1501,53.39,1862900,3253436.3,68.44403101254551,61.828014666707304,NaN,NaN,177.7113105129079,131.08365240501575,0.026964403699594075,0.4420932792071781,0.41512887550758404,107572695,106270471.8,81.4589464943256,86.81648547698344,NaN,NaN,26.70489343923138,24.10689108560929
2019-12-19T09:30:00-05:00,53.43,53.88,53.43,53.88,1872998,3225655.95,72.7789213386031,62.26758298829204,NaN,NaN,215.23957615142893,152.3196410297961,0.06898706225143192,0.5013627033218739,0.432375641070442,109445693,106962417.4,82.41158995266872,85.79574145706452,NaN,NaN,29.843243628728423,24.926370020340595
2019-12-20T09:30:00-05:00,54.05,54.085,53.65,53.93,3109747,3312330.75,73.1837334661526,63.40542470672709,NaN,NaN,203.79153946651135,179.7776597863777,0.09095863172309004,0.5460739307243045,0.4551152990012145,112555440,108843193,84.71103843752863,84.93668486760203,NaN,NaN,32.46122330842152,26.002777632923586
2019-12-23T09:30:00-05:00,54.08,54.145,53.755,53.79,3248619,3393509.5,70.04283003383387,64.43916487052121,NaN,NaN,170.64634105335313,182.29260870718502,0.08687811178934879,0.5637129387379005,0.4768348269485517,109306821,108918088.8,84.79628014229846,84.4787818072809,NaN,NaN,33.68569559279942,27.100337341477275
2019-12-24T09:30:00-05:00,53.85,53.89,53.735,53.78,891174,3320129.7,69.8123523173896,65.20648469396612,NaN,NaN,130.36277581423664,179.55030859968758,0.07478083803270213,0.5703108744894294,0.4955300364567273,108415647,109459259.2,85.42846026495049,84.28028910005958,NaN,NaN,34.61044251778681,28.173209509521495
2019-12-26T09:30:00-05:00,53.85,54.19,53.85,54.19,830231,3254309.6,73.64190321218416,66.05834581713945,NaN,NaN,140.14529303392288,172.03710510389058,0.08492595551724713,0.6016874808532862,0.516761525336039,109245878,109793895.8,85.82106776583147,84.30596063946734,NaN,NaN,36.61581438268297,29.379295919973135
2019-12-27T09:30:00-05:00,54.32,54.35,53.98,54.09,3205061,3243726.2,71.26720129045643,66.49628993328089,NaN,NaN,126.1025713015625,154.2097041339173,0.07573977712409985,0.6114362467411638,0.535696469617064,106040817,109112920.6,81.03614990317516,83.92896558289998,NaN,NaN,37.57357083557786,30.549906622202382
2019-12-30T09:30:00-05:00,54.11,54.11,53.47,53.53,2141308,3230974.1,59.66419348224096,66.37735290764749,NaN,NaN,70.08679315321955,127.46875487125894,0.025389920006296807,0.567433869624935,0.5420439496186382,103899509,107381734.4,70.30462069439396,82.7112004319536,NaN,NaN,34.70736882161657,31.143829793547265
2019-12-31T09:30:00-05:00,53.44,53.7,53.37,53.63,2050095,3108311.95,60.88875109043797,66.58071945291941,NaN,NaN,49.05639618041698,103.15076589667174,-0.006059321397726136,0.5344697978714805,0.5405291192692067,105949604,106710291,66.61963848418864,81.18692726726586,NaN,NaN,32.76675647867492,31.375676462851217
2020-01-02T09:30:00-05:00,53.97,54.26,53.74,54.26,6365149,3228374.85,67.56876281918343,67.04702361389316,NaN,NaN,95.88801497917459,96.25581372965932,0.00982377040617921,0.5528088322769307,0.5429850618707515,112314753,107490112.2,68.67333382121758,79.7996910691695,NaN,NaN,33.215239359369704,31.63847116235386
2020-01-03T09:30:00-05:00,53.67,54.2,53.56,53.91,2351385,3119964.95,61.304367778204146,67.01333299247416,NaN,NaN,67.41125924157535,81.7090069711898,-0.008022467133997346,0.5329569779532548,0.5409794450872522,109963368,107633610.2,69.0506728152315,78.43884432920761,NaN,NaN,31.44694595466146,31.611110418397804
2020-01-06T09:30:00-05:00,53.61,54.67,53.6,54.63,2535880,3062328.45,67.89786997118861,67.62302561875516,NaN,NaN,106.69171746099818,77.82683620307694,0.022229119510297157,0.5687658444751236,0.5465367249648264,112499248,108925296.4,72.28662957497468,77.98043098632452,NaN,NaN,32.27778395558914,31.706349495139424
2020-01-07T09:30:00-05:00,54.69,54.91,54.51,54.7,2642767,2934829.95,68.46054624470878,67.82524066466848,NaN,NaN,140.81801747514422,91.97308106746186,0.039509506242118464,0.5959236077674746,0.5564141015253561,115142015,111173797.6,76.82842736668132,77.82873890659837,NaN,NaN,33.101797577417926,31.90569922117921
2020-01-08T09:30:00-05:00,54.73,55.365,54.66,55.09,4161180,2992082.65,71.46179915080273,68.31551880056658,NaN,NaN,163.9143752186204,114.94467687510254,0.06808553200070777,0.6415210165262408,0.5734354845255331,119303195,113844515.8,80.84411784177415,77.87649811137426,NaN,NaN,34.81971365759078,32.32198699780943
2020-01-09T09:30:00-05:00,55.53,55.555,55.0952,55.38,2297293,2785338.1,73.48248726355622,68.67540853278163,NaN,NaN,184.8601906457317,132.73911200841397,0.09570649589699043,0.6930686043967711,0.5973621084997807,121600488,115701662.8,83.04459016595945,77.9897583736338,NaN,NaN,36.90478132695497,32.97667190197308
2020-01-10T09:30:00-05:00,55.59,55.59,55.08,55.16,1941803,2810604.7,69.46418145424838,68.43864139818486,NaN,NaN,160.03768822664392,151.26439780542768,0.08851576594108757,0.7080068159261401,0.6194910499850526,119658685,117640726.2,84.98411402767229,78.17351009327693,NaN,NaN,37.282231998569074,33.591751915772505
2020-01-13T09:30:00-05:00,55.42,55.71,55.18,55.68,2853998,2809965.9,73.19527274946222,68.43946563270698,NaN,NaN,162.4772249049612,162.4214992942203,0.10690601652921572,0.7531235706465722,0.6462175541173565,122512683,119643413.2,86.6789616793817,78.31407603912358,NaN,NaN,38.87235378200731,34.34612361094891
2020-01-14T09:30:00-05:00,55.67,55.785,55.47,55.54,2909613,2813726.4,70.69089873899897,68.48575625450448,NaN,NaN,146.02853413506912,163.46360262620527,0.09800256425592124,0.768720759437258,0.6707181951813368,119603070,120535624.2,87.36327264257183,78.49743264628594,NaN,NaN,39.32674949245554,35.057641594021284
2020-01-15T09:30:00-05:00,55.68,55.92,55.5931,55.81,2136763,2631525.55,72.63547291339717,68.68740772564789,NaN,NaN,138.90350118732903,158.461427819947,0.09840055597383068,0.7937188901486252,0.6953183341747945,121739833,121022951.8,87.73391869397048,78.6621082483588,NaN,NaN,40.322640749717735,35.80978433054935
2020-01-16T09:30:00-05:00,56.05,56.24,55.87,56.24,2031599,2571978.15,75.43120322456393,68.8152148693893,NaN,NaN,145.50534553892132,150.5904587985849,0.11459420064238546,0.8385610849777763,0.7239668843353908,123771432,121457140.6,88.06967135323964,78.82272279031653,NaN,NaN,42.09071710924191,36.70706044179114
2020-01-17T09:30:00-05:00,56.48,56.695,56.3,56.68,6103855,2784025.9,77.91735337929948,69.29022573287808,NaN,NaN,157.40913230347337,150.0647476139508,0.14021635023038836,0.8992373221233763,0.7590209718929879,129875287,123500461,89.52308601849782,79.42893251283957,NaN,NaN,44.42604407155795,37.80977238890069
2020-01-21T09:30:00-05:00,56.58,56.7258,56.34,56.63,3181953,2849473.65,76.96426189997104,70.52594490557308,NaN,NaN,136.44141215365374,144.8575850636893,0.13881471192572614,0.9325393618001456,0.7937246498744195,126693334,124336591.2,90.05688963629373,80.83980886583241,NaN,NaN,45.966329245794505,38.97499479702838
2020-01-22T09:30:00-05:00,56.87,56.905,56.54,56.6,4542797,2921126.15,76.36072149290735,71.63108564860661,NaN,NaN,127.40721589733391,141.13332141614225,0.12150852957228775,0.9456103118397792,0.8241017822674914,122150537,124846084.6,90.37857899081133,82.53687604487689,NaN,NaN,47.023109878246736,40.12472552291672
2020-01-23T09:30:00-05:00,56.5,56.53,56.21,56.37,1985754,2857982.9,71.71735692572554,71.9274137990739,NaN,NaN,94.71985910814709,132.29659300030588,0.08210043052629812,0.9267273204253641,0.844626889899066,120164783,124531074.6,88.4727049425756,83.95111683925961,NaN,NaN,46.564092608330604,41.044635106547275
2020-01-24T09:30:00-05:00,56.51,56.51,55.43,55.69,3175781,2972213.25,60.084397114045665,71.84027303734831,NaN,NaN,53.53735841970408,113.90299557646242,0.0020000437471554555,0.8471269445830103,0.8451269008358548,116989002,123174588.6,80.59148405898603,84.77546049952778,NaN,NaN,42.37712945290307,41.23499144174096
2020-01-27T09:30:00-05:00,54.65,55.03,54.51,54.82,5708759,3216139.65,49.10896234175744,70.49820820667465,NaN,NaN,-31.8953295051019,76.04210321474736,-0.11153640063755321,0.7057064000389133,0.8172428006764665,111280243,119455579.8,63.808802267669165,84.16990140614882,NaN,NaN,34.56846743783789,40.282630869754804
2020-01-28T09:30:00-05:00,55.17,55.675,54.91,55.45,6526647,3382218.95,55.454518130724466,69.56920619853291,NaN,NaN,7.4994503648808815,50.25371085699278,-0.14409744039559114,0.6371210001819776,0.7812184405775687,117806890,117678291,57.63215824982393,82.7987393263733,NaN,NaN,30.253101746036236,38.849840994937864
2020-01-29T09:30:00-05:00,55.76,55.76,55.16,55.36,5983914,3574349.25,54.41076017823322,68.35127484334939,NaN,NaN,8.012029892079449,26.374673655941887,-0.16981805251335846,0.5689458749358707,0.7387639274492291,111822976,115612778.8,51.40446431182732,80.6959069313771,NaN,NaN,26.601104983501138,37.100021564732614
2020-01-30T09:30:00-05:00,54.11,54.83,53.9737,54.8,3163224,3630005.7,48.316904491301926,66.5537332167598,NaN,NaN,-86.51293721028003,-9.871885607743502,-0.21951015242076588,0.4643762369232718,0.6838863893440377,108659752,113311772.6,45.50519690213178,78.01452169824655,NaN,NaN,21.382135584302393,34.854609281814014
2020-01-31T09:30:00-05:00,54.8,54.8,53.79,53.91,3635632,3493529.85,40.54494166687336,64.4880732319473,NaN,NaN,-124.88391418637912,-45.556140128960145,-0.3021816955005068,0.30615926996840415,0.6083409654689109,105024120,110918796.2,40.32256138528957,74.82441079521922,NaN,NaN,13.90073958012296,31.861199324429577
2020-02-03T09:30:00-05:00,54.35,54.81,54.35,54.55,5905758,3671248.5,47.13075438148468,62.62632191994889,NaN,NaN,-92.0616338562348,-57.58940099918673,-0.30286057689605084,0.22976524434884738,0.5326258212448982,110929878,110848723.2,40.17825759222218,71.50293193185067,NaN,NaN,10.177359796258568,28.763507963262292
2020-02-04T09:30:00-05:00,54.77,55.1513,54.34,55.12,3503988,3719653.9,52.208287073207224,61.30613537239234,NaN,NaN,-65.59494791807764,-72.20828065577844,-0.25588941427529266,0.21276405340078242,0.4686534676760751,114433866,110174118.4,38.74084283515486,68.02990123132089,NaN,NaN,9.024662984940784,25.94367296635922
2020-02-05T09:30:00-05:00,55.6,55.65,54.92,55.21,3771654,3776098.25,52.97621338773621,59.901902549130845,NaN,NaN,-26.183181816011,-79.04732299739652,-0.21156368805686554,0.20419885760499312,0.41576254566185866,118205520,111450627.2,42.90340095269874,64.82772139265862,NaN,NaN,8.410412785587946,23.438921511963322
2020-02-06T09:30:00-05:00,55.48,55.995,55.48,55.9,1998143,3667946.4,58.48396210056578,58.69138532598812,NaN,NaN,31.907620846601407,-55.36321138602024,-0.13244690320734298,0.25020391665267994,0.3826508198600229,120203663,113759409.4,49.5770230609084,62.07824651463496,NaN,NaN,9.810796693578402,21.492046537908333
2020-02-07T09:30:00-05:00,55.72,56.06,55.55,55.86,2698613,3688012.4,58.05941608686565,57.272961233671424,NaN,NaN,32.46882272706764,-23.892664003330886,-0.08195621072199338,0.2802055564575312,0.3621617671795246,117505050,116255595.4,55.6171396266249,59.656393200929756,NaN,NaN,10.75234237555619,19.95780308614374
2020-02-10T09:30:00-05:00,55.73,56.2,55.69,56.19,4420509,3811947.7,60.60049074354068,56.10412043678354,NaN,NaN,51.25599451159903,4.770861670235883,-0.028255273488124177,0.3268426753193694,0.35509794880749357,121925559,118454731.6,60.14655897013275,57.51994101048969,NaN,NaN,12.340538486468075,18.86962242904722
2020-02-11T09:30:00-05:00,56.48,56.56,56.06,56.13,1703261,3754410.85,59.889998650035324,54.927640233721256,NaN,NaN,69.8237647373134,31.85460420131409,-0.0001817983102084808,0.35487070091973294,0.3550524992299414,120222298,119612418,62.32622459004512,55.51620141043496,NaN,NaN,13.397919625226448,18.087950599929965
2020-02-12T09:30:00-05:00,56.41,56.94,56.39,56.86,1730212,3695440.8,65.23109502477804,54.464335812225,NaN,NaN,108.91910031373814,58.875060627263906,0.060773590950509604,0.4310194879180784,0.3702458969675688,121952510,120361816,63.70985173288982,53.74742618117169,NaN,NaN,16.063097209785347,17.798685829909306
2020-02-13T09:30:00-05:00,56.54,57.085,56.41,56.87,2761565,3726680.9,65.29926266560862,54.83682620876522,NaN,NaN,103.21762311714929,73.13706108137349,0.09305611144501891,0.48656603627384243,0.3935099248288235,124714075,121263898.4,65.35910515585783,52.659399116662534,NaN,NaN,18.192770420593124,17.854983628578424
2020-02-14T09:30:00-05:00,56.92,57.03,56.705,56.94,2111747,3730688.3,65.80466453388527,56.029376365345776,NaN,NaN,104.76087690048232,87.59547191605643,0.1092916963417534,0.5301245452560153,0.42083284891426187,126825822,123128052.8,68.54085426284907,52.99740283060396,NaN,NaN,20.078137785847854,18.172577079616914
2020-02-18T09:30:00-05:00,56.82,57.4348,56.81,57.32,2952909,3573141,68.48782564494651,56.96032690207591,NaN,NaN,124.93640196562285,102.33155340686119,0.13415265459835019,0.5885236671621996,0.45437101256384943,129778731,124698687.2,70.96097363453299,53.94946107236889,NaN,NaN,22.51066850269428,18.792304425770823
2020-02-19T09:30:00-05:00,57.53,57.75,57.31,57.58,4301848,3629135.75,70.21017883179941,58.088856805902076,NaN,NaN,143.72337548177745,117.11147555575398,0.15515269656882907,0.6483118832748858,0.4931591867060567,134080579,127470343.4,74.66489314143942,55.61092027448405,NaN,NaN,25.085411574970934,19.69131973279941
2020-02-20T09:30:00-05:00,57.33,57.375,56.46,56.99,2939039,3548947.85,61.93725302771098,59.06173884421701,NaN,NaN,90.00515541068702,113.32868657514378,0.11803329548387365,0.6407008060608987,0.5226675105770251,131141540,129308149.4,76.77979638095856,57.84482023725739,NaN,NaN,24.920554512694896,20.43835327278448
2020-02-21T09:30:00-05:00,56.73,56.82,55.96,56.12,2927374,3596028.85,52.17455742642131,59.89242568418472,NaN,NaN,37.102427264199214,100.10564740455376,0.02829364616922392,0.558034568288555,0.5297409221193311,128214166,130008167.6,77.54858308979784,60.503821787579405,NaN,NaN,21.550178939038886,20.59718551082082
2020-02-24T09:30:00-05:00,54.4,54.78,53.85,54.24,5297521,3702115.85,38.17250383274574,59.252550644989086,NaN,NaN,-113.4097020987413,56.471531604709035,-0.15424338200604143,0.33693669461177933,0.49118007661782076,122916645,129226332.2,74.57866067005465,62.96099343599601,NaN,NaN,12.600662887058897,19.45482513599769
2020-02-25T09:30:00-05:00,54.43,54.66,52.69,52.79,13048917,4069123.75,31.214506325270747,57.752994877279335,NaN,NaN,-163.03826711562576,-1.1234022115406788,-0.3575819695126635,0.044202614726991385,0.4017845842396549,109867728,125244131.6,61.63169895523796,64.59605458743052,NaN,NaN,2.035886331635542,16.966405306803097
2020-02-26T09:30:00-05:00,53.1,53.7607,52.4,52.69,6991531,4092367.95,30.79757282338936,56.16880626554028,NaN,NaN,-162.29433468188296,-62.32694424427276,-0.4763303788630636,-0.1936283893391746,0.28270198952388903,102876197,119003255.2,47.6658396370993,64.93622877917342,NaN,NaN,-5.689415903929566,13.729859419555574
2020-02-27T09:30:00-05:00,51.68,52.41,50.61,50.61,8635559,4224950.2,23.705069172949806,53.68459962785342,NaN,NaN,-211.21647405762283,-122.57127013793475,-0.6611076365624478,-0.5436825561791707,0.11742508038327706,94240638,111623074.8,36.990917685009904,64.03722125232352,NaN,NaN,-15.736856787141187,9.520328532884609
2020-02-28T09:30:00-05:00,49.2,50.85,49.04,50.76,17876433,4960610.65,25.04564855389593,51.326473375498445,NaN,NaN,-210.92731641344807,-172.1772188734642,-0.7337639796916273,-0.7997798942312571,-0.06601591453962977,112117071,108403655.8,33.469614793764734,62.4552551928335,NaN,NaN,-22.403291472142417,4.959811389309319
2020-03-02T09:30:00-05:00,51.29,52.52,50.44,52.52,7324434,5145050.75,38.663842354881375,49.759569919165635,NaN,NaN,-125.91626220878058,-174.67853089547205,-0.6279175048641805,-0.8509127956198554,-0.22299529075567492,119441505,107708627.8,32.744909304058865,60.497994502399656,NaN,NaN,-22.597912983148106,1.0229936218154014
2020-03-03T09:30:00-05:00,52.59,53.21,50.48,50.79,9167600,5308142.85,32.427207362996754,47.79794197009146,NaN,NaN,-119.94077812662188,-166.05903309767126,-0.6370300647446483,-1.0192828716864852,-0.382252806941837,110273905,107789863.2,32.92771160870883,58.3981007180185,NaN,NaN,-25.35771566584815,-2.745679133565106
2020-03-04T09:30:00-05:00,51.66,52.65,51.17,52.62,3398109,5302848.9,42.916487295457415,46.204041417997125,NaN,NaN,-84.71591232333442,-150.54334862596156,-0.48907622144033536,-0.9935980837422562,-0.5045218623019209,113672014,109949026.6,37.769281331738085,56.54520283222194,NaN,NaN,-23.075077465038994,-5.649878895204234
2020-03-05T09:30:00-05:00,51.44,51.76,50.32,50.7,4009242,5314728.3,36.51250327811202,44.14784431889023,NaN,NaN,-107.49954733936706,-129.79996328231042,-0.4886337201274672,-1.1153140124612548,-0.6266802923337876,109662772,113033453.4,43.98924869756319,55.018784513772324,NaN,NaN,-24.008296591184404,-8.272509994629972
2020-03-06T09:30:00-05:00,49.08,50.08,48.62,49.82,6736426,5551642.45,34.00772236734653,41.87663416413746,NaN,NaN,-129.15261267078972,-113.44502253377873,-0.5131876013962882,-1.2681647940791478,-0.7549771926828597,102926346,111195308.4,41.337585400239504,53.075693880728785,NaN,NaN,-25.70585012403601,-10.762987155973693
2020-03-09T09:30:00-04:00,46.55,48.2,45,46.5,6079966,5720710.1,26.595126927155306,38.88429854143809,NaN,NaN,-175.21686884208526,-123.30514386043964,-0.7066670173417652,-1.6383109643600662,-0.931643947018301,96846380,106676283.4,35.64827066836703,50.553357954574075,NaN,NaN,-30.44264659531472,-13.574367075879554
2020-03-10T09:30:00-04:00,48.06,48.89,46.38,48.87,5108072,5755088.25,37.13003844011923,36.521431370603786,NaN,NaN,-123.38351840445019,-123.9936919160053,-0.63115003089863,-1.7205814856415884,-1.0894314547429584,101954452,105012392.8,33.8035046459384,47.63468734775257,NaN,NaN,-29.485728369926573,-15.847418689314843
2020-03-11T09:30:00-04:00,47.69,47.93,46.08,46.77,5854673,5962658.85,32.65758617767473,34.4300265956012,NaN,NaN,-132.2911383868982,-133.50873712871808,-0.6748164746558862,-1.9329520480628162,-1.25813557340693,96099779,101497945.8,30.243491034118932,44.31066553726402,NaN,NaN,-30.668046706659783,-17.964651263221263
2020-03-12T09:30:00-04:00,43.76,45.39,41.05,42.38,9472174,6349756.95,25.690858422069795,32.53833380957609,NaN,NaN,-190.3901933639566,-150.08686633363598,-0.9355001232542537,-2.427510727474747,-1.4920106042204933,86627605,96890912.4,26.329015401047556,40.65212498806757,NaN,NaN,-34.858034686429484,-20.37799175225101
2020-03-13T09:30:00-04:00,45.01,46.25,42.63,46.19,7604703,6591913.85,38.04390155909952,32.52914793288707,NaN,NaN,-131.97357895992397,-150.65105959146283,-0.7931034465883182,-2.483389912455891,-1.690286465867573,94232308,95152104.8,25.013111297885203,37.11172860434119,NaN,NaN,-32.37803011323629,-22.09228294667748
2020-03-16T09:30:00-04:00,39.51,43.69,39.11,40.98,19813537,7477003.35,30.562014860681046,32.482541399702086,NaN,NaN,-176.3811950286866,-150.8839248287831,-0.9793561845526877,-2.9144816965584326,-1.935125512005745,74418771,90666583,21.96354434188258,34.27828898910152,NaN,NaN,-33.98126411492574,-23.790708827855802
2020-03-17T09:30:00-04:00,41.8,43.46,40.15,42.76,14016562,8030186,35.24744985856117,32.800389759357216,NaN,NaN,-138.67769638724306,-153.94276042534165,-0.9135187113845196,-3.0770239012363945,-2.163505189851875,88435333,87962759.2,20.35273776986456,32.3273531414419,NaN,NaN,-33.038582089209115,-25.111833579477704
2020-03-18T09:30:00-04:00,40.3,41.69,38.68,41.34,18094970,8719842.1,33.31610404821481,33.486892250447575,NaN,NaN,-142.93656406632942,-156.07184556122792,-0.895261717099618,-3.2825823362263975,-2.3873206191267795,70340363,82810876,17.69046515246103,30.948749389116976,NaN,NaN,-33.13857276095937,-26.258510605403657
2020-03-19T09:30:00-04:00,41.01,43.52,40.2,42.08,14289273,9287353.8,35.30552902007679,34.21974085517477,NaN,NaN,-106.6187158726454,-139.31755006296567,-0.7678976706081211,-3.347192707386931,-2.57929503677881,84629636,82411282.2,17.499265575706104,29.808010159255648,NaN,NaN,-32.47092004969036,-27.145997668873186
2020-03-20T09:30:00-04:00,42.87,42.92,40.05,40.22,10078080,9644889.1,32.66745032237159,33.79142713856693,NaN,NaN,-108.04514390883215,-134.5318630527473,-0.7429998031294529,-3.508044790690626,-2.765044987561173,74551556,78475131.8,15.699294831550446,28.59046626836219,NaN,NaN,-32.89146873481628,-27.966779249722197
2020-03-23T09:30:00-04:00,40.01,41.17,39.03,40.32,15113853,10135705.7,32.95749639338027,33.829304926451464,NaN,NaN,-109.72973168058604,-121.20157038312718,-0.656854870983917,-3.586113576291069,-2.929258705307152,89665409,81524459.4,22.361808572228213,27.83575890861357,NaN,NaN,-33.11279827302673,-28.70192482447999
2020-03-24T09:30:00-04:00,42.32,42.8,41.47,42.8,6497910,9808155.35,39.874771248822114,33.61203949454894,NaN,NaN,-67.22273554966641,-106.91057821561185,-0.38345417994372877,-3.4085764302368133,-3.0251222502930846,96163319,83070056.6,25.572632490995233,26.96456970570336,NaN,NaN,-30.976370819849897,-29.026845680961404
2020-03-25T09:30:00-04:00,42.66,43.95,41.42,42.14,5291385,9723148.05,38.729512092933454,33.77039726703618,NaN,NaN,-58.072872669932764,-89.93783993633251,-0.20653081771938764,-3.2832857724423192,-3.0767549547229316,90871934,87176370.8,33.44754436038079,26.211590824476048,NaN,NaN,-29.648953602653243,-29.115718241203094
2020-03-26T09:30:00-04:00,42.48,44.73,42.37,44.54,4691052,9525922.7,44.924186413827734,34.550144698927696,NaN,NaN,-30.127221938189564,-74.63954114944133,0.09640058567236043,-2.956254222632481,-3.0526548083048413,95562986,89363040.8,37.25477740596791,25.91996168202807,NaN,NaN,-26.494587283646805,-28.741270961552196
2020-03-27T09:30:00-04:00,43.28,43.935,42.59,42.76,3378111,8801006.6,41.56747340580866,35.61959801883151,NaN,NaN,-39.65193084685817,-60.960898537046525,0.19545367215779752,-2.8083377181075946,-3.003791390265392,92184875,92889704.6,42.92567324806385,26.439776152006413,NaN,NaN,-24.94147709990986,-28.198443267031863
2020-03-30T09:30:00-04:00,43.16,44.47,42.69,44.32,3025593,8586064.55,45.416779327775245,36.21150808223551,NaN,NaN,-20.595302394504674,-43.134012679830256,0.37423277161062796,-2.536000425752107,-2.910233197362735,95210468,93998716.4,44.6206950838439,27.21243261185681,NaN,NaN,-22.42934598228046,-27.374286512067375
2020-03-31T09:30:00-04:00,44.31,45.035,43.949,44.24,4777180,8366543.55,45.25214628051786,37.111119518152876,NaN,NaN,-1.3338933375233697,-29.95624423740165,0.48809677478313285,-2.300112228883819,-2.788209003666952,90433288,92852710.2,43.19316581935848,28.13740938223106,NaN,NaN,-20.491811871579767,-26.391075849140574
2020-04-01T09:30:00-04:00,42.95,43.45,42.08,42.48,5481183,8470697.25,41.673126248555974,38.2527100771876,NaN,NaN,-37.48656063799886,-25.838981831014927,0.44697816752864306,-2.229486294256148,-2.676464461784791,84952105,91668744.4,41.708561320629016,29.235948376486878,NaN,NaN,-19.893180039441095,-25.462805019183506
2020-04-02T09:30:00-04:00,42.3,43.29,42.24,43.02,4537246,8497097.45,43.15856835408091,38.61804341968627,NaN,NaN,-25.173373638999458,-24.848212171176915,0.4566368410306283,-2.1056684104965058,-2.562305251527134,89489351,90454017.4,40.182551067742345,30.31947978861953,NaN,NaN,-18.973198639665373,-24.53571839353806
2020-04-03T09:30:00-04:00,42.94,43.11,41.59,42.15,3071775,8313864.9,41.332210650166566,39.38734311893524,NaN,NaN,-38.98417180111059,-24.7146603620274,0.4065917330544484,-2.0540655852090737,-2.460657318263522,86417576,89300557.6,38.733359268334006,31.51732371193749,NaN,NaN,-18.715357664320745,-23.704238289364156
2020-04-06T09:30:00-04:00,43.73,45.17,43.48,44.93,3294998,8174616.5,48.789605808817285,40.354639972524964,NaN,NaN,63.326893195598615,-7.930221244006742,0.5537566668877281,-1.7684614846538622,-2.3222181515415903,89712574,88200978.8,37.35045278832878,32.73144621325636,NaN,NaN,-16.229007772045513,-22.636348215461492
2020-04-07T09:30:00-04:00,46.31,46.45,45.12,45.26,3694323,8103929.05,49.6084457409469,41.518378664862965,NaN,NaN,130.89605482998638,18.515768389495214,0.6591990055131411,-1.4982193946501638,-2.157418400163305,93406897,88795700.6,38.62677053388915,34.226896597644085,NaN,NaN,-13.970606913131425,-21.39838517227148
2020-04-08T09:30:00-04:00,45.76,46.44,45.29,46.23,2628222,7942606.5,52.036158664475295,42.71342363946286,NaN,NaN,158.89779072590466,57.79263866227592,0.7723038251047996,-1.1920386187823055,-1.964342443887105,96035119,91012303.4,43.26597159898527,36.06737559930688,NaN,NaN,-11.362099186919018,-19.964630031506843
2020-04-09T09:30:00-04:00,46.8,47.06,46.08,46.57,3256452,7631820.4,52.89283817846879,44.15809420061266,NaN,NaN,155.26556114145296,93.8804256183664,0.8423168329357851,-0.9114464027173739,-1.753763235653159,99291571,92972747.4,47.07632665758385,38.308592158309274,NaN,NaN,-8.960799900001613,-18.392654298434667
2020-04-13T09:30:00-04:00,46.45,46.73,45.56,46.64,2606243,7381897.4,53.078652296365924,45.595319622254486,NaN,NaN,133.60785088699188,128.3988301559869,0.8624999507445796,-0.6756382972224344,-1.538138247967014,101897814,96068795,52.5017911831689,40.46144805909074,NaN,NaN,-6.9185334291936575,-16.75349417425738
2020-04-14T09:30:00-04:00,47.61,48.3458,47.32,48.02,5554172,6668929.15,56.70442835428802,46.797437986930625,NaN,NaN,168.85824717932454,149.50510095273208,0.9320279542138976,-0.37310330519964197,-1.3051312594135396,107451986,99616677.4,57.83605462554006,42.76597821155823,NaN,NaN,-4.1111768007519,-14.947448835185169
2020-04-15T09:30:00-04:00,47.18,47.97,46.98,47.57,1969199,6066561,55.206339537361615,47.97435423296121,NaN,NaN,133.4627472730638,150.01843944134757,0.9099289981906371,-0.16772001167524309,-1.0776490098658802,105482787,102031855.4,61.04338060127099,44.73710937162182,NaN,NaN,-2.1174370929889044,-13.114590014871418
2020-04-16T09:30:00-04:00,47.92,47.92,47.08,47.76,2475845,5285604.75,55.73805204827311,48.746773206850165,NaN,NaN,120.3068719764976,142.30025569146613,0.8703278954548697,0.010260859452706939,-0.8600670360021627,107958632,104416558,63.95861261526137,46.64452617228564,NaN,NaN,-0.2954899986098414,-11.283290012548335
2020-04-17T09:30:00-04:00,48.6,48.6,47.76,48.41,3348453,4738563.75,57.592634138827236,49.89142754492292,NaN,NaN,126.05617877963894,136.45837921910336,0.8492052135089173,0.2014394808839839,-0.6477657326249334,111307085,106819660.8,66.66572152964703,48.34024390668451,NaN,NaN,1.772131183728096,-9.418229841651701
2020-04-20T09:30:00-04:00,47.96,48.56,47.8,47.97,1948599,4332089.7,55.88561047741034,50.639201198468285,NaN,NaN,107.24692581944424,131.18619420559384,0.7692749695993034,0.3138279793741958,-0.4554469902251076,109358486,108311795.2,68.25988551717998,50.02875750906566,NaN,NaN,3.1339339529458674,-7.62506358528062
2020-04-21T09:30:00-04:00,47.35,47.4358,46.12,46.46,4167713,3784782.7,50.36816921927495,51.0046314083795,NaN,NaN,53.423915357246216,108.09932784117814,0.5866371270579308,0.27784941859730594,-0.30878770846062487,105190773,107859552.6,67.21075642999259,51.74429969553953,NaN,NaN,2.919205556962817,-6.118739422102987
2020-04-22T09:30:00-04:00,47.68,48.0596,47.23,47.71,2151689,3567471.65,54.383126969473956,51.91248860273079,NaN,NaN,80.62544738784557,97.53186786413451,0.5239980164314523,0.3462098120786905,-0.1777882043527618,107342462,108231487.6,67.65111149711387,53.59733899385987,NaN,NaN,3.81891903701251,-4.699073927943631
2020-04-23T09:30:00-04:00,47.94,48.63,47.78,48.05,2486899,3427247.35,55.43904156912626,52.78966526094832,NaN,NaN,90.669538415196,91.6044011518742,0.4805870603453086,0.422945621078874,-0.05764143926643464,109829361,108605633.4,68.11500307621324,55.592514137322084,NaN,NaN,4.860323730537406,-3.3334456910177686
2020-04-24T09:30:00-04:00,47.95,48.69,47.5,48.66,2692999,3327344.7,57.34666176206425,53.93355462608387,NaN,NaN,87.59746309505101,83.9126580149566,0.4676390271725108,0.5269073446992039,0.059268317526693065,112522360,108848688.4,68.43170927372911,57.71382485199316,NaN,NaN,6.267223389957232,-1.9619215365927685
2020-04-27T09:30:00-04:00,49.14,49.3,48.915,49.06,2022355,3259556.9,58.59827644316847,54.63417395710894,NaN,NaN,109.38183201829297,84.33963925472634,0.45999576787315366,0.6342630273681351,0.17426725949498148,114544715,109885934.2,69.80986121396278,60.03235402525273,NaN,NaN,7.800382689855356,-0.5673066471001793
2020-04-28T09:30:00-04:00,49.56,49.56,48.09,48.17,2582980,3237426.25,54.74875644729178,55.00133900756215,NaN,NaN,84.6259979428398,90.58005577184505,0.37270490062213135,0.6401483852726457,0.2674434846505144,111961735,111240126.6,71.5557777079282,62.38442596625551,NaN,NaN,8.135874716792664,0.676004976313084
2020-04-29T09:30:00-04:00,49.9,50.96,49.8,50.5,3551572,3176145.85,61.82017122452363,55.7001970475656,NaN,NaN,141.34906075450724,102.72477844517739,0.44471179487411455,0.8233332282431576,0.378621433369043,115513307,112874295.6,73.54408039516784,64.5471480231257,NaN,NaN,10.532170050869018,2.084028558392503
2020-04-30T09:30:00-04:00,50.53,50.85,49.852,50.28,3663144,3085243.9,60.853206341178236,56.268794773473424,NaN,NaN,130.72826770494697,110.7365243031276,0.44904008867175493,0.9399215442087367,0.4908814555369818,111850163,113278456,74.02763050092277,66.47224115479277,NaN,NaN,12.228623083236174,3.5332563476558843
2020-05-01T09:30:00-04:00,49.75,50.31,49.1667,49.58,2793533,2998058.25,57.75757326055677,56.603003413772775,NaN,NaN,102.34790342769708,113.68661236965681,0.3790659187179106,0.96471385393437,0.5856479352164594,109056630,112585310,71.61022608370963,67.83712936197425,NaN,NaN,12.810287615119043,4.85854652872205
2020-05-04T09:30:00-04:00,49.27,49.94,49,49.87,3721946,3030566.8,58.69503365076086,56.745189506377976,NaN,NaN,96.52166310338104,111.11457858667441,0.32850408485196936,0.9962780412814212,0.6677739564294518,112778576,112232082.2,70.34946983291721,68.73094473392976,NaN,NaN,13.552511539840662,6.100541530310423
2020-05-05T09:30:00-04:00,50.28,50.7,50.03,50.13,2261420,2978887.9,59.56151452799719,57.05627343428051,NaN,NaN,126.0335026741233,119.39607953293111,0.29009680487373957,1.0303949625216262,0.7402981576478866,115039996,112847734.4,71.29796266438409,69.46341488129498,NaN,NaN,14.409065000617305,7.2874734546399775
2020-05-06T09:30:00-04:00,50.54,50.63,49.97,49.99,2486093,2918476.4,58.845683217678626,57.27824708923805,NaN,NaN,108.00872893682266,112.72801316939422,0.23513288205505078,1.0342142602167002,0.7990813781616494,112553903,112255853.6,69.0123027672974,69.82439274929756,NaN,NaN,14.948794132066315,8.381947837129454
2020-05-07T09:30:00-04:00,50.73,51.12,50.56,50.93,3207195,2947425.05,62.136127131319384,57.602782302987485,NaN,NaN,129.68911993488962,112.52018361538273,0.24106003743954385,1.1004064249610792,0.8593463875215354,115761098,113038040.6,70.36440391155186,70.08858434800504,NaN,NaN,16.30718486049338,9.514124554752872
2020-05-08T09:30:00-04:00,51.55,51.93,51.25,51.86,4640755,3016640.2,65.10846989454643,58.261557975640066,NaN,NaN,151.37697488450198,122.32599790674371,0.28365422848122956,1.2139141731230723,0.9302599446418427,120401853,115307085.2,73.91951129640955,70.49284333223572,NaN,NaN,18.33462610428366,10.774196204685841
2020-05-11T09:30:00-04:00,51.54,52.25,51.4242,51.89,2270011,2999828.6,65.20336288213365,59.32121466584426,NaN,NaN,142.79272076817122,131.58020943970175,0.28891534643639494,1.2914041276873363,1.0024887812509413,122671864,117285742.8,76.56013469174535,71.16065606521806,NaN,NaN,20.048266010991345,12.099063319872341
2020-05-12T09:30:00-04:00,52.05,52.14,50.87,50.88,13806478,3412443.9,59.35105273173327,59.67606650600563,NaN,NaN,100.88166111903665,126.54984112868442,0.20347215405948127,1.256828973825293,1.0533568197658116,108865386,116050820.8,71.68199335775904,71.4485761981213,NaN,NaN,19.997189714323415,13.227367090508208
2020-05-13T09:30:00-04:00,50.85,50.99,49.33,50.01,4338817,3530924.8,54.789262066127634,59.62965368436288,NaN,NaN,35.8052950624829,112.10915435381646,0.0741270492706847,1.1460156313541674,1.0718885820834827,104526569,114445354,65.81118522427363,71.28401778012561,NaN,NaN,18.661915010889444,14.003731079134099
2020-05-14T09:30:00-04:00,49.59,50.55,49.0575,50.55,3219782,3568121.65,56.99853497988058,59.60478748563548,NaN,NaN,28.11726706482107,91.79478377980277,0.013859515872450157,1.0892129769240455,1.0753534610515953,107746351,112842404.6,60.484747508270296,70.7163776540214,NaN,NaN,18.120578868738633,14.591852191934747
2020-05-15T09:30:00-04:00,50.14,51.25,49.89,51.25,3938609,3597629.45,59.74465958528695,59.6866719957868,NaN,NaN,65.27467316143269,74.57432343518892,0.010227027225638619,1.0881372450836437,1.0779102178580051,111684960,111099026,55.247464164555396,69.6762064362066,NaN,NaN,18.41256257977293,15.137667961625915
2020-05-18T09:30:00-04:00,51.82,52.61,51.67,52.33,2852415,3642820.25,63.606314198350894,60.31935469229102,NaN,NaN,135.34880514912356,73.08554031137939,0.06651011127009343,1.161047856945622,1.0945377456755285,114537375,109472128.2,50.82475167015659,68.19541886208006,NaN,NaN,19.793975292578693,15.802854723190597
2020-05-19T09:30:00-04:00,52.26,52.93,52.08,52.32,5526798,3710774.5,63.54552927778628,60.44259455323835,NaN,NaN,145.27659715676842,81.96452751892573,0.0876838196924572,1.2041425202911,1.1164587005986428,109010577,109501166.4,50.900304244007934,66.57800627985435,NaN,NaN,20.905113608189755,16.53174884961905
2020-05-20T09:30:00-04:00,53.08,53.9,53.04,53.77,4532936,3829836.85,68.27914684830478,60.97301887517596,NaN,NaN,189.16444791237356,112.63635808890388,0.17871563088522668,1.3398532392051763,1.1611376083199496,113543513,111304555.2,55.47546591615009,65.2528516666563,NaN,NaN,23.338591039522882,17.504154876748167
2020-05-21T09:30:00-04:00,54,54.18,53.33,53.39,4016269,3906305.35,65.86535569942671,61.552146192238105,NaN,NaN,165.77842045238805,140.16858876641726,0.19156745569291433,1.4005969279360926,1.2090294722431782,109527244,111660733.8,56.34076628909851,64.16217596704122,NaN,NaN,24.66929408203305,18.527746191788864
2020-05-22T09:30:00-04:00,53.37,53.8,53.09,53.71,3871294,3965220.1,66.92571519862831,62.140052017085786,NaN,NaN,138.74156666677717,154.86196746748618,0.19897960943013304,1.4577539840308447,1.2587743746007116,113398538,112003449.4,57.20262363492663,63.2231155243276,NaN,NaN,26.083315556629678,19.60711324390898
2020-05-26T09:30:00-04:00,54.74,54.79,53.78,53.86,3651128,4046658.75,67.43635738803866,62.70254079280303,NaN,NaN,147.94779160032363,157.3817647577262,0.19129120774908337,1.4978883842870658,1.3065971765379825,117049666,112505907.6,58.496216801219425,62.30870510553012,NaN,NaN,27.401724671308447,20.720629162108903
2020-05-27T09:30:00-04:00,53.9,54.24,52.895,54.24,5946614,4214840.45,68.75254530555831,63.410173799080155,NaN,NaN,115.10322421155107,151.3470901686827,0.18878318052020537,1.5425761521882393,1.353792971668034,122996280,115303048.2,64.86330067764831,62.012347813412326,NaN,NaN,28.890349470872263,21.88773206336081
2020-05-28T09:30:00-04:00,53.77,54.6,53.6,53.73,4074495,4240986.6,64.95775989298437,63.61171899634194,NaN,NaN,109.65268764600819,135.44473811540962,0.13242559071603743,1.5193249600630807,1.3868993693470433,118921785,116378702.6,66.9622706276022,61.76933829313021,NaN,NaN,29.157899880968447,22.926327465876188
2020-05-29T09:30:00-04:00,53.7,54.17,53.145,54.02,6113453,4363502.05,66.10344816665128,63.68278887292086,NaN,NaN,89.37183547672531,120.16342112027709,0.09602280265905128,1.5069278726708575,1.4109050700118062,125035238,119480301.4,72.1318071837068,61.64164514222288,NaN,NaN,29.68989354255289,23.892551191115718
2020-06-01T09:30:00-04:00,53.89,54.72,53.79,54.64,6930215,4570336.15,68.47639932511242,63.916577190276485,NaN,NaN,105.56986882747412,113.52908155241649,0.09487656572030234,1.529500777162184,1.4346242114418817,131965453,123193684.4,76.81029454104655,61.65951370288724,NaN,NaN,30.803532267825783,24.8798342020743
2020-06-02T09:30:00-04:00,54.7,54.88,54.07,54.86,3464256,4557451.65,69.29773257187048,64.62705432171485,NaN,NaN,104.90742050681901,104.92100733371555,0.09014523121206564,1.5473057504569638,1.4571605192448982,135429709,126869693,80.33059225825382,62.27727076720829,NaN,NaN,31.968771140188114,25.8925394789477
2020-06-03T09:30:00-04:00,55,55.205,54.83,55.03,3217019,4605231.6,69.94928492886058,65.70991309762435,NaN,NaN,111.74695128157052,104.24975274771946,0.08001850896790996,1.5571836554547858,1.4771651464868758,138646728,129999782.6,82.73406498158873,63.4860478927308,NaN,NaN,33.13130673559914,26.92664908704076
2020-06-04T09:30:00-04:00,54.88,55.11,54.22,54.62,2235316,4592692.75,66.29518455603304,66.37395949592096,NaN,NaN,86.7322003440995,99.6656552873377,0.02984429834830249,1.5144705194222539,1.4846262210739514,136411412,133497708,84.94762543915249,65.23339631636524,NaN,NaN,33.19084274270035,27.821533894992132
2020-06-05T09:30:00-04:00,54.99,55.9,54.98,55.51,2784270,4571546.5,69.963279287461,67.10386090321911,NaN,NaN,115.30921893874999,104.85313197974264,0.04009425466351879,1.5347440394033498,1.494649784739831,139195682,136329796.8,86.46107037219215,67.46293961691073,NaN,NaN,34.25577459097817,28.740711137275852
2020-06-08T09:30:00-04:00,55.52,56.59,55.37,56.55,3215990,4500308.25,73.58142456766873,67.81636878674182,NaN,NaN,136.36451204706233,111.01206062366028,0.09716085521158413,1.6161008537543111,1.518939998542727,142411672,138419040.6,87.46254069107727,70.07992454697649,NaN,NaN,36.29929542856426,29.820508893174196
2020-06-09T09:30:00-04:00,56.25,56.67,56.11,56.41,3549179,4564266.65,72.31854326348916,68.44301264286345,NaN,NaN,136.89016523570092,117.40860956943666,0.10505340332937885,1.6502567527044505,1.5452033493750716,138862493,139105597.4,87.78236604932782,72.71435753307077,NaN,NaN,37.62123326005175,30.93489808844242
2020-06-10T09:30:00-04:00,56.76,56.8,55.86,56.24,2638090,4005847.25,70.73105670150751,68.61814906094936,NaN,NaN,124.34701302925075,119.92862191897271,0.07955689975859181,1.6446494740733115,1.5650925743147197,136224403,138621132.4,86.11303348922814,74.90275521686205,NaN,NaN,38.287659501679364,31.985292576047698
2020-06-11T09:30:00-04:00,54.96,55.34,53.53,53.65,4669205,4022366.65,52.001998198024864,67.62790923942066,NaN,NaN,12.395306329527516,105.06124311605831,-0.12015071841502278,1.4149041762959413,1.5350548947109641,131555198,137649889.6,82.71693629539625,76.78676736016904,NaN,NaN,32.54072590437168,32.0646401943797
2020-06-12T09:30:00-04:00,54.83,55.03,53.11,54.12,4944221,4108588.6,54.363565274974334,66.73061281630251,NaN,NaN,-4.730958745013317,81.05320757930565,-0.22302558577238507,1.2562729124954828,1.4792984982678679,136499419,137110637,80.81133249916253,78.47310370761446,NaN,NaN,28.67949000405962,31.58104731004826
2020-06-15T09:30:00-04:00,53.33,55.18,53.24,54.99,4114351,4117375.7,58.43981410710931,66.08800258195042,NaN,NaN,10.347962641541955,55.84989769820157,-0.2337793043902323,1.1870743677800775,1.4208536721703098,140613770,136751056.6,79.4961896480114,79.9731017680996,NaN,NaN,26.760420076294682,30.89238627665489
2020-06-16T09:30:00-04:00,56.09,56.11,54.65,55.44,4335558,4191532.85,60.40959045252497,65.49207723530517,NaN,NaN,74.95803681662618,43.463472014386625,-0.21250013244177235,1.1552285066180943,1.3677286390598666,144949328,137968423.6,80.64463971513263,81.10034027077704,NaN,NaN,25.83182993570377,30.169449656519014
2020-06-17T09:30:00-04:00,55.56,55.93,55.07,55.51,2621709,4046278.4,60.72145430927656,65.18948397932606,NaN,NaN,73.78663227000149,33.351395862536776,-0.19602523608679467,1.1226970939513734,1.318722330038168,147571037,140237750.4,82.60105342022354,82.21739618453572,NaN,NaN,25.18771797111344,29.457773701461075
2020-06-18T09:30:00-04:00,55.4,55.73,55.27,55.69,4696358,4054449.5,61.559982704713576,64.86495073204478,NaN,NaN,69.32279427472919,44.7368934515771,-0.1759584837051118,1.0987742254067783,1.27473270911189,152267395,144380189.8,85.4851832096782,83.17120875781939,NaN,NaN,24.902137693445617,28.806968557458866
2020-06-19T09:30:00-04:00,56.36,56.36,55.13,55.54,4740415,4090656.8,60.40274522979314,64.28826115380768,NaN,NaN,70.23124575243155,59.72933435106607,-0.1753511419530147,1.0555437816706217,1.2308949236236364,147526980,146585702,86.74500574720169,83.88083098683046,NaN,NaN,24.341060810727267,28.16898173649721
2020-06-22T09:30:00-04:00,55.38,55.63,55.1862,55.55,1995825,3996883.35,60.45611517497257,63.656717054029265,NaN,NaN,45.21334849258117,66.70241152127392,-0.17636193271711642,1.010442507727241,1.1868044404443574,149522805,148367509,87.67567793091467,84.4054799634491,NaN,NaN,23.891370498300294,27.55789441675479
2020-06-23T09:30:00-04:00,55.91,56.48,55.71,55.91,4896999,4059176.9,62.41982649583327,63.118898594527316,NaN,NaN,87.70662715278426,69.25212958850553,-0.15559580341662427,0.9923096861735772,1.1479054895902014,154419804,150261604.2,88.59259464677582,84.82394636810533,NaN,NaN,24.02239218917999,27.052822669958392
2020-06-24T09:30:00-04:00,55.72,55.85,54.15,54.65,7736167,4148654.55,52.57839328178259,62.139127789223714,NaN,NaN,-20.67667794090974,50.35946754632327,-0.2252988983958748,0.866281866595358,1.0915807649912328,146683637,150084124.2,87.93243609116396,85.03714712896328,NaN,NaN,21.226153079709338,26.22044129992281
2020-06-25T09:30:00-04:00,54.61,55.01,54.07,54.89,4779411,4183900.35,54.06403476929165,61.00346746649733,NaN,NaN,-47.95731047975224,26.90344659542699,-0.25181240156659124,0.7768152630329936,1.0286276645995849,151463048,149923254.8,87.29745452069285,85.09688885385619,NaN,NaN,19.32347958447663,25.23516105485907
2020-06-26T09:30:00-04:00,54.56,54.61,52.37,52.47,6241409,4190298.15,40.340456336501965,58.62911259284255,NaN,NaN,-187.463506453594,-24.635503845778107,-0.4190466780208698,0.5048193170734976,0.9238659950943674,145221639,149462186.6,85.39411455665442,84.94914412996884,NaN,NaN,12.529986883098331,23.420136173178964
2020-06-29T09:30:00-04:00,52.18,53.44,51.925,53.44,3508384,4019206.6,46.23193579324333,56.765783487825,NaN,NaN,-182.1544678328475,-70.10906711086383,-0.44841833935607867,0.3633430708992691,0.8117614102553478,148730023,149303630.2,84.71011886314213,84.72969790238415,NaN,NaN,8.93367439625656,21.350641633618622
2020-06-30T09:30:00-04:00,53.42,54.2,53.17,54.04,2815900,3986788.8,49.55060956620953,55.252894406732274,NaN,NaN,-97.65833864665062,-107.18206027075082,-0.41243117286722186,0.2962224441713204,0.7086536170385422,151545923,148728854,82.14156840227372,84.44602182474455,NaN,NaN,7.172503733319472,19.325193362147314
2020-07-01T09:30:00-04:00,54.22,55.59,54.18,55.38,5156578,4083766.75,56.07173356448099,55.543589790050575,NaN,NaN,4.847829285395322,-102.07715882548982,-0.2891997807481852,0.34715389110331074,0.6363536718514959,156702501,150732626.8,83.96676010296649,84.53529495385669,NaN,NaN,7.96902062218746,17.702882970724477
2020-07-02T09:30:00-04:00,55.88,55.97,55.12,55.2,2252755,4084638.7,55.042492704892304,55.592084606473286,NaN,NaN,32.99419108221621,-85.88685851309612,-0.21408909561419665,0.36874230233375016,0.5828313979479468,154449746,151329966.4,84.47611796925611,84.79706534457766,NaN,NaN,8.24628468236779,16.351940358102095
2020-07-06T09:30:00-04:00,55.82,56.39,55.65,56.31,2082200,4049535.2,59.927393861392225,55.69834030320778,NaN,NaN,84.09121916231234,-31.57591338991485,-0.09026422491520347,0.4700011168039424,0.5602653417191459,156531946,153592027.8,86.25669467481853,85.27995856077818,NaN,NaN,10.146121929898703,15.465394868358754
2020-07-07T09:30:00-04:00,56.17,56.98,56.0737,56.15,2392342,4008352.8,58.933370651176084,55.59289603168286,NaN,NaN,104.57056139935578,25.76909245652581,-0.023240053408893346,0.5312152749580292,0.5544553283669226,154139604,154673944,87.02334451007869,85.73558033184577,NaN,NaN,11.323587864406482,14.87370815350843
2020-07-08T09:30:00-04:00,56.22,56.75,55.795,56.65,3103659,3986076.8,61.10459233009465,55.62026303316986,NaN,NaN,104.32621653191744,66.16600349223941,0.04684164933565671,0.6130073900364934,0.5661657407008367,157243263,155813412,87.79552386667115,86.10661393516344,NaN,NaN,12.977087760791639,14.602762383120316
2020-07-09T09:30:00-04:00,56.89,56.95,55.83,56.72,3453747,4026859.65,61.41218642861893,55.60970615630596,NaN,NaN,110.37508317267472,87.27145426969528,0.08761759772820221,0.6756877378610895,0.5880701401328873,160697010,156612313.8,88.32028725035832,86.30912136664058,NaN,NaN,14.395030432222109,14.573086390134858
2020-07-10T09:30:00-04:00,56.68,57.74,56.378,57.7,2429116,3914855.2,65.52294991197162,55.975435062175855,NaN,NaN,152.6658247666761,111.20578100658729,0.1657621002915486,0.7952727654973231,0.6295106652057745,163126126,158347589.8,89.38765836951741,86.49788226823456,NaN,NaN,16.92100525971605,14.908503371503599
2020-07-13T09:30:00-04:00,58.16,58.415,56.35,56.54,2954688,3815378.55,57.68898196540787,55.77778269006409,NaN,NaN,129.93375531998626,120.37428823812206,0.126284418781333,0.7873661886824408,0.6610817699011078,160171438,159075488.2,89.80839726284232,86.65021936337224,NaN,NaN,16.672276225921404,15.160470922134714
2020-07-14T09:30:00-04:00,55.97,57.16,55.725,57.1,3719919,3795656.95,60.16507561829041,55.61672905595389,NaN,NaN,88.70883861145964,117.20194368054285,0.12463147034399191,0.8168711078310977,0.6922396374871058,163891357,161025838.8,90.85463220583192,86.81179347473339,NaN,NaN,17.24398785873971,15.45811619879257
2020-07-15T09:30:00-04:00,57.35,57.67,56.82,57.44,3089179,3733338,61.6331410446406,56.26349675330089,NaN,NaN,120.0772568000881,120.35215173417699,0.13244903572717115,0.8578009321460698,0.7253518964188986,166980536,162973293.4,91.76381680231182,87.08546352552968,NaN,NaN,18.158874095070647,15.843938755403725
2020-07-16T09:30:00-04:00,56.94,57.62,56.73,57.54,2216683,3713086.7,62.07583461263606,56.835768170682634,NaN,NaN,104.89580875992877,119.25629685162778,0.13017460854307028,0.8880701570977365,0.7578955485546662,169197219,164673335.2,92.46778129775741,87.45477258103429,NaN,NaN,19.028961714920992,16.298942035334765
2020-07-17T09:30:00-04:00,57.55,57.58,56.81,57.41,1928862,3574711.9,61.08901421179237,58.31780801891767,NaN,NaN,91.63146259016357,107.04942441632527,0.10671918822092574,0.8912945338308234,0.7845753456098976,167268357,165501781.4,92.79113728494124,87.9831313473405,NaN,NaN,19.47552459287461,16.752739543554743
2020-07-20T09:30:00-04:00,57.31,58.23,56.85,58.1,2205297,3447956,64.33021862204018,59.61054250668885,NaN,NaN,106.41665490127309,102.34600433258265,0.12330475334888202,0.9387062872960001,0.8154015339471181,169473654,167362224.6,93.4691876852263,88.60877912034653,NaN,NaN,20.795089155228577,17.330218059508148
2020-07-21T09:30:00-04:00,58.48,58.53,57.66,57.82,2228124,3459570.95,62.07070738044955,60.504835207706,NaN,NaN,110.46903503460057,106.69804361721086,0.10193361932580203,0.9428185581043707,0.8408849387785686,167245530,168033059.2,93.6993142546074,89.43433239551322,NaN,NaN,21.280627429962635,17.89456225528736
2020-07-22T09:30:00-04:00,57.81,57.925,57.465,57.88,1528637,3291152.85,62.375669684419314,60.955116359130166,NaN,NaN,87.73993491256606,100.23057923970643,0.07935795013844715,0.9400823764516275,0.8607244263131804,168774167,168391785.4,93.82462695367852,90.13846574199263,NaN,NaN,21.765565479093944,18.447562715831157
2020-07-23T09:30:00-04:00,57.99,58.13,56.64,56.94,2271197,3017904.35,54.92488731835168,60.94671597437726,NaN,NaN,56.05964338015742,90.46334616375216,-0.006787781109327318,0.8522396999265212,0.8590274810358485,166502970,167852935.6,90.90006535699719,90.59731912683128,NaN,NaN,20.08618386795279,18.681651451848534
2020-07-24T09:30:00-04:00,56.55,57.026,56.26,56.85,3291876,2943527.6,54.25663746686437,60.541661946196704,NaN,NaN,23.812256976220283,76.8995050409635,-0.07400160914754372,0.7665254696014188,0.8405270787489625,163211094,167041483,86.52613997511541,90.61656521970963,NaN,NaN,18.511619753641057,18.657361209247465
2020-07-27T09:30:00-04:00,57.06,57.32,56.7581,57.24,1556189,2709266.6,56.71429289757916,60.38315639236835,NaN,NaN,42.68081203973963,64.1523364686568,-0.09502468382585771,0.7217462239666403,0.8167709077924981,164767283,166100208.8,81.61998388486069,90.23061088933692,NaN,NaN,17.815077848585073,18.537035014867122
2020-07-28T09:30:00-04:00,57.08,57.29,56.56,56.65,1818104,2624752.6,52.14955735013767,59.74351103665714,NaN,NaN,12.366288696889917,44.53178720111468,-0.14831895491352254,0.6313722141505949,0.7796911690641174,162949179,165240938.6,77.31044801069787,89.48167689962453,NaN,NaN,15.908387638852869,18.1615139611508
2020-07-29T09:30:00-04:00,56.93,57.325,56.72,57.17,1720805,2569997.85,55.54560532539767,59.32446952928418,NaN,NaN,24.624847103222788,31.908769639246024,-0.1478707572208765,0.5948527225380218,0.7427234797588983,164669984,164420102,73.32743143471778,88.41075862707878,NaN,NaN,15.20554778703232,17.739233079133875
2020-07-30T09:30:00-04:00,56.63,57.43,56.35,57.33,2202209,2422279.4,56.56703542895498,58.68476135192585,NaN,NaN,10.73292251338717,22.843425465891976,-0.1363986481325108,0.5722251695932599,0.7086238177257707,166872193,164493946.6,73.45990314404011,87.27306182525898,NaN,NaN,14.900120429484891,17.33364555775545
2020-07-31T09:30:00-04:00,58.38,58.38,57.235,58.13,2741736,2446728.45,61.34902959712313,58.946193325619795,NaN,NaN,136.63189407327573,45.40735288530304,-0.07746416691211788,0.6117936090856233,0.6892577759977412,169613929,165774513.6,75.712622876961,86.26622079769602,NaN,NaN,16.017149669552595,17.145574716583614
2020-08-03T09:30:00-04:00,58.28,58.35,57.7582,58.18,2335598,2459398.35,61.633350080304844,59.05107007290654,NaN,NaN,150.73041718032098,67.01727391341932,-0.03955732458597583,0.6398111202652714,0.6793684448512473,171949527,167210962.4,77.97135615094123,85.34598679377527,NaN,NaN,17.012727490698644,17.12659654145719
2020-08-04T09:30:00-04:00,58.16,58.56,58.16,58.55,2829284,2481245.45,63.75794881667799,59.2028420566235,NaN,NaN,178.8832184385456,100.32065986175046,0.0036944733074977254,0.6839865364856195,0.6802920631781217,174778811,169576888.8,81.09065251345342,84.58361791599965,NaN,NaN,18.469167949244657,17.3183924568554
2020-08-05T09:30:00-04:00,58.72,58.81,58.29,58.46,1874222,2419773.6,62.84629865534701,59.25787520253142,NaN,NaN,160.13264134709453,127.42221871052482,0.018664509277681596,0.7036226997752237,0.6849581904975421,172904589,171223809.8,82.90527850586544,83.90058200229308,NaN,NaN,19.44407724490532,17.622061712291103
2020-08-06T09:30:00-04:00,58.55,60.06,58.45,60,2277113,2360941.9,70.59428031629355,59.93682278142437,NaN,NaN,233.25034239215626,171.9257026862786,0.11910358259147313,0.8338376687368836,0.7147340861454105,175181702,172885711.6,84.51966734973684,83.30976272120704,NaN,NaN,22.870656881653538,18.371861022200022
2020-08-07T09:30:00-04:00,59.85,60.88,59.43,59.93,2525946,2365783.4,69.88092297773329,60.33330166397388,NaN,NaN,232.32867303606375,191.06505847883622,0.16482991060767227,0.9207714744050008,0.7559415637973286,172655756,173494077,85.07530962306899,82.71020000248153,NaN,NaN,25.410824675843376,19.377427258434786
2020-08-10T09:30:00-04:00,59.91,60.46,59.15,59.73,4230288,2429563.4,67.77367665997798,60.74065661251162,NaN,NaN,168.08117596764328,194.53521023630068,0.1651943231553391,0.9624344677415024,0.7972401445861633,168425468,172789265.2,81.42872762977647,81.83372952927932,NaN,NaN,26.91732191241763,20.45455506614662
2020-08-11T09:30:00-04:00,59.66,60.015,58.72,58.84,3121577,2399646.3,59.21626582164417,60.51498490802768,NaN,NaN,103.3670499251781,179.43197653362716,0.0926969634737238,0.913111348928318,0.8204143854545942,165303891,170894281.2,72.4385318631487,80.30615130852718,NaN,NaN,25.67081655957943,21.199735279494167
2020-08-12T09:30:00-04:00,59.17,59.91,59.17,59.54,6265954,2558485.05,63.15660572593083,61.10296479428333,NaN,NaN,113.86045125755341,170.17753851571894,0.07959049825626874,0.9199025082749301,0.8403120100186614,171569845,170627332.4,71.24521896567516,78.90223370914703,NaN,NaN,25.813638067546645,21.858864249215948
2020-08-13T09:30:00-04:00,59.6,60.2681,59.5693,59.84,1707267,2533014.25,64.72938448819397,61.851018152949734,NaN,NaN,120.43276361433165,147.61402276015403,0.07868768928813308,0.9386716216288278,0.8599839323406947,173277112,170246414.4,69.48619628413627,77.6850948740771,NaN,NaN,26.41022747735263,22.509058996092616
2020-08-14T09:30:00-04:00,59.89,60.01,59.63,59.83,1205195,2496830.9,64.63034510976192,62.416450453819934,NaN,NaN,101.31137759716948,121.41056367237518,0.06551840142664844,0.9418819341240052,0.8763635326973568,172071917,170129646.6,68.92441779472883,76.77826872478197,NaN,NaN,26.861539060793753,23.130841862478494
2020-08-17T09:30:00-04:00,60.06,60.06,59.69,59.9,1179408,2445536.45,65.03365547573955,63.33674317707721,NaN,NaN,93.47299131184063,106.48892674121467,0.05030716148246284,0.9392474845504353,0.8889403230679724,173251325,171094818,71.01068777479367,76.32828585078882,NaN,NaN,27.345290095181884,23.732905895721835
2020-08-18T09:30:00-04:00,60.06,60.63,59.795,60.44,1353247,2401792.6,68.05939859592453,64.2305855535434,NaN,NaN,104.65667155040074,106.74685106625921,0.0644931056624769,0.9695567051460685,0.9050635994835916,174604572,172954954.2,74.55605099535754,76.41604439083451,NaN,NaN,28.635173835880263,24.433229887173038
2020-08-19T09:30:00-04:00,60.49,60.94,60.13,60.27,2143560,2432538.75,66.11962063745753,64.91291306843644,NaN,NaN,100.95373850064563,104.16550851487766,0.050903450554402374,0.9686929126765946,0.9177894621221923,172461012,173133187.6,74.87314641077108,76.51699033845816,NaN,NaN,29.183083506745373,25.1117804042548
2020-08-20T09:30:00-04:00,60.03,61.09,59.995,61.02,7930614,2715509.6,70.16030820615862,65.54229011193898,NaN,NaN,104.46683595370737,100.9723229827528,0.07921321154366423,1.0168059765517725,0.9375927650081083,180391626,174556090.4,77.3048433938043,76.63072037537553,NaN,NaN,30.872909299916547,25.934798817920765
2020-08-21T09:30:00-04:00,60.88,61.07,60.54,60.75,2003242,2651077.9,67.05963923098483,65.9298821941304,NaN,NaN,102.10160097306328,101.13036765793156,0.06702611033913164,1.0213754029320228,0.9543492925928911,178388384,175819383.8,79.22698167259345,76.72040791263639,NaN,NaN,31.400250878671095,26.71557768374224
2020-08-24T09:30:00-04:00,61.19,61.76,61.1132,61.49,3340646,2740300.75,70.86062920774663,66.43721650777817,NaN,NaN,132.5538220534712,108.94653380625763,0.094398302841884,1.0723471711452461,0.9779488683033621,181729030,177514924.8,81.4925946927815,76.74911806830268,NaN,NaN,33.03007763275274,27.617649105029454
2020-08-25T09:30:00-04:00,61.51,62.175,61.36,62.07,4156201,2857205.6,73.446848806764,67.19439866145082,NaN,NaN,151.3774491009862,118.29068931637474,0.13470461965026947,1.146329642866199,1.0116250232159296,185885231,179771056.6,83.99412815762476,76.82689304342834,NaN,NaN,35.245108259818544,28.70728612714218
2020-08-26T09:30:00-04:00,62.2,64.26,62.18,64.19,3234539,2932892.3,80.3217241017255,67.88921607469595,NaN,NaN,233.92299184076145,144.88453998439792,0.2789770544707477,1.3603463413043642,1.0813692868336164,189119770,183102808.2,86.82598752923558,76.99163019910682,NaN,NaN,40.06549358051855,30.32988719191023
2020-08-27T09:30:00-04:00,64.15,64.1539,63.165,63.41,5037180,3074640.85,72.84842524966612,68.10118052269115,NaN,NaN,200.50478120432538,164.0921290345215,0.2951433682609921,1.4502984971598565,1.1551551288988644,184082590,183841001,87.35961068992599,77.15479456102518,NaN,NaN,41.19576240886349,31.88215508004641
2020-08-28T09:30:00-04:00,63.57,63.66,63.2299,63.56,1819344,3028521.25,73.36172002834125,68.50032647757425,NaN,NaN,164.62241019319083,176.596290878547,0.2888455182478178,1.5162120267086365,1.2273665084608187,185901934,185343711,88.39051773596319,77.65206528289568,NaN,NaN,42.23093842324858,33.36055270050386
2020-08-31T09:30:00-04:00,63.5,63.69,63.17,63.26,2728451,3048163.9,70.49144879031573,69.30569668962222,NaN,NaN,135.33367809780395,177.15226208741356,0.2394214231887528,1.5266432874467597,1.2872218642580069,183173483,185632601.6,88.5832893004019,78.80526224269946,NaN,NaN,42.113957466933186,34.61103909570805
2020-09-01T09:30:00-04:00,63.38,63.9367,63.12,63.78,4703021,3141850.75,72.49987066379889,69.97307275661278,NaN,NaN,124.70297780334113,171.81736782788454,0.21734232043862756,1.5588997648062914,1.3415574443676639,187876504,186030856.2,88.85795664986972,80.06331493442765,NaN,NaN,42.6596894177108,35.76084628456559
2020-09-02T09:30:00-04:00,64.15,65.34,63.89,65.14,4321674,3264223.35,76.92365824820584,70.84409231089936,NaN,NaN,151.37919029810695,155.30860751935364,0.26667142265208854,1.6748967226827745,1.408225300030686,192198178,186646537.8,89.28705322189525,81.47766185855328,NaN,NaN,44.68592478153626,37.035857498418544
2020-09-03T09:30:00-04:00,64.56,64.71,62.185,62.93,7536922,3527213.8,60.02568243941296,70.51518783444585,NaN,NaN,76.34646494588276,130.47694426766512,0.12973503333603875,1.5703940917007344,1.4406590583646957,184661256,186762271,89.36992620098663,82.93805531614314,NaN,NaN,39.910817456385914,37.446566063842454
2020-09-04T09:30:00-04:00,62.61,62.96,60.17,61.78,10039942,3902913.6,53.44633347865733,69.68752197751141,NaN,NaN,3.909008916448333,98.33426401231661,-0.049419494440833045,1.3788846903136545,1.4283041847544875,174621314,184506147,76.8837799367321,83.35756189913873,NaN,NaN,33.50844198937004,36.8839769103464
2020-09-08T09:30:00-04:00,60.26,61.015,60.02,60.15,8138564,4098327.4,45.78592006134838,68.09655922504167,NaN,NaN,-52.738454861140085,60.7198374205278,-0.2761637987269179,1.0830994363458402,1.359263235072758,166482750,181168000.4,62.88444578612089,82.52387581276469,NaN,NaN,25.132339149248306,35.205171515903814
2020-09-09T09:30:00-04:00,60.97,61.45,60.22,60.87,4940817,4189289.4,49.24635810255443,66.89132618683432,NaN,NaN,-38.130610283652665,28.153119803129034,-0.3702491987229153,0.896451736669114,1.2667009353920293,171423567,177877413,52.69806258040322,80.9399412534527,NaN,NaN,20.04899328522017,33.040003197234725
2020-09-10T09:30:00-04:00,61.24,61.7,59.79,59.97,4882441,4120113.75,45.34973471277384,65.11914236587826,NaN,NaN,-58.770553547919,-13.876828966076157,-0.47879519797041215,0.6682069379290141,1.1470021358994262,166541126,172746002.6,41.42815473127961,78.37732063470094,NaN,NaN,14.593905021631837,30.40484631500574
2020-09-11T09:30:00-04:00,60.34,60.5131,59.12,59.78,5509027,4310201.75,44.548348806023235,63.51119304980957,NaN,NaN,-91.15409047550324,-47.37694005035333,-0.54431284761905,0.4666110763756137,1.0109239239946637,161032099,168020171.2,34.17867148152931,75.15958419248206,NaN,NaN,10.179408473153636,27.515498051884013
2020-09-14T09:30:00-04:00,60.43,61.13,59.98,60.01,3241631,4412023.55,45.79702263987143,61.72093543781848,NaN,NaN,-66.21743023693747,-61.40222788103049,-0.551382599993107,0.3216956740032799,0.8730782739963869,164273730,165950654.4,31.573093847272446,71.59390556065999,NaN,NaN,7.115645963306111,24.601233467801457
2020-09-15T09:30:00-04:00,60.66,61.37,60.48,61.08,2024049,4454255.6,51.292108508296295,60.13845398792794,NaN,NaN,-40.76691858857275,-59.007920626517034,-0.466584184492276,0.289848043381042,0.756432227873318,166297779,165913660.2,31.526826088970623,67.8462411271847,NaN,NaN,6.286214217340508,21.984802146307036
2020-09-16T09:30:00-04:00,61.08,61.56,60.32,60.42,2368700,4505028.25,48.05585530804838,57.83374907409386,NaN,NaN,-53.321195634858334,-62.04603769675816,-0.4379909728807485,0.20894351177238235,0.6469344846531309,163929079,164414762.6,29.632098684849225,63.76096335258568,NaN,NaN,4.566628963344919,19.496491691598163
2020-09-17T09:30:00-04:00,59.37,59.84,58.58,59.31,4600520,4627876.25,43.1274191327506,55.710820065742745,NaN,NaN,-123.54900666571709,-75.00172832031778,-0.4738446762862971,0.05462863929525952,0.5284733155815566,159328559,162972249.2,27.8946199064072,59.51346401090576,NaN,NaN,1.4770052399868634,16.922279341367975
2020-09-18T09:30:00-04:00,59.65,59.68,57.96,58.74,4665396,4464615.35,40.81271810165829,53.38589135669396,NaN,NaN,-133.4932856276088,-83.4695673507389,-0.512671420774654,-0.11236596038676083,0.40030546038789316,154663163,161698462,26.421377339262605,55.08709683971286,NaN,NaN,-1.7853295284514255,14.249763788536633
2020-09-21T09:30:00-04:00,57.68,58.12,57.065,57.93,7846079,4756757.2,37.71494396860338,51.04471244085737,NaN,NaN,-161.60022629956038,-102.54612656326348,-0.5654740051576387,-0.3065370460591552,0.25893695909848347,146817084,158207132.8,22.857937329607495,50.392428841798974,NaN,NaN,-5.513597770818562,11.426426422914462
2020-09-22T09:30:00-04:00,58.46,59.17,58.02,59.05,2304638,4704956.8,44.039806938496,49.01185074619288,NaN,NaN,-103.43153589726556,-115.07905002500203,-0.4998114556945885,-0.3658273605197522,0.13398409517483634,149121722,154771921.4,19.999777486249812,45.473987472968986,NaN,NaN,-6.663996202183737,8.84208033361472
2020-09-23T09:30:00-04:00,59.17,59.29,57.47,57.64,3913303,4692811.9,38.71038046938434,46.282330904848486,NaN,NaN,-113.61543587154503,-127.13789807233938,-0.5236589127826488,-0.5205895458034746,0.0030693669791741485,145208419,151027789.4,17.440122797849668,40.34206387125143,NaN,NaN,-9.452248514754208,6.22860478384773
2020-09-24T09:30:00-04:00,57.28,58.29,57.18,57.75,2944856,4678327.75,39.32724111972092,44.80387081058477,NaN,NaN,-119.1006511535461,-126.24822696990518,-0.5041630111829519,-0.6271343969995158,-0.12297138581656383,148153275,148792732.6,16.114287940832398,35.10951828124041,NaN,NaN,-11.432439398572123,3.705598472073465
2020-09-25T09:30:00-04:00,57.68,58.7214,57.23,58.52,1879936,4520465.55,43.605981244682894,44.10098850815802,NaN,NaN,-95.29617044771528,-118.60880393392647,-0.41525359183163346,-0.6420383756061057,-0.2267847837744722,150033211,147866742.2,15.585639301756629,30.731079664456452,NaN,NaN,-11.753862294806476,1.4971040768049022
2020-09-28T09:30:00-04:00,59.4,59.51,58.8498,59.3,2016832,4530339.95,47.63459123430008,44.233036449083144,NaN,NaN,-48.928842047255436,-96.07452708346548,-0.2859132794240261,-0.5841763830545048,-0.2982631036304787,152050043,148913334,18.82696957528583,27.584117077968227,NaN,NaN,-10.760701543209,-0.2540110117685124
2020-09-29T09:30:00-04:00,59.37,59.595,59.03,59.36,3249193,4556377.05,47.942658460153766,44.139915046054526,NaN,NaN,-38.43980935275103,-83.07618177456257,-0.18330896317703782,-0.527399307601776,-0.3440903444247382,155299236,150148836.8,22.605045560455224,25.434615862257655,NaN,NaN,-9.876281701637508,-1.628621110321226
2020-09-30T09:30:00-04:00,59.42,60,59.07,59.4,2884050,4465428.5,48.16160895826383,44.340763206446674,NaN,NaN,-24.79659474588792,-65.31241354943116,-0.10369949423414149,-0.473714712217415,-0.3700152179832735,158183286,152743810.2,29.976859619081637,24.616666211386377,NaN,NaN,-9.095423468871424,-2.695307161542683
2020-10-01T09:30:00-04:00,59.89,60.385,59.8,60.25,7536761,4626182.85,52.713049532722096,44.923956115496594,NaN,NaN,22.986474914554908,-36.89498833581095,0.00925264980828111,-0.35844940572292217,-0.3677020555312033,165720047,156257164.6,38.51571371352261,24.926454942243037,NaN,NaN,-7.087309056348616,-3.322736003657816
2020-10-02T09:30:00-04:00,59.28,59.9,58.82,59.06,3316433,4415158.4,46.55082567758052,44.977799189618665,NaN,NaN,-21.517235294443044,-22.1392013051565,0.006973075764295178,-0.3589857108258343,-0.3659587865901295,162403614,158731245.2,43.720301495942174,25.794112631433737,NaN,NaN,-7.116604377777542,-3.864717199960634
2020-10-05T09:30:00-04:00,59.43,60.06,59.35,60.03,2122201,4019271.35,51.5252659492332,44.99445329254273,NaN,NaN,27.197939254926688,-6.9138450447200785,0.07041825306728422,-0.27793597025602423,-0.34835422332330845,164525815,161226399.6,48.45884240789251,27.003542368499584,NaN,NaN,-5.599588612586097,-4.112555973192843
2020-10-06T09:30:00-04:00,59.75,60.0701,58.67,58.77,2198661,3722276.2,45.58980503863444,44.818306844727445,NaN,NaN,-19.964470691372618,-3.2187773124443906,0.02925864242584142,-0.3117809202910067,-0.3410395627168481,162327154,162631983.2,50.96354342552523,28.527216992833587,NaN,NaN,-6.1591809882697035,-4.40493097534668
2020-10-07T09:30:00-04:00,59.28,59.38,58.65,59.2,2063392,3578404.95,47.799788695095515,45.152047527752075,NaN,NaN,-22.38602737851437,-2.7366638389696782,0.032477597522538204,-0.30044256581367534,-0.33292016333621355,164390546,163873435.2,53.13002204608522,30.329745717096305,NaN,NaN,-5.927776540294292,-4.622480341767767
2020-10-08T09:30:00-04:00,59.51,59.9999,59.51,59.97,1352517,3401908.75,51.59151696326469,45.92196173215253,NaN,NaN,51.78500674683433,3.023042527486203,0.0849674176066813,-0.22671089132786193,-0.31167830893454324,165743063,163878038.4,53.1382894291408,32.23809658065903,NaN,NaN,-4.551781339750897,-4.612380484336786
2020-10-09T09:30:00-04:00,60.28,60.41,60.08,60.33,1837894,3218352.1,53.299497653760085,47.03514413823516,NaN,NaN,89.19325163287115,25.16513991294904,0.13922875812844837,-0.13764236127398277,-0.27687111940243114,167580957,164913507,55.05864328892723,34.53814700632473,NaN,NaN,-2.907636096795152,-4.368845571830838
2020-10-12T09:30:00-04:00,61.22,62.58,60.985,61.92,3935387,3253039.9,60.01049170786666,48.17590733604734,NaN,NaN,202.5617879298028,60.23790964792427,0.26993438020056304,0.060546855848272685,-0.20938752435229036,171516344,166311612.8,57.58596486010593,37.222874675885876,NaN,NaN,0.7697067022376364,-3.634766675535342
2020-10-13T09:30:00-04:00,62.24,62.31,61.69,61.98,2581756,3280925.25,60.242669845655776,49.71392800578102,NaN,NaN,197.07762430421099,103.64632864704099,0.34344573159117103,0.21991964013667342,-0.1235260914544976,174098100,168665802,61.51094597482644,40.37079061709851,NaN,NaN,3.7486423900572676,-2.579993951879255
2020-10-14T09:30:00-04:00,62.24,62.29,61.06,61.24,1999659,3262473.2,55.929640251910364,50.89981365808027,NaN,NaN,150.47248429341084,138.218030981426,0.32541832229576095,0.2832468114152036,-0.04217151088055736,172098441,170207381,63.868813031067766,43.781828123543896,NaN,NaN,4.994429645925359,-1.4979334379071674
2020-10-15T09:30:00-04:00,60.51,60.9101,60.25,60.77,1700214,3117457.9,53.31863313109866,51.59357450710996,NaN,NaN,75.5494625029933,142.97092213265782,0.2674502928358835,0.29214135516429707,0.024691062328413532,170398227,171138413.8,65.25327133148724,47.32951612566751,NaN,NaN,5.261622410672403,-0.5322826023958003
2020-10-16T09:30:00-04:00,61.17,61.4,60.685,60.78,2932171,3030796.65,53.36851378212389,52.00314040338309,NaN,NaN,85.66215967431218,142.264703740946,0.21750994164271573,0.2965784893818082,0.07906854773909247,173330398,172288302,66.93826624394987,50.766037316286365,NaN,NaN,5.491910909632368,0.32831647075108095
2020-10-19T09:30:00-04:00,61,61.195,59.465,59.69,3320795,2804532.45,47.42057431734415,51.96584867889669,NaN,NaN,24.415500918592237,106.6354463387039,0.10452396004302941,0.20972349779287924,0.10519953774984983,170009603,171986953.8,66.03450591987387,53.86814162767341,NaN,NaN,3.9444126714976027,0.8449016422862983
2020-10-20T09:30:00-04:00,59.82,60.64,59.57,60.12,4365085,2907554.8,49.79759309051947,52.082704688343526,NaN,NaN,19.89429582710849,71.19878064328341,0.054709728312199224,0.17358669814009886,0.11887696982789964,174374688,172042271.4,66.12492051587643,56.45014597744447,NaN,NaN,3.32748752765643,1.1995567687677458
2020-10-21T09:30:00-04:00,60.86,61.7,60.71,61.13,3262306,2875004.95,54.94935079229138,52.24244049259847,NaN,NaN,89.46266783976148,58.996817352553535,0.08399122037722179,0.22386599529942686,0.13987477492220507,177636994,173149982,67.96394417619831,58.55359101049273,NaN,NaN,4.325885325350153,1.6461751339938038
2020-10-22T09:30:00-04:00,61.33,61.6723,60.715,61.53,2492166,2852370.45,56.8384352351715,52.97726974671211,NaN,NaN,90.69745381953604,62.026415615862085,0.12219318766956938,0.2926162595091668,0.17042307183959743,180129160,175096168.6,70.94811799113718,60.4984350458638,NaN,NaN,5.7152954569585885,2.227478037274487
2020-10-23T09:30:00-04:00,61.74,62.13,61.28,62.11,1839902,2850368.75,59.49093424602412,53.546246053625744,NaN,NaN,117.36623068089537,68.36722981717871,0.1751924022601965,0.38941357466484305,0.21422117240464655,181969062,176823901.4,73.32378750845646,62.27450255304694,NaN,NaN,7.683052426517066,3.0068458071662842
2020-10-26T09:30:00-04:00,61.57,61.86,60.175,60.75,2771493,2888101.8,51.4989913701316,53.96833079158983,NaN,NaN,39.462659542841536,71.37666154202857,0.11048237165237734,0.3523241369701182,0.24184176531774088,179197569,178661494.6,75.60838545551694,64.03484841233207,NaN,NaN,6.978440332017301,3.5742164535735723
2020-10-27T09:30:00-04:00,60.99,61.31,60.635,61.14,1582112,2804747.75,53.430999206046344,54.3705601138006,NaN,NaN,42.01475091461542,75.80075255952995,0.0868157733015521,0.350361481944681,0.2635457086431289,180779681,179942493.2,77.08188010920922,65.74569541684092,NaN,NaN,6.9850251210329315,4.061474834639195
2020-10-28T09:30:00-04:00,60.07,60.14,58.66,58.74,4236449,2872367.7,42.27165481165187,53.70485567439969,NaN,NaN,-109.07267101796404,36.09368478798485,-0.0881341074209275,0.15337807436696949,0.241512181787897,176543232,179723740.8,76.23494340786603,67.3954564153213,NaN,NaN,3.098238015540776,3.923869574767992
2020-10-29T09:30:00-04:00,59.44,60.785,59.15,60.22,3172884,2654173.85,49.30334669723867,53.41941632036245,NaN,NaN,-37.00376119662641,10.553441784752355,-0.1009208457802459,0.11536112456258962,0.21628197034283553,179716116,179641132,75.89580685086584,68.88382524117405,NaN,NaN,2.2948264592530196,3.6911491296944248
2020-10-30T09:30:00-04:00,60.37,60.73,58.57,59.2,3420985,2659401.45,45.2156156602024,52.362639459815,NaN,NaN,-84.19441318594116,-29.758686988614954,-0.1707107066970321,0.0028935869715454032,0.1736042936685775,176295131,178506345.8,71.2094984356604,69.8569347822851,NaN,NaN,0.20030171415546288,3.1924566417602875
2020-11-02T09:30:00-05:00,59.63,60.17,58.6814,59.17,3668573,2736720.05,45.09718582621807,51.280819172712306,NaN,NaN,-92.71759008058574,-56.1947369133004,-0.2090019492560223,-0.0876481429014504,0.12135380635457191,172626558,177192143.6,66.11778222717358,70.18599451459559,NaN,NaN,-1.438611789883421,2.5308754372397577
2020-11-03T09:30:00-05:00,59.63,60.57,59.41,60.05,3494529,2801513.45,49.29273628215621,50.80675460344414,NaN,NaN,-44.52859903770337,-73.50340690376416,-0.16699274605660033,-0.0873871262161785,0.07960561984042183,176121087,176260424.8,62.69509525532602,70.10215753061405,NaN,NaN,-1.4567869397768929,1.9612093833802362
2020-11-04T09:30:00-05:00,61.73,63.11,61.63,62.64,4571252,2926906.45,59.179871713562804,51.22541450219159,NaN,NaN,146.2725919566696,-22.434354308837435,0.0326538443930415,0.12042292533172372,0.08776908093868221,180692339,177090246.2,64.45972712034407,70.04547580124672,NaN,NaN,2.0994272126496956,1.9809547875615876
2020-11-05T09:30:00-05:00,63.71,64.29,63.26,63.85,3258092,3022185.2,62.8265959945039,51.900991803075875,NaN,NaN,216.75252514480283,28.316902959448413,0.23249589027078268,0.3783889437771606,0.1458930535063779,183950431,177937109.2,66.21607867876767,69.99389097516229,NaN,NaN,6.30365944187667,2.5984840238923135
2020-11-06T09:30:00-05:00,63.89,63.89,63.01,63.7,5735267,3217053.85,62.086115498154726,52.948530458848055,NaN,NaN,166.6027818650914,78.47634196965492,0.3346624656009845,0.5642211355076086,0.22955866990662405,178215164,178321115.8,67.01215525918143,70.06372307082711,NaN,NaN,9.277546542018873,3.5526358121961077
2020-11-09T09:30:00-05:00,64.66,64.85,63.12,63.16,6021902,3321379.6,59.373131490857425,53.63249748744363,NaN,NaN,155.8404507895478,128.18795014368163,0.3446005552359788,0.6603093639515976,0.31570880871561874,172193262,178234456.6,66.63058100757787,70.09984167737721,NaN,NaN,10.818725429986241,4.590648614737555
2020-11-10T09:30:00-05:00,62.46,63.16,61.86,62.96,12894017,3836992.65,58.3560412504771,53.87583252017118,NaN,NaN,86.58886278623864,154.41144250847003,0.31712323704642886,0.7121128550236548,0.394989617977226,159299245,174870088.2,53.818239283645205,69.089434185052,NaN,NaN,11.745769639231662,5.612808761093856
2020-11-11T09:30:00-05:00,63.4,63.61,63.2,63.53,5063071,3990163.25,60.43620269827243,54.13281591039267,NaN,NaN,115.61592068285303,148.28010825370671,0.31605188564790127,0.7900544750371026,0.4740025893892013,164362316,171604083.6,44.810209424920885,67.22244071603654,NaN,NaN,13.139599177850275,6.688064534916201
2020-11-12T09:30:00-05:00,63.49,63.84,62.94,63.17,7035879,4256946.5,58.45036128224132,54.05848927012247,NaN,NaN,94.3385397511376,123.79731117497367,0.27151667114749767,0.8133984283235733,0.5418817571760757,157326437,166279284.8,34.632405439130906,64.45877056822758,NaN,NaN,13.725380925230441,7.693395447818235
2020-11-13T09:30:00-05:00,63.63,64.21,63.27,64.11,1661319,4193403.9,61.96470488833471,54.80604023570841,NaN,NaN,105.42235535541133,111.56122587303767,0.28441788037209437,0.8974041076411936,0.6129862272690992,158987756,162433803.2,29.433099977560445,61.16053589123068,NaN,NaN,15.271447110742177,8.77597425680737
2020-11-16T09:30:00-05:00,64.13,64.595,64.09,64.52,4772285,4265978.4,63.418100704827765,55.51940462847851,NaN,NaN,114.85108776824055,103.3633532687762,0.2981712168487417,0.9857002483300263,0.6875290314812846,163760041,160747159,27.484142806535573,57.61784036961114,NaN,NaN,16.98325885488023,9.948443485103493
2020-11-17T09:30:00-05:00,64.22,64.6,63.97,64.29,3483093,4221878.8,61.987141064816,56.92765364656166,NaN,NaN,98.32824983867513,105.71123067926351,0.27021478019377565,1.0252975067235042,0.7550827265297285,160276948,160942699.6,28.078738467928616,54.1781114453299,NaN,NaN,18.010270971801827,11.100133126060397
2020-11-18T09:30:00-05:00,64.25,64.43,63.63,63.64,2470197,4182273.35,58.00385741429921,57.54911869778027,NaN,NaN,73.97182181894334,97.38241090648157,0.190161695451451,0.9927848458440423,0.8026231503925912,157806751,159631586.6,26.509195660748702,50.65049636032153,NaN,NaN,17.7880165311361,12.055545041071213
2020-11-19T09:30:00-05:00,63.37,64.17,63.28,64.03,3390683,4227199.2,59.678093207204256,58.582152808280405,NaN,NaN,64.89235206662687,91.49317336957941,0.1475889093520949,0.9871092870827098,0.8395203777306149,161197434,160405786,29.03184271493386,47.63780666598392,NaN,NaN,18.058273539956872,12.913077683769163
2020-11-20T09:30:00-05:00,64.08,64.3599,63.87,63.88,1876334,4229020.8,58.70865378110703,59.55440051934391,NaN,NaN,67.5419887442239,83.91710004734193,0.0959418606835073,0.9594477035849991,0.8635058429014918,159321100,160472454.8,29.25703899707561,45.004896435262644,NaN,NaN,18.025523289057148,13.643427055953161
2020-11-23T09:30:00-05:00,64.11,64.235,63.28,63.91,2190885,4199990.4,58.852620663147626,60.23724940370044,NaN,NaN,54.22817004366326,71.79251650242648,0.052583172247753995,0.9292348082111843,0.8766516359634303,161511985,160022843.6,28.597968253393034,42.569387363696,NaN,NaN,18.03478787182314,14.270764315363158
2020-11-24T09:30:00-05:00,64.08,65.28,64.03,65.22,2180413,4229905.45,64.64880719166351,60.627887652136216,NaN,NaN,91.12647877531842,70.35216228975516,0.09825916352892528,0.9994755903745869,0.9012164268456616,163692398,160705933.6,31.136125963494578,40.18913013820675,NaN,NaN,19.66671311746602,15.041614144234995
2020-11-25T09:30:00-05:00,65.35,65.36,64.6418,65.21,1693351,4102750.55,64.5740296042831,60.75270433854901,NaN,NaN,99.36129160375741,75.43005624671797,0.1128826874805463,1.0423197861963445,0.9294370987157982,161999047,161544392.8,34.22674896733986,37.90417801596191,NaN,NaN,20.99149103894819,15.891596557765451
2020-11-27T09:30:00-05:00,65.52,65.84,65.3,65.63,1229925,4005602.6,66.33527541174243,61.05621576094814,NaN,NaN,124.9146235437309,87.43451054213878,0.13446085016950926,1.0975131614276847,0.9630523112581755,163228972,161950700.4,35.73199365997354,35.669880758875635,NaN,NaN,22.61706842449834,16.852378253013008
2020-11-30T09:30:00-05:00,65.48,65.48,64.72,65.4,3617262,4015416.45,64.4457373567243,61.41854475136721,NaN,NaN,108.35836639553149,95.5977860724003,0.1174789377832599,1.1099009834872504,0.9924220457039905,159611710,162008822.4,35.95777834113312,33.478966282701016,NaN,NaN,23.51037425783778,17.803520539416546
2020-12-01T09:30:00-05:00,65.82,67.05,65.74,66.6,3888973,4026436.45,69.35103157639472,62.20390120321847,NaN,NaN,197.79644153636758,124.31144037094116,0.16821003827772563,1.2026845935511474,1.0344745552734218,163500683,162406562,37.5740261063833,32.31866534146802,NaN,NaN,25.76075754622913,18.940268683246916
2020-12-02T09:30:00-05:00,66.51,67.42,66.19,67.22,2381010,3970760.5,71.5360900750166,62.99675030155733,NaN,NaN,204.95288527147426,147.07672167017233,0.22132530559282304,1.3111311872644507,1.0898058816716276,165881693,162844421,39.38755095914424,31.931332593912543,NaN,NaN,28.352909855298247,20.284931707825677
2020-12-03T09:30:00-05:00,67.15,67.46,66.79,66.92,2129395,3848667.65,68.97370150423204,63.74841746027096,NaN,NaN,175.60453236275006,162.32536982197084,0.21393383654742215,1.3572231773559054,1.1432893408084832,163752298,163195071.2,40.86903722231486,32.3768062927114,NaN,NaN,29.805701587967388,21.645041690703064
2020-12-04T09:30:00-05:00,66.92,67.12,66.77,66.98,1997035,3785614.8,69.21123601861271,64.2660268267194,NaN,NaN,140.59091900906452,165.46062891503757,0.1914921508692229,1.3826545293950119,1.191162378525789,165749333,163699143.4,43.02491491190281,33.34765021659299,NaN,NaN,31.071542265815104,22.991684630004784
2020-12-07T09:30:00-05:00,66.92,67.585,66.8,67.4,1981886,3597945.75,70.89121393872695,64.79982062914075,NaN,NaN,136.14848058064737,171.01865175206075,0.18333162085076515,1.4203269045892455,1.2369952837384803,167731219,165323045.2,49.422528195001114,34.91467774434052,NaN,NaN,32.63032929831714,24.36863386833512
2020-12-08T09:30:00-05:00,67.33,67.39,66.785,67.3,1712778,3382489.55,69.91306485252164,65.3659580425483,NaN,NaN,113.41924012497711,154.14321146978267,0.1509469959627947,1.4256790286919738,1.2747320327291791,166018441,165826596.8,51.25051044907111,36.56980431442213,NaN,NaN,33.683861922193074,25.69938073317197
2020-12-09T09:30:00-05:00,67.39,67.81,66.06,66.5,5494671,3012522.25,62.48519263849949,65.68605341570547,NaN,NaN,83.99830971869042,129.9522963592259,0.06006042984939519,1.349807570040923,1.289747140191528,160523770,164755012.2,47.33020079252674,38.05701896669199,NaN,NaN,32.5756304734272,26.681702124637003
2020-12-10T09:30:00-05:00,66.13,66.65,65.5,66.54,2287661,2873751.75,62.69858852129029,65.90180308099733,NaN,NaN,47.692712794927985,104.36993244566148,-0.009259647936328053,1.278172580271118,1.287432228207446,162811431,164566838.8,46.65530049475343,39.31583737953624,NaN,NaN,31.71123476476075,27.400206787511824
2020-12-11T09:30:00-05:00,66.44,67.04,66.35,66.94,2668268,2655371.2,64.85172712769,66.34059403432467,NaN,NaN,69.66798808178828,90.18534626020623,-0.03843293204201581,1.239391063154926,1.277823995196942,165479699,164512912,46.45087911648306,40.54396881663678,NaN,NaN,31.52417419824148,27.989344989044632
2020-12-14T09:30:00-05:00,67.12,67.6,66.68,66.73,2622942,2703452.35,62.80214563539446,66.62270296091371,NaN,NaN,74.51330432142217,77.8583110083612,-0.07975485038478114,1.1781304322159656,1.2578852826007467,162856757,163538019.6,42.7999352853808,41.55839503320733,NaN,NaN,30.817267908525654,28.39333397754192
2020-12-15T09:30:00-05:00,67.06,67.28,66.41,67.28,1604248,2545050.5,65.84657553056476,66.7082578422638,NaN,NaN,67.11935529375818,68.59833404211739,-0.07784193213021284,1.1605828674379808,1.2384247995681936,164461005,163226532.4,41.672911047335916,42.31102253919601,NaN,NaN,31.006558552433216,28.766651773954962
2020-12-16T09:30:00-05:00,67.39,67.45,66.9605,67.22,3249333,2533362.5,65.21947290802692,66.75436093538836,NaN,NaN,73.54440554663972,66.50755320770726,-0.0876818916499249,1.1288224350057874,1.2165043266557123,161211672,163364112.8,42.39444300339876,42.894429256057364,NaN,NaN,30.99907643454256,29.085569582610333
2020-12-17T09:30:00-05:00,67.47,67.615,66.895,67.05,2437564,2531730.85,63.37774874413191,66.54310903055905,NaN,NaN,67.94195320693373,70.5574012901084,-0.11119259858234298,1.0775135784277836,1.1887061770101266,158774108,162556648.2,39.32010545273319,43.15072295554019,NaN,NaN,30.512178081396694,29.28937079672267
2020-12-18T09:30:00-05:00,67.21,67.325,66.58,67.11,4397842,2582088.8,63.76665306325291,66.4946030095968,NaN,NaN,52.75307829637574,67.1744193330259,-0.12710790193745636,1.0298212995883063,1.1569292015257626,163171950,162095098.4,37.63986871966591,43.27087226829253,NaN,NaN,30.194690362857646,29.418702163313384
2020-12-21T09:30:00-05:00,66.21,66.55,65.42,66.43,4508456,2713694.9,56.45012590345217,65.57310974724376,NaN,NaN,-21.382003446058675,47.995357779529726,-0.18436361358235986,0.9264746845478129,1.1108382981301728,158663494,161256445.8,34.73534065309978,43.068109021629425,NaN,NaN,27.90461283362138,29.2024036876431
2020-12-22T09:30:00-05:00,66.43,66.43,65.41,65.81,2041988,2706250.05,50.73428217505773,64.08726632581813,NaN,NaN,-62.102112656758315,22.151064189426428,-0.2602799914341607,0.785488308837472,1.0457683002716327,156621506,159688546,30.064432028390016,42.40217195514698,NaN,NaN,24.178386133333106,28.484686894170242
2020-12-23T09:30:00-05:00,66.04,66.65,65.87,66.19,1671244,2680791.6,53.82059774212855,63.004901771382166,NaN,NaN,-37.82450270707493,-0.12271746131650332,-0.27950195680701917,0.6963908542628587,0.9758928110698779,158292750,159104761.6,28.5262983101603,41.52054774713594,NaN,NaN,21.81771706417285,27.532262632742043
2020-12-24T09:30:00-05:00,66.26,66.53,66.035,66.26,859714,2639109.75,54.387461748248256,61.946060752070416,NaN,NaN,-46.33124115106421,-22.977356332916095,-0.28132774989022236,0.6242331237070999,0.9055608735973223,159152464,159180432.8,29.033125130440737,40.52113419131722,NaN,NaN,20.012807589281607,26.458054769390554
2020-12-28T09:30:00-05:00,66.8,67.55,66.5901,67.45,2806642,2717945.6,62.757115462731676,61.36505371807075,NaN,NaN,74.51343855343681,-18.625284281503877,-0.2000372617872006,0.6555142963633216,0.8555515581505222,161959106,158937864,28.339391362748074,39.01519584615629,NaN,NaN,20.84560518870384,25.65627625786388
2020-12-29T09:30:00-05:00,67.61,67.73,67.3099,67.39,1502000,2612182.5,62.13800304664862,60.8096921605084,NaN,NaN,119.64846936327157,9.580810280362172,-0.15022863496819716,0.6677657644402757,0.8179943994084728,160457106,159296586.4,30.96643676860114,37.566333440408435,NaN,NaN,21.33408954675322,25.0388210134195
2020-12-30T09:30:00-05:00,67.65,67.65,66.9,66.94,2151835,2525325.6,57.552209603786245,60.45733622945745,NaN,NaN,58.61234701582101,33.72370221487804,-0.14730976686139152,0.6338571908317334,0.7811669576931249,158305271,159633339.4,33.43350103546817,36.57371202918996,NaN,NaN,20.391016057462277,24.374848876854184
2020-12-31T09:30:00-05:00,66.86,67.59,66.86,67.48,2274156,2519982.9,61.248077031580436,60.353728265906746,NaN,NaN,79.5325661424701,57.19511598478705,-0.11041826706329616,0.6431441238640048,0.7535623909273009,160579427,160090674.8,36.739920399744506,35.865470593832185,NaN,NaN,20.692308777629066,23.848771719822025
2021-01-04T09:30:00-05:00,67.75,67.79,65.68,66.48,4456871,2636356.7,52.18638258976558,59.44906079891215,NaN,NaN,-34.31242949802433,59.59887831539502,-0.15219482997332612,0.5633188534606433,0.7155136834339694,156122556,159484693.2,34.308221874469695,34.99813793368837,NaN,NaN,17.99649677648631,23.012732442202637
2021-01-05T09:30:00-05:00,66.32,66.9,66.25,66.72,2184630,2645736.45,53.94741322241946,58.816579912271074,NaN,NaN,-35.40714759898016,37.61476108491163,-0.16160822813768683,0.5135033982618609,0.6751116263995477,158307186,158754309.2,31.593958074141483,34.19771099002842,NaN,NaN,16.369549077006422,22.063706247174608
2021-01-06T09:30:00-05:00,65.69,66.85,65.48,66.4,3904468,2741865.55,51.23767022597485,57.773086676228935,NaN,NaN,-90.26499161133879,-4.367931110010446,-0.18561310962743893,0.44309523936524897,0.6287083489926879,154402718,157543431.6,27.68365080818154,33.198478115803105,NaN,NaN,14.182985514320071,20.937888999623958
2021-01-07T09:30:00-05:00,66.7,67.6,66.59,67.28,2202607,2766357,57.552061099644945,57.22541440420165,NaN,NaN,64.21703466118511,-3.2469935809376267,-0.14050102822395671,0.45308206371274196,0.5935830919366987,156605325,157203442.4,26.68497793097889,32.07637346777312,NaN,NaN,14.2811127626049,19.986920965764092
2021-01-08T09:30:00-05:00,67.31,67.54,66.68,67.49,4993120,2741279.45,58.91918346449841,56.9069454556564,NaN,NaN,70.3817626219856,-5.077154285034527,-0.09687022784250254,0.47249530713357046,0.569365534976073,161598445,157407246,28.353478711147687,31.293042986231296,NaN,NaN,14.789184710982777,19.244387215081048
2021-01-11T09:30:00-05:00,66.51,66.89,66.15,66.29,2203086,2737050.7,49.17319594734146,55.86455566166273,NaN,NaN,-60.73178760644501,-10.361025906718659,-0.14621718349977852,0.38659405560134985,0.5328112391011284,159395359,158061806.6,33.58158763386663,31.003165765817066,NaN,NaN,11.944356878569739,18.201525738436576
2021-01-12T09:30:00-05:00,66.19,66.51,64.86,65.22,14316783,3319476.45,42.4331665838229,54.8633442816892,NaN,NaN,-172.32601377348865,-37.74479914162036,-0.2426243915719336,0.22953074963621134,0.47215514120814495,145078576,155416084.6,25.486256755326906,30.342516915976145,NaN,NaN,7.061218076268956,16.610053215269772
2021-01-13T09:30:00-05:00,65.19,65.7699,65,65.45,3685295,3372594.1,44.203555255534994,54.396863787437574,NaN,NaN,-160.04856083535168,-51.70151298642294,-0.2799582759674283,0.12220729624885962,0.4021655722162879,148763871,154288315.2,22.94692913946629,29.83412385248159,NaN,NaN,3.848221235276054,14.786934360984956
2021-01-14T09:30:00-05:00,65.57,65.82,64.975,65.08,2543319,3419547.65,41.96757126778827,53.55021903927042,NaN,NaN,-148.34332144486913,-94.21358420763379,-0.3159615583614461,0.007213624264480245,0.32317518262592637,146220552,152211360.6,19.160637834788574,29.165148104240753,NaN,NaN,0.5179639341138189,12.74851001428908
2021-01-15T09:30:00-05:00,65.09,65.6,64.785,65.29,4829003,3498531.15,43.70801623804205,52.787401502827116,NaN,NaN,-136.03475807955337,-135.4968883479416,-0.3115091083250793,-0.0662112027804227,0.24529790554465655,151049555,150101582.6,16.230912964560872,28.250704378106473,NaN,NaN,-1.6218755746574887,10.695597787296713
2021-01-19T09:30:00-05:00,65.74,66.63,65.32,66.47,4431471,3598226.5,52.354825301968646,52.044380777058336,NaN,NaN,-32.65125809865392,-129.88078244638336,-0.21932006757454842,-0.02885217892352898,0.19046788865101943,155481026,149318716,15.296285486591131,27.319053958380977,NaN,NaN,-0.6645515866825932,9.07271930529967
2021-01-20T09:30:00-05:00,67.8,68.87,67.58,68.56,4614855,3609077.15,63.151270719869444,52.11675703943125,NaN,NaN,183.81731016828758,-58.652117658028104,-0.01839818448392383,0.16747015804611465,0.18586834253003848,160095881,152322177,31.575278904301186,27.362542682359553,NaN,NaN,4.434805916909402,8.410160249815345
2021-01-21T09:30:00-05:00,68.85,69.2001,68.63,68.81,2394083,3503358.5,64.19639288530968,52.59134155954007,NaN,NaN,194.62019028957891,12.281632566958018,0.12276011232047832,0.3393184829306364,0.21655837061015806,162489964,155067395.6,42.46036384101132,28.007318597041206,NaN,NaN,8.657281904185057,8.445463343296732
2021-01-22T09:30:00-05:00,68.74,69.095,68.58,68.84,1979405,3500229.35,64.32714488572934,52.81127497769355,NaN,NaN,160.2967804160256,74.00965293913697,0.20474031871455095,0.47248376900334677,0.2677434502887958,164469369,158717159,53.134735524220815,29.178376820218084,NaN,NaN,11.91424805083371,8.941004015802013
2021-01-25T09:30:00-05:00,69.29,69.61,68.32,69.24,4083333,3620833.8,66.10454983564165,53.80542978097042,NaN,NaN,151.06492746026305,131.42959004710025,0.26847719763598693,0.6033399473337795,0.33486274969779256,168552702,162217788.4,60.67097218484466,31.0614304138163,NaN,NaN,15.140523478695792,9.826649653358267
2021-01-26T09:30:00-05:00,69.17,70.3,69.17,70.18,3038265,3729761.35,69.90003308613097,54.94490262837839,NaN,NaN,178.36807678379955,173.63345702359095,0.35128794443706857,0.7739726802441282,0.4226847358070597,171590967,165439776.6,66.07787967736812,33.524567671189615,NaN,NaN,19.205562409452494,11.1664943328003
2021-01-27T09:30:00-05:00,69.58,69.77,67.44,67.91,7709684,3974913.45,54.13523573905253,55.15187159359822,NaN,NaN,73.8587413462374,151.6417432591809,0.23605738877899424,0.7177564717808025,0.48169908300180825,163881283,166196857,67.21831266908848,36.348472089825826,NaN,NaN,17.16705554110711,12.023717362558415
2021-01-28T09:30:00-05:00,68.52,69.37,68.12,68.15,6688226,4234224.75,55.28351813396151,54.98983281033512,NaN,NaN,77.02327880071475,128.12236096140808,0.16238327121797536,0.6846781720242774,0.522294900806302,170569509,167812766,69.56984285327532,39.411676727132715,NaN,NaN,16.025484400414918,12.595398367966487
2021-01-29T09:30:00-05:00,67.73,67.87,66.44,66.88,4554744,4354370.2,48.38080543845121,54.237091522760316,NaN,NaN,-8.562207732334405,94.35056333173608,0.021883266270923962,0.549648983644957,0.527765717374033,166014765,168121845.2,70.01293170764669,42.387351941168355,NaN,NaN,12.564954879165485,12.591049298137772
2021-02-01T09:30:00-05:00,67.47,68.43,66.94,68.13,3135074,4397416.1,54.41399086482455,54.61143401686626,NaN,NaN,33.51146706589282,70.83987125286203,0.007633968597614893,0.5373081781210516,0.5296742095234367,169149839,168241272.6,70.19353099939798,45.002490752992024,NaN,NaN,11.873929991863994,12.488603682955803
2021-02-02T09:30:00-05:00,68.58,69.54,68.45,69.17,2010315,4275088.3,58.73536138791415,55.775876502872784,NaN,NaN,89.84586683837962,53.13542926377804,0.05984403133037275,0.6044792486864026,0.5446352173560298,171160154,168155110,69.86660371448838,48.17251553578927,NaN,NaN,12.877527694913493,12.544164256092616
2021-02-03T09:30:00-05:00,70.27,70.68,69.6578,70.1,2848262,4308269.9,62.18729162346215,57.060429100581864,NaN,NaN,127.97373611161908,63.95842821685439,0.14381625619985372,0.7244055376058469,0.5805892814059932,174008416,170180536.6,73.0447889892884,51.75093409649086,NaN,NaN,14.920443817269183,12.883632764832125
2021-02-04T09:30:00-05:00,70.23,70.53,69.83,70.52,2640010,4245047,63.66556056827162,58.61028547918782,NaN,NaN,120.56298123898709,72.66636870450886,0.2104196312901978,0.8436138205187405,0.6331941892285426,176648426,171396320,74.76528591141862,55.722694673393,NaN,NaN,17.02055431912229,13.474621558302148
2021-02-05T09:30:00-05:00,70.91,71.5,70.9,71.41,1849379,4227385.6,66.64164780515782,60.24840201969609,NaN,NaN,144.8858762808474,103.35598550714522,0.29215980194149227,0.998393941655408,0.7062341397139157,178497805,173892928,77.88665066915053,60.12667593800655,NaN,NaN,19.762143678783325,14.372839004085174
2021-02-08T09:30:00-05:00,71.75,71.83,71.14,71.69,5200997,4237779.45,67.54238178911427,61.33322748306363,NaN,NaN,138.58418906215334,124.37052990639731,0.3395078017719112,1.1306188919288047,0.7911110901568935,183698802,176802720.6,80.85845068888898,64.80968773817068,NaN,NaN,22.22181021469959,15.49412060560152
2021-02-09T09:30:00-05:00,71.51,72.31,71.39,71.93,6044268,4429838.55,68.331704398403,61.70325846010174,NaN,NaN,137.85255329635248,133.97186719799188,0.3594908813205925,1.2404746918076341,0.8809838104870417,189743070,180519303.8,83.84481912716423,68.54322632551803,NaN,NaN,24.443336415876665,16.772580007069397
2021-02-10T09:30:00-05:00,72.58,72.83,71.6,72.61,2494534,3838726.1,70.51925779604198,62.154891668011196,NaN,NaN,142.58369059466847,136.89385809460177,0.38853503257658695,1.3666526012077753,0.9781175686311884,192237604,184165141.4,86.13072436766907,71.66253779170788,NaN,NaN,26.9970742497256,18.233222041734567
2021-02-11T09:30:00-05:00,72.76,72.76,72.06,72.69,1860102,3747466.45,70.77503026776786,62.615454909585374,NaN,NaN,133.4970469111104,139.48067122902643,0.38255979741217283,1.4563173153964044,1.0737575179842316,194097706,187654997.4,87.89620454413316,74.14549986455877,NaN,NaN,29.134915227390216,19.79060678254252
2021-02-12T09:30:00-05:00,72.6,73.0899,72.54,73,1573927,3698996.85,71.79615795350648,63.02199834657572,NaN,NaN,130.64528867310585,136.63255370747814,0.3687544524944901,1.5347005836023442,1.165946131107854,195671633,191089763,89.33513180207996,76.19293983721843,NaN,NaN,31.218649588409992,21.423184326237873
2021-02-16T09:30:00-05:00,73,73.845,73,73.35,1996997,3557396.55,72.94551836040257,63.23953300902368,NaN,NaN,136.3162608286943,136.1789680607863,0.3524772860348473,1.606542738651413,1.2540654526165658,197668630,193883728.6,90.34103563066044,77.92602240531073,NaN,NaN,33.30955666235861,23.121237517112263
2021-02-17T09:30:00-05:00,72.92,73.62,72.79,73.56,1976545,3434650.25,73.63963944807229,64.6327047025251,NaN,NaN,119.72019142703903,132.55249568692363,0.3257662657142357,1.6612732847593605,1.3355070190451248,199645175,195864149.6,90.98975758486026,79.62398275643729,NaN,NaN,35.26117243630519,24.855513934139825
2021-02-18T09:30:00-05:00,73.06,73.49,72.6628,73.2,2019895,3304902.25,70.30938651673989,65.7059810155807,NaN,NaN,98.36933992394363,123.70962555277865,0.2567971881626132,1.6565035042483913,1.3997063160857781,197625280,196941684.8,91.33091885792562,81.17834532819802,NaN,NaN,36.05760296809599,26.455812367562135
2021-02-19T09:30:00-05:00,73.41,73.41,72.3799,72.48,2499836,3310189.9,64.06878132551603,66.82655072179962,NaN,NaN,76.10520743664969,112.23125765788652,0.14139740031354653,1.5764530664777112,1.4350556661641647,195125444,197147232.4,91.39782976403183,82.70583804651126,NaN,NaN,35.03764200879718,27.681788030595712
2021-02-22T09:30:00-05:00,71.79,72.86,71.74,72.19,2168062,3319622.75,61.693563516688585,67.34652019693276,NaN,NaN,52.39816193959665,96.58183231118467,0.030064512495058704,1.472636306782988,1.4425717942879293,192957382,196604382.2,89.43455329837752,84.08019678215264,NaN,NaN,33.51614527966583,28.515267637605728
2021-02-23T09:30:00-05:00,71.54,73,70.5,72.75,4636943,3347303.25,64.43544728850384,67.75366918983202,NaN,NaN,41.304051143106314,77.57939037406707,-0.018706576085276483,1.4191885741813337,1.4378951502666102,197594325,196589521.2,89.37795170070667,85.47386449545395,NaN,NaN,32.92762309362889,29.14560413132332
2021-02-24T09:30:00-05:00,72.01,73.06,71.8,72.88,4004605,3395620.25,65.06066593237193,67.958910211897,NaN,NaN,56.128972674219355,64.86114662350315,-0.05310743924356798,1.3715108512121503,1.4246182904557183,201598930,196980272.2,89.56495717961445,86.65387650904867,NaN,NaN,32.60130290748479,29.639275385060674
2021-02-25T09:30:00-05:00,72.91,73.4501,71.02,71.29,5492609,3284766.5,52.82808969752221,67.18480514970062,NaN,NaN,25.469151970916467,50.28110903289772,-0.18634331258317016,1.1916891497267557,1.3780324623099258,196106321,196676480.4,88.263919423552,87.61806461705818,NaN,NaN,28.503583228530072,29.477033648413446
2021-02-26T09:30:00-05:00,71.69,72.875,71.05,71.57,5379385,3219324.45,54.452188809502836,66.31412950715384,NaN,NaN,16.315760819646158,38.32321970949701,-0.2547788654679901,1.0595588804749383,1.3143377459429284,201485706,197948532.8,88.98541481489622,88.41083348461144,NaN,NaN,25.606181979775727,28.924054838608058
2021-03-01T09:30:00-05:00,72.52,73.6,72.22,73.4,4196107,3201392.6,63.33677937690088,66.01372933485288,NaN,NaN,79.16554185320197,43.676695692218075,-0.1795132566277342,1.0899461751582606,1.2694594317859949,205681813,200493419,90.27368474310512,89.08335020276975,NaN,NaN,25.78703437516152,28.475909058115697
2021-03-02T09:30:00-05:00,73.42,73.87,72.81,72.86,4646775,3276977.65,59.63990892386126,65.39288680095704,NaN,NaN,85.52256533594571,52.520398530785954,-0.1689628073824494,1.058255922557933,1.2272187299403825,201035038,201181561.6,90.59404339303424,89.56543765033189,NaN,NaN,24.71956066879591,27.939287859641443
2021-03-03T09:30:00-05:00,72.77,73.095,71.64,71.82,4724266,3412675.2,53.19954462667005,64.15576443171618,NaN,NaN,-4.24333100276595,40.4459377953889,-0.23105136990670294,0.9384045175570037,1.1694558874637067,196310772,200123930,85.91049520863095,89.54970699611488,NaN,NaN,21.634505990049405,27.038604735414008
2021-03-04T09:30:00-05:00,71.81,73.15,70.81,71.69,8581055,3699314.85,52.437275591622964,62.84592481199155,NaN,NaN,-48.06798656941549,25.73851008732248,-0.27681318582959413,0.823439405176714,1.1002525910063081,187729717,198448609.2,78.94800268273838,88.91054972030098,NaN,NaN,18.97093708858782,25.88608078586741
2021-03-05T09:30:00-05:00,72.3,73.59,71.39,73.37,11937347,4164181.7,60.344960605288655,62.027982144261706,NaN,NaN,44.067549846107894,31.288867892614824,-0.19380191852188622,0.8580001928539502,1.0518021113758365,199667064,198084880.8,77.47985005699275,88.06374388136616,NaN,NaN,19.233473960222106,24.935708382203796
2021-03-08T09:30:00-05:00,73.43,73.87,72.34,72.39,8331951,4488310.3,54.63830892367004,60.72032432735224,NaN,NaN,48.590073905291135,25.173774303032666,-0.20374303717687892,0.7971233149047379,1.0008663520816168,191335113,195215540.8,66.909122557187,86.3900358046895,NaN,NaN,17.488686634116682,23.871848132477066
2021-03-09T09:30:00-05:00,73.55,73.83,73.01,73.2,8758085,4666164.7,58.16018252258023,59.614648832674234,NaN,NaN,106.2253055830798,29.314322352459477,-0.15672579087119032,0.8049591134926288,0.9616849043638191,200093198,195027172.8,66.26991439374359,84.62433271960974,NaN,NaN,17.255036583802248,22.926589339809233
2021-03-10T09:30:00-05:00,74.11,74.11,73.13,73.51,5704604,4649181.5,59.457529360200034,58.83951617863567,NaN,NaN,127.0828169102696,55.57955193506659,-0.10802448874777448,0.826654293429101,0.9346787821768755,205797802,196924578.8,69.43720473668995,83.06049599666434,NaN,NaN,17.489851547015014,22.149912512267203
2021-03-11T09:30:00-05:00,74.23,75.355,74.07,74.9,3257114,4687310.5,64.73734876485662,58.887270995731434,NaN,NaN,242.88881240949812,113.77091173084932,0.008348630788247102,0.9451145706621844,0.9367659398739373,209054916,201189618.6,75.09773148457758,81.89620326241759,NaN,NaN,19.488600375588916,21.769725064170306
2021-03-12T09:30:00-05:00,74.3,74.79,74.04,74.69,3106589,4749634.85,63.3941289986929,59.00873995873174,NaN,NaN,175.0898944117433,139.9753806439764,0.05890937290739573,1.010402656008182,0.9514932831007863,205948327,202445871.2,76.47954087148472,80.97084523192525,NaN,NaN,20.63473604454254,21.607583775652053
2021-03-15T09:30:00-04:00,74.88,75.265,74.54,75.22,3338970,4837887,65.34828042496815,59.073942325622056,NaN,NaN,186.92462101772034,167.64229006646224,0.11266051905780772,1.092318931923046,0.9796584128652382,209287297,206036308,79.91062015480878,80.29460726436112,NaN,NaN,22.192850087114756,21.691193248718154
2021-03-16T09:30:00-04:00,75.65,76.6,75.42,76.01,3802789,4928176.6,68.08330531667613,59.28984513878664,NaN,NaN,223.9489894491148,191.18702683966924,0.18192944122663124,1.2070702143985272,1.025140773171896,213090086,208635685.6,81.96214431290676,79.7515492024534,NaN,NaN,24.378806285866723,22.075137968310806
2021-03-17T09:30:00-04:00,75.4325,76.31,74.74,76.02,4617234,5060211.05,68.11760933243946,60.38195368413786,NaN,NaN,160.95228965624412,197.96092138886416,0.20710098163808843,1.2840170002195066,1.0769160185814182,217707320,211017589.2,83.61348332631768,79.41937519550811,NaN,NaN,26.127654928438123,22.65406896261471
2021-03-18T09:30:00-04:00,75.1,75.79,74.68,74.76,5529937,5235713.15,59.44765150529703,60.738772448123164,NaN,NaN,102.87402227479986,169.9579633619245,0.12179314565210841,1.2291574506465537,1.1073643049944453,212177383,211642082.6,84.02638153222816,79.06515853246039,NaN,NaN,25.02013657835494,22.99207862200617
2021-03-19T09:30:00-04:00,74.88,75.8,74.79,75.41,9243529,5572897.8,62.125764850558554,60.652271410527284,NaN,NaN,101.9810811301621,155.33620070560826,0.09332510128487215,1.2240206816005355,1.1306955803156633,221420912,214736599.6,85.91967806544177,78.75415805548444,NaN,NaN,24.912517517514598,23.26642703565023
2021-03-22T09:30:00-04:00,75.49,76.42,75.14,75.91,5225780,5725783.7,64.09032679522684,60.97015840133913,NaN,NaN,111.72421535323097,140.29611957271038,0.09219012270526439,1.2459332336972437,1.1537431109919793,226646692,218208478.6,87.68351526266736,78.54626318902966,NaN,NaN,25.41812382600879,23.57381229141574
2021-03-23T09:30:00-04:00,75.83,76.255,75.225,75.35,4294871,5708680.1,60.31667393320014,61.47852478037699,NaN,NaN,89.03532708032496,113.3133870989524,0.04038963409995189,1.204230153616919,1.1638405195169672,222351821,220060825.6,88.51048578265495,78.73197680145995,NaN,NaN,24.710994574949343,23.73626690334911
2021-03-24T09:30:00-04:00,75.35,75.35,73.4301,73.45,4263531,5721626.4,49.63766273100087,61.2785524331897,NaN,NaN,7.841098059915608,82.6911487796867,-0.12605927308825393,1.0062664281566498,1.1323257012449037,218088290,220137019.6,88.54455782940016,79.4174450262215,NaN,NaN,20.47343352921128,23.27014784990085
2021-03-25T09:30:00-04:00,73.04,73.64,72.52,73.09,3846233,5639307.6,47.90694702215068,60.39012289153699,NaN,NaN,-49.97235292517449,52.12187373969183,-0.2570755443149395,0.8109812708512294,1.068056815166169,214242057,220549954.4,88.73945315892217,80.22170239064504,NaN,NaN,16.52656493192492,22.306778861618575
2021-03-26T09:30:00-04:00,73.13,73.33,71.02,72.29,4204567,5580566.7,44.217347197234325,59.645768482505865,NaN,NaN,-100.77078685487523,11.571500142684366,-0.38650908124658034,0.5849204636079435,0.9714295448545238,210037490,218273270,80.59769451005317,81.19945753013546,NaN,NaN,12.017089381866128,20.83682322165394
2021-03-29T09:30:00-04:00,72.27,73.31,72.04,73.03,4274016,5584462.15,48.19204092752771,58.93375836857354,NaN,NaN,-66.58330450392147,-24.090003828746116,-0.40900533644190273,0.4601728743021454,0.8691782107440481,214311506,215806232.8,72.80285080468391,81.66609584520265,NaN,NaN,9.48666855913781,19.215372555580206
2021-03-30T09:30:00-04:00,73.03,73.19,72.71,73.03,2660531,5485149.95,48.19204092752771,58.12908062338266,NaN,NaN,-55.36039765737393,-52.9691487762859,-0.40958894962373793,0.35719202371437575,0.7667809733381137,214311506,214198169.8,68.17457454989218,81.57590797471708,NaN,NaN,7.48314383813822,17.539339881659924
2021-03-31T09:30:00-04:00,73.33,73.77,73.05,73.32,3857374,5441805.35,49.81719696911502,57.0633554951154,NaN,NaN,-38.31888166346047,-62.20114472096111,-0.3769668907679138,0.2955723598782214,0.6725392506461352,218168880,214214287.8,68.19639883174477,81.08295564237189,NaN,NaN,6.2854340920839205,15.931639054577637
2021-04-01T09:30:00-04:00,73.98,74.63,73.98,74.58,4549730,5240239.1,56.24010991515627,56.55235413200565,NaN,NaN,14.515537786161525,-49.30356657869391,-0.26247994451052514,0.3444393200079787,0.6069192645185039,222718610,215909598.4,70.48872555826384,80.65504026285612,NaN,NaN,7.160904797705454,14.678677017881611
2021-04-05T09:30:00-04:00,74.94,76.255,74.94,76.15,3969963,4841869.9,62.65417003353926,56.35991767547502,NaN,NaN,92.76280948430164,-10.59684731085854,-0.08230154704853687,0.5040423307078328,0.5863438777563696,226688573,219239815,74.39320648791274,80.26093928664925,NaN,NaN,10.08188383695194,14.0219922777488
2021-04-06T09:30:00-04:00,76.13,76.57,75.97,76.34,2523533,4551449,63.35420476283251,56.022124778771904,NaN,NaN,114.18115435276921,25.556044460479598,0.041724935853205025,0.6385000475728759,0.5967751117196709,229212106,222219935,77.28894063699988,79.92713902408447,NaN,NaN,12.621031840152874,13.821855072377954
2021-04-07T09:30:00-04:00,76.36,77.009,76.36,76.93,2347756,4230932.55,65.5158297191191,55.83628337782044,NaN,NaN,128.657869723906,62.35969793673557,0.14948677933235355,0.7836335858851129,0.6341468065527593,231559862,225669606.2,80.09498555995731,79.67581775505873,NaN,NaN,15.416898557387995,14.049718427379387
2021-04-08T09:30:00-04:00,77.33,77.39,76.6921,76.94,2891595,4090282.1,65.55291839261616,56.27237386977181,NaN,NaN,128.802845348694,95.78404333916646,0.20405025239425978,0.8892096220455841,0.6851593696513243,234451457,228926121.6,82.31621113280296,79.55366272652836,NaN,NaN,17.668090744943953,14.56662875846004
2021-04-09T09:30:00-04:00,76.64,76.975,76.36,76.92,2324233,4043638.05,65.40141465704093,56.50634885594913,NaN,NaN,101.22234507438216,113.12540479681061,0.22003010836770542,0.9601970051109561,0.7401668967432506,232127224,230807844.4,83.46445930432759,79.37828995787734,NaN,NaN,19.468248224141117,15.266860110700193
2021-04-12T09:30:00-04:00,76.7,76.735,76.26,76.61,2234293,4000023.25,62.97203484205887,56.42647085929428,NaN,NaN,81.45690332972403,110.86422356589507,0.1919801945517946,0.9801421399329939,0.7881619453811993,229892931,231448716,83.84910173084529,79.10440327703292,NaN,NaN,20.355177536690572,15.99376260012739
2021-04-13T09:30:00-04:00,76.83,77.16,76.6,76.71,2891100,3977629.75,63.443764018372676,56.6498344368066,NaN,NaN,87.48141528065838,105.5242757514729,0.1635313773310645,0.9925761670450299,0.8290447897139654,232784031,232163101,84.28785488425903,78.80278678429035,NaN,NaN,21.22493198365097,16.74107251205933
2021-04-14T09:30:00-04:00,76.64,76.67,75.76,75.92,3939183,3984449.45,57.23975484425796,57.192841016324955,NaN,NaN,50.723305120991704,89.93736283089005,0.07915342730675223,0.9279865738474058,0.8488331465406536,228844848,231620098.2,82.45431078227672,78.36776913806725,NaN,NaN,20.32369227125934,17.252875334802187
2021-04-15T09:30:00-04:00,76.44,77.1,76.33,76.89,4523465,3979761,62.13576194024768,58.209184939046175,NaN,NaN,78.95672210106864,79.96813818136498,0.07628209358389504,0.9441857635205224,0.8679036699366274,233368313,231403469.4,81.69082936196375,77.86429600971307,NaN,NaN,20.912130550449263,17.775626079894625
2021-04-16T09:30:00-04:00,77.1,77.14,76.55,76.84,3378437,3872186,61.74332056608709,59.46104017967851,NaN,NaN,75.17249946304506,74.75816905909755,0.05938016855606898,0.9421288806317136,0.8827487120756446,229989876,230975999.8,80.11441815388916,77.82977626998706,NaN,NaN,21.2861240124394,18.27712578454388
2021-04-19T09:30:00-04:00,76.64,77.06,76.01,76.41,3188379,3569428.5,58.331253169871125,60.18526962556019,NaN,NaN,54.11814142193799,69.29041667754035,0.010184115888837164,0.8954788569366912,0.885294741047854,226801497,230357713,77.77657983119484,78.18504262902357,NaN,NaN,20.66589533481788,18.618378577440165
2021-04-20T09:30:00-04:00,76.27,76.47,75.43,76,3535193,3484899.15,55.198985969197544,60.68576569996518,NaN,NaN,29.24737884571053,57.64360939055077,-0.05542119035190729,0.8160182531079698,0.8714394434598771,223266304,228454167.6,70.91534968235914,78.38081228134263,NaN,NaN,19.259960265620876,18.710033104323124
2021-04-21T09:30:00-04:00,75.56,76.15,75.09,76.13,7034082,3621859.7,56.00566074031745,61.12779882647963,NaN,NaN,20.572951852379802,51.6135387368284,-0.09328450570677638,0.7548338113264066,0.848118317033183,230300386,228745275.2,71.33186178315597,78.60477392072914,NaN,NaN,18.29382524752277,18.65057483906593
2021-04-22T09:30:00-04:00,76.31,76.465,75.29,75.57,3533007,3585333.5,51.688172475250106,60.8026604379149,NaN,NaN,16.85427141943173,39.193048600501015,-0.15559639484515608,0.6536228234767378,0.8092192183218939,226767379,227425088.4,66.66898292998229,78.33193516156618,NaN,NaN,16.24090703475233,18.306336581306844
2021-04-23T09:30:00-04:00,75.9,76.67,75.7379,76.45,2741891,3530116.4,57.26358103314643,60.41761836645828,NaN,NaN,38.1923207611257,31.79701286011714,-0.13771361263411097,0.6370772025292553,0.7747908151633662,229509270,227328967.2,66.32901137763857,77.75592122511803,NaN,NaN,15.976695500954028,17.97353071268501
2021-04-26T09:30:00-04:00,76.61,76.75,76.42,76.61,2767131,3458244.6,58.20794403057516,60.05002831415418,NaN,NaN,53.7191188520264,31.71720834613483,-0.11613864981253152,0.6296175028977018,0.7457561527102333,232276401,228423948,68.31142151385113,77.11466985917885,NaN,NaN,16.023406865556787,17.694941591666694
2021-04-27T09:30:00-04:00,76.73,76.87,76.21,76.3,4684881,3478787.85,55.642436086239286,59.34478591180562,NaN,NaN,39.78929512453333,33.82559160189939,-0.1231100934346766,0.5918685359168876,0.7149786293515642,227591520,229288991.2,69.82299661326776,76.38095636298672,NaN,NaN,15.349553658006327,17.359886172572356
2021-04-28T09:30:00-04:00,77.34,77.85,76.93,77,3355435,3513533.05,59.93643317030127,58.943608395925985,NaN,NaN,113.0067219377153,52.31234561896649,-0.08287198372413596,0.6113886496963943,0.6942606334205302,230946955,229418305,70.05296732467374,75.50501037669177,NaN,NaN,15.987218891693345,17.163790846732496
2021-04-29T09:30:00-04:00,78.81,79.22,78.25,79.13,4816238,3561476.25,69.5847523477845,59.242418230979105,NaN,NaN,292.34582110217235,107.41065555551461,0.0762949524863955,0.7896293240285246,0.7133343715421291,235763193,231217467.8,73.12201348839014,74.76626424698195,NaN,NaN,19.992374648295883,17.56787424695584
2021-04-30T09:30:00-04:00,78.15,78.41,77.92,78.05,3819517,3524965.6,61.497708145238114,59.137109181206185,NaN,NaN,186.279790456212,137.02814949453187,0.09663178682153784,0.8341241050690513,0.7374923182475135,231943676,231704349,73.9014891828136,74.05572049355112,NaN,NaN,20.537907279856896,17.992164680227418
2021-05-03T09:30:00-04:00,78.36,78.449,77.55,77.64,3861572,3519546.05,58.708251219248055,58.798858266983004,NaN,NaN,136.5112181755096,153.58656935922852,0.07142410379539521,0.8267724479917575,0.7553483441963623,228082104,230865489.6,70.12795841718145,73.04429931733128,NaN,NaN,20.02490397501455,18.28255600805415
2021-05-04T09:30:00-04:00,77.21,77.45,75.81,76.94,6848754,3735807.1,54.18895919896885,58.58094429231949,NaN,NaN,-7.483659198854374,144.131978494551,0.0003215155417829463,0.755750238623591,0.7554287230818081,221233350,229593855.6,64.73196816727159,71.77841770197378,NaN,NaN,18.083834638907025,18.254167241033134
2021-05-05T09:30:00-04:00,77.41,77.65,76.695,76.79,3828964,3809867.5,53.2431299475714,57.94575629284261,NaN,NaN,29.45889516286163,127.42241313958024,-0.06072081270786078,0.6795277071969821,0.7402485199048429,217404386,226885341.8,55.021009233776596,69.87343054996042,NaN,NaN,16.25383270320747,17.968405164200895
2021-05-06T09:30:00-04:00,76.7,77.71,76.58,77.69,5321684,3931371.95,57.98198472495028,57.67708944704713,NaN,NaN,60.12012463019369,80.97727384518451,-0.04511068314887212,0.6838601659687527,0.7289708491176248,222726070,224277917.2,47.61546877044051,67.55207702257123,NaN,NaN,16.196002525373345,17.71520478722553
2021-05-07T09:30:00-04:00,78.27,78.645,77.9,78.28,3636572,3996988.9,60.787705270170804,57.85255031135425,NaN,NaN,141.39081812462854,71.99947937886782,-0.001955246237919761,0.7265267913202251,0.7284820375581449,226362642,223161710.4,44.833522983679096,65.19900153346295,NaN,NaN,17.044358164135026,17.61936955535546
2021-05-10T09:30:00-04:00,77.89,77.92,76.725,76.78,4043510,4087449.75,51.39201933938372,57.580624123510404,NaN,NaN,21.864363608723494,49.07010846551059,-0.07717168461113622,0.6320174317942246,0.7091891164053609,222319132,222009116,42.09836538108084,63.140645511943085,NaN,NaN,14.591346862098453,17.186794884890173
2021-05-11T09:30:00-04:00,75.65,76.75,75.56,76.56,9642139,4425001.7,50.167264214522575,57.16359580023934,NaN,NaN,-60.866871772029164,38.393465950875644,-0.14077585161330053,0.5332193018887352,0.6739951535020358,212676993,220297844.6,38.35683462472084,60.78528642919771,NaN,NaN,12.267311979758642,16.484011612728526
2021-05-12T09:30:00-04:00,75.62,76.08,74.84,75.06,5624986,4509291.85,42.69600089330288,56.52129783010025,NaN,NaN,-145.85545137260192,3.33059664378293,-0.27513318939676457,0.33007866675608,0.6052118561528446,207052007,218227368.8,34.375989805398405,58.47864406315602,NaN,NaN,7.6009488306081865,15.215002643854191
2021-05-13T09:30:00-04:00,75.53,76.26,75.13,75.6,7711883,4668712.75,45.82400766202193,55.7041854464485,NaN,NaN,-101.66091937294213,-29.02561215684424,-0.3159788918672882,0.21023824131873425,0.5262171331860225,214763890,216634932.8,31.654859205626508,56.00191890801229,NaN,NaN,4.888870442336316,13.739840900780209
2021-05-14T09:30:00-04:00,76.28,77.25,76.15,77.09,3257041,4662642.95,53.385102394240356,55.35969675813886,NaN,NaN,2.0953537965030398,-56.88470502246933,-0.23472515328994586,0.23281069157359013,0.467535844863536,218020931,214966590.6,29.059540216664303,53.19821310107038,NaN,NaN,5.1596095231891725,12.514093561124346
2021-05-17T09:30:00-04:00,77.07,77.13,75.98,76.48,3006248,4653536.4,50.2905862509908,54.977421769906826,NaN,NaN,-24.81290825834308,-66.22015939588266,-0.21468341367743926,0.19918157776673695,0.4138649914441762,215014683,213505700.8,26.974026088522578,50.13757234930286,NaN,NaN,4.330404808543804,11.344995167898555
2021-05-18T09:30:00-04:00,76.47,76.71,75.68,75.7,2438237,4598688.6,46.573037382867476,54.02289349937583,NaN,NaN,-69.94423856844101,-68.03563275516504,-0.24441848617374645,0.10834188372699316,0.3527603699007396,212576446,213485591.4,26.945359585276478,47.05845751077449,NaN,NaN,2.40730833520139,10.068182763227531
2021-05-19T09:30:00-04:00,74.6125,75.87,74.54,75.82,4936818,4493825.4,47.21945794217665,52.42537247040384,NaN,NaN,-120.96024881848155,-63.05659224434096,-0.24580096192097778,0.04550916749951739,0.29131012942049517,217513264,215577842.8,34.71885182656372,44.31537453492974,NaN,NaN,1.101445815402449,8.787220342109663
2021-05-20T09:30:00-04:00,76.2,77.285,76.02,77.12,3504520,4492401.05,53.748207825327995,51.87183673326741,NaN,NaN,-3.327716097723834,-43.3899515892973,-0.153475034226358,0.09946633663754767,0.25294137086390567,221017784,216828621.6,38.90419507124702,41.81556781267499,NaN,NaN,2.0900910273572975,7.830487582859325
2021-05-21T09:30:00-04:00,77.48,77.5,76.82,76.86,4451992,4577906.1,52.353395682400176,51.41791848063542,NaN,NaN,16.78830330120058,-40.45136168835779,-0.10646012728670726,0.11986621175552159,0.22632633904222885,216565792,216537593.8,38.28907929193554,39.541362160871714,NaN,NaN,2.447584912202519,7.06150148705121
2021-05-24T09:30:00-04:00,77.44,78.4599,77.29,78.26,3020104,4590554.75,58.585609901705354,51.73196495940231,NaN,NaN,93.9396853870226,-16.700842959284643,0.015870076655928073,0.24616393486213894,0.23029385820621087,219585896,217451836.4,41.42239191726855,37.87639242872864,NaN,NaN,4.822223429026091,6.74160462161905
2021-05-25T09:30:00-04:00,78.68,78.79,78.08,78.24,3079284,4510274.9,58.46795366433037,52.10516665345653,NaN,NaN,112.6116316384963,19.810331082102817,0.08833644449253963,0.3407144138218854,0.25237796932934575,216506612,218237869.6,44.052574680835725,37.0929328178043,NaN,NaN,6.645464018395991,6.727870249730041
2021-05-26T09:30:00-04:00,78.47,79.08,78.31,78.75,4644900,4574748.15,60.63874368084623,52.29493515030624,NaN,NaN,123.2613061198791,68.65464206977495,0.1593723443316769,0.45159339974394186,0.29222105541226495,221151512,218965519.2,46.449655362803156,37.00966043154448,NaN,NaN,8.827503506304307,7.027817857812079
2021-05-27T09:30:00-04:00,78.8475,79.2387,78.715,79.05,4462105,4557041.5,61.9002582756278,52.3744032221246,NaN,NaN,143.79704166670973,98.07959362266166,0.2120228840797876,0.5572496605119994,0.34522677643221183,225613617,219884685.8,49.39895345029706,37.33576260773149,NaN,NaN,11.001484205464052,7.595484478905218
2021-05-28T09:30:00-04:00,79.27,79.3,78.7113,78.79,2834360,4507783.65,60.10241420741877,52.9965742841271,NaN,NaN,128.54967142864714,120.43186724815098,0.21416867323344013,0.612937617974012,0.3987689447405719,222779257,221127378.8,53.15534411439823,38.12554680296844,NaN,NaN,12.307228965703276,8.268590834162083
2021-06-01T09:30:00-04:00,79.08,79.22,78.46,78.84,3301380,4479774.05,60.34096618967514,53.72326728235229,NaN,NaN,111.22373732840472,123.8886776364274,0.20384191939623025,0.6535713439858597,0.44972942458962945,226080637,222426327,56.76802033301643,39.44063149641813,NaN,NaN,13.449197960379685,9.008677566478884
2021-06-02T09:30:00-04:00,78.99,79.1,78.205,78.6,2782046,4276438.65,58.53189798733908,54.85440278906916,NaN,NaN,85.70837804276758,118.50802691728165,0.16726724327154818,0.6588134786790647,0.4915462354075165,223298591,223784722.8,60.22281480183189,41.286833281877655,NaN,NaN,13.945853020648924,9.713988345646033
2021-06-03T09:30:00-04:00,78.05,78.288,77.59,78.07,2812379,4225609.4,54.63630720258297,55.48385275625209,NaN,NaN,39.52355493410131,101.76047668012609,0.09726982453385813,0.6131335160748392,0.5158636915409811,220486212,223651662.8,59.719385723751124,43.29144231888655,NaN,NaN,13.336681707474481,10.231515968764382
2021-06-04T09:30:00-04:00,78.39,79.3,78.27,79.19,2333173,4076183.85,60.603441887981774,55.99944843437648,NaN,NaN,87.4817166497638,90.4974116767369,0.11507050628129412,0.6597018243925987,0.5446313181113046,222819385,223092816.4,57.5436590201553,45.326022233421625,NaN,NaN,14.496678626607832,10.840824919884875
2021-06-07T09:30:00-04:00,79.06,79.64,78.98,79.6,3321132,4060411.85,62.54571147099508,56.874814521519646,NaN,NaN,107.48698602956875,86.28487459692124,0.14139538505880478,0.7213755494348106,0.5799801643760059,226140517,223765068.4,59.45715502421016,47.64624572882788,NaN,NaN,16.041071893307386,11.58371734465952
2021-06-08T09:30:00-04:00,79.82,79.82,78.98,79.37,3325184,4024495.55,60.73674141412082,57.88650766660917,NaN,NaN,94.95575276622435,83.03127768448516,0.13051749822110792,0.7431270371523908,0.6126095389312829,222815333,223112007.6,56.77992310928873,49.777285980543034,NaN,NaN,16.829530275796596,12.333119191964817
2021-06-09T09:30:00-04:00,79.73,79.86,79.25,79.29,5167954,3800786.3,60.085784252186116,58.80553097446698,NaN,NaN,90.91745843018687,84.07309376196902,0.10616704922924625,0.7453183504678407,0.6391513012385944,217647379,221981765.2,52.38369087319629,51.03906019815965,NaN,NaN,17.31063673730235,13.044193127013036
2021-06-10T09:30:00-04:00,79.37,79.845,79.08,79.72,2470513,3643062.65,62.417369241924085,59.42475678993814,NaN,NaN,91.01881890675521,94.3721465564998,0.10695378242584508,0.7728435292709008,0.6658897468450558,220117892,221908101.2,52.10055392114672,51.981657258866775,NaN,NaN,18.362985207995568,13.804020567153398
2021-06-11T09:30:00-04:00,79.84,79.855,79.44,79.81,3729117,3443924.35,62.90578378445372,60.178498797227675,NaN,NaN,94.1798781436964,95.71177885528633,0.10151299757318188,0.7927809938115331,0.6912679962383512,223847009,222113626,52.8660238866911,53.0228675870636,NaN,NaN,19.376721396736357,14.60012068566525
2021-06-14T09:30:00-04:00,79.87,80.36,79.64,80.34,2733226,3417733.6,65.73021397910696,60.68882765989922,NaN,NaN,111.55757417150379,96.52589648367332,0.12030254341108348,0.8416461755022056,0.7213436320911221,226580235,222201569.6,53.21058791881192,53.86488158717384,NaN,NaN,21.047168472893727,15.521127512412175
2021-06-15T09:30:00-04:00,80.41,80.55,79.743,79.88,3085737,3421708.05,61.36306191664408,60.89562110649306,NaN,NaN,102.81664194129638,98.09807431868772,0.08984053105462919,0.8336442959094086,0.7438037648547794,223494498,222337402.6,53.772696430671914,54.55917599787643,NaN,NaN,21.328283516564664,16.350721227291103
2021-06-16T09:30:00-04:00,80.04,80.04,78.51,79.18,4692179,3534405.15,55.33774846733027,60.516978591241916,NaN,NaN,44.200937042959104,88.75477004124215,0.01458446114761136,0.7620343412892936,0.7474498801416822,218802319,222568390.6,54.767846657444125,55.153332518922205,NaN,NaN,19.857097446854123,16.851632115800108
2021-06-17T09:30:00-04:00,79.07,79.97,79.04,79.51,4556348,3515381.65,57.45848239610489,60.1997088855617,NaN,NaN,62.142975449804084,82.97960134985195,-0.019103655892600435,0.7235703102759317,0.7426739661685321,223358667,223216545.6,57.530589471350346,55.734163663283155,NaN,NaN,19.19635476680481,17.186592494515065
2021-06-18T09:30:00-04:00,79.159,79.24,78.46,78.58,6194786,3649894.95,50.221042252408495,59.49389660306097,NaN,NaN,-26.4683654012886,58.84995264085493,-0.10533851393293525,0.611000823752363,0.7163393376852982,217163881,221879920,50.65888597401276,55.5558452246842,NaN,NaN,16.39697735606532,17.073790331879387
2021-06-21T09:30:00-04:00,78.62,79.26,78.28,79.2,3274376,3591014.15,54.34934267023122,59.065923494529265,NaN,NaN,-22.709313706083044,31.99657506533756,-0.1208306107793875,0.5653010742110638,0.6861316849904513,220438257,220651524.4,45.303282446915134,54.736935375676964,NaN,NaN,15.229387725457446,16.810304245247682
2021-06-22T09:30:00-04:00,79.28,79.99,79.05,79.88,4690387,3674528.3,58.422112105038835,59.05808164579353,NaN,NaN,71.48867912887444,25.73098250285317,-0.08706593687581532,0.5772992638956822,0.6643652007714975,225128644,220978353.6,46.91141274491969,53.78612094304038,NaN,NaN,15.48401526704207,16.62083439121831
2021-06-23T09:30:00-04:00,79.81,80.22,79.735,79.8,4669040,3754016.1,57.76912539915301,59.281854374119966,NaN,NaN,103.31263252796285,37.55332159985392,-0.0725010569475204,0.573738879587097,0.6462399365346174,220459604,221309810.6,48.56309250778473,52.98924285618563,NaN,NaN,15.496352562174748,16.46019412992637
2021-06-24T09:30:00-04:00,80.18,80.59,80.13,80.55,3430936,3693317.9,62.051438021779965,59.38528266939126,NaN,NaN,158.1163813386605,56.748002777625196,-0.01759984545136961,0.6242401297204054,0.641839975171775,223890540,221416185.2,49.110297460708914,52.38685988765375,NaN,NaN,16.815813199772624,16.51099685419012
2021-06-25T09:30:00-04:00,80.53,80.74,80.375,80.65,5843445,3762384.9,62.59605246217847,59.38887845447579,NaN,NaN,159.24981953076968,93.89163976403685,0.018264017126718324,0.664669996580173,0.6464059794534547,229733985,223930206,59.953456286293125,52.42230997780253,NaN,NaN,18.0468636411511,16.73040639518455
2021-06-28T09:30:00-04:00,80.84,81.66,80.589,81.56,3553948,3798364.3,67.20803213457441,59.851113505936766,NaN,NaN,208.20407779574768,140.074318064403,0.09196627558198445,0.7613638239309353,0.6693975483489508,233287933,226500141.2,67.56223309875182,53.19247497704989,NaN,NaN,20.589896750027297,17.281762160162085
2021-06-29T09:30:00-04:00,81.57,81.65,80.895,81.12,4272919,3846941.25,63.15330181722377,60.07022190343945,NaN,NaN,170.1344201344173,159.8034662655116,0.09915785744732619,0.7933448701581085,0.6941870127107823,229015014,227277415.2,69.45265986392945,54.41168704781655,NaN,NaN,21.49620162500433,17.883824940853835
2021-06-30T09:30:00-04:00,81.05,81.19,80.68,80.97,2533727,3834525.3,61.78479898994697,60.02503831401252,NaN,NaN,122.04644041847043,163.55022784361307,0.0825659628395462,0.797394466260215,0.7148285034206688,226481287,228481751.8,72.15996446692773,55.84450208680091,NaN,NaN,21.836479677034127,18.448489903165306
2021-07-01T09:30:00-04:00,80.87,81.68,80.85,81.57,5227734,3955293.05,65.047467562089,60.17801572670074,NaN,NaN,145.53402551409977,161.03375667870097,0.09961188380561381,0.8393433581776861,0.7397314743720723,231709021,230045448,75.22959438145597,57.441899979284116,NaN,NaN,23.107277016308704,19.11403091932865
2021-07-02T09:30:00-04:00,81.87,82.255,81.735,82.14,4347547,4056011.75,67.8552006451103,60.329800488558135,NaN,NaN,178.10867340932765,164.80552745441253,0.1347061950093852,0.9081142181338038,0.7734080231244186,236056568,231309964.6,77.3997291945126,59.16969578469131,NaN,NaN,25.057820973711202,19.96314378424044
2021-07-06T09:30:00-04:00,82.28,82.386,81.19,81.94,3829492,4081429.75,65.85619674530791,60.65073869060554,NaN,NaN,134.78984739324972,150.12268137391294,0.1298265619685247,0.9356912255850744,0.8058646636165497,232227076,231097793.2,76.19353096607493,60.77118396579152,NaN,NaN,26.082656412059045,20.83735987392881
2021-07-07T09:30:00-04:00,82.32,82.32,81.63,81.82,3651770,4097759.05,64.62600239420752,61.31418539966821,NaN,NaN,122.5020416581236,140.5962056786542,0.10495734563581616,0.9370613456613199,0.8321040000255038,228575306,231009851.6,75.66717569872762,62.26399318302605,NaN,NaN,26.583349312958976,21.658215508075976
2021-07-08T09:30:00-04:00,80.77,81.29,80.52,80.92,5236971,4101209.9,56.153700708065486,61.2209867076654,NaN,NaN,39.95433345657885,124.1777842862759,0.018845734373774237,0.8556611679927215,0.8368154336189473,223338335,230381261.2,71.84663049129311,63.2865675415934,NaN,NaN,24.482148581201923,22.06163451852254
2021-07-09T09:30:00-04:00,80.95,81.7606,80.94,81.64,2914379,4123403.2,60.603371188653476,61.9625816316829,NaN,NaN,73.71602685053745,109.81418455356342,0.0022043515313081574,0.8395708730330824,0.8373665215017743,226252714,229289999.8,65.64944349709843,64.35732165038523,NaN,NaN,24.009195892856887,22.339857571998873
2021-07-12T09:30:00-04:00,81.81,82.26,81.5,82.22,3568668,4115380.75,63.791161058619316,62.636997230853474,NaN,NaN,103.92725401903245,94.9779006755044,0.021038433689924085,0.8636645636141793,0.8426261299242552,229821382,228042962.6,59.34944879599006,65.36061924674773,NaN,NaN,24.601655681022862,22.66297158757373
2021-07-13T09:30:00-04:00,82.14,82.645,81.93,82.01,3979144,4177676.65,61.840074163597045,62.88113737789335,NaN,NaN,105.9532844704611,89.21058809094667,0.010656631066683686,0.8559469187576099,0.8452902876909262,225842238,226765995,53.66976708743654,65.84335884264179,NaN,NaN,24.495704484147506,22.924790572798553
2021-07-14T09:30:00-04:00,82.48,82.54,81.86,81.95,3459600,4196369.8,61.263527131326,63.13073750162,NaN,NaN,91.34457252210669,82.97909426374329,-0.007944529928611166,0.8353596252801623,0.8433041552087734,222382638,225527461.4,48.79253636156459,65.85974768934035,NaN,NaN,24.244072815485687,23.113259464611
2021-07-15T09:30:00-04:00,82.05,82.05,81.03,81.37,4500540,4186787.85,55.84353031444312,62.68731552252451,NaN,NaN,42.558394442611835,83.49990646094989,-0.0638893999142196,0.7634424053159989,0.8273318052302185,217882098,224436214,44.91927797605397,65.56038915472213,NaN,NaN,22.422156639483752,23.014530489592822
2021-07-16T09:30:00-04:00,81.49,81.72,80.76,80.86,3509286,4134434.75,51.52678023224789,61.89665322038661,NaN,NaN,9.040774952335747,70.56485608130956,-0.135695007364793,0.6577130460242273,0.7934080533890203,214372812,222060233.6,37.87030024161603,63.983020865816634,NaN,NaN,19.548160644414654,22.519334797424513
2021-07-19T09:30:00-04:00,80.21,80.22,79.26,79.63,6897181,4169554.5,42.911368720699684,60.1611772622527,NaN,NaN,-121.92013338007867,25.395378601487344,-0.2593170907678013,0.46926168992926875,0.72857878069707,207475631,217591083.4,28.735821497881744,61.209705751468775,NaN,NaN,14.002206715197907,21.302602214249283
2021-07-20T09:30:00-04:00,79.9,80.825,79.475,80.53,4111822,4211426.8,49.55740249894584,59.19004159666143,NaN,NaN,-85.68983944193158,-12.933246180991194,-0.2724136035221191,0.3880617762944212,0.6604753798165403,211587453,214740126.4,24.651025178249384,58.00958898820591,NaN,NaN,11.441408266854724,19.893860221764346
2021-07-21T09:30:00-04:00,80.6,81.205,80.56,81.2,2612944,4107554.65,53.86341544407161,58.624228486241755,NaN,NaN,-22.884085886549364,-35.77897786272241,-0.22960546596245401,0.3734685473634727,0.6030740133259267,214200397,213103678.2,22.659889494280762,54.47386934730256,NaN,NaN,10.76541773592301,18.589797009501297
2021-07-22T09:30:00-04:00,81.19,81.5,80.82,81.48,2254845,3986844.9,55.57035689811731,57.94729201024377,NaN,NaN,1.417322698210083,-44.00719221160276,-0.17836702153455541,0.3801152364077325,0.5584822579422879,216455242,212818307,22.32129659156142,50.69470521945295,NaN,NaN,10.778252757440773,17.473862116349792
2021-07-23T09:30:00-04:00,82.43,83.729,82.07,83.5,3872537,4008924.95,65.49000210047839,57.77834925705577,NaN,NaN,202.35320846075442,-5.344705509919024,-0.013081358443503333,0.5421305598879087,0.555211918331412,220327779,214009300.4,27.20981002051262,47.10971099273866,NaN,NaN,14.491272707455524,17.047777915079184
2021-07-26T09:30:00-04:00,83.4,83.955,83.27,83.93,3189822,3876243.8,67.17032102940136,57.87221527734817,NaN,NaN,220.76721431876223,63.19276402984915,0.11358207385487495,0.6971895106500057,0.5836074367951307,223517601,217217694.4,38.44764263790042,44.41357611215477,NaN,NaN,17.97713305219223,17.18054293466676
2021-07-27T09:30:00-04:00,83.83,83.91,82.32,82.93,4857692,3941431,59.86954579743834,57.53246837757894,NaN,NaN,130.14037853779473,106.35880762579441,0.11787979792601655,0.7309571842026514,0.6130773862766349,218659909,218632185.6,42.65132896693536,42.05530134559818,NaN,NaN,18.29241093739487,17.339381220770775
2021-07-28T09:30:00-04:00,83.81,84.18,83.2,83.58,7295324,4092551.25,62.706927474796124,58.00055600377397,NaN,NaN,156.73665376016748,142.2829555551378,0.15028624629561116,0.8009351941461489,0.6506489478505377,225955233,220983152.8,48.898075332826814,40.41611883427915,NaN,NaN,19.53419661686947,17.652926277356304
2021-07-29T09:30:00-04:00,83.04,83.32,82.6401,82.68,5291288,4230429.3,56.72635946325949,57.72362659481727,NaN,NaN,84.05930020301066,158.8113510560979,0.09935198725386574,0.7748389319178699,0.6754869446640042,220663945,221824893.4,50.95783494278543,39.36671822325679,NaN,NaN,18.482517106805094,17.771439252991847
2021-07-30T09:30:00-04:00,82.17,82.935,82.03,82.4,2999598,4119022.5,54.96984539420659,57.09353261878778,NaN,NaN,44.78235549844266,127.29718046363556,0.03819195369951345,0.723226886788396,0.6850349330888825,217664347,221292207,49.59545214465003,38.670004176732505,NaN,NaN,17.07755096894756,17.672312355271234
2021-08-02T09:30:00-04:00,82.75,82.83,82.06,82.21,3988317,4101061,53.75350874945043,56.5159208034916,NaN,NaN,35.589016769693885,90.26154095382188,-0.020514744636429327,0.6593915022933459,0.6799062469297752,213676030,219323892.8,44.826425062496135,38.03833688923676,NaN,NaN,15.580447151083817,17.373474468958747
2021-08-03T09:30:00-04:00,82.24,82.2498,80.91,81.84,4860485,4152610.65,51.36971205428684,55.80921972656023,NaN,NaN,-19.79031555372577,60.27540213551778,-0.08604666008592399,0.5723479218223702,0.6583945819082941,208815545,217355020,40.61892371778778,37.45450741468128,NaN,NaN,13.61958074650453,16.837203937179574
2021-08-04T09:30:00-04:00,81.96,82.27,81.59,82.07,3864613,4163252.8,52.771797895696274,55.58981026807832,NaN,NaN,4.638939406701343,29.855859264824552,-0.1139344820671544,0.5159764793243511,0.6299109613915055,212680158,214700005,35.74637521083275,36.79930007430834,NaN,NaN,12.416920115519012,16.205734819799492
2021-08-05T09:30:00-04:00,82.31,82.835,82.11,82.82,2261344,4014471.45,57.113921749838134,55.98889180504904,NaN,NaN,48.218279368692244,22.687655097960874,-0.0833209249226824,0.5257598052381525,0.6090807301608349,214941502,213555516.4,33.86075768163484,36.512904177166824,NaN,NaN,12.663298702120548,15.699672517273928
2021-08-06T09:30:00-04:00,82.65,83.05,82.61,82.82,2764354,4006970.2,57.113921749838134,57.00335987855893,NaN,NaN,61.646655275873684,26.060515053447073,-0.06531799257553061,0.5274332394414216,0.5927512320169522,214941502,213010947.4,32.969586318240076,36.815315950049566,NaN,NaN,12.86175306992143,15.294255453366429
2021-08-09T09:30:00-04:00,82.81,82.82,82.39,82.67,2367789,3946926.25,55.92136805094256,57.45792884655871,NaN,NaN,41.84657334681309,27.31202636887091,-0.0655866756601321,0.5107678874417871,0.5763545631019192,212573713,212790484,32.595569277136434,37.38278338568436,NaN,NaN,12.70176260014004,14.923899331476944
2021-08-10T09:30:00-04:00,82.75,82.92,82.4701,82.83,6254449,4060691.5,56.95385282241469,57.67867437358321,NaN,NaN,47.41060239559065,40.75220995873419,-0.05736060742192717,0.5046538038245103,0.5620144112464375,218828162,214793007.4,39.32828036871555,38.573382733858274,NaN,NaN,12.841973599467371,14.62648136976129
2021-08-11T09:30:00-04:00,82.99,83.085,82.68,82.99,2457566,4010589.8,58.01299705746531,57.8531486706795,NaN,NaN,56.14077208567007,51.05257649452794,-0.04411068128808904,0.5068760596363262,0.5509867409244152,221285728,216514121.4,44.462826149611786,40.1549205594333,NaN,NaN,13.238279888260077,14.428166872403974
2021-08-12T09:30:00-04:00,82.9,83.18,82.47,83.14,2269033,3899014.45,59.03073268369922,57.391772283766706,NaN,NaN,52.65818131691281,51.940556884172054,-0.028944120848802934,0.5148065898634115,0.5437507107122145,223554761,218236773.2,49.105411353783715,41.71889208323837,NaN,NaN,13.839410712216374,14.344058849520032
2021-08-13T09:30:00-04:00,83.35,83.45,83.125,83.19,2144569,3830778.6,59.38414294284672,56.835616706155655,NaN,NaN,73.45233122024707,54.30169207304673,-0.019687104193574223,0.5191418304702466,0.5388289346638209,225699330,220388338.8,54.2495562300902,42.84760019696621,NaN,NaN,14.439351291950958,14.357672055581592
2021-08-16T09:30:00-04:00,82.9,83.3499,82.25,83.33,3483284,3660083.75,60.41383439414575,56.87449446306333,NaN,NaN,46.84904692965517,55.30218678961514,-0.008830882568539034,0.5277903314531471,0.5366212140216862,229182614,223710119,60.83182877706405,44.14620732626112,NaN,NaN,15.21531571357024,14.4801925781514
2021-08-17T09:30:00-04:00,82.79,83.13,82.1,82.64,5941469,3751566.1,53.24867248150264,56.19890482068522,NaN,NaN,-0.9314878623737144,45.63376873802227,-0.05048994492780723,0.4735087828619271,0.5239987277897343,223241145,224592715.6,62.38053555757019,45.10924019945708,NaN,NaN,14.057920993859208,14.419868066109657
2021-08-18T09:30:00-04:00,82.45,82.92,81.955,82.01,3041401,3772988.95,47.68745481407501,55.55326877431491,NaN,NaN,-60.765429281916916,22.25252846450487,-0.11893659638448312,0.37532798230913045,0.49426457869361357,220199744,224375518.8,61.733640770748316,45.87894061574014,NaN,NaN,11.436361800903681,13.993652885365947
2021-08-19T09:30:00-04:00,81.5,82.39,81.42,82.02,4409939,3880743.65,47.780680684966555,55.03975700936918,NaN,NaN,-130.23090577320917,-14.325288953519527,-0.15947071774862442,0.294926181507833,0.45439689925645743,224609683,224586503.2,62.14431482861097,46.77528795030878,NaN,NaN,9.293597830365933,13.322216448937374
2021-08-20T09:30:00-04:00,82,82.8582,81.83,82.73,4143389,3894286.25,54.042874280346965,55.0604259758618,NaN,NaN,-37.89138015267139,-36.59403122810322,-0.13534910968924596,0.2852105121449,0.42055962183414597,228753072,225197251.6,63.369821927771156,48.09981629782843,NaN,NaN,9.08288416915392,12.716597551825451
2021-08-23T09:30:00-04:00,82.84,84.08,82.84,83.73,3062270,3887908.65,61.11574059681598,55.75657087175674,NaN,NaN,147.6142463026251,-16.44099135350923,-0.053151427063950596,0.3541203380042077,0.4072717650681583,231815342,225723797.2,64.43868211556048,49.80122761195504,NaN,NaN,11.101529953831529,12.485873609254892
2021-08-24T09:30:00-04:00,83.91,84.3271,83.73,84,3132684,3801658.25,62.781271042031634,56.47153323935213,NaN,NaN,195.52031099339803,22.849368417645117,0.014672523897082734,0.4256124199395117,0.410939896042429,234948026,228065173.4,68.79857830833691,52.16209926177677,NaN,NaN,13.279986328061419,12.59931828337011
2021-08-25T09:30:00-04:00,84.03,84.32,83.85,84.13,3835074,3628645.75,63.58992841102548,56.93410514372265,NaN,NaN,193.65969543038938,73.73439336010638,0.060963940148888895,0.4871448212285401,0.4261808810796512,238783100,231781844.6,74.20491296681854,55.04382463928989,NaN,NaN,15.301761589409985,12.985381612804378
2021-08-26T09:30:00-04:00,84.07,84.2,83.4,83.4,3279808,3528071.75,56.20506215450567,56.8691866011989,NaN,NaN,114.57347183950941,122.69526888265008,0.03631036823208639,0.4715688413697592,0.4352584731376728,235503292,233960566.4,76.74831647280087,58.1708767931871,NaN,NaN,14.86496890402232,13.25389408297837
2021-08-27T09:30:00-04:00,83.59,84.86,83.43,84.72,3437150,3549949.35,64.2824617956937,57.46640758296684,NaN,NaN,168.5335037263212,163.9802456584486,0.09922568529416897,0.559290579755384,0.460064894461215,238940442,235998040.4,78.84866352695025,61.47466923960236,NaN,NaN,17.21571871470528,13.819869030367927
2021-08-30T09:30:00-04:00,84.7,85.48,84.415,85.3,2734660,3487266.5,67.14946907201836,58.19466588650995,NaN,NaN,199.9026584359073,174.43792808510506,0.16627813396075652,0.6679125619121606,0.5016344279514041,241675102,237969992.4,80.66872518546988,64.42755815508482,NaN,NaN,20.13428182414109,14.721928000906951
2021-08-31T09:30:00-04:00,85.27,85.81,85.17,85.62,6091008,3548792.65,68.64488612146472,58.95408653393849,NaN,NaN,198.8525407779769,175.10437404202082,0.2154370823149614,0.7709307808451058,0.5554936985301444,247766110,240533609.2,82.74721948260193,67.16215767886982,NaN,NaN,22.971220975187162,15.900398425804124
2021-09-01T09:30:00-04:00,85.76,86.355,85.75,86.05,3723203,3541722.15,70.58275795041635,59.779231195846855,NaN,NaN,196.35423171002068,175.64328129794708,0.2573326563549456,0.8771595189738264,0.6198268626188808,251489313,243074851.8,84.52359995725634,69.69202829340358,NaN,NaN,25.939269058454883,17.33452280189709
2021-09-02T09:30:00-04:00,86.12,86.24,85.32,85.47,3229914,3590150.65,64.768126130967,60.16380142356973,NaN,NaN,142.5153647973718,181.23165988951956,0.22743709923666855,0.9041232366647165,0.676686137428048,248259399,245626073.2,86.07382724529013,71.96519050877501,NaN,NaN,26.579236521624832,18.655196190429624
2021-09-03T09:30:00-04:00,85.34,85.615,85.105,85.47,2798989,3591882.4,64.768126130967,60.4748222619141,NaN,NaN,107.07878852473644,168.94071684920263,0.19060729629722017,0.9149452577995731,0.724337961502353,248259399,247489864.6,87.09112408236534,73.84085445915366,NaN,NaN,27.083657362338748,19.859262072130928
2021-09-07T09:30:00-04:00,85.47,85.83,85.27,85.67,4117488,3679367.35,65.8918337777297,61.3779052116446,NaN,NaN,104.49812040020788,149.85980924206274,0.16369102172355143,0.9289517386567923,0.7652607169332408,252376887,249630221.6,88.16070886046228,75.68229540936025,NaN,NaN,27.827157178110262,20.99753280155655
2021-09-08T09:30:00-04:00,85.52,85.76,84.95,85.23,3808544,3557072.1,61.262488319194496,62.34755046201028,NaN,NaN,78.84688857875064,125.8586788022175,0.10318296046968989,0.8942394175203532,0.7910564570506633,248568343,249790668.2,88.23937470057179,77.57556211863336,NaN,NaN,27.109231510510888,21.870632617121455
2021-09-09T09:30:00-04:00,85.08,85.36,84.675,84.81,4114455,3639916.55,57.136013234993015,63.01578850129789,NaN,NaN,51.53596110899762,96.8950246820129,0.025833329099175684,0.823348118424633,0.7975147893254573,244453888,248383583.2,83.02904703165376,79.06732870456497,NaN,NaN,25.27092688150579,22.35638894060493
2021-09-10T09:30:00-04:00,85.13,85.26,84.215,84.26,5103403,3781635.05,52.17943412805231,62.88268563327684,NaN,NaN,25.244989047546188,73.44094953204777,-0.06637265233325373,0.7145489739088902,0.7809216262421439,239350485,246601800.4,76.84151255751985,80.0295923209756,NaN,NaN,22.163759487324192,22.32887044727911
2021-09-13T09:30:00-04:00,84.82,84.89,84.05,84.47,5291595,3938986.35,53.826482512268214,62.36202434152343,NaN,NaN,15.324286337098142,55.09004909452011,-0.11440401505741149,0.6379166074203795,0.752320622477791,244642080,245878336.6,74.41655649282623,80.74229763363743,NaN,NaN,20.061911426710882,22.005019158626506
2021-09-14T09:30:00-04:00,84.69,84.79,83.6,83.74,5467608,4038202.55,47.6788779833888,61.2832819801918,NaN,NaN,-16.283727547740668,30.9336795049304,-0.19195755327446717,0.512373680884707,0.7043312341591742,239174472,243237853.6,66.20458739032597,80.55701256806523,NaN,NaN,16.279613563846606,21.18710407365795
2021-09-15T09:30:00-04:00,83.72,84.298,83.015,84.15,4996783,3990968.25,51.059699424235035,60.38826562399248,NaN,NaN,-37.916653817480515,7.58097102568416,-0.21075988768132325,0.4408813745575202,0.6516412622388434,244171255,242358436,63.683984525176584,79.8055176793765,NaN,NaN,14.102062783688348,20.174955317948005
2021-09-16T09:30:00-04:00,84.04,84.33,83.465,84.07,3856583,4031727.35,50.37569789193141,59.97188246238004,NaN,NaN,-37.61404040545229,-10.249029277205823,-0.22254274715521927,0.37346282829481936,0.5960055754500386,240314672,241530592.8,61.317317784064464,78.70330348732391,NaN,NaN,12.135242098988588,19.02642485809666
2021-09-17T09:30:00-04:00,83.84,84.03,82.784,83.14,9970610,4309760.9,43.140625179500475,58.46175127550909,NaN,NaN,-101.9861714228729,-35.69526137128963,-0.28304605307556796,0.24219800910557865,0.5252440621811466,230344062,239729308.2,56.4054477797801,77.10021664824033,NaN,NaN,8.042089673379337,17.457234117422757
2021-09-20T09:30:00-04:00,81.92,82.04,80.31,81.33,8942938,4549738.35,33.158959348503274,56.03385772382944,NaN,NaN,-257.737969637474,-90.30771256620407,-0.42642913263358817,-0.0077923536108386315,0.41863677902274954,221401124,235081117,46.13517035105606,74.63353416006792,NaN,NaN,0.3496416075621289,15.01329233029981
2021-09-21T09:30:00-04:00,81.88,82.13,80.93,80.99,6469711,4720110.4,31.67631733501068,53.39324566765414,NaN,NaN,-210.6894053628281,-129.18884812922155,-0.5194593866369487,-0.2306874542734363,0.2887719323635124,214931413,230232505.2,38.30105481785081,71.45880811258569,NaN,NaN,-6.171762552474399,11.986855918474923
2021-09-22T09:30:00-04:00,80.74,81.38,80.59,80.95,6815506,4904251.5,31.497881322234832,50.60146876564118,NaN,NaN,-192.34073953762254,-160.07366527324996,-0.55572341327564,-0.4058823342310376,0.1498410790446024,208115907,223021435.6,30.11154601484718,67.57223283098504,NaN,NaN,-11.254301456923272,8.666690579132323
2021-09-23T09:30:00-04:00,81.31,82.18,81.17,81.78,3989462,4911970.9,39.156724793980594,48.77208295585643,NaN,NaN,-125.90345895715141,-177.7315489835898,-0.49771847455537854,-0.47230701414962084,0.02541146040575773,212105369,217379575,25.514834735533782,63.24659050885959,NaN,NaN,-13.12360805639788,5.55379077405658
2021-09-24T09:30:00-04:00,81.41,82.605,81.3,82.45,4402089,4968084.95,44.54648748506774,47.32768019543506,NaN,NaN,-92.87977614144475,-175.91026992730417,-0.3927447145070073,-0.46551943272800145,-0.0727747182209941,216507458,214612254.2,23.610914213372,58.712289803931505,NaN,NaN,-12.892642445182775,2.9185860284509584
2021-09-27T09:30:00-04:00,82.01,82.68,81.76,82.44,3459668,4969210.85,44.48314975840961,45.79848847976933,NaN,NaN,-74.29523208777084,-139.22172241736354,-0.30633557189766275,-0.4556941830930725,-0.14935861119540977,213047790,212941587.4,22.518444366993236,54.02355662582657,NaN,NaN,-12.731969024105695,0.6827924495142939
2021-09-28T09:30:00-04:00,81.61,81.81,80.31,80.43,8982569,5281606.3,34.01444160566851,43.85219942880319,NaN,NaN,-121.31020662411461,-121.34588266962082,-0.3630292087842807,-0.6031451221757607,-0.24011591339147997,204065221,210768349,21.14768358519231,49.231292974728035,NaN,NaN,-16.336556094379066,-1.7485430567561862
2021-09-29T09:30:00-04:00,80.82,81.29,80.25,80.36,5467137,5250412.75,33.7168428375921,42.17940154327455,NaN,NaN,-114.01628921205163,-105.68099260450666,-0.38181123656367866,-0.7173799590960783,-0.33556872253239967,198598084,208864784.4,19.999309909019104,44.729168894539846,NaN,NaN,-19.172252784019804,-4.237644446365274
2021-09-30T09:30:00-04:00,80.61,80.95,80.1,80.11,10771375,5602821.35,32.61918363450066,40.78224079373515,NaN,NaN,-109.93551279985412,-102.48740337304719,-0.38646337173916046,-0.8186479372063502,-0.43218456546718975,187826709,204009052.4,17.4032091872147,40.4835757966609,NaN,NaN,-21.78324339610609,-6.744158582042534
2021-10-01T09:30:00-04:00,80.53,81.825,80.17,81.46,7308687,5806760,43.34514434919154,40.033573782086826,NaN,NaN,-71.45853271161377,-98.203154687081,-0.2790262010528687,-0.7809673167832756,-0.5019411157304069,195135396,199734640,15.496257276109176,36.27498299546682,NaN,NaN,-20.452062723574706,-8.702430602261416
2021-10-04T09:30:00-04:00,80.9,80.95,79.081,79.7,9449006,6139260.85,35.42738030020085,39.15846680471626,NaN,NaN,-110.98481411744514,-105.54107109301586,-0.3048026363215486,-0.8829444111323426,-0.578141774810794,185686390,194262360,13.462444790172668,32.50768709545588,NaN,NaN,-22.190453050705404,-10.629290952039128
2021-10-05T09:30:00-04:00,79.98,81.32,79.91,80.89,3316137,6099193.3,43.007850055124464,38.58333470692264,NaN,NaN,-73.04429305480807,-95.88788837915453,-0.22376672057053626,-0.8578501755239643,-0.634083454953428,189002527,191249821.2,12.490559507666703,28.851013879919453,NaN,NaN,-20.74240571964735,-12.074021633126016
2021-10-06T09:30:00-04:00,80.08,81.09,79.73,81.03,6600119,6238772.05,43.84310026711427,38.11672059086428,NaN,NaN,-72.11577577089045,-87.5077856909223,-0.14652946649768972,-0.8172452880755401,-0.6707158215778504,195602646,190650733.6,12.300385069197034,25.349804400286065,NaN,NaN,-19.36463396633534,-13.115537680727348
2021-10-07T09:30:00-04:00,81.72,82.145,81.32,81.38,4263949,6246246.75,45.974783938805295,38.319160502243186,NaN,NaN,-19.48557317299362,-69.4177977655502,-0.061986364763692015,-0.7481987775324654,-0.6862124127687734,199866595,193058710.8,17.722843684551577,22.586761250626886,NaN,NaN,-17.56780214910375,-13.751575461923977
2021-10-08T09:30:00-04:00,81.53,81.64,80.88,80.98,2732586,6127705.9,43.92274435984864,39.08800228876786,NaN,NaN,-38.26850443524868,-62.779792110277185,-0.025017956746621772,-0.7174848587020506,-0.6924669019554288,197134009,193458433.4,18.62233054629486,20.62155840742966,NaN,NaN,-16.76416233478222,-14.18194501518944
2021-10-11T09:30:00-04:00,80.64,80.95,79.73,79.76,3590064,6042629.35,38.30675898579432,39.56160526382383,NaN,NaN,-96.12492336733929,-59.80781396025602,-0.07207985345844337,-0.782566718778483,-0.7104868653200397,193543945,195029944.4,22.222420715582416,19.473084542981923,NaN,NaN,-17.9203441509587,-14.716002034585049
2021-10-12T09:30:00-04:00,79.77,79.8393,78.74,79.02,7990704,6168784.15,35.353977218309836,39.837040684972045,NaN,NaN,-154.20075209333592,-76.03910576796159,-0.13854649164630595,-0.8836699798779222,-0.7451234882316162,185553241,194340087.2,21.76718445500981,18.877058717279255,NaN,NaN,-19.853756706949106,-15.449966987779915
2021-10-13T09:30:00-04:00,79.52,79.65,78.9,79.39,4693758,6153632.9,37.930243051092184,39.7494348461943,NaN,NaN,-141.25108163750218,-89.86616694128392,-0.14253797253718137,-0.9232959539030929,-0.7807579813659116,190246999,193268957.8,21.046263086142133,18.557875028036992,NaN,NaN,-20.591207237568103,-16.1844298806068
2021-10-14T09:30:00-04:00,80.13,80.64,79.96,80.51,3614662,6141536.85,45.066741938277524,39.78659587856642,NaN,NaN,-52.543497255197785,-96.47775175772476,-0.05897387442018742,-0.8544753243911458,-0.7955014499709584,193861661,192067971,20.236958753640707,18.316878209484766,NaN,NaN,-18.882253211942306,-16.56983321365473
2021-10-15T09:30:00-04:00,80.78,80.8,80.2,80.32,3100385,5798025.6,44.1395841380554,39.762055477112554,NaN,NaN,-38.635901490698146,-96.55123116881467,-0.00837892993307432,-0.8059751123873014,-0.797596182454227,190761276,190793424.4,19.385025791988582,18.093062596984435,NaN,NaN,-17.811843639061117,-16.74726327442707
2021-10-18T09:30:00-04:00,80.22,80.96,80.06,80.94,2975407,5499649.05,47.90583583502646,40.75429792206669,NaN,NaN,-13.634212342837975,-80.0530889639144,0.07061072215177455,-0.7093327797645088,-0.7799435019162834,193736683,190831972,19.49541004568175,17.97504305844797,NaN,NaN,-15.74141892188862,-16.603571224064435
2021-10-19T09:30:00-04:00,81.36,81.73,81.16,81.72,2460257,5299176.35,52.26616338244178,42.07924938955596,NaN,NaN,78.94682382869557,-33.423573779508104,0.17330674886746167,-0.5633100658319563,-0.736616814699418,196196940,192960711.8,25.557498697620645,18.372056543348076,NaN,NaN,-12.600118479950059,-16.031649403476667
2021-10-20T09:30:00-04:00,81.91,82.11,81.6,81.88,2934606,5105131.35,53.13274529227988,43.54450379368304,NaN,NaN,100.93301589659676,15.013245727311684,0.24551602381142257,-0.4297217849351398,-0.6752378087465624,199131546,194737621.2,30.277091443008715,19.291619561619083,NaN,NaN,-9.806261570975511,-15.14230828454793
2021-10-21T09:30:00-04:00,81.85,82.16,81.56,82.12,2681176,5039717.05,54.46803533075465,44.33899600665184,NaN,NaN,105.91666199585622,46.70527757752249,0.29937729628302645,-0.3010161883927793,-0.6003934846758058,201812722,196327833.4,34.292005553498896,20.634173010004066,NaN,NaN,-7.109054155397384,-13.994700551812137
2021-10-22T09:30:00-04:00,80.88,81.2,79.98,80.38,3130971,4976161.15,44.55652017404484,44.99107742621213,NaN,NaN,-26.051738123932783,49.22211025087556,0.21187358358531594,-0.3355515051941609,-0.5474250887794768,198681751,197911928.4,38.1149445931588,22.395065853074502,NaN,NaN,-7.69784372985404,-13.095149577246694
2021-10-25T09:30:00-04:00,80.14,80.73,79.69,80.73,3225245,4964440,46.65914501493554,45.251884209055774,NaN,NaN,-34.98279518021387,44.95239368340039,0.17324814071531602,-0.3308649128853318,-0.5041130536006478,201906996,199545991,41.871911365836105,24.493733842943747,NaN,NaN,-7.523759330712841,-12.299236684884715
2021-10-26T09:30:00-04:00,81.07,81.17,79.63,80.01,6559480,4843285.55,43.042868335548505,45.1947247853725,NaN,NaN,-44.965831269654885,20.169862663730292,0.09860369214255804,-0.38085843842245026,-0.4794621305650083,195347516,199376106.2,41.58922625981581,26.585793927987943,NaN,NaN,-8.50400970913001,-11.757061402634042
2021-10-27T09:30:00-04:00,79.89,80.61,79.685,79.79,5845362,4862196.8,41.972424708972824,44.90884198324161,NaN,NaN,-67.52204148607277,-13.521148812803611,0.036980308086649594,-0.4332367454566963,-0.4702170535433459,189502154,197450227.8,38.42240394052116,28.064333946271486,NaN,NaN,-9.620484473399147,-11.451836127029058
2021-10-28T09:30:00-04:00,79.85,80.52,79.35,80.05,3589067,4503081.4,43.75274952051386,44.8966994947177,NaN,NaN,-69.26066174954421,-48.556613561883694,0.017296867659998105,-0.4485959689683483,-0.4658928366283464,193091221,195705927.6,35.766021838027385,29.288883324252378,NaN,NaN,-10.031924756092515,-11.248991645466694
2021-10-29T09:30:00-04:00,79.87,80.44,79.76,80.3,2845097,4279901.9,45.484696524320846,45.40940931889816,NaN,NaN,-43.25743371387108,-51.99775267987136,0.024254810162577967,-0.43557432392512396,-0.45982913408770193,195936318,195156841,34.94695443242023,30.197778589740796,NaN,NaN,-9.889993449197071,-11.054849045999605
2021-11-01T09:30:00-04:00,80.58,81.06,80.205,80.43,4124601,4013681.65,46.40878788065883,46.1990386519231,NaN,NaN,-1.097117139780041,-45.22061707178459,0.039832907235668846,-0.41003800004311586,-0.4498709072787847,200060919,194787625.6,34.37687025591504,31.098470432662598,NaN,NaN,-9.521074913129379,-10.835738455589572
2021-11-02T09:30:00-04:00,80.64,80.775,79.975,80.44,3982100,4046979.8,46.48393666578205,46.81001676725809,NaN,NaN,-19.643563443475244,-40.156163506548666,0.05224841369218214,-0.38456039016355703,-0.43680880385573917,204043019,196526726.2,39.39207480838736,32.408885555680115,NaN,NaN,-9.194556308974718,-10.601283863216022
2021-11-03T09:30:00-04:00,80,80.76,79.76,80.73,2834110,3858679.35,48.729268724250524,47.07162582339902,NaN,NaN,-15.969133162570953,-29.845581841848304,0.07978068942105576,-0.33708294207941947,-0.41686363150047523,206877129,200001721.2,47.95166065210238,34.388507119855944,NaN,NaN,-8.328827746727688,-10.27664727514626
2021-11-04T09:30:00-04:00,80.98,81.42,80.68,81.05,6281938,3959578.8,51.16411818876441,47.57337825559252,NaN,NaN,68.70799281414374,-2.2518509291107174,0.11707726946608477,-0.2705170446678693,-0.38759431413395407,213159067,204015290.4,55.72858680194531,36.98447576342429,NaN,NaN,-6.936551444475391,-9.799490727907564
2021-11-05T09:30:00-04:00,81.76,82.35,81.61,81.7,3237476,3984823.3,55.75997059222806,48.134387881106925,NaN,NaN,158.16497738559886,38.03263129078327,0.17933176421526414,-0.1634296088648739,-0.34276137308013804,216396543,208107335.4,61.968010412014564,40.018232932448065,NaN,NaN,-4.411919058927488,-9.029837632338982
2021-11-08T09:30:00-05:00,82.11,82.11,81.26,81.34,3171712,3963905.7,52.796465255900536,48.17226658635398,NaN,NaN,102.76669785974545,58.80539429068837,0.1891013390788326,-0.10638469923159732,-0.2954860383104299,213224831,210740117.8,65.35149949291129,42.860661560683106,NaN,NaN,-3.0181399800094377,-8.17102368200619
2021-11-09T09:30:00-05:00,81.52,81.67,80.75,81.14,3921034,3760422.2,51.169397425342495,48.032027453001305,NaN,NaN,51.50318744808183,73.03474446899978,0.17524207170996609,-0.0764334486729723,-0.2516755203829384,209303797,211792273.4,66.62920842440629,45.457241345068645,NaN,NaN,-2.263024111147282,-7.32702374331206
2021-11-10T09:30:00-05:00,80.73,81.02,79.91,80.22,4074378,3729453.2,44.39220192876959,47.31232506714523,NaN,NaN,-47.4511444451089,66.7383422124922,0.10095109941541355,-0.12548664611367144,-0.226437745529085,205229419,211462731.4,65.81063237080735,47.708571832019246,NaN,NaN,-3.5158807682402364,-6.7825747468732285
2021-11-11T09:30:00-05:00,80.23,80.52,80.015,80.06,2046923,3651066.25,43.31766441494403,47.223835370066595,NaN,NaN,-67.80679841741488,39.435383966180474,0.04094849728335431,-0.1752521239248921,-0.2162006212082464,203182496,209467417.2,60.92963928359098,49.338192881335836,NaN,NaN,-4.862910013499286,-6.508336927819808
2021-11-12T09:30:00-05:00,80.46,81.3,80.16,81.23,3240215,3658057.75,52.39253629168149,47.63336331840559,NaN,NaN,12.19633612106466,10.241655713273634,0.0778311672799433,-0.11891166210831727,-0.19674282938826057,206422711,207472650.8,56.42414397271408,50.377638067541405,NaN,NaN,-3.348884621843869,-6.0569865983946745
2021-11-15T09:30:00-05:00,81.46,81.91,81.25,81.46,2319256,3625250.2,53.95323317973507,48.41267509299034,NaN,NaN,78.86534396370266,5.461384934065073,0.11334020139771955,-0.05506757764111114,-0.1684077790388307,208741967,206576078,54.47436964964932,51.298005452529516,NaN,NaN,-1.6376639392027652,-5.4256547899386875
2021-11-16T09:30:00-05:00,81.29,81.44,80.8,80.85,2383216,3621398.15,49.33393537152301,48.9384972831725,NaN,NaN,25.546063083132893,0.2699600610752796,0.0922616620618674,-0.05308070146149646,-0.14534236352336385,206358751,205987068.8,53.17437091123482,52.35171737900906,NaN,NaN,-1.5535037862580812,-4.872490360841458
2021-11-17T09:30:00-05:00,80.84,81.02,80.4433,80.54,7330265,3841181.1,47.12576080252805,49.17942666045923,NaN,NaN,-11.29951293655581,7.500286362785891,0.05575511598622865,-0.07564846854057805,-0.1314035845268067,199028486,204746882.2,50.444666556150814,53.40019200173216,NaN,NaN,-2.1424743606470633,-4.482488075099401
2021-11-18T09:30:00-05:00,80.35,80.37,79.63,79.96,3335907,3873917.65,43.227270648628526,49.01818195505263,NaN,NaN,-97.37184328460125,1.5872773893486278,-0.005865518772464967,-0.13873548299238792,-0.13286996421992295,195692579,203248898.8,47.287045007650185,54.28162704282001,NaN,NaN,-3.8382200478923023,-4.3904497854983875
2021-11-19T09:30:00-05:00,80.29,80.48,79.57,79.69,6857667,4060252.45,41.505922975144905,48.6679773189445,NaN,NaN,-98.41615775220107,-20.535221385304517,-0.06020007779239761,-0.20812006146041995,-0.14791998366802234,188834912,199731339,40.82474039766313,54.74218919580202,NaN,NaN,-5.760895122714197,-4.5862276908149315
2021-11-22T09:30:00-05:00,79.8,80,78.71,78.72,4517686,4124874.5,35.96498466920171,47.916623604903045,NaN,NaN,-177.91130962019358,-71.89055210208377,-0.151654714844434,-0.33748837722356484,-0.18583366237913085,184317226,194846390.8,33.896760731848985,54.349666761763565,NaN,NaN,-9.27081808340419,-5.255454889756254
2021-11-23T09:30:00-05:00,78.57,78.93,77.95,78.51,5081021,4050951.55,34.87937385053769,46.927345399637844,NaN,NaN,-218.41474736009297,-120.68271419072894,-0.21273421820255362,-0.45175143513232285,-0.23901721692976924,179236205,189421881.6,28.17825634163232,52.93728073958713,NaN,NaN,-12.462299840802006,-6.285004168477076
2021-11-24T09:30:00-05:00,78.3,78.725,77.9,78.62,4243342,3970850.55,35.969654248105925,45.84202654673367,NaN,NaN,-191.367593058766,-156.69633021517097,-0.2306667709936715,-0.5273506806718586,-0.29668390967818714,183479547,186312093.8,25.52020476081651,50.77953916522079,NaN,NaN,-14.753508693308673,-7.494790529167304
2021-11-26T09:30:00-05:00,77.86,77.865,77.11,77.18,4963010,4039547.7,29.10086713249646,43.93780487103856,NaN,NaN,-227.52933791651043,-182.72782914155283,-0.31900723970248324,-0.6954429593062912,-0.37643571960380795,178516537,182876885.4,22.945359299566846,47.99220694290309,NaN,NaN,-19.237188015632672,-9.172275884376642
2021-11-29T09:30:00-05:00,78.05,78.2,77.375,77.84,6518660,4223225.85,35.207922089903136,42.6814803591816,NaN,NaN,-157.52396701762882,-194.54939099463837,-0.3121028966901779,-0.7665643404665303,-0.45446144377635245,185035197,182116942.4,22.406768592156865,44.92472616427778,NaN,NaN,-21.009951230298867,-10.863372362365531
2021-11-30T09:30:00-05:00,77.53,77.53,75.285,75.37,10423911,4538191.35,26.134939076373016,40.89330476282663,NaN,NaN,-209.9329799298017,-200.95372505656,-0.4449008300750964,-1.010587481370223,-0.5656866512951265,174611286,180175754.4,21.047704337151927,41.668904443759615,NaN,NaN,-26.313674689679456,-13.070558409124663
2021-12-01T09:30:00-05:00,76.45,76.66,73.59,73.63,9392412,4808706.95,21.861095662356902,39.283940029511434,NaN,NaN,-214.9878556733714,-200.26834671921566,-0.6106990431439251,-1.329060455225033,-0.7183614120811078,165218874,177372288.2,19.233327099839627,38.34195406726193,NaN,NaN,-32.52836436644459,-15.850244974456082
2021-12-02T09:30:00-05:00,73.91,75.175,73.76,74.87,7579154,5045959.15,30.57423944381607,38.37369538871659,NaN,NaN,-173.36872006797847,-196.66857212105816,-0.5969212310716563,-1.4645129509206782,-0.867591719849022,172798028,175235984.4,17.962621496855576,35.2728813682094,NaN,NaN,-33.91143803153114,-18.43041541118109
2021-12-03T09:30:00-05:00,75.23,75.36,73.73,74.7,8986863,5181205.4,30.07903629140388,36.77987396012533,NaN,NaN,-146.00086871830317,-180.3628782814167,-0.5599333028348115,-1.5675083483925363,-1.0075750455577248,163811165,172294910,16.360098997078893,32.41116386994974,NaN,NaN,-35.10329068527566,-20.81225473605174
2021-12-06T09:30:00-05:00,75.12,76.115,74.83,75.93,7739219,5406292.55,37.914405342294515,35.634243400308144,NaN,NaN,-98.88643770919849,-168.63537241973063,-0.4197157611537512,-1.532219746999914,-1.1125039858461627,171550384,169597947.4,15.035439826564811,29.594097454015134,NaN,NaN,-33.18266931494465,-22.579456818750728
2021-12-07T09:30:00-05:00,76.73,77.08,76.48,76.71,4549221,5475168,42.32798860779935,35.13381863147074,NaN,NaN,-56.061577372963825,-137.86109190836305,-0.24990766448773738,-1.4248885664558344,-1.174980901968097,176099605,169895611.2,15.84534125965456,26.92773819318797,NaN,NaN,-30.07010123006473,-23.649548877509872
2021-12-08T09:30:00-05:00,76.92,77.465,76.645,77.27,9484401,5753336.35,45.332722612402556,35.005744475033204,NaN,NaN,-38.264865648993286,-102.51649390348743,-0.08392469816468617,-1.2798867746739546,-1.1959620765092684,185584006,173968637.6,26.21026667645731,25.19670963035272,NaN,NaN,-26.573110483368424,-24.067200535489665
2021-12-09T09:30:00-05:00,77.05,77.495,76.48,76.66,4065804,5752907.65,42.721669868926455,34.96963013362592,NaN,NaN,-41.506256160132445,-76.14400112191822,-0.003515736107322809,-1.200356746643422,-1.1968410105360991,181518202,175712672.4,30.17592950047792,23.974487094126125,NaN,NaN,-24.61291841454759,-24.14516023249794
2021-12-10T09:30:00-05:00,77.13,77.28,76.12,76.7,4255379,5863330.45,42.95370094589037,35.07304284582202,NaN,NaN,-42.811647998589144,-55.50615697797542,0.060531421814933095,-1.1211767332674327,-1.1817081550823658,185773581,180105155.6,39.059106376417525,23.848370378322873,NaN,NaN,-23.011709758146065,-23.983238736161958
2021-12-13T09:30:00-05:00,76.61,76.95,76.065,76.3,4980811,5950360.25,41.15815552841849,35.44398362148036,NaN,NaN,-46.87996110222305,-45.10486165658034,0.08274812460058789,-1.078272999331631,-1.1610211239322188,180792770,181953632.8,42.38123009043021,24.45440390393582,NaN,NaN,-22.22765586796776,-23.732441183562788
2021-12-14T09:30:00-05:00,75.43,76.24,75.33,76.1,7010607,6184927.8,40.2521321924326,35.827752074472855,NaN,NaN,-62.44563759605976,-46.381673701199524,0.09015660527516323,-1.0483253673382649,-1.138481972613428,173782163,181490144.4,41.766416230082484,25.424986753110833,NaN,NaN,-21.845952594298783,-23.46294281366793
2021-12-15T09:30:00-05:00,75.92,76.985,74.9134,76.9,6693162,6400425.1,45.427073169165766,36.5032819974057,NaN,NaN,-41.606400376224336,-47.049980646645736,0.1515073930919879,-0.9490977312484432,-1.1006051243404311,180475325,180468408.2,40.37589739845747,26.48610765579947,NaN,NaN,-19.981039691248224,-22.965528081893687
2021-12-16T09:30:00-05:00,77.08,77.69,76.55,76.79,7365334,6402178.55,44.851831218843834,37.628350860716225,NaN,NaN,1.3737227186083012,-38.47398487089758,0.1850326742449837,-0.8693142815342014,-1.0543469557791851,173109991,178786766,38.126060205874225,27.57044343482143,NaN,NaN,-18.61692507371946,-22.34429908072594
2021-12-17T09:30:00-05:00,76.29,77.075,75.82,76.48,9932351,6732000.75,43.19189373661929,38.198634549767384,NaN,NaN,-21.45379373607766,-34.2024140183953,0.18617475659838534,-0.8216285100312035,-1.0078032666295889,163177640,174267577.8,32.831486859373896,28.315066168194075,NaN,NaN,-17.91871161766671,-21.712072300288906
2021-12-20T09:30:00-05:00,75.56,75.84,75.08,75.79,4487127,6613473.75,39.67246021690951,39.165600345519984,NaN,NaN,-69.62995297254952,-38.7524123924606,0.14228476528656575,-0.8299473100213817,-0.9722320753079474,158690513,169847126.4,28.6416429660634,28.857490355973464,NaN,NaN,-18.296299514761355,-21.224104759499255
2021-12-21T09:30:00-05:00,76.15,77.325,75.98,77.23,5198177,6647498.3,49.01038438582918,41.104835254339434,NaN,NaN,28.522918454052384,-20.55870118243817,0.20807765665726163,-0.7121350044863703,-0.920212661143632,163888690,167868431.8,26.981771055690302,29.410950638534224,NaN,NaN,-15.754191095990775,-20.442688521855185
2021-12-22T09:30:00-05:00,77.06,77.63,76.9,77.42,3266966,6556795.55,50.10773087035986,42.500084641949705,NaN,NaN,73.80851013699915,2.5242809202065315,0.25892235105817063,-0.5965597223209187,-0.8554820733790893,167155656,165204498,24.890369904639144,29.90578981051877,NaN,NaN,-13.365166742715084,-19.43161398197803
2021-12-23T09:30:00-05:00,77.52,78.37,77.48,78.11,2383458,6463801.35,53.981014103336335,44.20736877137345,NaN,NaN,133.45474411656002,28.94048519979687,0.3290511377919042,-0.44416815113920904,-0.7732192889311132,169539114,164490322.6,24.345550421968582,30.47617919801089,NaN,NaN,-10.135196104454549,-18.10355428518896
2021-12-27T09:30:00-05:00,78.35,79.045,78.34,78.87,2667643,6349033,57.86140302367053,45.63215432004317,NaN,NaN,178.85875454264567,69.00299485554153,0.4113078154860065,-0.2590845195736051,-0.6703923350596116,172206757,166296146,28.601212988966367,31.445162995325287,NaN,NaN,-6.149980998687604,-16.39590095854591
2021-12-28T09:30:00-05:00,78.96,79.545,78.715,78.83,3214722,6183836.1,57.586178232218316,46.722025007501664,NaN,NaN,182.70950726499433,119.47088690305031,0.44486240454569514,-0.11431432937749264,-0.5591767339231878,168992035,168356450.4,33.21693707363151,32.68599126775221,NaN,NaN,-3.019112157820365,-14.48493112987083
2021-12-29T09:30:00-05:00,78.87,79.07,78.1929,78.44,3775702,5851425.65,54.846876993700214,47.40160746330864,NaN,NaN,130.35932899001605,139.83816901024304,0.4227823672181841,-0.030698774900457693,-0.45348114211864177,165216333,168621979,33.810819683218654,33.22888791109231,NaN,NaN,-1.1340492451398123,-12.57766228919497
2021-12-30T09:30:00-05:00,78.63,79.19,78.61,78.77,4483541,5605982.1,56.72279874928553,48.40168809762,NaN,NaN,136.25179801974065,152.32682658679136,0.41197420734899415,0.061486617067600946,-0.3504875902813932,169699874,169130822.6,35.00365611967179,33.57372552674901,NaN,NaN,0.9907602095311515,-10.639316217948382
2021-12-31T09:30:00-05:00,78.57,78.87,77.655,77.68,5689093,5511479.05,49.419449471053994,48.86352727798884,NaN,NaN,73.08021786711731,140.2519213369028,0.31723756832465455,0.04605937012442496,-0.2711781982002296,164010781,168025156,33.5872340285008,33.18287750189781,NaN,NaN,0.7590925605905521,-9.010972106728534
2022-01-03T09:30:00-05:00,77.86,78.51,77.8,78.22,11984807,5661376.25,52.67067205376839,49.68584988694239,NaN,NaN,70.95382954990573,118.67093633835482,0.2781621791272507,0.07652452570883383,-0.20163765341841688,175995588,168782922.2,35.51318803999796,32.69230306972408,NaN,NaN,1.5275951273644366,-7.50546250185811
2022-01-04T09:30:00-05:00,78.53,78.73,77.62,78.05,11729065,5860868.55,51.547337206300114,50.49265024507579,NaN,NaN,59.72601699774654,94.07423828490525,0.23007805027132297,0.08595990942073684,-0.14411814085058613,164266523,167837819.8,34.18176181270927,32.15054203991171,NaN,NaN,1.8354297147165157,-6.171049328061735
2022-01-05T09:30:00-05:00,78.06,78.44,76.07,76.09,19325639,6599689.45,40.7550472290302,50.15893410649468,NaN,NaN,-36.39392288070123,60.72358791076179,0.06411005476541554,-0.06398057239381671,-0.12809062715923225,144940884,163782730,29.13464386524373,31.347595358967872,NaN,NaN,-1.46528067197319,-5.498796662906229
2022-01-06T09:30:00-05:00,76.13,77.38,75.89,76.43,14641289,6857533.85,42.9850413240688,50.02559197115361,NaN,NaN,-55.59333116041422,22.35456207473081,-0.02041044099548167,-0.15360367840358435,-0.13319323740810268,159582173,161759189.8,26.99277632041742,30.552360795720954,NaN,NaN,-3.4141931088853683,-5.200996155188963
2022-01-07T09:30:00-05:00,76.43,76.96,76.15,76.44,7882807,7048384,43.05293502256932,50.01566634872147,NaN,NaN,-56.938722641166095,-3.6492260269258763,-0.07046382730139106,-0.22127302153484152,-0.15080919423345046,167464980,162450029.6,28.914169025616445,30.272552379023995,NaN,NaN,-4.936838360451327,-5.163259327369301
2022-01-10T09:30:00-05:00,75.71,75.98,74.23,75.96,9446086,7307919.35,40.55646330680949,50.07880942657146,NaN,NaN,-125.91170908282736,-43.0223337534725,-0.12740006987520114,-0.3100592815774519,-0.18265921170225075,158018894,158854690.8,25.197492356705652,30.026541621212726,NaN,NaN,-6.9724932606749075,-5.42172131784153
2022-01-11T09:30:00-05:00,75.89,76.92,75.49,76.91,6813372,7399547.4,47.095095016868896,49.9420030430743,NaN,NaN,-54.275041059166156,-65.82254536485505,-0.094116031707353,-0.300304251336442,-0.206188219629089,164832266,158967839.4,25.521956248766074,29.922269135003855,NaN,NaN,-6.778740254813025,-5.6155811659803145
2022-01-12T09:30:00-05:00,77.19,77.44,76.63,77.01,5666206,7332327.35,47.746659456458836,49.77335508493851,NaN,NaN,-19.120287700242688,-62.36781832876333,-0.06005897847898764,-0.28126194272782357,-0.22120296424883593,170498472,164079357,38.50003595755447,30.89438813878352,NaN,NaN,-6.431675992073884,-5.732166141136538
2022-01-13T09:30:00-05:00,77.2,77.37,76.075,76.21,6354091,7315373.8,43.166477648490755,49.000888195306686,NaN,NaN,-55.118214213623624,-62.27279493940521,-0.08460175226859643,-0.32695515458458146,-0.24235340231598504,164144381,164991798.6,40.49340263595075,32.04780615406796,NaN,NaN,-7.507653699001302,-5.9858072208315045
2022-01-14T09:30:00-05:00,75.54,76.62,75.535,76.56,6608785,7277546.35,45.62406630335243,48.12679271528397,NaN,NaN,-72.42665445425429,-65.37038130202284,-0.07100405171178142,-0.33110846695571183,-0.2601044152439304,170753166,165649435.8,41.95373788618239,33.001557932440534,NaN,NaN,-7.6827931874347195,-6.228233787489106
2022-01-18T09:30:00-05:00,76.5,76.62,75.475,75.63,5902992,7076078.4,40.60025859657849,46.9135127413097,NaN,NaN,-91.3218953153341,-58.45241854852419,-0.11573823176086051,-0.404777204945006,-0.2890389731841455,164850174,167015691.8,44.97493070010651,33.84141462004589,NaN,NaN,-9.387494483334306,-6.679556744038421
2022-01-19T09:30:00-05:00,75.85,76.669,75.451,75.5,6647004,7184072.25,39.93823574377646,45.84860979488657,NaN,NaN,-96.11031079930554,-66.81947249655207,-0.14337074296373864,-0.4682524018888188,-0.32488165892508014,158203170,165689872.6,42.654817485801196,34.473128748801784,NaN,NaN,-10.96481301591234,-7.29173621144898
2022-01-20T09:30:00-05:00,75.94,76.83,74.665,74.75,7335372,7290932,36.26434210453826,44.38729146311891,NaN,NaN,-115.27149773972815,-86.04971450444916,-0.19807589819318927,-0.5724765316665668,-0.3744006334733775,150867798,161763737.8,36.6288409387606,34.589213378736694,NaN,NaN,-13.461985366661738,-8.173200376479373
2022-01-21T09:30:00-05:00,73.78,74.195,72.19,72.22,14330921,7844129.75,27.18097799921938,42.79882921513073,NaN,NaN,-228.4917827149228,-120.72442820470901,-0.38002591413794057,-0.8494330261458032,-0.4694071120078626,136536877,156242237,30.172979960999072,34.34533808820086,NaN,NaN,-19.299321219962316,-9.76264621126265
2022-01-24T09:30:00-05:00,71.1,72.84,69.48,72.75,18812744,8665594.05,31.075724209886218,41.25633294056771,NaN,NaN,-241.9759619458563,-154.63428970302942,-0.4360442159307655,-1.0144623819213194,-0.578418165990554,155349621,153161528,27.283562509110567,33.75750769313748,NaN,NaN,-22.56561148273497,-11.59164125004441
2022-01-25T09:30:00-05:00,71.54,72.22,70.62,71.26,9180322,8991228,26.744901490579608,39.48473038944483,NaN,NaN,-211.62503443855553,-178.69491752767368,-0.5381122349909574,-1.2510584597292507,-0.7129462247382933,146169299,149425353,24.250545687677473,33.04813511277806,NaN,NaN,-26.96179887619494,-13.787378053780198
2022-01-26T09:30:00-05:00,72.35,72.35,69.51,70.22,12983057,9479644.75,24.208865885353774,38.30286029346793,NaN,NaN,-194.17899360431446,-198.3086540886755,-0.6337483351341086,-1.505131643655929,-0.8713833085218204,133186242,144421967.4,20.89982757909523,32.459933949481744,NaN,NaN,-31.4695360809762,-16.313400629093913
2022-01-27T09:30:00-05:00,70.72,71.75,70.18,70.3,9541540,9767936.65,24.799578101365498,37.00389863470342,NaN,NaN,-156.60059035169724,-206.57447261106933,-0.6474194065807133,-1.680657566747712,-1.0332381601669987,142727782,142793964.2,19.934663289423113,31.955783018696433,NaN,NaN,-34.70525523631957,-18.94080843012615
2022-01-28T09:30:00-05:00,70.47,72.33,70.2,72.31,6249465,9856232.85,37.896378944225106,36.63557320053598,NaN,NaN,-107.49611580291277,-182.3753392286673,-0.48435603485601453,-1.638683203737017,-1.1543271688810024,148977247,145282038.2,25.590291680744286,31.71836320834842,NaN,NaN,-32.913599804879816,-20.93692148366239
2022-01-31T09:30:00-05:00,72.3,74,71.82,73.95,6105893,9877072.85,46.138777764277194,37.03430994749795,NaN,NaN,-49.15778399426985,-143.81170363835002,-0.24157557969588872,-1.4562966435008633,-1.2147210638049746,155083140,145228742,25.54866017710941,31.743446624091547,NaN,NaN,-28.316634125887173,-21.991166146837358
2022-02-01T09:30:00-05:00,74,74.69,73.38,74.59,6284117,9592038.35,48.98429613503408,37.16925288450976,NaN,NaN,-14.31973928345419,-104.35064460732974,-0.024824017855983982,-1.2457510861249546,-1.2209270682689706,161367257,148268333.6,32.31201426888897,32.22845076838604,NaN,NaN,-23.717977807571266,-22.237853526942203
2022-02-02T09:30:00-05:00,76.57,76.57,75.26,76.08,5357318,9273451,54.95132561013174,37.68387189548639,NaN,NaN,46.894497778813424,-56.135946330704165,0.21855225608073292,-0.9477367481680545,-1.1662890042487875,166724575,154976000.2,44.3304565726227,32.64490938374806,NaN,NaN,-17.688293412826106,-21.58791636778276
2022-02-03T09:30:00-05:00,71.7,72.49,70.85,70.99,9281059,8771222,38.419462990788766,37.344799419936244,NaN,NaN,-91.61687488683579,-43.139203237731834,0.04543984459295869,-1.109489198507589,-1.1549290431005477,157443516,157919147,48.63959249452769,33.22678008793212,NaN,NaN,-18.89202299918064,-21.202788743696743
2022-02-04T09:30:00-05:00,70.72,71.755,69.98,71.17,6675822,8372948.65,39.11701875292204,36.88001030919123,NaN,NaN,-94.55265216873043,-40.550510510895364,-0.043429245805615135,-1.2092156003575667,-1.1657863545519516,164119338,160947565.2,52.69701029665384,33.994156688680086,NaN,NaN,-19.459329283839633,-20.953723106574298
2022-02-07T09:30:00-05:00,71.35,71.4,69.755,69.93,4843454,8220981,36.08458683491124,36.557462326214996,NaN,NaN,-101.15455956391676,-50.94986562482476,-0.16535968862697503,-1.3724859653356702,-1.2071262767086952,159275884,161786114,53.78567725028442,34.62349572797851,NaN,NaN,-21.046897361385057,-20.967033714404405
2022-02-08T09:30:00-05:00,69.66,70.145,69.36,69.9,6073936,8052373.5,36.01184990017452,36.277006194529136,NaN,NaN,-105.68304814720175,-69.22252739757427,-0.2240242899503162,-1.4871566391465905,-1.2631323491962743,153201948,160153052.2,51.3090568659642,35.24165568370444,NaN,NaN,-22.24865494458073,-21.15012246157245
2022-02-09T09:30:00-05:00,70.71,71.89,70.64,71.87,6325605,8027985.15,43.995248081339376,36.829213764300654,NaN,NaN,-51.979224548929885,-88.99727186312293,-0.11181386783814129,-1.402899683993951,-1.2910858161558096,159527553,158713647.8,49.16037140024328,36.13676500238177,NaN,NaN,-20.4508322458202,-21.05022385932213
2022-02-10T09:30:00-05:00,70.88,72.105,70.52,70.84,6571635,8073256.6,41.10746471537339,37.8239628154545,NaN,NaN,-56.40468172753027,-81.95483323126182,-0.08958269221249449,-1.4030641814214277,-1.3134814892089333,152955918,157816128.2,47.8157633510559,37.39696381595726,NaN,NaN,-19.99886672640808,-20.90002998319155
2022-02-11T09:30:00-05:00,70.8,71.19,69.06,69.31,7358850,8123494.55,37.20125691775587,38.261500866016625,NaN,NaN,-92.56903132629438,-81.5581090627746,-0.15661881489107188,-1.509255007822773,-1.3526361929317012,145597068,154111674.2,42.63268062660426,38.49332939577824,NaN,NaN,-20.96697918656393,-20.909594155101892
2022-02-14T09:30:00-05:00,69.23,69.76,68.78,69.32,5342638,8060187.2,37.24323170211714,39.01138159541217,NaN,NaN,-107.06005482793766,-82.73920811557879,-0.17745563818996013,-1.5744557406691513,-1.3970001024791912,150939706,152444438.6,40.504642975379085,39.65433634489978,NaN,NaN,-21.696534297568526,-21.02201417545427
2022-02-15T09:30:00-05:00,70.06,70.33,69.7,70.29,4291904,7979632.8,41.33907071688743,40.23496765480743,NaN,NaN,-74.3109423997351,-76.46478696608547,-0.10657392039828895,-1.5302175029770524,-1.4236435825787634,155231610,152850371,41.27326696184928,41.10958201509651,NaN,NaN,-21.019816714751027,-21.021700252496665
2022-02-16T09:30:00-05:00,69.36,69.95,68.95,69.8,4556385,7875101.85,39.921646712057566,41.31511541271401,NaN,NaN,-97.24522535064685,-85.51798712642885,-0.07485142035911752,-1.5172078580276604,-1.442356437668543,150675225,151079905.4,38.91206263456294,42.46511053974935,NaN,NaN,-20.895683505737146,-21.00369786010245
2022-02-17T09:30:00-05:00,69.22,69.36,67.895,67.94,7516684,7884167.45,35.01391023156616,41.10922479038123,NaN,NaN,-148.99535781507097,-104.036122343937,-0.1565957031404257,-1.638101066594075,-1.4815053634536492,143158541,149120430,36.428136455667826,43.23924230938674,NaN,NaN,-22.34291650491638,-21.19501480936158
2022-02-18T09:30:00-05:00,68.14,68.585,67.21,67.41,7513380,7543290.4,33.74105487859765,40.22367315568982,NaN,NaN,-162.67671142591215,-118.05765836386054,-0.21993919063629663,-1.75642935174902,-1.5364901611127233,135645161,147130048.6,34.05043016112597,43.84651159395935,NaN,NaN,-23.91116130389471,-21.583035737152027
2022-02-22T09:30:00-05:00,67.06,67.795,66.25,66.72,8859527,7045629.55,32.104744941390805,39.01799092757245,NaN,NaN,-172.9609342762006,-131.2378342535131,-0.2781383861514659,-1.8841631438020556,-1.6060247576505897,126785634,142299234.2,29.08790787779394,43.6162182803097,NaN,NaN,-25.70876366483475,-22.1724254411067
2022-02-23T09:30:00-05:00,67.16,67.32,65.55,65.6,6548941,6914060.5,29.59580276995375,37.20688215327402,NaN,NaN,-173.12671832041826,-151.00098943764974,-0.3568700029140568,-2.0521122612931606,-1.6952422583791038,120236693,135300250.8,23.698914843753457,42.14253672824761,NaN,NaN,-28.016784231199466,-23.00733383969138
2022-02-24T09:30:00-05:00,64.07,67.58,64.03,67.44,10993424,6814578.85,38.14768774417063,37.18746963565844,NaN,NaN,-141.13357043172732,-159.77865845386583,-0.25463003826259256,-2.0135298062073446,-1.758899767944752,131230117,131411229.2,21.33379413264298,40.192122559541566,NaN,NaN,-27.36523894100443,-23.62989171130753
2022-02-25T09:30:00-05:00,67.58,68.625,67.13,68.53,7187136,6696858.65,42.59603373133883,37.43597070554535,NaN,NaN,-70.77641402584048,-144.13486969601973,-0.09160307477319707,-1.8734036114112484,-1.7818005366380514,138417253,130462971.6,20.789004047868218,37.91297925605688,NaN,NaN,-25.409725844687202,-23.884153730361767
2022-02-28T09:30:00-05:00,67.7,68.87,67.62,68.45,8388765,6803823.65,42.35526604163625,37.88387636316857,NaN,NaN,-57.55046078550304,-123.10961956793793,0.02651997440269116,-1.7486505686346874,-1.7751705430373785,130028488,129339637,20.133101577435767,35.5092238508534,NaN,NaN,-23.92544530467284,-23.89005252669192
2022-03-01T09:30:00-05:00,68.14,68.58,67.21,67.59,6151272,6806092.6,39.75389738511934,38.151165469236055,NaN,NaN,-69.14723054118475,-102.34687882093478,0.060467692429485576,-1.6995859275005216,-1.7600536199300072,123877216,128757953.4,19.78500156501343,33.2575056150712,NaN,NaN,-23.426814394003177,-23.82387565059353
2022-03-02T09:30:00-05:00,67.78,68.44,67.36,68.17,7782522,6881012.85,42.32656984210956,38.031974166433926,NaN,NaN,-55.33544638140331,-78.78862443313179,0.13163596595930072,-1.5955086624808814,-1.7271446284401821,131659738,131042562.4,25.25145724915022,31.54972603285027,NaN,NaN,-22.263263482273416,-23.600931055119226
2022-03-03T09:30:00-05:00,68.66,68.78,67.18,67.46,6528205,6939557.2,40.07078128859358,37.95792535023537,NaN,NaN,-54.918961140399865,-61.5457025748663,0.13977779277957691,-1.552422387465711,-1.692200180245288,125131533,129822845.6,24.299369318316977,29.869983601940344,NaN,NaN,-21.917317664871167,-23.36041485651236
2022-03-04T09:30:00-05:00,67.09,67.38,66.19,66.49,6324990,6791753.75,37.157204829470125,37.95477877250067,NaN,NaN,-98.50846482182881,-67.09211273406396,0.09107788135536987,-1.5783528285510755,-1.6694307099064454,118806543,125900703.6,21.493046755581986,28.360009754010182,NaN,NaN,-22.461724138282463,-23.232030468193802
2022-03-07T09:30:00-05:00,66.39,66.39,64.24,64.28,7726783,6844301.8,31.53181304113761,37.54682029671642,NaN,NaN,-164.42428405618483,-88.46687738820032,-0.07003788861205007,-1.756978070671508,-1.6869401820594578,111079760,122110958,19.187222868258587,26.837336889215862,NaN,NaN,-24.748663758003183,-23.448692366737998
2022-03-08T09:30:00-05:00,64.19,65.81,63.685,64.12,10154054,7109831.8,31.163959649962536,36.82002664907892,NaN,NaN,-164.8737337708641,-107.61217803413619,-0.16218194462281965,-1.8896676128379823,-1.7274856682151627,100925706,117520656,16.831772830726862,25.091515879849972,NaN,NaN,-26.68859404107451,-23.911535463071786
2022-03-09T09:30:00-05:00,65.63,66.255,65.38,66.04,6776030,7144936.5,40.18220687934454,36.83863808959942,NaN,NaN,-93.59199803354117,-115.26348836456376,-0.07315513665421647,-1.8189295890329333,-1.7457744523787169,107701736,112729055.6,14.790633839280787,23.368556680186966,NaN,NaN,-25.592184295457603,-24.151628153412616
2022-03-10T09:30:00-05:00,65.15,65.75,64.845,65.55,5783610,7117836.75,38.78565547262347,37.10804846396065,NaN,NaN,-105.72724871424116,-125.425145879332,-0.02887470783615087,-1.7818678371739054,-1.7529931293377545,101918126,108086374.2,13.129298807589464,21.70435399103851,NaN,NaN,-25.123485868803954,-24.290464969897094
2022-03-11T09:30:00-05:00,65.97,66.05,64.29,64.37,4982589,7038384.45,35.57876165747754,37.239313233880644,NaN,NaN,-113.98543131389148,-128.52053917774455,-0.05893007257108018,-1.8266557200516047,-1.7677256474805245,96935537,103712173,11.786058857520658,20.114041755066697,NaN,NaN,-25.708070469925914,-24.492980041329783
2022-03-14T09:30:00-04:00,64.36,65.05,63.49,63.62,6999104,7020397.15,33.67303899967578,37.35133423804386,NaN,NaN,-136.52928993520536,-122.94154035354866,-0.10642621170052857,-1.9007584121061853,-1.7943322004056568,89936433,99483507.6,10.651535275069762,18.79715799772926,NaN,NaN,-26.774999972129564,-24.818982888586895
2022-03-15T09:30:00-04:00,64.1,64.95,63.75,64.84,6259300,7066230.25,39.36276688141572,38.04897453171971,NaN,NaN,-104.5136319653921,-110.86951999245426,-0.03640069965463688,-1.8398330749739529,-1.803432375319316,96195733,98537513,10.410116778020779,17.847958135891215,NaN,NaN,-25.945262734066922,-24.979880009369754
2022-03-16T09:30:00-04:00,65.4,66.65,64.86,66.63,6621778,7182723.95,46.60070409638518,38.65276141402075,NaN,NaN,-28.11982474896588,-97.7750853355392,0.14007328645579809,-1.6283407672495684,-1.7684140537053665,102817511,97560668,10.154184497834393,17.049414590547748,NaN,NaN,-22.874343845242667,-24.67908912878017
2022-03-17T09:30:00-04:00,66.41,67.35,66.17,67.35,5120694,7210939.4,49.226015530154754,39.12633154250761,NaN,NaN,26.875944657600314,-71.25444666117092,0.3054119002602613,-1.3866491783800399,-1.6920610786403012,107938205,98764683.8,12.993491904194997,16.49259229457109,NaN,NaN,-19.528234611389365,-23.943252769152913
2022-03-18T09:30:00-04:00,67.1,68.31,66.89,68.23,8622240,7266217.2,52.311970175224054,39.83752469490673,NaN,NaN,78.06227053831364,-32.84490629072988,0.46461848579827536,-1.111287971392457,-1.5759064571907324,116560445,102689665.4,21.68237927851405,16.60325498750525,NaN,NaN,-15.770127890901787,-22.775663500831325
2022-03-21T09:30:00-04:00,67.78,67.92,66.74,67.42,6153917,7198244.05,49.339418909021425,40.52220480375688,NaN,NaN,54.26086113736174,5.313123923783539,0.5027249511620477,-0.9475002682381728,-1.4502252194002205,110406528,106783684.4,29.5817839013705,17.303025154387896,NaN,NaN,-13.526559854094932,-21.454362979868982
2022-03-22T09:30:00-04:00,67.52,69.05,67.48,68.68,4462394,6978387.4,53.74272180913539,41.33764422997301,NaN,NaN,103.91005507761153,46.99786133238426,0.5938873556655582,-0.7078660248182729,-1.301753380483831,114868922,110518322.2,35.93028215074425,18.065798361644614,NaN,NaN,-10.223742075899565,-19.849988565016208
2022-03-23T09:30:00-04:00,68.18,68.615,67.735,67.74,5143173,6908099,50.234761047013116,42.063642784145834,NaN,NaN,75.32383476336787,67.68659323485102,0.5717728612612065,-0.5870373039073229,-1.1588101651685294,109725749,111899969.8,38.15178382671816,19.055256540816124,NaN,NaN,-8.516125511900693,-18.23086527171399
2022-03-24T09:30:00-04:00,68.17,68.87,67.93,68.85,4300687,6573462.15,54.04901579694591,43.2702007103941,NaN,NaN,92.10318351592754,80.73204100651645,0.609340904316398,-0.3971340347730319,-1.0064749390894299,114026436,113117616,40.12224489068347,20.38591355046623,NaN,NaN,-5.88163523927774,-16.466689552794527
2022-03-25T09:30:00-04:00,69.03,69.39,68.41,69.18,3860651,6407137.9,55.14960566964933,44.95718589814494,NaN,NaN,108.6989432888257,86.85937555661886,0.6311808377574613,-0.2174988918926033,-0.8486797296500646,117887087,113382944.4,40.566588199843885,21.913011074150894,NaN,NaN,-3.4101211631100803,-14.601465497125321
2022-03-28T09:30:00-04:00,69.1,69.41,68.4,69.4,2914362,6133417.75,55.90780919072146,46.724603722484865,NaN,NaN,107.91016875368227,97.58923707988296,0.6335592795727785,-0.056730630184091524,-0.69028990975687,120801449,115461928.6,44.0689290105667,23.85852222985374,NaN,NaN,-1.1659384127781507,-12.682104485075726
2022-03-29T09:30:00-04:00,69.98,70.81,69.82,70.61,6935132,6172610.75,59.92094936800103,48.13451390024604,NaN,NaN,152.47579107337398,107.30238427903546,0.6853504310441503,0.16639812904831786,-0.5189523019958324,127736581,118035460.4,48.14273536626789,26.240815196067103,NaN,NaN,1.9964539645672852,-10.585167563698153
2022-03-30T09:30:00-04:00,70.33,70.61,69.85,70.11,4664587,6016714,57.5884199389856,49.477568504986195,NaN,NaN,128.97183553447974,118.03198443325782,0.6547072765110279,0.29943179364295247,-0.3552754828680754,123071994,120704709.4,52.04424108014646,29.020453929821173,NaN,NaN,3.9859510129087,-8.50357919561146
2022-03-31T09:30:00-04:00,70.1,70.1,68.7625,68.78,4784858,5929546.65,51.81096642835901,50.6370117029063,NaN,NaN,82.73080589572596,116.1575089092175,0.519541389502736,0.2941512540103446,-0.22539013549239142,118287136,121556849.4,53.25338869349583,31.98240606096226,NaN,NaN,4.041084701140819,-6.711484353218277
2022-04-01T09:30:00-04:00,69.11,69.33,68.73,69.29,4019004,5814247.35,53.72797061862866,52.06950681854579,NaN,NaN,71.31524950465794,108.68077015238396,0.4421886593742456,0.3273456887254156,-0.11484297064883002,122306140,122440660,54.533830538546944,35.1168557226392,NaN,NaN,4.639403827797136,-5.0899288987875035
2022-04-04T09:30:00-04:00,69.72,71.275,69.72,71.2,5201350,5687975.7,60.12557211959956,53.55256433555893,NaN,NaN,119.84473894779815,111.06768419120712,0.4934639458281537,0.5019869616363621,0.008523015808208412,127507490,123781868.2,56.48188664499662,38.40769642742318,NaN,NaN,7.173405213087161,-3.3380240256625515
2022-04-05T09:30:00-04:00,71.23,71.57,70.12,70.29,3991280,5379837,56.142800373893536,54.23414264109523,NaN,NaN,108.94032313767646,102.36059060406761,0.44158232977697476,0.5605009280294269,0.11891859825245212,123516210,122937794,54.88799223068988,41.60296840834144,NaN,NaN,8.071185494877692,-1.7081369512996596
2022-04-06T09:30:00-04:00,69.52,69.7,68.53,68.98,5011002,5291585.6,50.914262702912,54.35473172486361,NaN,NaN,43.61551923000545,85.28932734317274,0.30123016478106357,0.4954563042287816,0.19422613944771802,118505208,122024436.8,53.14047876530592,44.47061032699222,NaN,NaN,7.1879917208036295,-0.43726142671347534
2022-04-07T09:30:00-04:00,68.87,69.03,67.41,68.38,4387201,5221765.15,48.678193397443096,54.09517624073641,NaN,NaN,6.783305319683911,70.09982722796435,0.1574078429084038,0.39098594308322276,0.23357810017481898,114118007,121190611,51.52759736332772,46.60241161876463,NaN,NaN,5.769695259923243,0.4494466713774845
2022-04-08T09:30:00-04:00,68.24,68.67,67.71,68.08,3827915,5164031.45,47.553629445520464,53.967619850486344,NaN,NaN,-6.35905195726826,54.56496693557911,0.03773643253216946,0.2807486408400308,0.24301220830786135,110290092,118787401.4,47.09131860839722,47.85309266926653,NaN,NaN,4.278488145568646,0.9964525962619362
2022-04-11T09:30:00-04:00,67.63,68.2629,67.11,67.2,5361016,5082127.05,44.319269150018165,53.29451608912082,NaN,NaN,-54.04124512336879,19.78777012134571,-0.09762453529674633,0.12098153918692844,0.21860607448367478,104929076,114271718.6,40.10437623132714,48.15124224645103,NaN,NaN,2.033210706806873,1.1445608977683557
2022-04-12T09:30:00-04:00,67.93,68.19,66.315,66.65,8250336,5181678.85,42.37917875770904,52.73340306845624,NaN,NaN,-99.64995871421898,-21.930286249033376,-0.2144412330495933,-0.04944546682831685,0.16499576622127646,96678740,108904224.6,33.703317832218374,47.83349467541533,NaN,NaN,-0.4229939216700103,0.9206244949914463
2022-04-13T09:30:00-04:00,66.55,67.9,66.45,67.63,6185914,5159885.65,46.844243380446734,52.21877646727773,NaN,NaN,-91.02546087628015,-48.858482270290494,-0.2153812366661857,-0.10423077961145566,0.11115045705473003,102864654,105776113.8,30.63453240737236,47.1558009266074,NaN,NaN,-1.2592736268312916,0.609210477588198
2022-04-14T09:30:00-04:00,67.84,67.84,66.44,66.48,4718695,5139785.7,42.66606179136695,51.327094761686126,NaN,NaN,-118.7761661841974,-73.97037657106675,-0.2790834232860303,-0.23770382205280782,0.04137960123322246,98145959,102581704.2,27.84615088025521,46.247198260922495,NaN,NaN,-3.254987469987488,0.057182199363100095
2022-04-18T09:30:00-04:00,66.44,66.7571,65.68,66.26,6386390,5027993.2,41.89619569288649,50.326265226126495,NaN,NaN,-149.74640545960597,-102.64784727153429,-0.31879784149642065,-0.3571177006373034,-0.038319859140882734,91759569,98875599.6,25.00273601148774,44.88532733241685,NaN,NaN,-5.110882788761165,-0.6811127989403664
2022-04-19T09:30:00-04:00,66.08,67.76,65.94,67.58,4526218,4946608.25,47.96326067826406,49.47214460543099,NaN,NaN,-92.53094526731414,-110.34578730032335,-0.2423894887143786,-0.341306720033856,-0.09891723131947738,96285787,97146941.8,23.782861369785948,43.145336332668144,NaN,NaN,-4.9568091429749845,-1.2919265623738831
2022-04-20T09:30:00-04:00,66.36,66.38,64.34,64.65,9530509,5200014,38.382752138305726,48.100311191096715,NaN,NaN,-179.2108544691142,-126.2579664513024,-0.36787570140778464,-0.5587618580792082,-0.19088615667142356,86755278,95162249.4,22.429786971586395,41.030018182056715,NaN,NaN,-8.077698667290717,-2.2613225773620025
2022-04-21T09:30:00-04:00,64.84,65.25,62.63,62.81,8232068,5354458.75,33.81479975330815,46.81487071430737,NaN,NaN,-211.74417322343587,-150.40170892073354,-0.5429276050695888,-0.8695456630084095,-0.32661805793882076,78523210,90293960.6,19.499272962879118,38.61900991558408,NaN,NaN,-12.35609706797738,-3.703433218878485
2022-04-22T09:30:00-04:00,62.82,62.97,61.21,61.32,9702046,5624526.7,30.635287215331786,45.165393328357595,NaN,NaN,-224.74780020855295,-171.59603572560465,-0.7162961893627957,-1.2219882946423155,-0.5056921052795198,68821164,84429001.6,16.67304657916887,35.914668204199934,NaN,NaN,-17.016304126724975,-5.605271919999412
2022-04-25T09:30:00-04:00,61.2,62.19,60.82,62.16,13360404,6099514.35,34.38121668954878,43.32651079763968,NaN,NaN,-188.4369380218191,-179.3341422380473,-0.7291936934178709,-1.4171842220518585,-0.6879905286339876,82181568,82513401.4,15.864261794975647,33.01340928634129,NaN,NaN,-19.47846625015632,-7.587156824307542
2022-04-26T09:30:00-04:00,61.74,61.74,60.09,60.12,9913139,6449453.2,30.126202953494285,41.46818241046831,NaN,NaN,-183.26453015509148,-197.48085921560275,-0.8229678166133239,-1.7167002994006424,-0.8937324827873185,72268429,77709929.8,14.026824941965018,30.09475448000381,NaN,NaN,-23.083850676121607,-9.80097023170955
2022-04-27T09:30:00-04:00,59.26,59.92,58.43,58.78,17372401,6971316.65,27.70106984112816,39.81009720605517,NaN,NaN,-182.45060336581022,-198.12880899494195,-0.9159699685574672,-2.0386949434841526,-1.1227249749266854,54896028,71338079.8,12.035462396443947,27.158681882227956,NaN,NaN,-26.87113841263129,-12.239565686126943
2022-04-28T09:30:00-04:00,60.82,61.5113,59.33,61.13,11270863,7301630.45,37.24233008782169,38.9932498267965,NaN,NaN,-121.14045490318391,-180.00806533089158,-0.766038077065978,-2.080272571259158,-1.31423449419318,66166891,68866816,11.361750153247414,24.289692795793645,NaN,NaN,-26.718502432022976,-14.307985221254947
2022-04-29T09:30:00-04:00,60.74,61.48,58.97,59.06,9692787,7547026.9,33.09877634798133,37.96076031982942,NaN,NaN,-119.32854427835413,-158.92421414485182,-0.7520276294091102,-2.2542690309545677,-1.5022414015454575,56474104,66397404,10.716225779956929,21.691471879476484,NaN,NaN,-28.07921558777085,-16.275303845042934
2022-05-02T09:30:00-04:00,59.18,60.74,59.06,60.69,11094738,7900813.6,38.866656428438695,37.57128798257374,NaN,NaN,-98.81314910617081,-140.99945636172214,-0.5861051811168498,-2.2348728779415197,-1.6487676968246698,67568842,63474858.8,9.992624473277345,19.54063246818721,NaN,NaN,-27.12143663599816,-17.824751386607968
2022-05-03T09:30:00-04:00,60.53,61.4,60.08,60.85,8362104,8058851.3,39.418781195728094,37.35983101386081,NaN,NaN,-76.89526217970753,-119.72560276664535,-0.426141276311478,-2.1814442922140174,-1.7553030159025393,75930946,64207362.2,11.603731935054228,17.962090618389773,NaN,NaN,-26.207081351214217,-19.022227095837433
2022-05-04T09:30:00-04:00,60.58,63.09,60.005,62.94,9761106,8347342.6,46.247911645153266,37.31723588991128,NaN,NaN,-45.63969852792218,-92.36342179906774,-0.15415829000891246,-1.94800087841368,-1.7938425884047675,85692052,70366567,23.93312428390918,17.48341860957098,NaN,NaN,-23.100774905574394,-19.604876782942714
2022-05-05T09:30:00-04:00,62.19,62.43,60,60.62,9109632,8552274.1,40.75575709863096,37.18078555471585,NaN,NaN,-60.79236876390977,-80.29380457121292,-0.10730625067664956,-1.9279754017505795,-1.82066915107393,76582420,72449672.8,27.610634430213437,17.46659600599657,NaN,NaN,-22.33652274155148,-19.995111919886824
2022-05-06T09:30:00-04:00,60.15,60.32,58.92,59.37,9318610,8798844.55,38.12847464280043,36.911662622566844,NaN,NaN,-86.24574787315281,-73.67724529017264,-0.13548851577925736,-1.9900297957980015,-1.8545412800187442,67263810,74607614,31.315156413553467,17.917483177572688,NaN,NaN,-22.605317000684963,-20.367998360000843
2022-05-09T09:30:00-04:00,58.55,59.07,57.6,57.83,11949120,9204904.8,35.12432744227681,35.99459596285347,NaN,NaN,-109.3084740945413,-75.77631028784673,-0.22742178511309086,-2.1388185114101077,-1.9113967262970168,55314690,72156783.6,29.47054892927339,18.323746574678932,NaN,NaN,-23.83250243400048,-20.862927513429362
2022-05-10T09:30:00-04:00,58.75,59.16,57.56,58.09,9632988,9418503.4,36.04057668218753,35.827297715987875,NaN,NaN,-101.25328385585428,-80.64791462307608,-0.2391035198230982,-2.2102761260758896,-1.9711726062527914,64947678,69960130,27.88509194608966,18.713411215714878,NaN,NaN,-24.50714844439528,-21.38353050356735
2022-05-11T09:30:00-04:00,57.87,59.05,56.95,57.04,15059730,9758973.1,33.95495493301296,35.83730880025251,NaN,NaN,-111.57677901079911,-93.83533071965147,-0.2829289458386155,-2.324833788551061,-2.0419048427124453,49887948,62799309.2,23.455215805153557,18.99597856159162,NaN,NaN,-25.712520276691492,-22.001957614013655
2022-05-12T09:30:00-04:00,56.57,58.38,56.28,57.66,16809343,10290144.55,36.29905821327426,36.241863871534115,NaN,NaN,-112.42020065300628,-104.16089709747075,-0.23738366271412215,-2.3386344211050982,-2.101250758390976,66697291,60822283.4,22.397304003149245,19.404854091875933,NaN,NaN,-26.001734689692313,-22.573354339110605
2022-05-13T09:30:00-04:00,57.84,59.32,57.77,59.01,5895433,10348981.45,41.19334840406427,36.728444708285224,NaN,NaN,-72.97941310300253,-101.50763014344071,-0.09108216952842474,-2.215103470301507,-2.1240213007730824,72592724,61888066.2,24.37747305220674,20.012940610249583,NaN,NaN,-24.772984277691382,-22.887587187479287
2022-05-16T09:30:00-04:00,58.67,59.32,58.49,58.63,6900848,10374704.35,40.25577228510466,37.45198537482882,NaN,NaN,-64.91540024439163,-92.62901537341077,0.0005050344107493387,-2.123390007759646,-2.1238950421703953,65691876,63963503.4,28.21863606077774,21.026641404450494,NaN,NaN,-24.03594744920291,-23.051638653439806
2022-05-17T09:30:00-04:00,59.52,59.95,59.08,59.91,10529968,10674891.85,44.81228814569107,38.674215253726175,NaN,NaN,-25.59467004062536,-77.49729261036498,0.15893340013270096,-1.925228292004519,-2.08416169213722,76221844,66218336.6,32.245257127173275,22.470198170931162,NaN,NaN,-22.055757828368023,-22.90936996414384
2022-05-18T09:30:00-04:00,59.23,59.51,57.78,57.95,9766383,10686685.55,39.8059957411133,38.85733422896129,NaN,NaN,-74.25454921849416,-70.032846651904,0.1438199622729468,-1.9043867392960365,-2.0482067015689833,66455461,69531839.2,37.76970048043118,24.35648033715857,NaN,NaN,-21.810747941260374,-22.752423960874772
2022-05-19T09:30:00-04:00,57.72,58.55,57.65,57.87,8299192,10690041.75,39.611478213536806,39.32252721935811,NaN,NaN,-87.87194652453809,-65.12319582621035,0.14037556856939393,-1.8727372408572407,-2.0131128094266346,58156269,67823634.8,36.13400617555729,26.172036079701456,NaN,NaN,-21.670039712896052,-22.597797639734956
2022-05-20T09:30:00-04:00,58.58,58.805,56.64,58.02,8785184,10644198.65,40.201524815984136,39.41787496132564,NaN,NaN,-90.09448656847132,-68.54621051930411,0.15878378484776268,-1.8146330783669313,-1.973416863214694,66941453,66693380.6,35.05233192102405,27.962015183111934,NaN,NaN,-21.391454039514,-22.425462839703393
2022-05-23T09:30:00-04:00,58.48,58.98,57.69,58.89,9217024,10437029.65,43.64111711697449,39.71947038427181,NaN,NaN,-44.967851108061815,-64.55670069203815,0.23551062217633723,-1.6790285854942724,-1.9145392076706096,76158477,68786700.8,38.7116688029975,29.898296387965026,NaN,NaN,-20.196728882816743,-22.10707227443387
2022-05-24T09:30:00-04:00,56.91,57.03,55.68,56.8,8468809,10364813.15,37.988147053161306,39.12948719912953,NaN,NaN,-151.3123354126229,-89.70023376643765,0.155331232514762,-1.7203751670271572,-1.8757063995419192,67689668,67080265.6,36.887132350851445,30.8235826784609,NaN,NaN,-20.76387777216358,-21.915187345538115
2022-05-25T09:30:00-04:00,56.61,57.82,56.55,57.56,5346177,9763501.95,40.98191365760249,39.14564123905607,NaN,NaN,-92.56123807516005,-93.36157153777083,0.16253550623189916,-1.6725370167520452,-1.8350725229839444,73035845,68396342.4,39.26467400028387,31.65601407632308,NaN,NaN,-20.367003873568173,-21.694018278113838
2022-05-26T09:30:00-04:00,57.7,59.14,57.68,58.96,4975160,9448716.8,46.140217858039826,39.71790861157317,NaN,NaN,-16.36259427765568,-79.05970108839435,0.26460536086624,-1.5043158219011445,-1.7689211827673845,78011005,72367289.6,45.88834291702393,32.69695596942811,NaN,NaN,-18.47564436261394,-21.234250575899566
2022-05-27T09:30:00-04:00,59.24,60.24,59.1,60.22,5187117,9223433.3,50.34650433980622,40.8052069613967,NaN,NaN,60.21727674409335,-48.99734842588141,0.4112468912493443,-1.254862568705704,-1.6661094599550483,83198122,75618623.4,50.6354054563563,34.20873143564832,NaN,NaN,-15.568785860996714,-20.424898473770586
2022-05-31T09:30:00-04:00,60.1,60.79,59.58,60.18,7167818,9027087.3,50.21243801808627,41.81748277110375,NaN,NaN,80.1271345135811,-23.97835130155284,0.4942376153437944,-1.0483124407753053,-1.5425500561190997,76030304,75592988.8,50.59771644840352,35.83106175724216,NaN,NaN,-13.262606043460723,-19.401713840869178
2022-06-01T09:30:00-04:00,60.65,60.99,59.26,59.49,6233030,8920633.6,47.845612341486515,42.80967258599471,NaN,NaN,69.92559404752623,20.26923459047698,0.4903747873040081,-0.9295815719890896,-1.4199563592930977,69797274,76014510,51.240401349018946,37.815717867518266,NaN,NaN,-11.961977280790205,-18.33889433228647
2022-06-02T09:30:00-04:00,59.42,61.005,59.27,60.94,7218651,8793510.85,52.87285333053464,43.99351509437046,NaN,NaN,117.49549994706048,62.28058219492109,0.5677284684851787,-0.7102957736866244,-1.278024242171803,77015925,76810526,52.497176416022974,39.965708754152104,NaN,NaN,-9.329250994982747,-17.051802426957366
2022-06-03T09:30:00-04:00,60.32,60.49,59.45,59.62,4498543,8562956.4,48.30779164398244,44.501689611507466,NaN,NaN,89.0765251787628,83.36840608620477,0.5138631796381163,-0.6356952676241576,-1.149558447262274,72517382,75711801.4,50.56005558568911,41.83589322082941,NaN,NaN,-8.3856782041779,-15.813784680846014
2022-06-06T09:30:00-04:00,60.28,60.535,59.505,59.92,4689147,8331483.25,49.377558157684234,45.153245745263156,NaN,NaN,94.77861165539288,90.28067306846468,0.48278950721516045,-0.5460715632433235,-1.028861070458484,77206529,74513482.8,48.459807553511894,43.281691184596134,NaN,NaN,-7.303840654247579,-14.598078391331953
2022-06-07T09:30:00-04:00,59.35,60.41,59.21,60.35,3251506,7896602.55,50.944607083177296,45.59126852651217,NaN,NaN,83.95738846113525,91.04672385797551,0.4748260330261541,-0.43532852917579135,-0.9101545622019455,80458035,75399029,50.10913793395579,44.55768267079488,NaN,NaN,-5.958109884397735,-13.363797176055636
2022-06-08T09:30:00-04:00,60.13,61.0362,60.075,60.19,3947497,7612328,50.320412679758455,46.34229830784397,NaN,NaN,100.68384372571424,97.19837379361311,0.4430303956181316,-0.3563665676792809,-0.7993969632974125,76510538,76741681.8,52.586561457219005,45.61602988342259,NaN,NaN,-5.005104353575999,-12.169698201415688
2022-06-09T09:30:00-04:00,59.87,60.27,58.29,58.34,4422197,7080451.35,43.65945874945199,46.631439774695046,NaN,NaN,-0.12939488806235644,73.67339482658855,0.28910239212358513,-0.43801897314293115,-0.7271213652665163,72088341,75756165,50.60038397127958,46.64934258311704,NaN,NaN,-6.054418160613239,-11.296086767015339
2022-06-10T09:30:00-04:00,57.465,57.63,56.605,56.71,6654131,6572690.75,38.78768954261974,46.530451540883305,NaN,NaN,-133.92866681896479,29.07235642704304,0.08007431116910502,-0.627028476305135,-0.70710278747424,65434210,74339530.6,47.80528234380843,47.56026761331592,NaN,NaN,-8.492647472099968,-10.895595439170286
2022-06-13T09:30:00-04:00,55.32,55.59,53.88,54.03,7046529,6630245.55,32.38842503720679,45.7266878208999,NaN,NaN,-236.22147074649632,-37.12766005333479,-0.2197228860262792,-0.9817563950070891,-0.7620335089808099,58387681,70575761,41.28085493255708,47.743780908284464,NaN,NaN,-12.91747384811275,-11.184435211876352
2022-06-14T09:30:00-04:00,54.37,54.565,53.43,53.88,4388412,6504623.75,32.06951390729499,45.303928310480885,NaN,NaN,-209.47819394513652,-95.81477653458914,-0.39873705996178344,-1.2604548339330393,-0.8617177739712558,53999269,65284007.8,34.21122911571614,47.552644962917654,NaN,NaN,-16.49206584762971,-11.942668159841118
2022-06-15T09:30:00-04:00,54.47,55.81,54.11,55.09,7353282,6345789.45,37.422281258539975,45.04966885340498,NaN,NaN,-135.86038776418593,-143.1236228325692,-0.40496173086151666,-1.3679199375481517,-0.962958206686635,61352551,62252410.4,30.941949639536517,46.9581646514357,NaN,NaN,-17.864159751897834,-12.788595530134934
2022-06-16T09:30:00-04:00,53.89,54.17,52.735,53.08,6917880,6203364.3,32.79881988199331,44.09671185511594,NaN,NaN,-167.27082591393656,-176.55190903774402,-0.5071288690059372,-1.5968692929440564,-1.0897404239381192,54434671,58721676.4,27.630281313016184,45.65401739400657,NaN,NaN,-20.60002803047621,-13.904514458755116
2022-06-17T09:30:00-04:00,53.28,54.27,52.87,53.84,11930228,6384916.1,36.017659347127356,43.07322292706745,NaN,NaN,-130.67561330904704,-175.9012983357605,-0.4861443386511255,-1.697420847252026,-1.2112765086009005,66364899,58907814.2,28.067379796607298,44.04201556116736,NaN,NaN,-21.805948015304192,-15.03329068111927
2022-06-21T09:30:00-04:00,54.47,54.88,53.965,54.09,4110020,6151157.9,37.08520462989387,42.13556339933943,NaN,NaN,-95.85810231387416,-147.82862464923605,-0.4205097593441134,-1.7369137077810421,-1.3164039484369288,70474919,61325261.8,33.67057584686576,42.83293408962895,NaN,NaN,-22.45102840718218,-16.092967499128257
2022-06-22T09:30:00-04:00,53.83,54.98,53.725,54.18,6471997,6013906.55,37.4895625040741,41.39584555380997,NaN,NaN,-85.70821596179299,-123.07462905256735,-0.33958246688122773,-1.7408820320384635,-1.4012995651572357,76946916,65914791.2,42.78294326178204,42.2288299405406,NaN,NaN,-22.857570077297744,-17.05933929600961
2022-06-23T09:30:00-04:00,54.46,54.99,53.96,54.85,6001331,5890532.65,40.55267139800748,40.51583255862946,NaN,NaN,-71.82796166950631,-110.26814383363141,-0.2155241183315033,-1.6707047130716148,-1.4551805947401115,82948247,70233930.4,49.77575929991515,42.034443003675754,NaN,NaN,-22.336019762611798,-17.813150791238495
2022-06-24T09:30:00-04:00,55.28,56.94,55.27,56.94,8894605,6067954.05,48.95532578873431,40.5620849975403,NaN,NaN,-22.849542237674385,-81.38388709837896,0.020176902641166672,-1.4299594664386532,-1.45013636907982,91842852,77715566.6,59.100358256128395,42.64446462299286,NaN,NaN,-19.266896981349174,-18.020828818397163
2022-06-27T09:30:00-04:00,57.06,57.11,56.14,56.4,3790214,6008706.75,47.10280502150376,40.399602630670266,NaN,NaN,-16.10332066303663,-58.4694285691769,0.14561110773075692,-1.2681224844163737,-1.4137335921471306,88052638,82053114.4,63.34886736208798,43.707968895034,NaN,NaN,-17.27554947578391,-17.914360340880986
2022-06-28T09:30:00-04:00,56.58,57,54.735,54.76,4804990,5989600.4,41.91517286799617,39.75464304387162,NaN,NaN,-39.63170717996666,-47.22414954239539,0.12482543317899975,-1.2577018006733809,-1.3825272338523806,83247648,84607660.2,65.61428957302498,44.815479726396084,NaN,NaN,-17.105210852986634,-17.798767556896077
2022-06-29T09:30:00-04:00,54.91,55.17,54.34,54.93,3939069,5828162.95,42.62062567812579,39.2046582580407,NaN,NaN,-53.49639398025513,-40.781785146087806,0.12870705932272264,-1.2216434096989772,-1.3503504690216999,87186717,86655620.4,67.35631098160923,45.870461835281105,NaN,NaN,-16.76036018771502,-17.65042364701307
2022-06-30T09:30:00-04:00,54.36,55.085,53.49,54.27,4901666,5761594.75,40.560975988744616,38.98333806084732,NaN,NaN,-63.753564622015354,-39.16690573658961,0.09458418000919666,-1.2321202440102041,-1.3267044240194008,82285051,86522981.2,67.11914251222356,47.05037315963425,NaN,NaN,-17.06554896520443,-17.56687012104041
2022-07-01T09:30:00-04:00,54.08,54.89,53.705,54.82,4400436,5620684,43.03162367071206,39.28647621285392,NaN,NaN,-53.00000283244122,-45.19699785554299,0.11543338740440023,-1.1824126897639005,-1.2978460771683007,86685487,85491508.2,65.19660727897495,48.29261065500328,NaN,NaN,-16.61992693583893,-17.431592523154485
2022-07-05T09:30:00-04:00,54.13,56.12,53.61,56.09,4237414,5607627.55,48.36841610491982,40.427904146261994,NaN,NaN,-21.5997213693673,-46.29627799680912,0.2153307057680527,-1.0286826949582348,-1.2440134007262875,90922901,86065560.8,65.78400943069124,50.04283597629858,NaN,NaN,-14.651832693568018,-17.034483976070703
2022-07-06T09:30:00-04:00,56.09,56.545,55.492,56.1,4234945,5584917.45,48.409398564906084,41.59503876466278,NaN,NaN,16.086934554541145,-35.152549649907556,0.2786360275235942,-0.8957183663217947,-1.1743543938453889,95157846,88447600.4,68.18365042617916,52.46943749847451,NaN,NaN,-13.04100038966703,-16.463986320870177
2022-07-07T09:30:00-04:00,56.27,57.21,56.12,56.98,3297224,5587203.35,52.0186906268791,42.63763943382986,NaN,NaN,62.00544329773036,-12.052182194310461,0.37057392478881,-0.7111369878593763,-1.0817109126481863,98455070,90701271,70.3055215496513,55.28112120633985,NaN,NaN,-10.60742353770537,-15.627334494703776
2022-07-08T09:30:00-04:00,56.45,57.13,56.17,56.71,2566941,5518175.55,50.84338274535509,43.926536781212846,NaN,NaN,79.6110577838523,16.62074228686307,0.4014037028592006,-0.5799562840741856,-0.9813599869333862,95888129,93421886.6,72.67468617480253,58.49857869646745,NaN,NaN,-8.887821619995737,-14.664546941174056
2022-07-11T09:30:00-04:00,56.02,56.08,54.89,54.99,3350748,5464603.1,44.02011013319209,44.498140408788906,NaN,NaN,13.247827137012052,29.870308280753722,0.298865454998982,-0.6077781681846588,-0.9066436231836408,92537381,94592265.4,73.648700881298,61.75438734537392,NaN,NaN,-9.296989999808966,-13.897753092407614
2022-07-12T09:30:00-04:00,55.19,55.68,54.75,54.96,4103543,5337073.7,43.90942392344922,44.98558464404285,NaN,NaN,7.012554735092279,35.592763501645635,0.22528061366837748,-0.6250428560981689,-0.8503234697665464,88433838,94094452.8,72.46550727496052,64.52545387595212,NaN,NaN,-9.660740607608181,-13.292465594579124
2022-07-13T09:30:00-04:00,54.12,55.11,54.0476,54.71,4923971,5230945.8,42.940449279375976,45.374933699421554,NaN,NaN,-34.71250176560847,25.432876237615712,0.15914729947755535,-0.6513893454196023,-0.8105366448971576,83509867,91764857,67.03787592504025,66.25794906618485,NaN,NaN,-10.230843909257452,-12.8550910681046
2022-07-14T09:30:00-04:00,54.03,54.27,53.41,54.02,4174009,5220225.65,40.29728460510939,45.35669178564312,NaN,NaN,-92.94363395574729,-5.556939213079815,0.07270877478041682,-0.7196506764216366,-0.7923594512020534,79335858,87941014.6,59.19989766166606,66.93110180630991,NaN,NaN,-11.45968313075991,-12.655747077055358
2022-07-15T09:30:00-04:00,54.58,55.43,54.36,55.41,4048173,5054970.2,47.33069012609332,45.24064638116876,NaN,NaN,1.387473766679542,-21.201656016514367,0.11064961054826816,-0.6540474380167183,-0.7646970485649864,83384031,85440195,54.69582823918399,66.61649251938532,NaN,NaN,-10.54573856256241,-12.35431728927065
2022-07-18T09:30:00-04:00,55.8,56.24,54.98,55.13,3790886,4898620.5,46.1512313104654,45.17267683038032,NaN,NaN,25.956846764301492,-18.65985209105648,0.11773240710168387,-0.6175315396878815,-0.7352639467895654,79593145,82851347.8,50.41931520853767,65.692953079846,NaN,NaN,-10.118260125844222,-12.034880551638302
2022-07-19T09:30:00-04:00,55.88,57.155,55.76,57.09,3235786,4463898.4,54.66721907456775,46.08353727370685,NaN,NaN,119.48084449381581,3.8338058606882144,0.24778592157691137,-0.42553154481842626,-0.6733174663953376,82828931,81730366.4,48.64571055398721,64.4809117213433,NaN,NaN,-7.0653440073094,-11.324946759591317
2022-07-20T09:30:00-04:00,57.36,58.335,57.0006,58.03,5639620,4540378.4,58.090395478615086,47.18852083088466,NaN,NaN,180.3285774022215,46.84202169425421,0.38243870824358495,-0.1952690810908564,-0.5777077893344413,88468551,82722103.2,50.31104863848202,63.26339298254851,NaN,NaN,-3.3947521926175943,-10.192061821452214
2022-07-21T09:30:00-04:00,57.53,58,56.77,58,6391025,4536329.8,57.94002116695128,48.42988120075656,NaN,NaN,139.32274134913334,93.29529675523034,0.4501407189582734,-0.015031890636599599,-0.465172609594873,82077526,83270436.8,51.25231555413323,62.130048199827776,NaN,NaN,-0.5045847106060074,-8.808136519902757
2022-07-22T09:30:00-04:00,56.73,57.37,55.62,55.99,3765866,4424556.55,48.82122553740748,48.84342419123481,NaN,NaN,43.10074838223622,101.63795167834166,0.34494529297281235,-0.03399099337885758,-0.3789362863516699,78311660,82255962.6,49.38826550866794,61.000880930520125,NaN,NaN,-0.7250431354685183,-7.653408893555008
2022-07-25T09:30:00-04:00,56.05,56.41,55.41,55.8,2894455,4124549.05,48.05137419374447,48.820778340436576,NaN,NaN,12.525089546220084,98.95160023472539,0.25225756935122595,-0.0636143246626375,-0.31587189401386345,75417205,81420774.6,47.84545465659584,59.71955558951332,NaN,NaN,-1.1365365540281476,-6.722427130765457
2022-07-26T09:30:00-04:00,55.47,55.47,54.52,54.68,4278036,4148940.15,43.67897561405925,48.482890986804655,NaN,NaN,-55.79379418416581,63.89667249912907,0.11234290151086557,-0.17544326712528147,-0.28778616863614703,71139169,79082822.2,43.72751645247401,57.972688877105796,NaN,NaN,-2.857571253584764,-6.170304862596787
2022-07-27T09:30:00-04:00,55.6,57.3,55.48,56.99,4802153,4148798.3,53.14828063527274,48.5635759874042,NaN,NaN,65.94703172861564,41.02036336440789,0.16880039275575429,-0.07678567769145417,-0.24558607044720845,75941322,76577376.4,39.776575323611844,55.79204986096013,NaN,NaN,-1.255527360372446,-5.468193790850452
2022-07-28T09:30:00-04:00,55.94,56.35,55.24,56.34,4808906,4192290.15,50.57171447749864,48.54417111112874,NaN,NaN,17.989071038252465,16.75362930223171,0.15609553883153787,-0.05046664690778613,-0.206562185739324,71132416,74388354.4,36.65993136591099,53.219567374610726,NaN,NaN,-0.8099269255499163,-4.802727095807518
2022-07-29T09:30:00-04:00,55.86,56.49,55.52,56.37,5980995,4246256.6,50.6905304946789,49.0206297083778,NaN,NaN,23.96183044793795,12.92584571537206,0.14374731437723204,-0.02687804276778394,-0.17062535714501598,77113411,74148704.6,36.32437186166275,50.553543873208206,NaN,NaN,-0.4237842289231467,-4.177163829109751
2022-08-01T09:30:00-04:00,55.95,56.87,55.58,56.29,3758165,4214143.05,50.343000768623455,49.48017091160453,NaN,NaN,28.531575453934778,16.127142896915,0.12492236046947122,-0.014472406558176942,-0.13939476702764816,73355246,73736312.8,35.718489081097815,47.928756859360874,NaN,NaN,-0.21292810793384787,-3.610844440370336
2022-08-02T09:30:00-04:00,55.94,56.875,55.88,56.2,4688509,4236697.8,49.928286489313436,49.97930214088577,NaN,NaN,31.11469647539412,33.508841028826986,0.10210185323910703,-0.011767450478764374,-0.1138693037178714,68666737,73241826.4,34.96538020600016,45.63786430800087,NaN,NaN,-0.15430144519947964,-3.1170525839173564
2022-08-03T09:30:00-04:00,56.42,57.73,56.32,57.55,4331687,4241534.9,55.80887618932506,51.08727296832975,NaN,NaN,97.73217198424447,39.86586907995276,0.1696380244118088,0.09817822679688959,-0.0714597976149192,72998424,72653246.8,34.0452346042985,43.841102661046044,NaN,NaN,1.615939502599458,-2.4409108572720974
2022-08-04T09:30:00-04:00,57.4,58.09,57.27,57.8,3261797,4239763.55,56.8202221686167,51.76509668565285,NaN,NaN,130.1261044214818,62.29327575659862,0.21968158384537895,0.20314218219180447,-0.016539401653574468,76260221,73678807.8,37.148881363489636,42.58774931278216,NaN,NaN,3.369482662852958,-1.6108546401113752
2022-08-05T09:30:00-04:00,56.69,57.44,56.575,57.09,3421891,4282511.05,53.103253826236944,52.26166972249367,NaN,NaN,73.11559844144064,72.12402935529916,0.19437209101894853,0.2264257121201112,0.03205362110116267,72838330,72823791.6,35.64297628581997,41.53229653258804,NaN,NaN,3.835369904721505,-0.8328225622781067
2022-08-08T09:30:00-04:00,57.43,58.56,57.34,57.42,3962699,4313108.6,54.590135521714366,52.25616375443273,NaN,NaN,116.81059748495043,89.77983376150229,0.18908688736057697,0.2684122303018839,0.07932534294130691,76801029,73512948.2,37.83052297354701,40.759783133985174,NaN,NaN,4.639912735323093,-0.05100323404936391
2022-08-09T09:30:00-04:00,57.27,57.27,56.58,56.86,2718193,4243841.1,51.600316895856224,51.792586712807086,NaN,NaN,46.63761547576424,92.88441756157633,0.13940089126459962,0.25357645702205645,0.11417556575745683,74082836,74596168,41.21293500928742,40.109917874756995,NaN,NaN,4.502858755932792,0.5995484788052297
2022-08-10T09:30:00-04:00,58.18,58.75,57.98,58.46,3338752,4164580.15,58.58029845015666,51.838320804464615,NaN,NaN,145.19800929790736,102.3775850243089,0.20201839168964814,0.366698555369517,0.16468016367986887,77421588,75480800.8,43.897433461334,39.584569153842764,NaN,NaN,6.477887656286726,1.4393112184454435
2022-08-11T09:30:00-04:00,59.16,59.75,58.41,58.52,3001745,4105966.95,58.82013349475059,52.55252851570341,NaN,NaN,166.30950536025688,109.6142652120639,0.2330033921530284,0.45593440387115436,0.22293101171812596,80423333,76313423.2,46.37932824486569,39.36964506357117,NaN,NaN,8.144667321922752,2.397219233227916
2022-08-12T09:30:00-04:00,59.15,59.57,58.84,59.56,2779417,4042529.15,62.836965075474076,53.608642150112665,NaN,NaN,172.9773293224547,129.5866113882667,0.3045477182180705,0.603615659490714,0.2990679412726436,83202750,78386307.2,52.0648031171035,39.67102709646458,NaN,NaN,10.821232875525771,3.6006497535561808
2022-08-15T09:30:00-04:00,59.28,59.91,59.18,59.77,2623812,3984175.45,63.60887183954917,55.03220616621909,NaN,NaN,166.49471629544277,139.52343515036517,0.34410058518965003,0.7291936727597061,0.3850930875700561,85826562,80191413.8,56.40022422637036,40.57622050888574,NaN,NaN,13.248218071672266,4.978873799001336
2022-08-16T09:30:00-04:00,59.48,60.24,59.2,59.89,2471343,3945953.3,64.06815427220248,55.8121971402855,NaN,NaN,148.76749269549265,159.94941059431088,0.3550005341527078,0.8288437552609409,0.47384322110823307,88297905,83034427.6,62.19905258609073,42.17782602763424,NaN,NaN,15.385562865398327,6.465543665629478
2022-08-17T09:30:00-04:00,59.13,59.36,58.61,58.73,4400974,3884021,56.628075346997676,56.244794345249716,NaN,NaN,87.49498308583422,148.40880535189623,0.26487426815817194,0.804936056305948,0.5400617881477761,83896931,84329496.2,64.51435233095165,44.16742752513715,NaN,NaN,15.179823052582526,7.710440720908485
2022-08-18T09:30:00-04:00,58.63,58.88,58.09,58.64,2416970,3685318.25,56.08389518881234,56.63003468054496,NaN,NaN,61.20806351297209,127.3885169824393,0.18383249387047584,0.7698524054858709,0.586019911615395,81479961,84540821.8,64.89223049609996,46.20798885616837,NaN,NaN,14.858381397234238,8.731575103240736
2022-08-19T09:30:00-04:00,58.11,58.19,57.425,57.69,3337908,3663920.35,50.56070725573837,56.64558514391032,NaN,NaN,15.566093377689525,95.90626979348625,0.05743086438990308,0.6578084921027738,0.6003776277128707,78142053,83528682.4,61.513582212338136,48.05049550839982,NaN,NaN,12.957875948356644,9.335332366828723
2022-08-22T09:30:00-04:00,56.94,56.94,55.915,56.04,3312535,3684824.35,42.695980086086024,56.12899182939407,NaN,NaN,-70.13598577675083,48.580129379047534,-0.1355785225023487,0.43090447458493486,0.5664829970872836,74829518,81329273.6,54.83261211490548,49.469583501893055,NaN,NaN,8.6575057422846,9.238499991893848
2022-08-23T09:30:00-04:00,55.88,56.2803,55.47,55.56,5294766,3735660.85,40.712010337769186,55.050644268568654,NaN,NaN,-107.21293017451784,-2.61595519495456,-0.28524281279559816,0.20992948109278586,0.495172293888384,69534752,77576643,45.71043668213511,50.30281222173853,NaN,NaN,4.489785175090337,8.560112160921918
2022-08-24T09:30:00-04:00,55.39,56.3,55.3,55.89,4279014,3709503.9,42.68389765559174,54.040906803352584,NaN,NaN,-97.99617541688238,-39.714186895497875,-0.34755115310761936,0.060733352503859805,0.40828450561147916,73813766,75560010,41.69595780798968,50.62760339634567,NaN,NaN,1.644939215972194,7.572230311643386
2022-08-25T09:30:00-04:00,56.11,57.01,56.05,56.98,2492086,3593662.9,48.747461956849726,53.72977881268207,NaN,NaN,-52.36725027665534,-62.429249653423355,-0.30254660629685415,0.030101247740411452,0.3326478540372656,76305852,74525188.2,39.76599456270132,50.9221047018372,NaN,NaN,0.9931755087897324,6.63236533980715
2022-08-26T09:30:00-04:00,56.82,57.225,55.14,55.16,5293844,3559305.35,40.956309124771735,52.75593407004332,NaN,NaN,-100.35741677944795,-85.61395168485085,-0.377659470338702,-0.1394264838861119,0.2382329864525901,71012008,73099179.2,37.210020878513866,50.87778312362054,NaN,NaN,-2.2325416186646496,5.365950060025464
2022-08-29T09:30:00-04:00,54.77,55.39,54.681,54.73,3620831,3552438.65,39.35586354389211,51.88133025918874,NaN,NaN,-141.84072891574112,-99.95490031264892,-0.43455474495870827,-0.3049604447457952,0.12959430021291307,67391177,71611511,34.70395761515081,50.4128561668965,NaN,NaN,-5.338532106396326,3.8367383219652087
2022-08-30T09:30:00-04:00,54.94,55.17,53.89,54.25,3754554,3505740.9,37.59002815754001,50.38202523828755,NaN,NaN,-152.3267566345584,-108.97766560465702,-0.4792494881776334,-0.4694675600091287,0.009781928168504705,63636623,70431885.2,32.81662314264027,49.62136971556124,NaN,NaN,-8.433906493385226,2.0837890626294326
2022-08-31T09:30:00-04:00,55.3,55.54,54.37,54.38,5491369,3563725,38.3962136411329,48.923173820172,NaN,NaN,-117.97881518952025,-112.9741935591846,-0.47393312092930034,-0.5826344729931208,-0.10870135206382041,69127992,69494730.4,31.35759275075712,48.5483886088392,NaN,NaN,-10.686118614212937,0.25951653736623714
2022-09-01T09:30:00-04:00,54.24,54.93,53.87,54.88,6217352,3711502.75,41.524908665020874,47.400884076568204,NaN,NaN,-112.45292336584896,-124.99132817702332,-0.41285672621038805,-0.6247722598268055,-0.21191553361641746,75345344,69302628.8,31.052820214563965,47.04753268722923,NaN,NaN,-11.674400346715595,-1.4453287317883101
2022-09-02T09:30:00-04:00,55.22,55.26,53.63,53.84,5575511,3819183.75,37.28340880893362,45.52049386009566,NaN,NaN,-111.03108842300365,-127.12606250573444,-0.41737097034712933,-0.7336292465503291,-0.3162582762031998,69769833,69054193.8,30.638094139918323,45.207380538196944,NaN,NaN,-13.835741699114191,-3.2153877271205786
2022-09-06T09:30:00-04:00,53.81,53.88,52.81,53.17,9949956,4118546.6,34.81613432837952,43.43106386410831,NaN,NaN,-131.66854120774548,-125.09162496413532,-0.4381957036002522,-0.864002905703515,-0.42580720210326284,59819877,67539933.8,28.1686527551705,42.7766376931312,NaN,NaN,-16.420136171215702,-5.1017803619913105
2022-09-07T09:30:00-04:00,53.12,54.34,53.11,54.24,7466675,4355970.7,41.47688182183785,42.34883575516833,NaN,NaN,-96.42916938434048,-113.91210751409176,-0.35611039682735424,-0.8709451981374556,-0.5148348013101014,67286552,68269919.6,31.053659550874926,40.38658820884,NaN,NaN,-16.60742520244986,-6.745443910628246
2022-09-08T09:30:00-04:00,53.72,54.37,53.45,54.11,11092446,4743655.4,40.929657705871385,41.26639022067254,NaN,NaN,-85.83223444170382,-107.48279136452848,-0.28959566703859996,-0.8768293851083513,-0.5872337180697513,56194106,65683142.4,26.92657604239885,37.674755747861354,NaN,NaN,-16.91929018349631,-8.19885052103797
2022-09-09T09:30:00-04:00,54.51,55.685,54.51,55.62,9515752,5069355.75,49.2973891045324,41.17615320987211,NaN,NaN,-34.98414523459946,-91.98903573827857,-0.13100606953187488,-0.7509913049845949,-0.61998523545272,65709858,63756045.2,24.33215572986819,35.01893957054208,NaN,NaN,-14.528147453000765,-9.103035797032655
2022-09-12T09:30:00-04:00,55.72,56.235,55.46,55.91,4837240,5172246.9,50.74061064222913,41.750769678168055,NaN,NaN,-6.22381346248879,-71.02758074617562,-0.0005782180096078893,-0.6207080079647298,-0.6201297899551219,70547098,63911498.2,24.96025849226848,32.885200026068006,NaN,NaN,-12.146691994859692,-9.53784382529366
2022-09-13T09:30:00-04:00,54.31,54.43,52.69,52.84,7053160,5393714.3,38.30897504583663,41.579124300172865,NaN,NaN,-110.9316110031,-66.88019470524652,-0.10906487933687026,-0.7564608891262097,-0.6473960097893394,63493938,64646310.4,28.002533639231473,31.620349808717744,NaN,NaN,-14.227298957609738,-10.207765987053099
2022-09-14T09:30:00-04:00,53,53.05,52.18,52.93,7515169,5645905.6,38.782493636373694,41.30045258451444,NaN,NaN,-130.7242969274893,-73.73922021387628,-0.15969908013707956,-0.8470198599606888,-0.6873207798236093,71009107,65390821.4,31.052567780218155,30.860107663876924,NaN,NaN,-15.648636554573939,-10.985033210984648
2022-09-15T09:30:00-04:00,52.71,53.56,52.495,52.7,6948604,5773287.1,37.98018379313063,40.53136128710592,NaN,NaN,-113.92415964051202,-79.35760525363791,-0.19147581690656257,-0.9266655509568125,-0.7351897340502499,64060503,66964100.8,37.11509010551978,30.67075734550681,NaN,NaN,-17.025777475843874,-11.847996677393109
2022-09-16T09:30:00-04:00,52.29,52.3488,51.7,52.14,10953483,6200112.75,36.02599188025918,40.179195769640735,NaN,NaN,-150.22215945866014,-102.40520809845006,-0.23039068844286859,-1.0231780946038356,-0.792787406160967,53107020,64443533.2,32.22609000042236,30.314762282785985,NaN,NaN,-18.768661051638595,-12.836663016571036
2022-09-19T09:30:00-04:00,51.72,52.33,51.565,52.33,7144482,6390441.45,37.20651632582073,40.02567096834992,NaN,NaN,-137.67962025469808,-128.6963694568919,-0.22335126784721082,-1.0719764909699805,-0.8486252231227697,60251502,62384414,28.879330738500798,29.898717505882413,NaN,NaN,-19.83495101214609,-13.836418444510329
2022-09-20T09:30:00-04:00,51.78,52.12,51.36,51.52,5358409,6492735.15,34.300562144389644,39.790709110267755,NaN,NaN,-141.88480049421082,-134.88700735511406,-0.2511862063844579,-1.162607981103342,-0.9114217747188842,54893093,60664245,26.41166178278459,29.44122026589272,NaN,NaN,-21.62350673034492,-14.948859628200985
2022-09-21T09:30:00-04:00,51.65,52.03,50.24,50.26,6596000,6557796.85,30.33193676513666,39.21468933341088,NaN,NaN,-161.70528364374212,-141.08320469836465,-0.32756600866827434,-1.320879285554227,-0.9933132768859527,48297093,56121842.2,21.248389755648986,28.71913433767071,NaN,NaN,-24.45876378961515,-16.307417365545867
2022-09-22T09:30:00-04:00,50.06,50.52,49.86,50.08,6186214,6653156.85,29.801463977669897,38.37730042717153,NaN,NaN,-167.30031160607618,-151.75843509147745,-0.36069916951416614,-1.4441872387786603,-1.0834880692644941,42110879,51731917.4,17.656039374195586,27.762221420501543,NaN,NaN,-26.906489807005297,-17.82157057146864
2022-09-23T09:30:00-04:00,49.64,49.7,48.515,49.11,7014330,6879269.05,27.05545632060175,37.64673239229068,NaN,NaN,-188.16756434509756,-159.34751606876495,-0.41458312633863814,-1.6017169771877917,-1.1871338508491536,35096549,48129823.2,15.36116237240995,26.67101200853666,NaN,NaN,-29.88446992191044,-19.54484190724604
2022-09-26T09:30:00-04:00,48.89,49.37,48.19,48.31,6194055,6924279.6,25.008734599167255,36.946203840204085,NaN,NaN,-176.8766290966261,-167.18691783715056,-0.46685467236153255,-1.7707021913010692,-1.3038475189395367,28902494,41860021.6,12.351770440520752,25.541234700347392,NaN,NaN,-33.0596618170708,-21.475530465792435
2022-09-27T09:30:00-04:00,48.81,49.14,47.8,48.05,6616878,7074081.95,24.36365338875703,35.72383038069832,NaN,NaN,-158.49417872852345,-170.50879348401307,-0.4798498350195908,-1.9036598127140252,-1.4238099776944344,22285616,35338526.2,10.128980239049795,24.046614749502744,NaN,NaN,-35.84876988829169,-23.52885038329233
2022-09-28T09:30:00-04:00,48.19,49.88,48.17,49.69,7825425,7277625.5,35.6405628863934,35.34603789359275,NaN,NaN,-108.71138552576977,-159.9100138604186,-0.34519885750332113,-1.8553085495735857,-1.5101096920702646,30111041,31701315.8,9.140957649481933,22.776213435722962,NaN,NaN,-34.82951961609256,-25.14323170226379
2022-09-29T09:30:00-04:00,49.16,49.16,48.04,48.48,6384682,7322291.15,31.865637525818485,34.10091278082747,NaN,NaN,-117.28797403798826,-149.90754634680098,-0.30615833030598294,-1.8928076049527434,-1.5866492746467604,23726359,28024411.8,8.263431381361286,21.628447410829615,NaN,NaN,-35.167417008369476,-26.575258174564603
2022-09-30T09:30:00-04:00,48.48,49.23,47.86,47.89,6277411,7325294.1,30.186713763030696,32.63277728945615,NaN,NaN,-109.62525571714998,-134.19908462121148,-0.2888264017022375,-1.9476822767745574,-1.65885587507232,17448948,24494891.6,7.517404600144687,20.382529275677914,NaN,NaN,-35.97441237907618,-27.917994489494827
2022-10-03T09:30:00-04:00,48.44,49.48,48.3,49.23,5783699,7335703.5,38.156389809790824,32.6218783440243,NaN,NaN,-78.18909044168218,-114.4615768902227,-0.1621831855074387,-1.8615848569566182,-1.6994016714491795,23232647,23360922.2,7.289698885825075,18.903041079006034,NaN,NaN,-34.0408722228056,-28.792691308539222
2022-10-04T09:30:00-04:00,49.87,50.76,49.86,50.74,8840115,7280211.45,45.68141361819716,33.11465834272598,NaN,NaN,-28.136486853755382,-88.39003851526908,0.037554032512024715,-1.6524591308091487,-1.6900131633211735,32072762,25318351.4,12.23181055445049,17.55870127716548,NaN,NaN,-29.775640584083014,-28.933112633616908
2022-10-05T09:30:00-04:00,49.95,50.58,49.27,50.35,5179814,7165868.4,44.18597087602965,33.55792884864734,NaN,NaN,-35.95311537618665,-73.83838448535246,0.15129544530030725,-1.5008938566957895,-1.6521893019960967,26892948,24674732.8,12.00519946953176,15.765137660309195,NaN,NaN,-26.87597476385797,-28.639235795079916
2022-10-06T09:30:00-04:00,50.16,50.75,49.9,50.08,6508742,6936683.2,43.13321913845602,34.06558793851855,NaN,NaN,-25.40994798392055,-55.46277927453893,0.2124871273125175,-1.3865803928554499,-1.5990675201679674,20384206,24006302.2,11.761493978435354,14.303380801595836,NaN,NaN,-24.875756946140818,-28.101595959517187
2022-10-07T09:30:00-04:00,49.44,49.61,48.5,48.73,4890313,6705411.25,38.228806606945085,34.13860867288457,NaN,NaN,-68.04929687181263,-47.14758750547147,0.1681265089782502,-1.3889093839451547,-1.557035892923405,15493893,23615291.2,11.612983506242628,13.070070285005967,NaN,NaN,-24.67656702128822,-27.612306111198762
2022-10-10T09:30:00-04:00,48.89,49.13,48.175,48.6,4930961,6710097.3,37.78328466373469,34.38737456712351,NaN,NaN,-77.96894659878491,-47.10355873689201,0.13740756612530403,-1.3852764352667748,-1.5226840013920788,10562932,21081348.2,10.67249578506484,11.945844142311698,NaN,NaN,-24.65238349793855,-27.18946002359016
2022-10-11T09:30:00-04:00,48.29,48.555,47.43,47.69,7811720,6748025.3,34.731947377070895,34.70166103940453,NaN,NaN,-105.6395514893507,-62.604171664011076,0.0667583415102111,-1.439236074504315,-1.505994416014526,2751212,15217038.2,8.880106781835252,11.062395358467857,NaN,NaN,-25.562792125103655,-26.957078895234947
2022-10-12T09:30:00-04:00,47.72,48.005,47.41,47.63,5351775,6639855.6,34.53391742000221,35.03969342814254,NaN,NaN,-107.2438962091781,-76.86232783060936,0.02887799744222752,-1.4698969192117417,-1.4987749166539692,-2600563,9318336,7.51326240526906,10.337911289258818,NaN,NaN,-26.353059138858086,-26.870790358609682
2022-10-13T09:30:00-04:00,46.65,48.975,46.473,48.78,10305338,6807692.3,41.427241689167616,36.06624952589725,NaN,NaN,-82.05489089484313,-88.19131641279388,0.09067585751458695,-1.3854300947607356,-1.4761059522753226,7704775,6782449.8,7.013467694541333,9.741647383696774,NaN,NaN,-24.987899772371993,-26.601805989147156
2022-10-14T09:30:00-04:00,49.17,49.37,47.88,47.98,8173321,6668684.2,38.39823361370146,37.02264231264969,NaN,NaN,-58.80970403880757,-86.34339784619286,0.0870594258477273,-1.3672816699656636,-1.4543410958133909,-468546,3589962,6.433266264828717,9.318897085433056,NaN,NaN,-24.728552796462825,-26.334198390192253
2022-10-17T09:30:00-04:00,48.8,49.62,48.76,49.3,6105204,6616720.3,45.48140421460737,38.53105308592472,NaN,NaN,4.079637876607756,-69.93368095111433,0.17772718397962461,-1.2321821158388602,-1.4099092998184848,5636658,2604707.2,6.261118297285478,9.04262123244989,NaN,NaN,-22.261184847555143,-25.752339312672664
2022-10-18T09:30:00-04:00,50.37,50.49,49.23,49.67,5524044,6625002.05,47.31023398549613,39.36460102157491,NaN,NaN,64.39168961442418,-35.92743273035937,0.2617056351568672,-1.0827772558724007,-1.3444828910292679,11160702,4286605.2,10.656234900843756,9.150855321832877,NaN,NaN,-19.69093858957248,-24.886424923658353
2022-10-19T09:30:00-04:00,49.78,50.425,49.42,49.71,11117533,6851078.7,47.515210936238276,40.48242769374775,NaN,NaN,79.6688062469667,1.4551077608695864,0.315432760009863,-0.9501919410169393,-1.2656247010268022,22278235,9262364.8,22.267922131221738,10.15117608968005,NaN,NaN,-17.561051393466602,-23.839942990773817
2022-10-20T09:30:00-04:00,49.83,50.805,49.68,49.83,6788857,6881210.85,48.16667989045143,41.766710988563524,NaN,NaN,104.91961017600063,38.85000797503834,0.3517689529636019,-0.8259135098222998,-1.1776824627859017,29067092,13534828.2,30.60755467707331,11.800472523746379,NaN,NaN,-15.621466373547571,-22.665874902598638
2022-10-21T09:30:00-04:00,49.03,50.2,48.86,50.15,7086691,6884828.9,49.950747384150176,42.60916510101776,NaN,NaN,62.76277182259047,63.164503147317944,0.38726182360807027,-0.6936051832758139,-1.0808670068838842,36153783,20859294,42.080032697617646,14.28549636744585,NaN,NaN,-13.484573540765723,-21.354260422336793
2022-10-24T09:30:00-04:00,50.29,50.77,49.69,50.5,6334649,6891858.6,51.90078500653988,43.05340591447081,NaN,NaN,103.13380307454214,82.97533618690483,0.4213974031220964,-0.5541202529812637,-0.97551765610336,42488432,28229648.8,50.880334489635736,17.04610521995908,NaN,NaN,-11.123439114908567,-19.892714521275618
2022-10-25T09:30:00-04:00,50.74,51.95,50.73,51.84,4684382,6795233.8,58.558197515486206,44.07999353157485,NaN,NaN,176.01189156143303,105.2993765763066,0.5151118526240026,-0.3316278403233568,-0.8467396929473594,47172814,35432071.2,57.65175186179395,20.30657324797781,NaN,NaN,-6.952302438581698,-18.044084223747916
2022-10-26T09:30:00-04:00,50.58,51.39,50.12,50.2,5785977,6693261.4,49.52369483533749,44.53645608135209,NaN,NaN,89.39520961802843,107.24465725051896,0.4499058350159373,-0.28435739917743774,-0.734263234193375,41386837,39253791.6,60.74413792846601,23.805333530122855,NaN,NaN,-5.917903980179494,-16.311772760380997
2022-10-27T09:30:00-04:00,48.4,49.02,47.79,47.82,6867807,6717417.65,39.90240289653405,44.6559986734656,NaN,NaN,-83.53341738690399,69.55405173793801,0.2402592569856017,-0.4339391629613729,-0.6741984199469746,34519030,40344179.2,61.605593519321225,27.376234245342754,NaN,NaN,-8.379962032553674,-15.17865694211995
2022-10-28T09:30:00-04:00,48.05,49.07,47.94,49.03,8235219,6815308.05,45.680312143032815,45.22007206484403,NaN,NaN,-51.4692455326318,46.70764826689357,0.1796279676654301,-0.449663460365187,-0.6292914280306171,42754249,41664272.4,62.673549713563226,31.090595240235498,NaN,NaN,-8.368263214592156,-14.205743552473123
2022-10-31T09:30:00-04:00,48.67,48.86,47.93,48.21,7609363,6906591.25,42.68525795685142,45.78816567768549,NaN,NaN,-72.10996761079839,11.658894129825459,0.08561570075436697,-0.5222718020876584,-0.6078875028420254,35144886,40195563.2,60.652170783496906,34.78859981178276,NaN,NaN,-9.396808783072675,-13.518752871130202
2022-11-01T09:30:00-04:00,48.84,49.15,47.87,47.9,4956890,6712430,41.57545679405506,46.291132775832125,NaN,NaN,-67.40629444292976,-37.024743071047105,0.007961035212428968,-0.5979362088264892,-0.6058972440389182,30187996,36798599.6,56.14201830931188,38.26208237635724,NaN,NaN,-10.567454594043255,-13.097138831546353
2022-11-02T09:30:00-04:00,47.84,48.32,46.53,46.55,10548837,6980881.15,37.05696154425455,45.978969908338335,NaN,NaN,-135.26712490727678,-81.95720997610815,-0.12175873198475196,-0.7580956590198582,-0.6363369270351062,19639159,32449064,50.92074634195765,41.39831656545841,NaN,NaN,-13.092127213046306,-13.096422886046346
2022-11-03T09:30:00-04:00,46.05,46.15,45.36,45.41,11167517,7213819.9,33.723850922933096,45.64508543042631,NaN,NaN,-206.2704072324574,-106.50460794521882,-0.26363254950141213,-0.9658776139118714,-0.7022450644104593,8471642,27239586.4,45.46671263981299,44.18641987795729,NaN,NaN,-16.33551248563645,-13.559149971702075
2022-11-04T09:30:00-04:00,45.93,46.15,44.86,45.72,6621203,7300364.4,35.424784333583716,44.926755438924616,NaN,NaN,-178.0171541390266,-131.81418966649778,-0.31255054590233966,-1.0929332467883839,-0.7803827008860442,15092845,21707305.6,40.50505283612382,46.632415202160026,NaN,NaN,-18.3700162214024,-14.24641657880212
2022-11-07T09:30:00-05:00,46.23,46.57,45.895,46.54,7202249,7413928.8,39.82414112669204,44.39203452043862,NaN,NaN,-117.57854656136651,-140.90790545661142,-0.26738189781335076,-1.1146100731527326,-0.8472281753393819,22295094,19137347.2,38.408218343135054,48.61469973375227,NaN,NaN,-18.693073631419537,-14.88165330060461
2022-11-08T09:30:00-05:00,46.43,47.11,45.95,46.59,8272960,7436990.8,40.09214921112685,43.861815825787794,NaN,NaN,-98.06142463565077,-147.03893149515562,-0.21413956259845546,-1.1149026285874513,-0.9007630659889958,30568054,19213358.8,38.509609636598555,49.774820269850615,NaN,NaN,-18.871075048648674,-15.451570693182333
2022-11-09T09:30:00-05:00,46.41,46.7,45.9,45.96,7028639,7520834,37.80730523413955,43.12186049319409,NaN,NaN,-107.12665163181966,-141.41083684006418,-0.20153579191397264,-1.1526828058814615,-0.9511470139674889,23539415,19993410,39.60831926701321,50.41773202627489,NaN,NaN,-19.692371287458318,-16.057399349507474
2022-11-10T09:30:00-05:00,47.81,48.81,47.35,48.74,8306183,7420876.25,51.061102477961086,43.201171571323435,NaN,NaN,-6.681313389709877,-101.49301807151468,0.003013377791151406,-0.9473802917285497,-0.9503936695197011,31845598,24668201.2,45.85253117215536,50.687196203027575,NaN,NaN,-16.003121670402574,-16.049645395349632
2022-11-11T09:30:00-05:00,48.72,50.22,48.7,50.02,9255252,7474972.8,55.73823361033399,43.47527504302302,NaN,NaN,52.93381829378909,-55.30282358495155,0.22141403570064644,-0.6736261248938931,-0.8950401605945395,41100850,29869802.2,51.82167097940105,50.7544345237251,NaN,NaN,-11.304826090653238,-15.37181406610729
2022-11-14T09:30:00-05:00,49.66,50.56,49.61,49.82,5432301,7441327.65,54.85605875306589,43.21083655999299,NaN,NaN,65.57198822846102,-18.67271662698603,0.34209282486617043,-0.46742412951182644,-0.8095169543779969,35668549,32544493.2,54.593538766476,50.53599073120239,NaN,NaN,-7.915616843137248,-14.306643034254428
2022-11-15T09:30:00-05:00,50.792,51.2,49.85,50.56,8965496,7613400.25,57.53416353412377,43.78301289562058,NaN,NaN,86.05182787440184,18.149933875024498,0.4544041635923459,-0.24151174988756452,-0.6959159134799104,44634045,35357691.4,57.3715363091807,50.29509061553915,NaN,NaN,-4.260055788587491,-12.871416284873437
2022-11-16T09:30:00-05:00,50.27,50.42,49.845,50.06,5374065,7326226.85,55.1533627460549,44.87236717058636,NaN,NaN,66.12988049253997,52.80124029989641,0.4754138183866379,-0.10164864049661304,-0.5770624588832509,39259980,38501804.4,60.29527711389249,50.20149658657996,NaN,NaN,-1.980867289307989,-11.31562357122123
2022-11-17T09:30:00-05:00,49.1,49.975,48.91,49.68,7109632,7342265.6,53.3465953809397,45.41995883043684,NaN,NaN,42.6783502486487,62.67317302756813,0.4446705410785311,-0.021224282535087013,-0.4658948236136181,32150348,38562754.4,60.352047284787524,50.035674984524555,NaN,NaN,-0.6356247366881219,-9.789909452002215
2022-11-18T09:30:00-05:00,50.09,50.198,49.26,49.53,4049341,7190398.1,52.613900619358745,46.12914759204451,NaN,NaN,49.21960422388806,61.93033021358792,0.3967657105142517,0.0300623145291965,-0.3667033959850552,28101007,35962785.8,56.63223672130483,49.74853683722512,NaN,NaN,0.26027781936976574,-8.35416841323479
2022-11-21T09:30:00-05:00,49.66,49.86,48.93,49.12,3202536,7033792.45,50.56942617846464,46.77157397664519,NaN,NaN,36.74443408568931,56.16481938503358,0.32311869931637566,0.037194978160414394,-0.28592372115596126,24898471,33808770.2,53.68028626549981,49.57269883409568,NaN,NaN,0.4530152390944192,-7.095999320044903
2022-11-22T09:30:00-05:00,49.21,49.9,48.84,49.85,5479257,7073536.2,53.997030917629345,47.98157893188625,NaN,NaN,55.51945779238493,50.05834536863021,0.3092133699053997,0.10059299122578835,-0.20862037867961133,30377728,30957506.8,49.96745065966768,49.50460628536069,NaN,NaN,1.579709198166358,-5.856612388871866
2022-11-23T09:30:00-05:00,49.77,50.59,49.77,50.48,4605817,7014528.2,56.78225148338968,49.62860754334743,NaN,NaN,94.3079887949618,55.693967029114575,0.3263953833957141,0.19937385056503132,-0.1270215328306828,34983545,30102219.8,48.87540577673607,49.74808436656947,NaN,NaN,3.338605729655781,-4.543009800510774
2022-11-25T09:30:00-05:00,50.18,50.45,50.14,50.2,1895782,6765926.95,55.18312725030977,51.039917751685,NaN,NaN,83.69402907095552,63.89710279357594,0.3033436364397183,0.2521580127189651,-0.05118562372075321,33087763,30289702.8,49.13781735639166,50.36471040373146,NaN,NaN,4.379960911890497,-3.268299698739164
2022-11-28T09:30:00-05:00,49.91,50.205,49.28,49.4,3680298,6538180.9,50.78263307884421,51.82266717683873,NaN,NaN,49.89272398413348,64.03172674562502,0.22240599186734872,0.2268218661134327,0.004415874246083973,29407465,30550994.4,49.52665068541555,51.15888414246577,NaN,NaN,4.062357808227668,-2.221062912029617
2022-11-29T09:30:00-05:00,49.43,49.55,48.97,49.42,3823064,6348865.95,50.88807342056969,52.59380462037036,NaN,NaN,32.76173025958987,63.23518598040513,0.16125304926373568,0.20598218582575356,0.04472913656201789,33230529,32217406,52.044602974080014,52.12566938085731,NaN,NaN,3.8285881959370314,-1.3568270394629531
2022-11-30T09:30:00-05:00,49.31,51.525,49.16,51.51,10313915,6616717.2,60.42857296442362,54.209609458247805,NaN,NaN,88.20186257071582,69.7716669360713,0.2474415486476467,0.35403107237157627,0.10658952372392957,43544444,34850749.2,55.797304251967276,53.28202545121117,NaN,NaN,6.524257025493123,-0.2309578873263709
2022-12-01T09:30:00-05:00,51.61,52.19,51.415,51.81,6604261,6419488.4,61.58222801210397,54.9611184249723,NaN,NaN,126.34723394477236,76.17951596603342,0.30666507825855266,0.4899208715471204,0.18325579328856773,50148705,37883781.2,59.70820941094606,54.271716753981934,NaN,NaN,9.07569550771467,1.0985640262509206
2022-12-02T09:30:00-05:00,50.96,52.075,50.96,51.94,4402212,6081223.15,62.0978891900548,55.4153795378095,NaN,NaN,121.0172517976287,83.64416051136804,0.33433493733524416,0.601174464957623,0.2668395276223788,54550917,42176412,64.49601840573177,55.17702728443411,NaN,NaN,11.310323229981037,2.557386769640937
2022-12-05T09:30:00-05:00,51.53,52.09,50.965,51.12,4033220,5951824,56.90906566249305,55.56202288848287,NaN,NaN,109.78353543009008,95.62232280055937,0.27938826970422065,0.6160748647526546,0.33668659504843396,50517697,46398458.4,68.46514730266395,56.16785646559039,NaN,NaN,11.771046473134142,3.873623870139966
2022-12-06T09:30:00-05:00,50.95,51.02,49.4726,49.65,5810986,5882260.85,49.003901604229796,54.952718464919016,NaN,NaN,22.558126599181897,93.58160206847779,0.1334212949306106,0.5034632137116972,0.3700419187810866,44706711,48693694.8,70.40230567504524,57.09862570600929,NaN,NaN,9.710906558348228,4.707521397026861
2022-12-07T09:30:00-05:00,49.51,49.8,49.1,49.4,4700897,5703657.7,47.78811681404425,54.426629469775385,NaN,NaN,-35.50983777826336,68.83926199868196,0.015609840751077353,0.3895542197199333,0.37394437896885596,40005814,47985968.8,68.99491770792642,57.72002860558314,NaN,NaN,7.668645640976661,5.130539146162547
2022-12-08T09:30:00-05:00,49.63,49.76,49.14,49.3,5180760,5611263.75,47.282788304605546,53.993500392894376,NaN,NaN,-63.70498576784221,30.828818056159044,-0.06884133589284558,0.28789270910279896,0.35673404499564454,34825054,44921238.6,63.111282510586264,57.917116835997334,NaN,NaN,5.859192624385418,5.234632500194386
2022-12-09T09:30:00-05:00,49.29,49.98,49.0401,49.44,6324987,5512203.95,48.11006301176164,53.67179770663744,NaN,NaN,-65.88458016651155,-6.551548336669006,-0.11248272399889503,0.21613063999702575,0.3286133639959208,41150041,42241063.4,58.41945780228522,58.0447754846388,NaN,NaN,4.580571240735598,5.141195177414559
2022-12-12T09:30:00-05:00,49.44,49.84,49.09,49.83,5129671,5305924.9,50.443105525513964,53.66277480285525,NaN,NaN,-54.373885411561176,-39.383032504999264,-0.11204678675255797,0.1885548805552233,0.30060166730778126,46279712,41393466.4,56.976863474291726,58.28024528526679,NaN,NaN,4.110354872139333,4.9939322766609555
2022-12-13T09:30:00-05:00,51.65,52.07,50.3,50.67,9909660,5529792.85,55.12325985231853,53.743219726761616,NaN,NaN,88.72115913685244,-26.150425997465153,-0.05503356243616536,0.23180971426257457,0.28684327669873994,56189372,43689998.6,59.86847640409294,58.987461409868594,NaN,NaN,5.008218232256794,4.995973127460361
2022-12-14T09:30:00-05:00,50,50.84,49.47,50.01,10321562,5597596.15,51.04427177322456,53.3333640331784,NaN,NaN,-0.7275939525097449,-19.193977232314428,-0.06114858120255939,0.2104075501955407,0.2715561313981001,45867810,44862397.8,61.29853283834454,59.874827628554904,NaN,NaN,4.6200219087339,4.942265810499438
2022-12-15T09:30:00-05:00,49.11,49.3,47.84,48.06,9817271,5819756.45,41.31644462798086,52.34288670301205,NaN,NaN,-154.0975675583753,-37.272493590421064,-0.18869601668675404,0.035686110539657534,0.22438212722641157,36050539,45107494.8,61.60654783177541,60.76545123393946,NaN,NaN,1.0546404692004117,4.386890761742435
2022-12-16T09:30:00-05:00,48.15,48.49,47.77,48.05,8563454,5892447.55,41.27300511016046,51.663627562391774,NaN,NaN,-160.88564578868667,-56.272706714856085,-0.26143234690501815,-0.1024083064048611,0.15902404050015703,27487085,42374903.6,56.23304612534406,61.24447947964864,NaN,NaN,-1.760245977785772,3.508728370381262
2022-12-19T09:30:00-05:00,47.69,47.79,46.68,46.81,5688212,5974391.1,36.191678124833366,50.61388504126775,NaN,NaN,-206.33209422970046,-86.66434847848396,-0.3739010488838406,-0.30835227060464376,0.06554877827919686,21798873,37478735.8,48.1321655332997,60.96501966245005,NaN,NaN,-5.914997233884299,2.162481855486182
2022-12-20T09:30:00-05:00,46.63,47.23,46.475,47.13,5743839,6101456.25,38.30268803053058,49.03346468884682,NaN,NaN,-186.2614258638521,-141.66086547862488,-0.4049696848564079,-0.440663327791313,-0.03569364293490511,27542712,31749403.8,40.736796165194704,59.88926908482343,NaN,NaN,-8.642543569840889,0.6189067947251721
2022-12-21T09:30:00-05:00,47.3,47.98,47.13,47.75,5863252,6120656,42.286653797353424,47.65520938779321,NaN,NaN,-123.49071029796193,-166.2134887477153,-0.36332136022739153,-0.4898453432191445,-0.126523982991753,33405964,29257034.6,38.001418206895515,58.33878399881983,NaN,NaN,-9.731831837521355,-0.8597701527386175
2022-12-22T09:30:00-05:00,47.26,47.37,46.48,47.34,4384277,6109579,40.42755003905048,46.107328019864326,NaN,NaN,-136.02770638914296,-162.59951651386882,-0.34318283831246077,-0.5555025308823289,-0.21231969256986818,29021687,27851264.2,36.51221041198809,56.339940570695276,NaN,NaN,-11.193050283127135,-2.3359530285084054
2022-12-23T09:30:00-05:00,47.15,47.82,47.06,47.8,3845538,6207066.8,43.432425811374166,45.14471088764156,NaN,NaN,-94.15973063655407,-149.2543334834423,-0.28127838799206506,-0.5639176775599495,-0.2826392895678844,32867225,28927292.2,38.49890986103476,54.19949503915034,NaN,NaN,-11.53894058959937,-3.650665537235686
2022-12-27T09:30:00-05:00,47.65,47.75,47.06,47.37,3905716,6218337.7,41.33358526399942,44.59683114905367,NaN,NaN,-89.7098205897488,-125.92987875545198,-0.2525976269203891,-0.5983863232183708,-0.3457886962979817,28961509,30359819.4,41.13966819001536,52.10930664736249,NaN,NaN,-12.438912035503964,-4.906129322702583
2022-12-28T09:30:00-05:00,47.2,47.625,46.67,46.68,6047789,6329573.95,38.147910516052555,43.908244984911406,NaN,NaN,-95.53213896833856,-107.78402137634926,-0.2622611950136715,-0.6736151900650711,-0.4113539950513996,22913720,29434021,39.94590991534878,50.03437751932123,NaN,NaN,-14.15910871397364,-6.227983521455591
2022-12-29T09:30:00-05:00,47.11,48.155,47.02,47.97,3466928,5987224.6,46.456551560618976,43.849228074626645,NaN,NaN,-56.268733399359384,-94.33962599662877,-0.16849494489431438,-0.6219726761692925,-0.45347773127497815,26380648,28028957.8,38.137201542151296,48.250514593004446,NaN,NaN,-13.110849782876482,-7.211250130230003
2022-12-30T09:30:00-05:00,47.38,48,47.22,47.99,4828551,5898439.1,46.57637284228321,43.73967877680677,NaN,NaN,-49.4555867245839,-77.02520206371696,-0.09548066924647403,-0.5728285678330707,-0.47734789858659665,31209199,28466460.2,39.062433450860965,46.86786999647414,NaN,NaN,-12.24074732042594,-7.929749728829423
2023-01-03T09:30:00-05:00,48.58,49.05,48.15,48.61,8578066,6107231.8,50.29015486635868,43.72875372972425,NaN,NaN,1.0607390988816077,-57.981108116629834,-0.0007926400950882817,-0.478338698705457,-0.4775460586103687,39787265,29850468.2,42.01681091536652,45.79929481369377,NaN,NaN,-10.38396196857842,-8.280351477364993
2023-01-04T09:30:00-05:00,49.28,49.83,48.8,49.52,5837371,6197439.35,55.211501223825366,43.735056684831875,NaN,NaN,56.00563167377845,-28.838017663924358,0.12102530400351014,-0.32626442860598104,-0.4472897326094912,45624636,33183093.6,48.49247271136764,44.98672312135625,NaN,NaN,-7.228665611938653,-8.130110639446945
2023-01-05T09:30:00-05:00,49.43,49.915,49.05,49.59,5407704,6177275.25,55.575837238723054,44.05873993236748,NaN,NaN,67.9085173516775,3.8501136000788536,0.19957917651740353,-0.19781576196273676,-0.3973949384801403,51032340,38806817.6,57.182573332867044,44.692726013822146,NaN,NaN,-4.574891903851181,-7.62222224864755
2023-01-06T09:30:00-05:00,50.05,50.535,49.35,50.4,4578619,6171161.35,59.66461466451363,45.369323506405536,NaN,NaN,99.24268540026175,34.952397360003076,0.2936682332361274,-0.03030964693498106,-0.32397788017110846,55610959,44652879.8,63.98497063565184,44.862613356956174,NaN,NaN,-1.0033595024614161,-6.676670427763817
2023-01-09T09:30:00-05:00,50.62,51.1,50.43,50.48,6430066,6233626.65,60.05565287541786,46.71094120392392,NaN,NaN,122.91820411371262,69.42715552766238,0.345305914726505,0.1076545132370228,-0.23765140148948222,62041025,50819245,69.49079996890458,45.80959577435335,NaN,NaN,2.0202789565291965,-5.43424908715053
2023-01-10T09:30:00-05:00,50.07,51.245,50.022,51.24,8684913,6351622.95,63.65999689385878,48.67296397314003,NaN,NaN,120.63175521665336,93.34135875121673,0.4102379534207579,0.27514604028646517,-0.13509191313429275,70725938,57006979.6,73.81647769604072,47.644189500263415,NaN,NaN,5.764025220445378,-3.834495614636829
2023-01-11T09:30:00-05:00,51.35,51.62,51.08,51.61,4098604,6300069.6,65.30154589123012,50.60145382033284,NaN,NaN,136.0002531042787,109.34028303731677,0.4542748887250952,0.4327516977720762,-0.021523190953018967,74824542,62846960.8,77.11446423349973,50.24259436228521,NaN,NaN,9.404284511380665,-1.9432413109200444
2023-01-12T09:30:00-05:00,51.75,52.35,51.15,52.18,4193903,6014281.75,67.72063407544985,52.418166697339736,NaN,NaN,150.65440979781164,125.8894615265436,0.4946348375155879,0.5967703559414659,0.102135518425878,79018445,68444181.8,79.74743766190484,53.22445289478588,NaN,NaN,13.269085061625251,0.2299481708721407
2023-01-13T09:30:00-05:00,51.85,52.43,51.7548,52.35,3712363,5683821.8,68.42761502682123,54.41817133932336,NaN,NaN,146.2647827328252,135.2938809930563,0.5039199488109125,0.7320354544395187,0.22811550562860616,82730808,73868151.6,81.91839755312861,56.467751976295915,NaN,NaN,16.678411238756013,2.5797286091412652
2023-01-17T09:30:00-05:00,52.22,52.28,51.54,51.86,3529873,5369451.9,64.07168678240781,55.89240426582576,NaN,NaN,114.9011262794868,133.69046542621112,0.4499730194913655,0.790581779992813,0.3406087605014475,79200935,77300133.6,83.14924336082578,59.65706151199527,NaN,NaN,18.415099361449585,4.841924430899597
2023-01-18T09:30:00-05:00,52.01,52.17,51.0812,51.23,5930257,5237792.05,58.88178176536409,57.14584687306609,NaN,NaN,87.96734212584026,127.1575828080485,0.3492614068345394,0.7771855190446217,0.42792411221008236,73270678,77809081.6,83.33046221755843,62.67068965681978,NaN,NaN,18.442050942036204,6.784799646776255
2023-01-19T09:30:00-05:00,50.97,51.755,50.8,51.49,7387450,5322753.95,60.310626305691784,58.728898000897466,NaN,NaN,74.89802981637536,114.93713815046786,0.2805197492011215,0.7785737987114842,0.49805404951036275,80658128,78975798.8,83.76158839834592,65.80038097703387,NaN,NaN,18.864018096162834,8.510402282402909
2023-01-20T09:30:00-05:00,51.91,53.1556,51.77,53.1,4874271,5279275.55,67.77761629163899,60.25183119597033,NaN,NaN,113.35386697912645,107.47702958673081,0.320934276200878,0.8992218947614603,0.5782876185605823,85532399,80278589.6,84.25138631654215,69.09425131806178,NaN,NaN,21.648587168355373,10.387285837538975
2023-01-23T09:30:00-05:00,53.15,54.155,53.02,54.03,6279040,5300064.95,71.15363032969918,62.007349587928616,NaN,NaN,136.90917465252784,105.60590797067134,0.3835197032050228,1.0576872475668608,0.674167544361838,91811439,82094715.8,84.93362777382524,72.37076519827352,NaN,NaN,25.16078668832437,12.497785959079746
2023-01-24T09:30:00-05:00,53.58,54.65,53.413,53.88,8866992,5524200.7,69.8818734027248,63.40675805481191,NaN,NaN,132.64252573235314,109.1541878612446,0.38692339340440607,1.1578217861173457,0.7708983927129396,82944447,82843418.2,85.21792913654133,75.45655935692886,NaN,NaN,27.55716850136926,14.649126322263962
2023-01-25T09:30:00-05:00,53.5,54.19,53.31,54.07,4976809,5580764.25,70.59871046743478,64.50584442935543,NaN,NaN,118.36590993610731,115.23390142329802,0.37387081946862166,1.2382369170487166,0.864366097580095,87921256,85773533.8,86.30693712049886,78.15759252900966,NaN,NaN,29.72037419727388,16.802161732979663
2023-01-26T09:30:00-05:00,54.45,54.92,54.11,54.91,4303637,5600660.3,73.5913169425857,65.79266440820278,NaN,NaN,135.595264728657,127.37334840575436,0.3918173697354296,1.354137809749382,0.9623204400139523,92224893,88086886.8,87.11408460219526,80.29555761967596,NaN,NaN,32.544809489300725,19.051111412454098
2023-01-27T09:30:00-05:00,54.8,55.5957,54.8,55.29,3764082,5486474.95,74.83898863082271,66.87654826293914,NaN,NaN,147.29066453267777,134.16070791646462,0.39800362628107155,1.4598249728652917,1.0618213465842201,95988975,90178202,87.81343659318088,81.9975909023566,NaN,NaN,35.270807855160605,21.36821090426931
2023-01-30T09:30:00-05:00,54.74,55.115,54.39,54.42,3857076,5505982.35,67.03083186175361,67.37477533339168,NaN,NaN,113.03160530512116,129.38519404698326,0.31581525422238665,1.4565904143622035,1.1407751601398168,92131899,90242294,87.83522641021813,83.30790707673614,NaN,NaN,35.2342054115015,23.349067262445338
2023-01-31T09:30:00-05:00,54.43,55.095,54.43,55.08,4265457,5477827.65,69.62031587821323,67.80051240370273,NaN,NaN,110.07212792821332,124.87111448615534,0.27946504612252787,1.4901064677929767,1.2106414216704489,96397356,92932875.8,88.74502241442342,84.37423169947776,NaN,NaN,36.001969938526415,25.156624787599778
2023-02-01T09:30:00-05:00,54.69,55.995,54.3,55.73,7523173,5425083,71.95642302047253,68.27586077007717,NaN,NaN,114.68095572806885,124.13412364454761,0.2724757151254633,1.5512360655772781,1.2787603504518148,103920529,96132730.4,89.72886819007671,85.27526055351898,NaN,NaN,37.37845938122098,26.902601158117093
2023-02-02T09:30:00-05:00,58.45,59.79,58.125,59.39,9444675,5605448.2,80.8745489654543,69.21542611936322,NaN,NaN,219.07117375285057,140.82930544938634,0.4757257461821358,1.8734175331794845,1.3976917869973486,113365204,100360792.6,90.86513502212055,86.06938179353439,NaN,NaN,42.42071093353414,29.119473983176672
2023-02-03T09:30:00-05:00,58.02,59.43,58.01,58.2,7829219,5726523.95,72.7714392776389,69.5256992801359,NaN,NaN,173.25242147996877,146.02165683884454,0.4894950891574186,2.009560648444122,1.5200655592867034,105535985,102270194.6,91.33152113518813,86.74174776368149,NaN,NaN,43.173876301590006,31.127245742950006
2023-02-06T09:30:00-05:00,57.52,57.98,57.17,57.5,5708272,5783006.6,68.4282285120207,69.83688083225111,NaN,NaN,126.38246523934959,148.69182882569024,0.41393479293049285,2.0374840504498195,1.6235492575193267,99827713,103809357.4,91.6994162188096,87.35247439639463,NaN,NaN,42.116589812641436,32.69715203862021
2023-02-07T09:30:00-05:00,57.39,58.7699,57.26,58.57,7167224,5819864.5,71.25258291606426,70.72050948587255,NaN,NaN,130.51464968621022,152.7803331772896,0.39835922887378006,2.121498293611552,1.7231390647377718,106994937,105928873.6,92.19091037887424,87.98536355077432,NaN,NaN,42.295385614287966,34.06832826371561
2023-02-08T09:30:00-05:00,57.63,57.81,56.43,56.73,6530462,5712141.95,61.125959519885946,70.7787475726007,NaN,NaN,82.37114106993155,146.31837024566215,0.23458008667743724,2.0163641730845683,1.781784086407131,100464475,105237662.8,90.31281534786459,88.4533083328828,NaN,NaN,38.57436750786773,34.712048155737335
2023-02-09T09:30:00-05:00,57.44,57.46,55.285,55.49,6056289,5810026.2,55.410577444231556,69.89538765492874,NaN,NaN,46.71365460185761,111.84686641546355,0.024251328972131114,1.8120982476222949,1.7878469186501638,94408186,101446259.2,80.61209760508497,88.19335913920727,NaN,NaN,33.44755579706127,34.53140639021218
2023-02-10T09:30:00-05:00,55.34,55.57,54.81,54.96,4483281,5824495.1,53.12418524753367,68.60757014905977,NaN,NaN,8.745068035086963,78.94539572648719,-0.158972777261303,1.589130947073535,1.748103724334838,89924905,98324043.2,73.6010029553212,87.38388593788557,NaN,NaN,28.691483385506633,33.69713167525425
2023-02-13T09:30:00-05:00,55.23,55.93,55.04,55.74,2956286,5786691.25,56.00157442481314,67.61612022206609,NaN,NaN,20.319617096973047,57.73282609801189,-0.23163983192688287,1.4585539344262344,1.6901937663531172,92881191,96934738.8,70.65620785010424,86.34376298885434,NaN,NaN,25.857005450468662,32.57711364314202
2023-02-14T09:30:00-05:00,55.46,55.94,54.97,55.76,5888055,5904600.35,56.07602558720123,66.57878558776368,NaN,NaN,13.855594265362324,34.401015013842326,-0.27917601190210806,1.3412237514754821,1.6203997633775902,98769246,95289600.6,67.22616649813534,84.98085080154264,NaN,NaN,23.694572711201854,31.308179224293426
2023-02-15T09:30:00-05:00,55.36,56.3,55.31,56.27,4233820,5819778.5,58.026474841032474,65.46701115193845,NaN,NaN,23.459063892155307,22.618599578287093,-0.2765617675099681,1.27469755399013,1.551259321500098,103003066,95797318.8,67.74655791930564,83.59745603847911,NaN,NaN,22.514234152495476,30.05190135689372
2023-02-16T09:30:00-05:00,55.28,56.11,55.16,55.41,5267652,5713788.6,53.69643919948862,63.956829049700296,NaN,NaN,-5.209478888123172,12.233972880290933,-0.3294511109297562,1.1394454328379027,1.4688965437676589,97735414,96462764.4,68.45357124037328,82.21460851327858,NaN,NaN,20.176428906836758,28.641119578314154
2023-02-17T09:30:00-05:00,54.99,55.395,54.725,55.35,4245115,5682330.8,53.39706103576022,62.98298827641505,NaN,NaN,-35.04194532564152,3.476570208145236,-0.36255146435227315,1.0157072133273175,1.3782586776795906,93490299,97175843.2,69.23189786416991,80.88579933141799,NaN,NaN,18.213670347598693,27.15148397392623
2023-02-21T09:30:00-05:00,54.79,55.08,54.11,54.13,4176444,5577201,47.5872917515107,61.409200838793446,NaN,NaN,-78.65922458835624,-16.319198128920625,-0.454715448903398,0.8098643665503431,1.264579815453741,89313855,96462376,67.43904653764596,79.36394391164818,NaN,NaN,14.696490042290842,25.372199126549745
2023-02-22T09:30:00-05:00,54.07,54.47,53.945,54.24,4410612,5354382,48.135229886363874,59.70768704349997,NaN,NaN,-92.6345396472386,-37.61722491144081,-0.49315410346430166,0.648137186123364,1.1412912895876657,93724467,95453420.2,64.88026353387323,77.58904357906219,NaN,NaN,12.004233836228801,23.462489799361038
2023-02-23T09:30:00-05:00,54.29,54.35,53.38,53.99,5151074,5363095.25,46.934301010678894,57.28338361815888,NaN,NaN,-110.84505241062168,-64.4780481719962,-0.5177541052487378,0.49409865802674346,1.0118527632754812,88573393,92567485.6,58.09089853605075,75.24802668720008,NaN,NaN,9.425252720511642,21.457170216668267
2023-02-24T09:30:00-05:00,53.16,53.37,52.845,53.24,4842339,5390030.35,43.43336888012558,55.18780716119363,NaN,NaN,-143.4944319072257,-92.13503877581671,-0.5631195004011005,0.30795338777410564,0.8710728881752061,83731054,89766613.6,52.36374636230039,72.46461420342239,NaN,NaN,6.166450798637472,19.272781728378153
2023-02-27T09:30:00-05:00,53.63,53.9,53.25,53.41,3659181,5384785.3,44.444923707387694,53.4747139608627,NaN,NaN,-112.94608394780893,-107.7158665002502,-0.5591263988862863,0.1721648895673482,0.7312912884536346,87390235,88546600.8,50.04910987402175,69.48959232165183,NaN,NaN,3.7280987471788722,17.05211273106397
2023-02-28T09:30:00-05:00,53.36,53.975,53.36,53.5,5728571,5478360.05,45.00561745598003,51.59993071371383,NaN,NaN,-102.5298610764894,-112.48999379787683,-0.5282367238158782,0.07099538368378688,0.599232107499665,93118806,89307591,51.48952274058914,66.5823503474886,NaN,NaN,1.8358968606786423,14.87836760672321
2023-03-01T09:30:00-05:00,53.4,53.62,53.01,53.09,7092339,5619704.15,42.88234128777828,50.29681512570614,NaN,NaN,-111.90018470352763,-116.34312280913464,-0.5128129588879446,-0.04178409111026582,0.47102886777767883,86026467,87767991,48.44574510334727,63.59184533002307,NaN,NaN,-0.3725767351011727,12.699661272176868
2023-03-02T09:30:00-05:00,52.76,53.705,52.74,53.59,4649358,5476013.4,46.21486215728931,49.63997831949598,NaN,NaN,-95.01684425196345,-113.17748117740298,-0.4486485875181609,-0.0897818666200223,0.3588667208981386,90675825,88188477.4,49.32679631468207,61.35718095213714,NaN,NaN,-1.4330815843344582,10.680698006960965
2023-03-03T09:30:00-05:00,54.07,54.825,53.94,54.76,5373298,5272444.55,53.10917373778953,49.638906068799976,NaN,NaN,-35.737101932799824,-91.62601518251782,-0.3135177550258136,-0.033030472884128415,0.28048728214168517,96049123,90652091.2,54.25906814739953,59.975614180142735,NaN,NaN,-0.44129102344184085,9.091842431189136
2023-03-06T09:30:00-05:00,55.09,55.515,54.75,54.76,5626379,5162302.55,53.10917373778952,49.43230601972686,NaN,NaN,-1.5164969885063062,-69.3400977906573,-0.2149423973678723,0.011809285431844785,0.22675168279971708,96049123,92383868.8,57.39814079981213,59.02860939083616,NaN,NaN,0.3705537216455969,7.845944044111487
2023-03-07T09:30:00-05:00,55.01,55.16,54.04,54.2,5464489,5150113.4,49.58126186041,48.96839432495606,NaN,NaN,-26.520129131787385,-54.13815140171689,-0.1796947808112987,0.0021332067855937,0.1818279875968924,90584634,91877034.4,56.182908711871804,58.23980526324591,NaN,NaN,0.12071545880826676,6.742339960496741
2023-03-08T09:30:00-05:00,54.16,54.46,53.84,54.23,4289371,5006220.75,49.77374685357891,48.378913754423664,NaN,NaN,-37.69336848128304,-39.296788157267976,-0.14792552141226092,-0.003078914168433755,0.14484660724382717,94874005,93646542,59.41372062473063,57.64460259934771,NaN,NaN,-0.03586994241641792,5.774024260080576
2023-03-09T09:30:00-05:00,54.3,54.66,52.825,53.01,6195518,4989473.55,42.64383138899561,47.58944176795988,NaN,NaN,-84.12074588175646,-37.11756848322658,-0.199436753553021,-0.1044493346974491,0.09498741885557191,88678487,93247074.4,58.367429574189224,56.92416390890599,NaN,NaN,-2.234799779398367,4.629906540155012
2023-03-10T09:30:00-05:00,52.89,53.165,51.97,52.26,13124314,5342874.8,38.94999567556551,46.55750852794597,NaN,NaN,-152.91375291374706,-60.552898679416025,-0.2699974217750407,-0.24250935836322896,0.02748806341181173,75554173,89148084.4,48.85933863770589,55.468981107015715,NaN,NaN,-5.262262786132049,3.2167394935425753
2023-03-13T09:30:00-04:00,51.85,52.97,51.37,52.26,15248659,5881143.7,38.94999567556551,45.9405588082356,NaN,NaN,-152.18311213694366,-90.68622170910349,-0.3003203740573802,-0.34791240415991354,-0.047592030102533336,75554173,85049094.4,41.567152912246165,53.620988705201434,NaN,NaN,-7.717302074252309,1.654733555286163
2023-03-14T09:30:00-04:00,53.17,53.84,53.05,53.74,10217994,6244229.1,49.05026795418995,46.005918670223174,NaN,NaN,-42.91557701333764,-93.96531128541355,-0.20869889292669253,-0.308465646260899,-0.09976675333420648,85772167,84086601,40.05541348098321,51.847785129994996,NaN,NaN,-6.920451611186806,0.4297071029328816
2023-03-15T09:30:00-04:00,53.28,54.39,53,54.32,12706533,6585153,52.375548780987586,46.39457922524522,NaN,NaN,-8.006947204185424,-88.02802702999404,-0.1024081832706556,-0.22777698242252598,-0.12536879915187038,98478700,84807540,41.76387260478728,50.681568992047616,NaN,NaN,-5.212887208278173,-0.37637779866869747
2023-03-16T09:30:00-04:00,54.18,55.61,54.03,55.54,11406755,6943799.75,58.50963898485474,47.471455661297306,NaN,NaN,104.99952745488096,-50.20397236266656,0.04858169380568604,-0.06464168189476283,-0.11322337570044887,109885455,89048933.6,50.671243416650746,50.56067592450121,NaN,NaN,-1.6671116374453816,-0.5607683470653666
2023-03-17T09:30:00-04:00,55.36,55.68,54.81,55.01,12332603,7297047.3,55.18429631483848,48.238553704686645,NaN,NaN,120.63894440924622,4.506567101932092,0.10788136501084777,0.021628330563110865,-0.08625303444773691,97552852,93448669.4,57.86991109911167,51.119304583436204,NaN,NaN,0.2019869996142371,-0.45180329753970894
2023-03-20T09:30:00-04:00,54.91,55.41,54.71,55.27,7192184,7444400.75,56.490687873965506,49.05891587739989,NaN,NaN,117.4458937906198,58.432368287444795,0.156772875720731,0.10971306020317684,-0.04705981551755416,104745036,99286842,65.13964864813079,52.09431357683204,NaN,NaN,2.1188745042580797,-0.08456361156859632
2023-03-21T09:30:00-04:00,55.88,56.56,55.65,56.45,5008704,7486013.75,61.916593949065486,50.418505353206115,NaN,NaN,188.2423310262421,104.66394989536074,0.25493271290753605,0.2716060756168659,0.016673362709329856,109753740,104083156.6,69.75675758936465,53.61652875440471,NaN,NaN,5.589385641235553,0.7260005674034249
2023-03-22T09:30:00-04:00,56.38,57.13,55.43,55.46,6751467,7603056.5,55.646607298286945,51.09220143470595,NaN,NaN,144.194561165553,135.10425156930842,0.23976190807257197,0.31637574780004485,0.07661383972747286,103002273,104987871.2,70.54912247689873,55.13240919456304,NaN,NaN,6.526007114655491,1.5545729312965773
2023-03-23T09:30:00-04:00,56.04,56.98,55.905,56.36,7071137,7699059.65,59.64720748694194,51.5592038453597,NaN,NaN,147.08640020661736,143.5216261196557,0.27442184978381656,0.4196411519572436,0.14521930217342702,110073410,105025462.2,70.58360850930218,56.2984477918418,NaN,NaN,8.642570130258209,2.5671439597196675
2023-03-24T09:30:00-04:00,56.37,56.725,55.98,56.65,5494602,7731672.8,60.87190047604118,52.113684326663375,NaN,NaN,130.90194829325776,145.57422689645801,0.29894356879662753,0.5188987631692115,0.2199551943725839,115568012,108628494.2,73.75572088239878,57.466846369169424,NaN,NaN,10.724838227041724,3.73252885505139
2023-03-27T09:30:00-04:00,56.65,56.87,56.11,56.33,3758345,7736631,58.752953898692724,52.76880518654072,NaN,NaN,114.6732055823034,145.01968925479474,0.2762152494090717,0.5652242561339236,0.28900900672485186,111809667,110041420.4,74.89883374068239,58.80369815694161,NaN,NaN,11.783015091413024,4.882598317388766
2023-03-28T09:30:00-04:00,56.22,56.22,55.58,55.87,4112988,7655851.85,55.748740733031966,53.195590463644514,NaN,NaN,73.29223303375166,122.02966965629665,0.21549895403611147,0.5583826992699912,0.3428837452338797,107696679,109630008.2,73.8896266224831,59.83769144249535,NaN,NaN,11.771796566660907,5.866769495856214
2023-03-29T09:30:00-04:00,56.39,56.67,56.15,56.61,4815667,7542018.25,59.349739275245945,54.38886959837668,NaN,NaN,98.18738944112229,112.82823531141051,0.21024541067125485,0.6056905085729483,0.3954450979016934,112512346,111532022.8,75.53112555915203,61.063669727135554,NaN,NaN,12.851185003146872,6.86454313975488
2023-03-30T09:30:00-04:00,56.74,56.96,56.6,56.88,6365129,7627806.8,60.60926804017321,55.93596048156295,NaN,NaN,108.68462662967642,105.1478805960223,0.20955675138377433,0.6573910371314113,0.447834285747637,118877475,113292835.8,76.97431754189215,63.071882506006,NaN,NaN,14.110837232184611,7.899728010101985
2023-03-31T09:30:00-04:00,57,58.02,56.98,57.97,9690947,7843689.25,65.28556681038802,57.817072705478836,NaN,NaN,138.82852331188317,106.73319559974739,0.2636182357624097,0.7773570804506491,0.5137388446882394,128568422,115892917.8,78.94876751680323,65.74199783490293,NaN,NaN,16.68958862635623,9.15542238385259
2023-04-03T09:30:00-04:00,57.55,58.24,57.49,58.21,8983852,8011562.9,66.23602112527996,59.04462650341384,NaN,NaN,133.75722062918604,110.54999860912395,0.29431620363212263,0.8816340992283926,0.58731789559627,137552274,121041439.2,82.20307607686088,68.75254516317992,NaN,NaN,19.081159090363677,10.57338477049703
2023-04-04T09:30:00-04:00,58.25,58.56,57.97,58.39,9755165,8226096.7,66.9665231128575,60.086838955690254,NaN,NaN,131.64156667562733,122.21986533749907,0.30426126778767304,0.9676444803308613,0.6633832125431882,147307439,128963591.2,85.83238062981182,71.90029573639596,NaN,NaN,21.261418819579745,12.100246777508847
2023-04-05T09:30:00-04:00,58.42,58.48,57.79,58.2,12243036,8623779.95,65.35906598584523,60.576083741475294,NaN,NaN,113.12033981176147,125.20645541162692,0.27637146866171614,1.0088475483703334,0.7324760797086173,135064403,133474002.6,87.406966974005,74.52427599049268,NaN,NaN,22.639783142078407,13.605894829590213
2023-04-06T09:30:00-04:00,58.11,59.105,57.76,58.93,10713878,8849697.95,68.48875478351935,61.52640220352392,NaN,NaN,124.69173497428382,128.4078770805484,0.28431188380087735,1.087865934459714,0.8035540506588366,145778281,138854163.8,88.98024461201275,76.74644266998563,NaN,NaN,24.765008431910417,15.200053915635955
2023-04-10T09:30:00-04:00,58.49,58.815,58.19,58.8,4791217,8433043.1,67.32227947550092,62.300087317919306,NaN,NaN,119.31587494925213,124.50534740802217,0.25876253823555173,1.1270072234532762,0.8682446852177245,140987064,141337892.2,89.6246669308074,78.49537254731966,NaN,NaN,26.209229269437223,16.77279325189328
2023-04-11T09:30:00-04:00,58.91,59.07,58.575,58.65,17443777,8542799,65.92702838501204,62.58654692048692,NaN,NaN,118.99966431689117,121.55383614556322,0.2116956729346957,1.132864276386094,0.9211686034513984,123543287,138536094.8,83.67987128116411,79.48988066816248,NaN,NaN,27.052560317548114,18.241331404129685
2023-04-12T09:30:00-04:00,59.03,59.16,57.98,58.04,5886171,8326207.85,60.441111078600784,62.929011476223614,NaN,NaN,88.15886636195056,112.85729608282786,0.12377074336423033,1.0758820326566862,0.9521112892924559,117657116,132606030.2,72.69002596678172,79.64280234601128,NaN,NaN,26.289006030216388,19.390999207856357
2023-04-13T09:30:00-04:00,58.55,59.275,58.48,59.25,5416191,7961690.75,66.41166296915364,63.41218686781018,NaN,NaN,109.02535934389003,112.03829998925357,0.13071199034674041,1.1155012772258814,0.984789286879141,123073307,130207811,68.75721572150604,79.51234571831154,NaN,NaN,27.357328980272516,20.529046318201523
2023-04-14T09:30:00-04:00,58.89,59.43,58.66,59.23,4906214,7636663.7,66.23372081090534,63.79517403458618,NaN,NaN,103.45217883418604,107.79038876123403,0.11795600173067067,1.1322342890424792,1.0142782873118086,118167093,124685573.4,60.62364726865334,78.57434046018686,NaN,NaN,28.168203817703187,21.620354532416048
2023-04-17T09:30:00-04:00,58.58,58.94,58.4,58.89,6479072,7343987.15,63.13666017697597,64.10829591160642,NaN,NaN,76.01172442671432,99.12955865672646,0.07283235943215982,1.1053187366020083,1.0324863771698485,111688021,118825764.8,53.40438546515567,77.03902272622067,NaN,NaN,27.980579203506274,22.52895805685751
2023-04-18T09:30:00-04:00,59.13,59.2,58.4709,58.59,4380286,7203392.25,60.45070390336425,64.444150423773,NaN,NaN,71.47501770392577,89.62462933413337,0.01217346163680677,1.047703204215857,1.0355297425790502,107307735,115578654.4,49.861063813975804,75.3226968113273,NaN,NaN,27.06692730720362,23.177239378335525
2023-04-19T09:30:00-04:00,57.942,58.395,57.82,58.15,4409512,7173432.65,56.64450709547011,64.25091955378902,NaN,NaN,26.595603665277803,77.31197679479882,-0.0640050123955227,0.9555234770846468,1.0195284894801695,102898223,112626875.8,46.819928063244724,73.27189699019105,NaN,NaN,25.193763848847333,23.465314302694356
2023-04-20T09:30:00-04:00,57.54,58.1002,57.4,57.55,4414239,7056571.25,51.85022301245716,63.62527348038073,NaN,NaN,-10.263110667888418,53.45428279244313,-0.15598240050199197,0.8245504888526796,0.9805328893546715,98483984,107709011.2,42.201639543753394,70.78813427603828,NaN,NaN,22.138664739916887,23.27579293658329
2023-04-21T09:30:00-04:00,57.4,57.765,57.21,57.69,7125252,7059277,52.852948307278716,62.73722930158721,NaN,NaN,-26.522695762912452,27.45930787302341,-0.20546004853652677,0.7237078286840131,0.9291678772205398,105609236,105197439.8,40.02999140111761,68.00822169634645,NaN,NaN,19.87405223599393,22.789829979356238